"d1_code"	"d2_code"	"d1_name"	"d2_name"	"direction_yes_no"	"n_dir12"	"n_dir21"	"n_total"
"O82"	"K66"	"Encounter for cesarean delivery without indication"	"Other disorders of peritoneum"	1	205	50	255
"K27"	"F03"	"Peptic ulcer, site unspecified"	"Unspecified dementia"	1	555	347	902
"K80"	"G62"	"Cholelithiasis"	"Other and unspecified polyneuropathies"	1	804	326	1130
"O73"	"K43"	"Retained placenta and membranes, without hemorrhage"	"Ventral hernia"	1	28	0	28
"O20"	"O41"	"Hemorrhage in early pregnancy"	"Other disorders of amniotic fluid and membranes"	1	1564	618	2182
"D27"	"B96"	"Benign neoplasm of ovary"	"Oth bacterial agents as the cause of diseases classd elswhr"	1	32	3	35
"N81"	"K57"	"Female genital prolapse"	"Diverticular disease of intestine"	1	4430	0	4430
"O75"	"N95"	"Oth complications of labor and delivery, NEC"	"Menopausal and other perimenopausal disorders"	1	33	0	33
"M72"	"C20"	"Fibroblastic disorders"	"Malignant neoplasm of rectum"	1	304	70	374
"Q54"	"E66"	"Hypospadias"	"Overweight and obesity"	1	77	15	92
"M51"	"D53"	"Thoracic, thoracolum, and lumbosacral intvrt disc disorders"	"Other nutritional anemias"	1	71	1	72
"J03"	"F43"	"Acute tonsillitis"	"Reaction to severe stress, and adjustment disorders"	1	366	144	510
"M20"	"D63"	"Acquired deformities of fingers and toes"	"Anemia in chronic diseases classified elsewhere"	1	280	0	280
"N80"	"I46"	"Endometriosis"	"Cardiac arrest"	1	25	0	25
"H02"	"K55"	"Other disorders of eyelid"	"Vascular disorders of intestine"	1	126	38	164
"K00"	"K30"	"Disorders of tooth development and eruption"	"Functional dyspepsia"	1	91	29	120
"K40"	"H35"	"Inguinal hernia"	"Other retinal disorders"	1	2850	804	3654
"J43"	"C79"	"Emphysema"	"Secondary malignant neoplasm of other and unspecified sites"	1	274	38	312
"M47"	"E55"	"Spondylosis"	"Vitamin D deficiency"	1	449	216	665
"N75"	"I63"	"Diseases of Bartholin's gland"	"Cerebral infarction"	1	68	6	74
"J30"	"M05"	"Vasomotor and allergic rhinitis"	"Rheumatoid arthritis with rheumatoid factor"	1	98	14	112
"K21"	"M80"	"Gastro-esophageal reflux disease"	"Osteoporosis with current pathological fracture"	1	1500	364	1864
"H65"	"O99"	"Nonsuppurative otitis media"	"Oth maternal diseases classd elsw but compl preg/chldbrth"	1	440	0	440
"E11"	"C83"	"Type 2 diabetes mellitus"	"Non-follicular lymphoma"	1	462	261	723
"K59"	"A41"	"Other functional intestinal disorders"	"Other sepsis"	1	7971	5946	13917
"M70"	"I61"	"Soft tissue disorders related to use, overuse and pressure"	"Nontraumatic intracerebral hemorrhage"	1	321	57	378
"M75"	"C13"	"Shoulder lesions"	"Malignant neoplasm of hypopharynx"	1	53	7	60
"M22"	"E21"	"Disorder of patella"	"Hyperparathyroidism and other disorders of parathyroid gland"	1	72	0	72
"N92"	"C82"	"Excessive, frequent and irregular menstruation"	"Follicular lymphoma"	1	67	0	67
"J40"	"J15"	"Bronchitis, not specified as acute or chronic"	"Bacterial pneumonia, not elsewhere classified"	1	456	310	766
"M65"	"H33"	"Synovitis and tenosynovitis"	"Retinal detachments and breaks"	1	341	196	537
"C64"	"F41"	"Malignant neoplasm of kidney, except renal pelvis"	"Other anxiety disorders"	1	422	95	517
"D14"	"M19"	"Benign neoplasm of middle ear and respiratory system"	"Other and unspecified osteoarthritis"	1	255	137	392
"I83"	"C21"	"Varicose veins of lower extremities"	"Malignant neoplasm of anus and anal canal"	1	44	5	49
"J00"	"M22"	"Acute nasopharyngitis [common cold]"	"Disorder of patella"	1	58	0	58
"O70"	"H93"	"Perineal laceration during delivery"	"Other disorders of ear, not elsewhere classified"	1	569	77	646
"N81"	"B34"	"Female genital prolapse"	"Viral infection of unspecified site"	1	207	107	314
"B18"	"A41"	"Chronic viral hepatitis"	"Other sepsis"	1	522	318	840
"M79"	"B44"	"Oth and unsp soft tissue disorders, not elsewhere classified"	"Aspergillosis"	1	52	8	60
"L21"	"J15"	"Seborrheic dermatitis"	"Bacterial pneumonia, not elsewhere classified"	1	230	80	310
"Q17"	"G44"	"Other congenital malformations of ear"	"Other headache syndromes"	1	120	9	129
"H25"	"C92"	"Age-related cataract"	"Myeloid leukemia"	1	518	185	703
"J44"	"D46"	"Other chronic obstructive pulmonary disease"	"Myelodysplastic syndromes"	1	458	206	664
"K86"	"J81"	"Other diseases of pancreas"	"Pulmonary edema"	1	140	57	197
"K90"	"M85"	"Intestinal malabsorption"	"Other disorders of bone density and structure"	1	333	205	538
"M05"	"N13"	"Rheumatoid arthritis with rheumatoid factor"	"Obstructive and reflux uropathy"	1	151	66	217
"N20"	"J15"	"Calculus of kidney and ureter"	"Bacterial pneumonia, not elsewhere classified"	1	1508	282	1790
"N63"	"B95"	"Unspecified lump in breast"	"Strep as the cause of diseases classified elsewhere"	1	27	2	29
"L02"	"I44"	"Cutaneous abscess, furuncle and carbuncle"	"Atrioventricular and left bundle-branch block"	1	430	182	612
"O82"	"H26"	"Encounter for cesarean delivery without indication"	"Other cataract"	1	117	0	117
"D30"	"J22"	"Benign neoplasm of urinary organs"	"Unspecified acute lower respiratory infection"	1	146	14	160
"O62"	"F51"	"Abnormalities of forces of labor"	"Sleep disorders not due to a substance or known physiol cond"	1	45	0	45
"O68"	"K30"	"Labor and delivery comp by abnlt of fetal acid-base balance"	"Functional dyspepsia"	1	834	316	1150
"M70"	"J93"	"Soft tissue disorders related to use, overuse and pressure"	"Pneumothorax and air leak"	1	206	84	290
"B27"	"N87"	"Infectious mononucleosis"	"Dysplasia of cervix uteri"	1	79	0	79
"H83"	"A04"	"Other diseases of inner ear"	"Other bacterial intestinal infections"	1	156	0	156
"J32"	"G45"	"Chronic sinusitis"	"Transient cerebral ischemic attacks and related syndromes"	1	229	106	335
"J34"	"L30"	"Other and unspecified disorders of nose and nasal sinuses"	"Other and unspecified dermatitis"	1	287	105	392
"M23"	"E11"	"Internal derangement of knee"	"Type 2 diabetes mellitus"	1	4314	1492	5806
"I20"	"I26"	"Angina pectoris"	"Pulmonary embolism"	1	4763	0	4763
"N81"	"C16"	"Female genital prolapse"	"Malignant neoplasm of stomach"	1	151	0	151
"I63"	"J90"	"Cerebral infarction"	"Pleural effusion, not elsewhere classified"	1	1013	513	1526
"J32"	"H91"	"Chronic sinusitis"	"Other and unspecified hearing loss"	1	699	391	1090
"M20"	"E89"	"Acquired deformities of fingers and toes"	"Postproc endocrine and metabolic comp and disorders, NEC"	1	105	36	141
"J00"	"J11"	"Acute nasopharyngitis [common cold]"	"Influenza due to unidentified influenza virus"	1	478	141	619
"Q21"	"L20"	"Congenital malformations of cardiac septa"	"Atopic dermatitis"	1	180	57	237
"O26"	"I26"	"Maternal care for oth conditions predom related to pregnancy"	"Pulmonary embolism"	1	166	24	190
"K40"	"H33"	"Inguinal hernia"	"Retinal detachments and breaks"	1	591	357	948
"C73"	"D64"	"Malignant neoplasm of thyroid gland"	"Other anemias"	1	105	34	139
"L03"	"A41"	"Cellulitis and acute lymphangitis"	"Other sepsis"	1	1490	336	1826
"N84"	"I26"	"Polyp of female genital tract"	"Pulmonary embolism"	1	208	89	297
"D27"	"E21"	"Benign neoplasm of ovary"	"Hyperparathyroidism and other disorders of parathyroid gland"	1	133	11	144
"E11"	"G47"	"Type 2 diabetes mellitus"	"Sleep disorders"	1	4130	2505	6635
"I83"	"M70"	"Varicose veins of lower extremities"	"Soft tissue disorders related to use, overuse and pressure"	1	1305	582	1887
"J30"	"J47"	"Vasomotor and allergic rhinitis"	"Bronchiectasis"	1	198	63	261
"M77"	"C50"	"Other enthesopathies"	"Malignant neoplasm of breast"	1	493	233	726
"N83"	"J18"	"Noninflammatory disord of ovary, fallop and broad ligament"	"Pneumonia, unspecified organism"	1	1611	652	2263
"O47"	"H91"	"False labor"	"Other and unspecified hearing loss"	1	140	31	171
"O80"	"A86"	"Encounter for full-term uncomplicated delivery"	"Unspecified viral encephalitis"	1	94	22	116
"F17"	"E87"	"Nicotine dependence"	"Other disorders of fluid, electrolyte and acid-base balance"	1	1863	1090	2953
"I35"	"I51"	"Nonrheumatic aortic valve disorders"	"Complications and ill-defined descriptions of heart disease"	1	1495	961	2456
"J42"	"I61"	"Unspecified chronic bronchitis"	"Nontraumatic intracerebral hemorrhage"	1	383	181	564
"D25"	"G93"	"Leiomyoma of uterus"	"Other disorders of brain"	1	93	25	118
"M17"	"H18"	"Osteoarthritis of knee"	"Other disorders of cornea"	1	525	283	808
"I48"	"E53"	"Atrial fibrillation and flutter"	"Deficiency of other B group vitamins"	1	787	579	1366
"D24"	"J18"	"Benign neoplasm of breast"	"Pneumonia, unspecified organism"	1	1362	124	1486
"O00"	"O80"	"Ectopic pregnancy"	"Encounter for full-term uncomplicated delivery"	1	4294	3771	8065
"K44"	"E16"	"Diaphragmatic hernia"	"Other disorders of pancreatic internal secretion"	1	353	191	544
"Q18"	"J96"	"Other congenital malformations of face and neck"	"Respiratory failure, not elsewhere classified"	1	112	19	131
"M23"	"G90"	"Internal derangement of knee"	"Disorders of autonomic nervous system"	1	145	44	189
"N60"	"A49"	"Benign mammary dysplasia"	"Bacterial infection of unspecified site"	1	231	0	231
"M50"	"D50"	"Cervical disc disorders"	"Iron deficiency anemia"	1	362	76	438
"O70"	"H80"	"Perineal laceration during delivery"	"Otosclerosis"	1	232	68	300
"C50"	"E23"	"Malignant neoplasm of breast"	"Hypofunction and other disorders of the pituitary gland"	1	80	20	100
"D17"	"I51"	"Benign lipomatous neoplasm"	"Complications and ill-defined descriptions of heart disease"	1	158	39	197
"K51"	"M07"	"Ulcerative colitis"	"Enteropathic arthropathies"	1	617	72	689
"K61"	"E66"	"Abscess of anal and rectal regions"	"Overweight and obesity"	1	1225	722	1947
"M23"	"M94"	"Internal derangement of knee"	"Other disorders of cartilage"	1	1692	1153	2845
"M62"	"K59"	"Other disorders of muscle"	"Other functional intestinal disorders"	1	7957	0	7957
"M65"	"I42"	"Synovitis and tenosynovitis"	"Cardiomyopathy"	1	290	60	350
"O14"	"M20"	"Pre-eclampsia"	"Acquired deformities of fingers and toes"	1	132	28	160
"O14"	"M70"	"Pre-eclampsia"	"Soft tissue disorders related to use, overuse and pressure"	1	110	19	129
"O68"	"M25"	"Labor and delivery comp by abnlt of fetal acid-base balance"	"Other joint disorder, not elsewhere classified"	1	1205	139	1344
"O80"	"K11"	"Encounter for full-term uncomplicated delivery"	"Diseases of salivary glands"	1	465	74	539
"O82"	"J32"	"Encounter for cesarean delivery without indication"	"Chronic sinusitis"	1	407	96	503
"M17"	"J69"	"Osteoarthritis of knee"	"Pneumonitis due to solids and liquids"	1	471	0	471
"M65"	"N28"	"Synovitis and tenosynovitis"	"Oth disorders of kidney and ureter, not elsewhere classified"	1	198	53	251
"O62"	"M02"	"Abnormalities of forces of labor"	"Postinfective and reactive arthropathies"	1	307	148	455
"M19"	"D61"	"Other and unspecified osteoarthritis"	"Oth aplastic anemias and other bone marrow failure syndromes"	1	83	28	111
"D25"	"F01"	"Leiomyoma of uterus"	"Vascular dementia"	1	25	0	25
"I70"	"N18"	"Atherosclerosis"	"Chronic kidney disease (CKD)"	1	4157	2119	6276
"O24"	"N63"	"Diabetes in pregnancy, childbirth, and the puerperium"	"Unspecified lump in breast"	1	137	57	194
"K51"	"L88"	"Ulcerative colitis"	"Pyoderma gangrenosum"	1	129	22	151
"C50"	"H53"	"Malignant neoplasm of breast"	"Visual disturbances"	1	391	173	564
"N81"	"K22"	"Female genital prolapse"	"Other diseases of esophagus"	1	445	162	607
"O70"	"A40"	"Perineal laceration during delivery"	"Streptococcal sepsis"	1	73	15	88
"M21"	"C34"	"Other acquired deformities of limbs"	"Malignant neoplasm of bronchus and lung"	1	323	8	331
"Q53"	"J34"	"Undescended and ectopic testicle"	"Other and unspecified disorders of nose and nasal sinuses"	1	76	0	76
"G45"	"C15"	"Transient cerebral ischemic attacks and related syndromes"	"Malignant neoplasm of esophagus"	1	268	16	284
"F50"	"O26"	"Eating disorders"	"Maternal care for oth conditions predom related to pregnancy"	1	165	40	205
"O23"	"E11"	"Infections of genitourinary tract in pregnancy"	"Type 2 diabetes mellitus"	1	231	24	255
"E11"	"B95"	"Type 2 diabetes mellitus"	"Strep as the cause of diseases classified elsewhere"	1	337	104	441
"H65"	"O20"	"Nonsuppurative otitis media"	"Hemorrhage in early pregnancy"	1	156	77	233
"M47"	"I48"	"Spondylosis"	"Atrial fibrillation and flutter"	1	3727	1356	5083
"O48"	"K56"	"Late pregnancy"	"Paralytic ileus and intestinal obstruction without hernia"	1	84	0	84
"G40"	"O75"	"Epilepsy and recurrent seizures"	"Oth complications of labor and delivery, NEC"	1	182	23	205
"H35"	"J84"	"Other retinal disorders"	"Other interstitial pulmonary diseases"	1	471	262	733
"M75"	"K82"	"Shoulder lesions"	"Other diseases of gallbladder"	1	121	44	165
"K80"	"M79"	"Cholelithiasis"	"Oth and unsp soft tissue disorders, not elsewhere classified"	1	4184	3420	7604
"N35"	"C15"	"Urethral stricture"	"Malignant neoplasm of esophagus"	1	41	6	47
"L05"	"M81"	"Pilonidal cyst and sinus"	"Osteoporosis without current pathological fracture"	1	80	1	81
"N95"	"I21"	"Menopausal and other perimenopausal disorders"	"Acute myocardial infarction"	1	747	461	1208
"H80"	"M21"	"Otosclerosis"	"Other acquired deformities of limbs"	1	57	11	68
"O30"	"D64"	"Multiple gestation"	"Other anemias"	1	106	11	117
"K35"	"D64"	"Acute appendicitis"	"Other anemias"	1	1081	198	1279
"K35"	"E68"	"Acute appendicitis"	"Sequelae of hyperalimentation"	1	160	1	161
"K09"	"G47"	"Cysts of oral region, not elsewhere classified"	"Sleep disorders"	1	94	21	115
"K44"	"K57"	"Diaphragmatic hernia"	"Diverticular disease of intestine"	1	4011	2780	6791
"M31"	"I51"	"Other necrotizing vasculopathies"	"Complications and ill-defined descriptions of heart disease"	1	147	41	188
"M45"	"D64"	"Ankylosing spondylitis"	"Other anemias"	1	139	34	173
"M18"	"A49"	"Osteoarthritis of first carpometacarpal joint"	"Bacterial infection of unspecified site"	1	208	44	252
"N40"	"F41"	"Benign prostatic hyperplasia"	"Other anxiety disorders"	1	753	58	811
"N92"	"M46"	"Excessive, frequent and irregular menstruation"	"Other inflammatory spondylopathies"	1	270	70	340
"N97"	"G45"	"Female infertility"	"Transient cerebral ischemic attacks and related syndromes"	1	123	0	123
"G40"	"K57"	"Epilepsy and recurrent seizures"	"Diverticular disease of intestine"	1	828	489	1317
"O26"	"M31"	"Maternal care for oth conditions predom related to pregnancy"	"Other necrotizing vasculopathies"	1	28	0	28
"O30"	"E65"	"Multiple gestation"	"Localized adiposity"	1	490	23	513
"M20"	"M79"	"Acquired deformities of fingers and toes"	"Oth and unsp soft tissue disorders, not elsewhere classified"	1	3144	2435	5579
"D41"	"F03"	"Neoplasm of uncertain behavior of urinary organs"	"Unspecified dementia"	1	73	23	96
"I80"	"C80"	"Phlebitis and thrombophlebitis"	"Malignant neoplasm without specification of site"	1	325	139	464
"I10"	"C91"	"Essential (primary) hypertension"	"Lymphoid leukemia"	1	957	627	1584
"G56"	"E34"	"Mononeuropathies of upper limb"	"Other endocrine disorders"	1	156	54	210
"I25"	"J96"	"Chronic ischemic heart disease"	"Respiratory failure, not elsewhere classified"	1	16953	0	16953
"M02"	"C79"	"Postinfective and reactive arthropathies"	"Secondary malignant neoplasm of other and unspecified sites"	1	103	0	103
"M23"	"N18"	"Internal derangement of knee"	"Chronic kidney disease (CKD)"	1	1363	0	1363
"J35"	"O60"	"Chronic diseases of tonsils and adenoids"	"Preterm labor"	1	135	5	140
"C83"	"D63"	"Non-follicular lymphoma"	"Anemia in chronic diseases classified elsewhere"	1	499	200	699
"D25"	"G20"	"Leiomyoma of uterus"	"Parkinson's disease"	1	59	0	59
"D50"	"D63"	"Iron deficiency anemia"	"Anemia in chronic diseases classified elsewhere"	1	1895	987	2882
"H83"	"D22"	"Other diseases of inner ear"	"Melanocytic nevi"	1	111	11	122
"H91"	"K22"	"Other and unspecified hearing loss"	"Other diseases of esophagus"	1	1855	805	2660
"J35"	"G51"	"Chronic diseases of tonsils and adenoids"	"Facial nerve disorders"	1	243	41	284
"N92"	"K81"	"Excessive, frequent and irregular menstruation"	"Cholecystitis"	1	468	133	601
"O82"	"M81"	"Encounter for cesarean delivery without indication"	"Osteoporosis without current pathological fracture"	1	193	0	193
"Q76"	"M79"	"Congenital malformations of spine and bony thorax"	"Oth and unsp soft tissue disorders, not elsewhere classified"	1	194	63	257
"L68"	"E55"	"Hypertrichosis"	"Vitamin D deficiency"	1	82	18	100
"J44"	"F33"	"Other chronic obstructive pulmonary disease"	"Major depressive disorder, recurrent"	1	2587	1718	4305
"N87"	"M18"	"Dysplasia of cervix uteri"	"Osteoarthritis of first carpometacarpal joint"	1	112	0	112
"J34"	"E64"	"Other and unspecified disorders of nose and nasal sinuses"	"Sequelae of malnutrition and other nutritional deficiencies"	1	69	8	77
"D03"	"C34"	"Melanoma in situ"	"Malignant neoplasm of bronchus and lung"	1	58	9	67
"J06"	"H92"	"Acute upper resp infections of multiple and unsp sites"	"Otalgia and effusion of ear"	1	608	293	901
"K35"	"F33"	"Acute appendicitis"	"Major depressive disorder, recurrent"	1	519	139	658
"O70"	"M72"	"Perineal laceration during delivery"	"Fibroblastic disorders"	1	440	0	440
"Q38"	"O80"	"Other congenital malformations of tongue, mouth and pharynx"	"Encounter for full-term uncomplicated delivery"	1	30	1	31
"C44"	"F03"	"Other and unspecified malignant neoplasm of skin"	"Unspecified dementia"	1	1716	543	2259
"M72"	"M10"	"Fibroblastic disorders"	"Gout"	1	403	158	561
"K57"	"I44"	"Diverticular disease of intestine"	"Atrioventricular and left bundle-branch block"	1	1111	676	1787
"O65"	"N71"	"Obstructed labor due to maternal pelvic abnormality"	"Inflammatory disease of uterus, except cervix"	1	415	98	513
"G51"	"I48"	"Facial nerve disorders"	"Atrial fibrillation and flutter"	1	572	258	830
"O32"	"N84"	"Maternal care for malpresentation of fetus"	"Polyp of female genital tract"	1	265	1	266
"O65"	"N12"	"Obstructed labor due to maternal pelvic abnormality"	"Tubulo-interstitial nephritis, not spcf as acute or chronic"	1	31	0	31
"M50"	"K72"	"Cervical disc disorders"	"Hepatic failure, not elsewhere classified"	1	85	2	87
"N97"	"I25"	"Female infertility"	"Chronic ischemic heart disease"	1	64	0	64
"O71"	"A46"	"Other obstetric trauma"	"Erysipelas"	1	92	0	92
"M16"	"H25"	"Osteoarthritis of hip"	"Age-related cataract"	1	17215	0	17215
"O99"	"H02"	"Oth maternal diseases classd elsw but compl preg/chldbrth"	"Other disorders of eyelid"	1	374	88	462
"M16"	"J70"	"Osteoarthritis of hip"	"Respiratory conditions due to other external agents"	1	43	7	50
"G63"	"F05"	"Polyneuropathy in diseases classified elsewhere"	"Delirium due to known physiological condition"	1	90	23	113
"M35"	"O72"	"Other systemic involvement of connective tissue"	"Postpartum hemorrhage"	1	831	161	992
"D27"	"K30"	"Benign neoplasm of ovary"	"Functional dyspepsia"	1	456	308	764
"G35"	"I70"	"Multiple sclerosis"	"Atherosclerosis"	1	186	33	219
"M16"	"L57"	"Osteoarthritis of hip"	"Skin changes due to chronic expsr to nonionizing radiation"	1	657	114	771
"D48"	"E78"	"Neoplasm of uncertain behavior of other and unsp sites"	"Disorders of lipoprotein metabolism and other lipidemias"	1	194	21	215
"O80"	"I78"	"Encounter for full-term uncomplicated delivery"	"Diseases of capillaries"	1	563	29	592
"J35"	"I46"	"Chronic diseases of tonsils and adenoids"	"Cardiac arrest"	1	86	0	86
"K30"	"C20"	"Functional dyspepsia"	"Malignant neoplasm of rectum"	1	244	102	346
"O03"	"O48"	"Spontaneous abortion"	"Late pregnancy"	1	3164	1972	5136
"O42"	"N18"	"Premature rupture of membranes"	"Chronic kidney disease (CKD)"	1	39	0	39
"O66"	"M76"	"Other obstructed labor"	"Enthesopathies, lower limb, excluding foot"	1	65	9	74
"O44"	"O72"	"Placenta previa"	"Postpartum hemorrhage"	1	2336	1493	3829
"M48"	"J95"	"Other spondylopathies"	"Intraop and postproc comp and disorders of resp sys, NEC"	1	149	34	183
"I25"	"E50"	"Chronic ischemic heart disease"	"Vitamin A deficiency"	1	599	199	798
"O36"	"N64"	"Maternal care for other fetal problems"	"Other disorders of breast"	1	704	346	1050
"C61"	"I61"	"Malignant neoplasm of prostate"	"Nontraumatic intracerebral hemorrhage"	1	439	244	683
"M67"	"H25"	"Other disorders of synovium and tendon"	"Age-related cataract"	1	1895	547	2442
"O20"	"I25"	"Hemorrhage in early pregnancy"	"Chronic ischemic heart disease"	1	91	0	91
"M12"	"M05"	"Other and unspecified arthropathy"	"Rheumatoid arthritis with rheumatoid factor"	1	253	85	338
"C19"	"N39"	"Malignant neoplasm of rectosigmoid junction"	"Other disorders of urinary system"	1	74	5	79
"J42"	"I51"	"Unspecified chronic bronchitis"	"Complications and ill-defined descriptions of heart disease"	1	305	145	450
"D25"	"M46"	"Leiomyoma of uterus"	"Other inflammatory spondylopathies"	1	122	24	146
"C16"	"C77"	"Malignant neoplasm of stomach"	"Secondary and unspecified malignant neoplasm of lymph nodes"	1	560	288	848
"E78"	"I71"	"Disorders of lipoprotein metabolism and other lipidemias"	"Aortic aneurysm and dissection"	1	3396	1614	5010
"M32"	"J18"	"Systemic lupus erythematosus (SLE)"	"Pneumonia, unspecified organism"	1	401	190	591
"I20"	"G95"	"Angina pectoris"	"Other and unspecified diseases of spinal cord"	1	704	17	721
"M42"	"M23"	"Spinal osteochondrosis"	"Internal derangement of knee"	1	287	73	360
"M47"	"C78"	"Spondylosis"	"Secondary malignant neoplasm of resp and digestive organs"	1	1014	12	1026
"O20"	"M17"	"Hemorrhage in early pregnancy"	"Osteoarthritis of knee"	1	307	0	307
"O23"	"E78"	"Infections of genitourinary tract in pregnancy"	"Disorders of lipoprotein metabolism and other lipidemias"	1	113	0	113
"M50"	"A41"	"Cervical disc disorders"	"Other sepsis"	1	920	0	920
"N88"	"J18"	"Other noninflammatory disorders of cervix uteri"	"Pneumonia, unspecified organism"	1	99	4	103
"M70"	"D12"	"Soft tissue disorders related to use, overuse and pressure"	"Benign neoplasm of colon, rectum, anus and anal canal"	1	1558	539	2097
"K76"	"E13"	"Other diseases of liver"	"Other specified diabetes mellitus"	1	156	77	233
"O68"	"H93"	"Labor and delivery comp by abnlt of fetal acid-base balance"	"Other disorders of ear, not elsewhere classified"	1	377	19	396
"I47"	"D35"	"Paroxysmal tachycardia"	"Benign neoplasm of other and unspecified endocrine glands"	1	137	49	186
"A87"	"O72"	"Viral meningitis"	"Postpartum hemorrhage"	1	138	51	189
"H66"	"A63"	"Suppurative and unspecified otitis media"	"Oth predominantly sexually transmitted diseases, NEC"	1	107	22	129
"O20"	"K20"	"Hemorrhage in early pregnancy"	"Esophagitis"	1	121	8	129
"O66"	"D64"	"Other obstructed labor"	"Other anemias"	1	91	0	91
"H36"	"J18"	"Retinal disorders in diseases classified elsewhere"	"Pneumonia, unspecified organism"	1	2752	1266	4018
"I70"	"B95"	"Atherosclerosis"	"Strep as the cause of diseases classified elsewhere"	1	208	53	261
"Q25"	"A09"	"Congenital malformations of great arteries"	"Infectious gastroenteritis and colitis, unspecified"	1	678	157	835
"H65"	"O90"	"Nonsuppurative otitis media"	"Complications of the puerperium, not elsewhere classified"	1	38	5	43
"H35"	"E63"	"Other retinal disorders"	"Other nutritional deficiencies"	1	102	15	117
"M51"	"F22"	"Thoracic, thoracolum, and lumbosacral intvrt disc disorders"	"Delusional disorders"	1	71	11	82
"K21"	"D69"	"Gastro-esophageal reflux disease"	"Purpura and other hemorrhagic conditions"	1	346	169	515
"K61"	"I21"	"Abscess of anal and rectal regions"	"Acute myocardial infarction"	1	510	231	741
"E66"	"I27"	"Overweight and obesity"	"Other pulmonary heart diseases"	1	890	463	1353
"M20"	"J44"	"Acquired deformities of fingers and toes"	"Other chronic obstructive pulmonary disease"	1	1851	493	2344
"N81"	"I46"	"Female genital prolapse"	"Cardiac arrest"	1	349	0	349
"G56"	"C15"	"Mononeuropathies of upper limb"	"Malignant neoplasm of esophagus"	1	192	1	193
"H33"	"K59"	"Retinal detachments and breaks"	"Other functional intestinal disorders"	1	893	174	1067
"J36"	"A63"	"Peritonsillar abscess"	"Oth predominantly sexually transmitted diseases, NEC"	1	221	70	291
"G56"	"I21"	"Mononeuropathies of upper limb"	"Acute myocardial infarction"	1	1909	1193	3102
"H80"	"I25"	"Otosclerosis"	"Chronic ischemic heart disease"	1	754	71	825
"L02"	"M17"	"Cutaneous abscess, furuncle and carbuncle"	"Osteoarthritis of knee"	1	1621	1337	2958
"O80"	"K71"	"Encounter for full-term uncomplicated delivery"	"Toxic liver disease"	1	104	16	120
"D24"	"M25"	"Benign neoplasm of breast"	"Other joint disorder, not elsewhere classified"	1	628	181	809
"M02"	"I21"	"Postinfective and reactive arthropathies"	"Acute myocardial infarction"	1	269	135	404
"M35"	"K65"	"Other systemic involvement of connective tissue"	"Peritonitis"	1	244	119	363
"C54"	"L89"	"Malignant neoplasm of corpus uteri"	"Pressure ulcer"	1	95	3	98
"G35"	"C50"	"Multiple sclerosis"	"Malignant neoplasm of breast"	1	149	20	169
"I83"	"D14"	"Varicose veins of lower extremities"	"Benign neoplasm of middle ear and respiratory system"	1	210	109	319
"N70"	"J18"	"Salpingitis and oophoritis"	"Pneumonia, unspecified organism"	1	545	8	553
"N70"	"M51"	"Salpingitis and oophoritis"	"Thoracic, thoracolum, and lumbosacral intvrt disc disorders"	1	610	20	630
"N94"	"M23"	"Pain and oth cond assoc w fem gntl org and menstrual cycle"	"Internal derangement of knee"	1	1240	942	2182
"K29"	"G31"	"Gastritis and duodenitis"	"Oth degenerative diseases of nervous system, NEC"	1	374	111	485
"K51"	"K59"	"Ulcerative colitis"	"Other functional intestinal disorders"	1	2115	1710	3825
"A15"	"G47"	"Respiratory tuberculosis"	"Sleep disorders"	1	43	0	43
"O70"	"G47"	"Perineal laceration during delivery"	"Sleep disorders"	1	543	0	543
"G43"	"M10"	"Migraine"	"Gout"	1	111	45	156
"I83"	"M72"	"Varicose veins of lower extremities"	"Fibroblastic disorders"	1	884	450	1334
"K40"	"G95"	"Inguinal hernia"	"Other and unspecified diseases of spinal cord"	1	488	6	494
"M06"	"B37"	"Other rheumatoid arthritis"	"Candidiasis"	1	368	112	480
"M31"	"M81"	"Other necrotizing vasculopathies"	"Osteoporosis without current pathological fracture"	1	1913	800	2713
"H66"	"K85"	"Suppurative and unspecified otitis media"	"Acute pancreatitis"	1	87	24	111
"I20"	"F17"	"Angina pectoris"	"Nicotine dependence"	1	2657	919	3576
"D17"	"E55"	"Benign lipomatous neoplasm"	"Vitamin D deficiency"	1	145	25	170
"N46"	"K70"	"Male infertility"	"Alcoholic liver disease"	1	34	3	37
"A63"	"I80"	"Oth predominantly sexually transmitted diseases, NEC"	"Phlebitis and thrombophlebitis"	1	234	53	287
"M50"	"D46"	"Cervical disc disorders"	"Myelodysplastic syndromes"	1	49	0	49
"M76"	"C77"	"Enthesopathies, lower limb, excluding foot"	"Secondary and unspecified malignant neoplasm of lymph nodes"	1	141	19	160
"N80"	"E21"	"Endometriosis"	"Hyperparathyroidism and other disorders of parathyroid gland"	1	58	0	58
"Q85"	"H57"	"Phakomatoses, not elsewhere classified"	"Other disorders of eye and adnexa"	1	187	81	268
"H25"	"C38"	"Age-related cataract"	"Malignant neoplasm of heart, mediastinum and pleura"	1	130	29	159
"N87"	"K56"	"Dysplasia of cervix uteri"	"Paralytic ileus and intestinal obstruction without hernia"	1	229	18	247
"M62"	"M19"	"Other disorders of muscle"	"Other and unspecified osteoarthritis"	1	4361	0	4361
"J45"	"E87"	"Asthma"	"Other disorders of fluid, electrolyte and acid-base balance"	1	3250	0	3250
"M17"	"M46"	"Osteoarthritis of knee"	"Other inflammatory spondylopathies"	1	347	182	529
"H25"	"K22"	"Age-related cataract"	"Other diseases of esophagus"	1	1941	1462	3403
"M06"	"E55"	"Other rheumatoid arthritis"	"Vitamin D deficiency"	1	225	95	320
"K01"	"O02"	"Embedded and impacted teeth"	"Other abnormal products of conception"	1	150	16	166
"K85"	"C79"	"Acute pancreatitis"	"Secondary malignant neoplasm of other and unspecified sites"	1	282	24	306
"I47"	"D68"	"Paroxysmal tachycardia"	"Other coagulation defects"	1	615	121	736
"J38"	"I48"	"Diseases of vocal cords and larynx, not elsewhere classified"	"Atrial fibrillation and flutter"	1	924	398	1322
"D07"	"I63"	"Carcinoma in situ of other and unspecified genital organs"	"Cerebral infarction"	1	92	28	120
"Q25"	"J45"	"Congenital malformations of great arteries"	"Asthma"	1	1046	262	1308
"A63"	"G96"	"Oth predominantly sexually transmitted diseases, NEC"	"Other disorders of central nervous system"	1	172	3	175
"M62"	"F34"	"Other disorders of muscle"	"Persistent mood [affective] disorders"	1	268	55	323
"N43"	"D69"	"Hydrocele and spermatocele"	"Purpura and other hemorrhagic conditions"	1	126	33	159
"O02"	"M99"	"Other abnormal products of conception"	"Biomechanical lesions, not elsewhere classified"	1	100	0	100
"K02"	"I08"	"Dental caries"	"Multiple valve diseases"	1	65	14	79
"I45"	"A41"	"Other conduction disorders"	"Other sepsis"	1	1009	356	1365
"G45"	"D46"	"Transient cerebral ischemic attacks and related syndromes"	"Myelodysplastic syndromes"	1	140	29	169
"O62"	"I82"	"Abnormalities of forces of labor"	"Other venous embolism and thrombosis"	1	163	0	163
"O82"	"F43"	"Encounter for cesarean delivery without indication"	"Reaction to severe stress, and adjustment disorders"	1	963	128	1091
"N95"	"B96"	"Menopausal and other perimenopausal disorders"	"Oth bacterial agents as the cause of diseases classd elswhr"	1	61	5	66
"M72"	"N18"	"Fibroblastic disorders"	"Chronic kidney disease (CKD)"	1	690	13	703
"N92"	"F06"	"Excessive, frequent and irregular menstruation"	"Other mental disorders due to known physiological condition"	1	115	1	116
"H35"	"I87"	"Other retinal disorders"	"Other disorders of veins"	1	265	155	420
"M51"	"D18"	"Thoracic, thoracolum, and lumbosacral intvrt disc disorders"	"Hemangioma and lymphangioma, any site"	1	228	122	350
"H71"	"F17"	"Cholesteatoma of middle ear"	"Nicotine dependence"	1	99	6	105
"H65"	"I35"	"Nonsuppurative otitis media"	"Nonrheumatic aortic valve disorders"	1	273	9	282
"O80"	"J32"	"Encounter for full-term uncomplicated delivery"	"Chronic sinusitis"	1	1228	55	1283
"F50"	"O47"	"Eating disorders"	"False labor"	1	123	31	154
"O64"	"K05"	"Obstructed labor due to malposition and malpresent of fetus"	"Gingivitis and periodontal diseases"	1	28	0	28
"O63"	"I63"	"Long labor"	"Cerebral infarction"	1	31	0	31
"H10"	"F32"	"Conjunctivitis"	"Depressive episode"	1	679	184	863
"O04"	"K45"	"Complications following (induced) termination of pregnancy"	"Other abdominal hernia"	1	251	0	251
"J03"	"E66"	"Acute tonsillitis"	"Overweight and obesity"	1	1656	683	2339
"C32"	"K04"	"Malignant neoplasm of larynx"	"Diseases of pulp and periapical tissues"	1	631	305	936
"H65"	"K29"	"Nonsuppurative otitis media"	"Gastritis and duodenitis"	1	449	172	621
"J45"	"M00"	"Asthma"	"Pyogenic arthritis"	1	227	102	329
"N46"	"K42"	"Male infertility"	"Umbilical hernia"	1	129	41	170
"N95"	"C56"	"Menopausal and other perimenopausal disorders"	"Malignant neoplasm of ovary"	1	640	91	731
"C20"	"F03"	"Malignant neoplasm of rectum"	"Unspecified dementia"	1	437	134	571
"N13"	"C34"	"Obstructive and reflux uropathy"	"Malignant neoplasm of bronchus and lung"	1	439	230	669
"M23"	"C80"	"Internal derangement of knee"	"Malignant neoplasm without specification of site"	1	149	0	149
"C61"	"E55"	"Malignant neoplasm of prostate"	"Vitamin D deficiency"	1	194	64	258
"O14"	"G43"	"Pre-eclampsia"	"Migraine"	1	354	140	494
"J36"	"N17"	"Peritonsillar abscess"	"Acute kidney failure"	1	45	0	45
"I83"	"J18"	"Varicose veins of lower extremities"	"Pneumonia, unspecified organism"	1	8247	0	8247
"O08"	"O24"	"Complications following ectopic and molar pregnancy"	"Diabetes in pregnancy, childbirth, and the puerperium"	1	383	198	581
"N46"	"H26"	"Male infertility"	"Other cataract"	1	58	16	74
"N97"	"D32"	"Female infertility"	"Benign neoplasm of meninges"	1	25	0	25
"E16"	"F03"	"Other disorders of pancreatic internal secretion"	"Unspecified dementia"	1	993	489	1482
"Q74"	"O68"	"Other congenital malformations of limb(s)"	"Labor and delivery comp by abnlt of fetal acid-base balance"	1	35	0	35
"I70"	"D62"	"Atherosclerosis"	"Acute posthemorrhagic anemia"	1	1088	563	1651
"A63"	"M48"	"Oth predominantly sexually transmitted diseases, NEC"	"Other spondylopathies"	1	117	4	121
"O04"	"O86"	"Complications following (induced) termination of pregnancy"	"Other puerperal infections"	1	780	399	1179
"O99"	"F17"	"Oth maternal diseases classd elsw but compl preg/chldbrth"	"Nicotine dependence"	1	1662	1183	2845
"O04"	"M35"	"Complications following (induced) termination of pregnancy"	"Other systemic involvement of connective tissue"	1	662	141	803
"C09"	"K12"	"Malignant neoplasm of tonsil"	"Stomatitis and related lesions"	1	444	92	536
"J36"	"F60"	"Peritonsillar abscess"	"Specific personality disorders"	1	41	3	44
"J35"	"J30"	"Chronic diseases of tonsils and adenoids"	"Vasomotor and allergic rhinitis"	1	1561	752	2313
"H65"	"K20"	"Nonsuppurative otitis media"	"Esophagitis"	1	122	53	175
"H65"	"M46"	"Nonsuppurative otitis media"	"Other inflammatory spondylopathies"	1	35	3	38
"K60"	"L98"	"Fissure and fistula of anal and rectal regions"	"Oth disorders of skin, subcu, not elsewhere classified"	1	288	132	420
"K43"	"F03"	"Ventral hernia"	"Unspecified dementia"	1	632	50	682
"K40"	"F98"	"Inguinal hernia"	"Oth behav/emotn disord w onset usly occur in chldhd and adol"	1	164	49	213
"M20"	"E13"	"Acquired deformities of fingers and toes"	"Other specified diabetes mellitus"	1	85	21	106
"K20"	"D64"	"Esophagitis"	"Other anemias"	1	2202	1545	3747
"K25"	"F03"	"Gastric ulcer"	"Unspecified dementia"	1	2518	922	3440
"H25"	"I63"	"Age-related cataract"	"Cerebral infarction"	1	18996	0	18996
"M23"	"I15"	"Internal derangement of knee"	"Secondary hypertension"	1	535	240	775
"Q21"	"E06"	"Congenital malformations of cardiac septa"	"Thyroiditis"	1	31	2	33
"E86"	"F41"	"Volume depletion"	"Other anxiety disorders"	1	1773	1450	3223
"H10"	"F33"	"Conjunctivitis"	"Major depressive disorder, recurrent"	1	392	23	415
"O36"	"J15"	"Maternal care for other fetal problems"	"Bacterial pneumonia, not elsewhere classified"	1	245	32	277
"O46"	"O82"	"Antepartum hemorrhage, not elsewhere classified"	"Encounter for cesarean delivery without indication"	1	4461	3036	7497
"E20"	"A41"	"Hypoparathyroidism"	"Other sepsis"	1	152	70	222
"H83"	"G12"	"Other diseases of inner ear"	"Spinal muscular atrophy and related syndromes"	1	48	0	48
"D36"	"J15"	"Benign neoplasm of other and unspecified sites"	"Bacterial pneumonia, not elsewhere classified"	1	73	9	82
"J34"	"D62"	"Other and unspecified disorders of nose and nasal sinuses"	"Acute posthemorrhagic anemia"	1	75	13	88
"E28"	"O34"	"Ovarian dysfunction"	"Maternal care for abnormality of pelvic organs"	1	567	184	751
"O42"	"K64"	"Premature rupture of membranes"	"Hemorrhoids and perianal venous thrombosis"	1	554	0	554
"K00"	"M54"	"Disorders of tooth development and eruption"	"Dorsalgia"	1	319	75	394
"L20"	"O26"	"Atopic dermatitis"	"Maternal care for oth conditions predom related to pregnancy"	1	174	44	218
"I21"	"A41"	"Acute myocardial infarction"	"Other sepsis"	1	10988	0	10988
"N20"	"E78"	"Calculus of kidney and ureter"	"Disorders of lipoprotein metabolism and other lipidemias"	1	2730	1029	3759
"J35"	"M77"	"Chronic diseases of tonsils and adenoids"	"Other enthesopathies"	1	664	32	696
"K62"	"J90"	"Other diseases of anus and rectum"	"Pleural effusion, not elsewhere classified"	1	712	272	984
"K00"	"E78"	"Disorders of tooth development and eruption"	"Disorders of lipoprotein metabolism and other lipidemias"	1	63	8	71
"N20"	"M15"	"Calculus of kidney and ureter"	"Polyosteoarthritis"	1	197	89	286
"J20"	"K65"	"Acute bronchitis"	"Peritonitis"	1	153	60	213
"K30"	"J91"	"Functional dyspepsia"	"Pleural effusion in conditions classified elsewhere"	1	279	36	315
"C53"	"F41"	"Malignant neoplasm of cervix uteri"	"Other anxiety disorders"	1	223	37	260
"K41"	"C34"	"Femoral hernia"	"Malignant neoplasm of bronchus and lung"	1	170	14	184
"N20"	"D72"	"Calculus of kidney and ureter"	"Other disorders of white blood cells"	1	82	18	100
"H20"	"I69"	"Iridocyclitis"	"Sequelae of cerebrovascular disease"	1	313	55	368
"M70"	"I50"	"Soft tissue disorders related to use, overuse and pressure"	"Heart failure"	1	1718	701	2419
"L02"	"M50"	"Cutaneous abscess, furuncle and carbuncle"	"Cervical disc disorders"	1	544	386	930
"N46"	"I63"	"Male infertility"	"Cerebral infarction"	1	102	0	102
"C61"	"K56"	"Malignant neoplasm of prostate"	"Paralytic ileus and intestinal obstruction without hernia"	1	881	467	1348
"O48"	"M62"	"Late pregnancy"	"Other disorders of muscle"	1	788	244	1032
"H10"	"J81"	"Conjunctivitis"	"Pulmonary edema"	1	171	14	185
"O24"	"M07"	"Diabetes in pregnancy, childbirth, and the puerperium"	"Enteropathic arthropathies"	1	51	6	57
"K40"	"E25"	"Inguinal hernia"	"Adrenogenital disorders"	1	87	9	96
"O42"	"K45"	"Premature rupture of membranes"	"Other abdominal hernia"	1	96	0	96
"I69"	"E86"	"Sequelae of cerebrovascular disease"	"Volume depletion"	1	13330	9722	23052
"M23"	"D12"	"Internal derangement of knee"	"Benign neoplasm of colon, rectum, anus and anal canal"	1	5651	0	5651
"M20"	"C64"	"Acquired deformities of fingers and toes"	"Malignant neoplasm of kidney, except renal pelvis"	1	134	13	147
"O66"	"C53"	"Other obstructed labor"	"Malignant neoplasm of cervix uteri"	1	33	0	33
"O20"	"K90"	"Hemorrhage in early pregnancy"	"Intestinal malabsorption"	1	108	0	108
"M17"	"G93"	"Osteoarthritis of knee"	"Other disorders of brain"	1	308	81	389
"M31"	"N28"	"Other necrotizing vasculopathies"	"Oth disorders of kidney and ureter, not elsewhere classified"	1	133	57	190
"O75"	"F17"	"Oth complications of labor and delivery, NEC"	"Nicotine dependence"	1	212	30	242
"M17"	"E16"	"Osteoarthritis of knee"	"Other disorders of pancreatic internal secretion"	1	657	178	835
"M22"	"D84"	"Disorder of patella"	"Other immunodeficiencies"	1	31	0	31
"H33"	"C16"	"Retinal detachments and breaks"	"Malignant neoplasm of stomach"	1	61	1	62
"O65"	"M05"	"Obstructed labor due to maternal pelvic abnormality"	"Rheumatoid arthritis with rheumatoid factor"	1	55	0	55
"O80"	"J43"	"Encounter for full-term uncomplicated delivery"	"Emphysema"	1	57	0	57
"E10"	"L28"	"Type 1 diabetes mellitus"	"Lichen simplex chronicus and prurigo"	1	186	76	262
"B34"	"M08"	"Viral infection of unspecified site"	"Juvenile arthritis"	1	180	62	242
"H71"	"O99"	"Cholesteatoma of middle ear"	"Oth maternal diseases classd elsw but compl preg/chldbrth"	1	100	18	118
"H81"	"C45"	"Disorders of vestibular function"	"Mesothelioma"	1	34	1	35
"N48"	"D63"	"Other disorders of penis"	"Anemia in chronic diseases classified elsewhere"	1	115	7	122
"D27"	"F05"	"Benign neoplasm of ovary"	"Delirium due to known physiological condition"	1	86	0	86
"E66"	"H35"	"Overweight and obesity"	"Other retinal disorders"	1	1848	1165	3013
"G56"	"I69"	"Mononeuropathies of upper limb"	"Sequelae of cerebrovascular disease"	1	2380	480	2860
"I15"	"I51"	"Secondary hypertension"	"Complications and ill-defined descriptions of heart disease"	1	261	151	412
"O70"	"M47"	"Perineal laceration during delivery"	"Spondylosis"	1	446	0	446
"I25"	"J18"	"Chronic ischemic heart disease"	"Pneumonia, unspecified organism"	1	53658	0	53658
"C18"	"C92"	"Malignant neoplasm of colon"	"Myeloid leukemia"	1	63	18	81
"F10"	"G97"	"Alcohol related disorders"	"Intraop and postproc comp and disorders of nervous sys, NEC"	1	51	9	60
"G12"	"E64"	"Spinal muscular atrophy and related syndromes"	"Sequelae of malnutrition and other nutritional deficiencies"	1	86	21	107
"O30"	"B34"	"Multiple gestation"	"Viral infection of unspecified site"	1	114	45	159
"O42"	"M25"	"Premature rupture of membranes"	"Other joint disorder, not elsewhere classified"	1	535	116	651
"I63"	"N17"	"Cerebral infarction"	"Acute kidney failure"	1	1717	771	2488
"M81"	"E64"	"Osteoporosis without current pathological fracture"	"Sequelae of malnutrition and other nutritional deficiencies"	1	874	604	1478
"O21"	"G45"	"Excessive vomiting in pregnancy"	"Transient cerebral ischemic attacks and related syndromes"	1	34	1	35
"D23"	"M19"	"Other benign neoplasms of skin"	"Other and unspecified osteoarthritis"	1	839	397	1236
"H65"	"O80"	"Nonsuppurative otitis media"	"Encounter for full-term uncomplicated delivery"	1	539	235	774
"M43"	"J96"	"Other deforming dorsopathies"	"Respiratory failure, not elsewhere classified"	1	637	32	669
"H80"	"A41"	"Otosclerosis"	"Other sepsis"	1	267	0	267
"O36"	"I80"	"Maternal care for other fetal problems"	"Phlebitis and thrombophlebitis"	1	297	135	432
"A02"	"C78"	"Other salmonella infections"	"Secondary malignant neoplasm of resp and digestive organs"	1	52	7	59
"A02"	"C79"	"Other salmonella infections"	"Secondary malignant neoplasm of other and unspecified sites"	1	35	4	39
"A02"	"O62"	"Other salmonella infections"	"Abnormalities of forces of labor"	1	80	23	103
"A02"	"O68"	"Other salmonella infections"	"Labor and delivery comp by abnlt of fetal acid-base balance"	1	45	5	50
"A02"	"O70"	"Other salmonella infections"	"Perineal laceration during delivery"	1	92	6	98
"A02"	"O72"	"Other salmonella infections"	"Postpartum hemorrhage"	1	69	0	69
"A02"	"O80"	"Other salmonella infections"	"Encounter for full-term uncomplicated delivery"	1	136	56	192
"A04"	"O72"	"Other bacterial intestinal infections"	"Postpartum hemorrhage"	1	318	50	368
"A08"	"C34"	"Viral and other specified intestinal infections"	"Malignant neoplasm of bronchus and lung"	1	201	77	278
"A08"	"C78"	"Viral and other specified intestinal infections"	"Secondary malignant neoplasm of resp and digestive organs"	1	220	61	281
"A08"	"E73"	"Viral and other specified intestinal infections"	"Lactose intolerance"	1	103	20	123
"A08"	"F33"	"Viral and other specified intestinal infections"	"Major depressive disorder, recurrent"	1	297	105	402
"A08"	"K52"	"Viral and other specified intestinal infections"	"Other and unsp noninfective gastroenteritis and colitis"	1	1160	802	1962
"A08"	"K58"	"Viral and other specified intestinal infections"	"Irritable bowel syndrome"	1	364	192	556
"A08"	"O70"	"Viral and other specified intestinal infections"	"Perineal laceration during delivery"	1	639	138	777
"A09"	"A49"	"Infectious gastroenteritis and colitis, unspecified"	"Bacterial infection of unspecified site"	1	2167	957	3124
"A09"	"B96"	"Infectious gastroenteritis and colitis, unspecified"	"Oth bacterial agents as the cause of diseases classd elswhr"	1	328	138	466
"A09"	"C78"	"Infectious gastroenteritis and colitis, unspecified"	"Secondary malignant neoplasm of resp and digestive organs"	1	1090	438	1528
"A09"	"C79"	"Infectious gastroenteritis and colitis, unspecified"	"Secondary malignant neoplasm of other and unspecified sites"	1	628	288	916
"A09"	"D63"	"Infectious gastroenteritis and colitis, unspecified"	"Anemia in chronic diseases classified elsewhere"	1	758	497	1255
"A09"	"E41"	"Infectious gastroenteritis and colitis, unspecified"	"Nutritional marasmus"	1	190	67	257
"A09"	"E55"	"Infectious gastroenteritis and colitis, unspecified"	"Vitamin D deficiency"	1	633	313	946
"A09"	"E66"	"Infectious gastroenteritis and colitis, unspecified"	"Overweight and obesity"	1	2512	1467	3979
"A09"	"F03"	"Infectious gastroenteritis and colitis, unspecified"	"Unspecified dementia"	1	2127	1073	3200
"A09"	"F12"	"Infectious gastroenteritis and colitis, unspecified"	"Cannabis related disorders"	1	160	58	218
"A09"	"F33"	"Infectious gastroenteritis and colitis, unspecified"	"Major depressive disorder, recurrent"	1	1019	517	1536
"A09"	"G95"	"Infectious gastroenteritis and colitis, unspecified"	"Other and unspecified diseases of spinal cord"	1	199	110	309
"A09"	"H50"	"Infectious gastroenteritis and colitis, unspecified"	"Other strabismus"	1	756	403	1159
"A09"	"I35"	"Infectious gastroenteritis and colitis, unspecified"	"Nonrheumatic aortic valve disorders"	1	1012	757	1769
"A09"	"I95"	"Infectious gastroenteritis and colitis, unspecified"	"Hypotension"	1	1057	629	1686
"A09"	"J06"	"Infectious gastroenteritis and colitis, unspecified"	"Acute upper resp infections of multiple and unsp sites"	1	3615	2728	6343
"A09"	"J90"	"Infectious gastroenteritis and colitis, unspecified"	"Pleural effusion, not elsewhere classified"	1	503	301	804
"A09"	"J96"	"Infectious gastroenteritis and colitis, unspecified"	"Respiratory failure, not elsewhere classified"	1	3138	1616	4754
"A09"	"K52"	"Infectious gastroenteritis and colitis, unspecified"	"Other and unsp noninfective gastroenteritis and colitis"	1	5602	4727	10329
"A09"	"K59"	"Infectious gastroenteritis and colitis, unspecified"	"Other functional intestinal disorders"	1	8272	5016	13288
"A09"	"K63"	"Infectious gastroenteritis and colitis, unspecified"	"Other diseases of intestine"	1	741	432	1173
"A09"	"K90"	"Infectious gastroenteritis and colitis, unspecified"	"Intestinal malabsorption"	1	627	309	936
"A09"	"L30"	"Infectious gastroenteritis and colitis, unspecified"	"Other and unspecified dermatitis"	1	847	461	1308
"A09"	"L57"	"Infectious gastroenteritis and colitis, unspecified"	"Skin changes due to chronic expsr to nonionizing radiation"	1	332	109	441
"A09"	"L90"	"Infectious gastroenteritis and colitis, unspecified"	"Atrophic disorders of skin"	1	497	175	672
"A09"	"M08"	"Infectious gastroenteritis and colitis, unspecified"	"Juvenile arthritis"	1	151	67	218
"A09"	"M80"	"Infectious gastroenteritis and colitis, unspecified"	"Osteoporosis with current pathological fracture"	1	1138	897	2035
"A09"	"N28"	"Infectious gastroenteritis and colitis, unspecified"	"Oth disorders of kidney and ureter, not elsewhere classified"	1	503	269	772
"A09"	"N39"	"Infectious gastroenteritis and colitis, unspecified"	"Other disorders of urinary system"	1	5013	3511	8524
"A09"	"N47"	"Infectious gastroenteritis and colitis, unspecified"	"Disorders of prepuce"	1	1182	488	1670
"A09"	"N50"	"Infectious gastroenteritis and colitis, unspecified"	"Other and unspecified disorders of male genital organs"	1	338	129	467
"A09"	"O32"	"Infectious gastroenteritis and colitis, unspecified"	"Maternal care for malpresentation of fetus"	1	313	165	478
"A09"	"O47"	"Infectious gastroenteritis and colitis, unspecified"	"False labor"	1	599	370	969
"A09"	"O63"	"Infectious gastroenteritis and colitis, unspecified"	"Long labor"	1	280	143	423
"A09"	"O68"	"Infectious gastroenteritis and colitis, unspecified"	"Labor and delivery comp by abnlt of fetal acid-base balance"	1	1142	647	1789
"A09"	"O70"	"Infectious gastroenteritis and colitis, unspecified"	"Perineal laceration during delivery"	1	2006	892	2898
"A09"	"O72"	"Infectious gastroenteritis and colitis, unspecified"	"Postpartum hemorrhage"	1	3117	0	3117
"A09"	"O82"	"Infectious gastroenteritis and colitis, unspecified"	"Encounter for cesarean delivery without indication"	1	1230	724	1954
"A09"	"O99"	"Infectious gastroenteritis and colitis, unspecified"	"Oth maternal diseases classd elsw but compl preg/chldbrth"	1	2118	751	2869
"A09"	"Q17"	"Infectious gastroenteritis and colitis, unspecified"	"Other congenital malformations of ear"	1	193	69	262
"A09"	"Q53"	"Infectious gastroenteritis and colitis, unspecified"	"Undescended and ectopic testicle"	1	657	481	1138
"A09"	"Q55"	"Infectious gastroenteritis and colitis, unspecified"	"Other congenital malformations of male genital organs"	1	144	65	209
"A15"	"B90"	"Respiratory tuberculosis"	"Sequelae of tuberculosis"	1	477	111	588
"A15"	"D50"	"Respiratory tuberculosis"	"Iron deficiency anemia"	1	82	14	96
"A15"	"D64"	"Respiratory tuberculosis"	"Other anemias"	1	221	84	305
"A15"	"E87"	"Respiratory tuberculosis"	"Other disorders of fluid, electrolyte and acid-base balance"	1	175	20	195
"A15"	"F05"	"Respiratory tuberculosis"	"Delirium due to known physiological condition"	1	41	4	45
"A15"	"I10"	"Respiratory tuberculosis"	"Essential (primary) hypertension"	1	225	71	296
"A15"	"I48"	"Respiratory tuberculosis"	"Atrial fibrillation and flutter"	1	153	76	229
"A15"	"I69"	"Respiratory tuberculosis"	"Sequelae of cerebrovascular disease"	1	84	17	101
"A15"	"J96"	"Respiratory tuberculosis"	"Respiratory failure, not elsewhere classified"	1	333	102	435
"A15"	"K72"	"Respiratory tuberculosis"	"Hepatic failure, not elsewhere classified"	1	59	12	71
"A18"	"E55"	"Tuberculosis of other organs"	"Vitamin D deficiency"	1	84	19	103
"A18"	"M75"	"Tuberculosis of other organs"	"Shoulder lesions"	1	48	5	53
"A39"	"H90"	"Meningococcal infection"	"Conductive and sensorineural hearing loss"	1	71	16	87
"A39"	"K59"	"Meningococcal infection"	"Other functional intestinal disorders"	1	49	11	60
"A39"	"M54"	"Meningococcal infection"	"Dorsalgia"	1	32	2	34
"A39"	"O04"	"Meningococcal infection"	"Complications following (induced) termination of pregnancy"	1	34	0	34
"A41"	"J09"	"Other sepsis"	"Influenza due to certain identified influenza viruses"	1	437	298	735
"A41"	"K64"	"Other sepsis"	"Hemorrhoids and perianal venous thrombosis"	1	490	319	809
"A46"	"A41"	"Erysipelas"	"Other sepsis"	1	5640	3120	8760
"A46"	"A49"	"Erysipelas"	"Bacterial infection of unspecified site"	1	2434	1579	4013
"A46"	"C16"	"Erysipelas"	"Malignant neoplasm of stomach"	1	167	27	194
"A46"	"C25"	"Erysipelas"	"Malignant neoplasm of pancreas"	1	202	56	258
"A46"	"D63"	"Erysipelas"	"Anemia in chronic diseases classified elsewhere"	1	746	403	1149
"A46"	"E46"	"Erysipelas"	"Unspecified protein-calorie malnutrition"	1	158	74	232
"A46"	"E68"	"Erysipelas"	"Sequelae of hyperalimentation"	1	88	33	121
"A46"	"F03"	"Erysipelas"	"Unspecified dementia"	1	1958	1120	3078
"A46"	"F41"	"Erysipelas"	"Other anxiety disorders"	1	518	306	824
"A46"	"G47"	"Erysipelas"	"Sleep disorders"	1	1212	709	1921
"A46"	"I46"	"Erysipelas"	"Cardiac arrest"	1	1209	104	1313
"A46"	"I89"	"Erysipelas"	"Oth noninfective disorders of lymphatic vessels and nodes"	1	991	716	1707
"A46"	"J90"	"Erysipelas"	"Pleural effusion, not elsewhere classified"	1	630	330	960
"A46"	"K56"	"Erysipelas"	"Paralytic ileus and intestinal obstruction without hernia"	1	800	548	1348
"A46"	"K59"	"Erysipelas"	"Other functional intestinal disorders"	1	2580	1979	4559
"A46"	"K64"	"Erysipelas"	"Hemorrhoids and perianal venous thrombosis"	1	472	74	546
"A46"	"M14"	"Erysipelas"	"Arthropathies in other diseases classified elsewhere"	1	227	125	352
"A46"	"N17"	"Erysipelas"	"Acute kidney failure"	1	1398	671	2069
"A46"	"N18"	"Erysipelas"	"Chronic kidney disease (CKD)"	1	2173	1295	3468
"A49"	"F41"	"Bacterial infection of unspecified site"	"Other anxiety disorders"	1	728	547	1275
"A49"	"I46"	"Bacterial infection of unspecified site"	"Cardiac arrest"	1	736	412	1148
"A56"	"M51"	"Other sexually transmitted chlamydial diseases"	"Thoracic, thoracolum, and lumbosacral intvrt disc disorders"	1	82	14	96
"A56"	"N87"	"Other sexually transmitted chlamydial diseases"	"Dysplasia of cervix uteri"	1	181	31	212
"A56"	"O34"	"Other sexually transmitted chlamydial diseases"	"Maternal care for abnormality of pelvic organs"	1	45	0	45
"A56"	"O62"	"Other sexually transmitted chlamydial diseases"	"Abnormalities of forces of labor"	1	319	87	406
"A56"	"O72"	"Other sexually transmitted chlamydial diseases"	"Postpartum hemorrhage"	1	529	0	529
"A56"	"O80"	"Other sexually transmitted chlamydial diseases"	"Encounter for full-term uncomplicated delivery"	1	643	215	858
"A63"	"C18"	"Oth predominantly sexually transmitted diseases, NEC"	"Malignant neoplasm of colon"	1	41	1	42
"A63"	"C44"	"Oth predominantly sexually transmitted diseases, NEC"	"Other and unspecified malignant neoplasm of skin"	1	129	11	140
"A63"	"C51"	"Oth predominantly sexually transmitted diseases, NEC"	"Malignant neoplasm of vulva"	1	59	15	74
"A63"	"C77"	"Oth predominantly sexually transmitted diseases, NEC"	"Secondary and unspecified malignant neoplasm of lymph nodes"	1	58	0	58
"A63"	"C79"	"Oth predominantly sexually transmitted diseases, NEC"	"Secondary malignant neoplasm of other and unspecified sites"	1	57	0	57
"A63"	"D17"	"Oth predominantly sexually transmitted diseases, NEC"	"Benign lipomatous neoplasm"	1	194	37	231
"A63"	"D24"	"Oth predominantly sexually transmitted diseases, NEC"	"Benign neoplasm of breast"	1	218	74	292
"A63"	"D35"	"Oth predominantly sexually transmitted diseases, NEC"	"Benign neoplasm of other and unspecified endocrine glands"	1	42	0	42
"A63"	"E04"	"Oth predominantly sexually transmitted diseases, NEC"	"Other nontoxic goiter"	1	180	27	207
"A63"	"E65"	"Oth predominantly sexually transmitted diseases, NEC"	"Localized adiposity"	1	102	30	132
"A63"	"E66"	"Oth predominantly sexually transmitted diseases, NEC"	"Overweight and obesity"	1	1870	287	2157
"A63"	"E86"	"Oth predominantly sexually transmitted diseases, NEC"	"Volume depletion"	1	194	20	214
"A63"	"F17"	"Oth predominantly sexually transmitted diseases, NEC"	"Nicotine dependence"	1	752	127	879
"A63"	"G43"	"Oth predominantly sexually transmitted diseases, NEC"	"Migraine"	1	290	91	381
"A63"	"G45"	"Oth predominantly sexually transmitted diseases, NEC"	"Transient cerebral ischemic attacks and related syndromes"	1	127	5	132
"A63"	"G56"	"Oth predominantly sexually transmitted diseases, NEC"	"Mononeuropathies of upper limb"	1	522	55	577
"A63"	"G93"	"Oth predominantly sexually transmitted diseases, NEC"	"Other disorders of brain"	1	43	4	47
"A63"	"G95"	"Oth predominantly sexually transmitted diseases, NEC"	"Other and unspecified diseases of spinal cord"	1	29	0	29
"A63"	"H26"	"Oth predominantly sexually transmitted diseases, NEC"	"Other cataract"	1	86	7	93
"A63"	"H52"	"Oth predominantly sexually transmitted diseases, NEC"	"Disorders of refraction and accommodation"	1	233	106	339
"A63"	"H81"	"Oth predominantly sexually transmitted diseases, NEC"	"Disorders of vestibular function"	1	120	27	147
"A63"	"H90"	"Oth predominantly sexually transmitted diseases, NEC"	"Conductive and sensorineural hearing loss"	1	119	47	166
"A63"	"H91"	"Oth predominantly sexually transmitted diseases, NEC"	"Other and unspecified hearing loss"	1	225	62	287
"A63"	"H93"	"Oth predominantly sexually transmitted diseases, NEC"	"Other disorders of ear, not elsewhere classified"	1	148	50	198
"A63"	"I10"	"Oth predominantly sexually transmitted diseases, NEC"	"Essential (primary) hypertension"	1	816	118	934
"A63"	"I20"	"Oth predominantly sexually transmitted diseases, NEC"	"Angina pectoris"	1	302	61	363
"A63"	"I21"	"Oth predominantly sexually transmitted diseases, NEC"	"Acute myocardial infarction"	1	149	16	165
"A63"	"I42"	"Oth predominantly sexually transmitted diseases, NEC"	"Cardiomyopathy"	1	41	2	43
"A63"	"I49"	"Oth predominantly sexually transmitted diseases, NEC"	"Other cardiac arrhythmias"	1	144	27	171
"A63"	"I83"	"Oth predominantly sexually transmitted diseases, NEC"	"Varicose veins of lower extremities"	1	268	61	329
"A63"	"I95"	"Oth predominantly sexually transmitted diseases, NEC"	"Hypotension"	1	32	2	34
"A63"	"K25"	"Oth predominantly sexually transmitted diseases, NEC"	"Gastric ulcer"	1	93	25	118
"A63"	"K30"	"Oth predominantly sexually transmitted diseases, NEC"	"Functional dyspepsia"	1	323	158	481
"A63"	"K42"	"Oth predominantly sexually transmitted diseases, NEC"	"Umbilical hernia"	1	162	23	185
"A63"	"K57"	"Oth predominantly sexually transmitted diseases, NEC"	"Diverticular disease of intestine"	1	200	0	200
"A63"	"K59"	"Oth predominantly sexually transmitted diseases, NEC"	"Other functional intestinal disorders"	1	739	156	895
"A63"	"K60"	"Oth predominantly sexually transmitted diseases, NEC"	"Fissure and fistula of anal and rectal regions"	1	403	185	588
"A63"	"K76"	"Oth predominantly sexually transmitted diseases, NEC"	"Other diseases of liver"	1	90	6	96
"A63"	"K80"	"Oth predominantly sexually transmitted diseases, NEC"	"Cholelithiasis"	1	534	128	662
"A63"	"K91"	"Oth predominantly sexually transmitted diseases, NEC"	"Intraop and postproc comp and disorders of dgstv sys, NEC"	1	43	7	50
"A63"	"K92"	"Oth predominantly sexually transmitted diseases, NEC"	"Other diseases of digestive system"	1	143	57	200
"A63"	"L29"	"Oth predominantly sexually transmitted diseases, NEC"	"Pruritus"	1	129	44	173
"A63"	"L50"	"Oth predominantly sexually transmitted diseases, NEC"	"Urticaria"	1	193	99	292
"A63"	"L57"	"Oth predominantly sexually transmitted diseases, NEC"	"Skin changes due to chronic expsr to nonionizing radiation"	1	57	10	67
"A63"	"L97"	"Oth predominantly sexually transmitted diseases, NEC"	"Non-pressure chronic ulcer of lower limb, NEC"	1	45	2	47
"A63"	"M16"	"Oth predominantly sexually transmitted diseases, NEC"	"Osteoarthritis of hip"	1	174	11	185
"A63"	"M17"	"Oth predominantly sexually transmitted diseases, NEC"	"Osteoarthritis of knee"	1	302	26	328
"A63"	"M20"	"Oth predominantly sexually transmitted diseases, NEC"	"Acquired deformities of fingers and toes"	1	206	69	275
"A63"	"M65"	"Oth predominantly sexually transmitted diseases, NEC"	"Synovitis and tenosynovitis"	1	364	223	587
"A63"	"M96"	"Oth predominantly sexually transmitted diseases, NEC"	"Intraop and postproc comp and disorders of ms sys, NEC"	1	29	0	29
"A63"	"N60"	"Oth predominantly sexually transmitted diseases, NEC"	"Benign mammary dysplasia"	1	159	35	194
"A63"	"N64"	"Oth predominantly sexually transmitted diseases, NEC"	"Other disorders of breast"	1	317	79	396
"A63"	"N76"	"Oth predominantly sexually transmitted diseases, NEC"	"Other inflammation of vagina and vulva"	1	436	261	697
"A63"	"N80"	"Oth predominantly sexually transmitted diseases, NEC"	"Endometriosis"	1	260	60	320
"A63"	"N90"	"Oth predominantly sexually transmitted diseases, NEC"	"Other noninflammatory disorders of vulva and perineum"	1	525	295	820
"A63"	"N96"	"Oth predominantly sexually transmitted diseases, NEC"	"Recurrent pregnancy loss"	1	59	0	59
"A63"	"O08"	"Oth predominantly sexually transmitted diseases, NEC"	"Complications following ectopic and molar pregnancy"	1	394	75	469
"A63"	"O12"	"Oth predominantly sexually transmitted diseases, NEC"	"Gestational edema and proteinuria without hypertension"	1	108	10	118
"A63"	"O14"	"Oth predominantly sexually transmitted diseases, NEC"	"Pre-eclampsia"	1	392	41	433
"A63"	"O20"	"Oth predominantly sexually transmitted diseases, NEC"	"Hemorrhage in early pregnancy"	1	873	247	1120
"A63"	"O30"	"Oth predominantly sexually transmitted diseases, NEC"	"Multiple gestation"	1	268	10	278
"A63"	"O32"	"Oth predominantly sexually transmitted diseases, NEC"	"Maternal care for malpresentation of fetus"	1	484	11	495
"A63"	"O34"	"Oth predominantly sexually transmitted diseases, NEC"	"Maternal care for abnormality of pelvic organs"	1	558	0	558
"A63"	"O35"	"Oth predominantly sexually transmitted diseases, NEC"	"Maternal care for known or suspected fetal abnlt and damage"	1	129	0	129
"A63"	"O36"	"Oth predominantly sexually transmitted diseases, NEC"	"Maternal care for other fetal problems"	1	872	39	911
"A63"	"O41"	"Oth predominantly sexually transmitted diseases, NEC"	"Other disorders of amniotic fluid and membranes"	1	176	19	195
"A63"	"O42"	"Oth predominantly sexually transmitted diseases, NEC"	"Premature rupture of membranes"	1	997	59	1056
"A63"	"O44"	"Oth predominantly sexually transmitted diseases, NEC"	"Placenta previa"	1	73	0	73
"A63"	"O46"	"Oth predominantly sexually transmitted diseases, NEC"	"Antepartum hemorrhage, not elsewhere classified"	1	298	51	349
"A63"	"O47"	"Oth predominantly sexually transmitted diseases, NEC"	"False labor"	1	855	82	937
"A63"	"O62"	"Oth predominantly sexually transmitted diseases, NEC"	"Abnormalities of forces of labor"	1	3626	0	3626
"A63"	"O64"	"Oth predominantly sexually transmitted diseases, NEC"	"Obstructed labor due to malposition and malpresent of fetus"	1	504	47	551
"A63"	"O70"	"Oth predominantly sexually transmitted diseases, NEC"	"Perineal laceration during delivery"	1	3920	0	3920
"A63"	"O82"	"Oth predominantly sexually transmitted diseases, NEC"	"Encounter for cesarean delivery without indication"	1	2104	0	2104
"A63"	"O90"	"Oth predominantly sexually transmitted diseases, NEC"	"Complications of the puerperium, not elsewhere classified"	1	351	4	355
"A63"	"O98"	"Oth predominantly sexually transmitted diseases, NEC"	"Matern infec/parastc dis classd elsw but compl preg/chldbrth"	1	88	12	100
"A63"	"O99"	"Oth predominantly sexually transmitted diseases, NEC"	"Oth maternal diseases classd elsw but compl preg/chldbrth"	1	3082	0	3082
"A69"	"A41"	"Other spirochetal infections"	"Other sepsis"	1	135	14	149
"A69"	"C78"	"Other spirochetal infections"	"Secondary malignant neoplasm of resp and digestive organs"	1	60	0	60
"A69"	"C79"	"Other spirochetal infections"	"Secondary malignant neoplasm of other and unspecified sites"	1	47	1	48
"A69"	"D64"	"Other spirochetal infections"	"Other anemias"	1	97	10	107
"A69"	"E11"	"Other spirochetal infections"	"Type 2 diabetes mellitus"	1	151	52	203
"A69"	"E86"	"Other spirochetal infections"	"Volume depletion"	1	112	18	130
"A69"	"I21"	"Other spirochetal infections"	"Acute myocardial infarction"	1	112	29	141
"A69"	"I25"	"Other spirochetal infections"	"Chronic ischemic heart disease"	1	154	50	204
"A69"	"I50"	"Other spirochetal infections"	"Heart failure"	1	124	13	137
"A69"	"I69"	"Other spirochetal infections"	"Sequelae of cerebrovascular disease"	1	125	36	161
"A69"	"J15"	"Other spirochetal infections"	"Bacterial pneumonia, not elsewhere classified"	1	92	8	100
"A69"	"J18"	"Other spirochetal infections"	"Pneumonia, unspecified organism"	1	286	88	374
"A69"	"J44"	"Other spirochetal infections"	"Other chronic obstructive pulmonary disease"	1	126	18	144
"A69"	"J90"	"Other spirochetal infections"	"Pleural effusion, not elsewhere classified"	1	27	2	29
"A69"	"J96"	"Other spirochetal infections"	"Respiratory failure, not elsewhere classified"	1	102	3	105
"A69"	"K57"	"Other spirochetal infections"	"Diverticular disease of intestine"	1	137	31	168
"A69"	"K62"	"Other spirochetal infections"	"Other diseases of anus and rectum"	1	102	40	142
"A69"	"K92"	"Other spirochetal infections"	"Other diseases of digestive system"	1	59	4	63
"A69"	"M16"	"Other spirochetal infections"	"Osteoarthritis of hip"	1	125	38	163
"A69"	"M17"	"Other spirochetal infections"	"Osteoarthritis of knee"	1	166	62	228
"A69"	"N30"	"Other spirochetal infections"	"Cystitis"	1	183	60	243
"A69"	"N39"	"Other spirochetal infections"	"Other disorders of urinary system"	1	169	36	205
"A69"	"O72"	"Other spirochetal infections"	"Postpartum hemorrhage"	1	102	20	122
"A86"	"B94"	"Unspecified viral encephalitis"	"Sequelae of other and unsp infectious and parasitic diseases"	1	79	26	105
"A86"	"G09"	"Unspecified viral encephalitis"	"Sequelae of inflammatory diseases of central nervous system"	1	46	6	52
"A87"	"H93"	"Viral meningitis"	"Other disorders of ear, not elsewhere classified"	1	54	12	66
"A87"	"K59"	"Viral meningitis"	"Other functional intestinal disorders"	1	86	32	118
"A88"	"C50"	"Oth viral infections of central nervous system, NEC"	"Malignant neoplasm of breast"	1	47	6	53
"A88"	"C78"	"Oth viral infections of central nervous system, NEC"	"Secondary malignant neoplasm of resp and digestive organs"	1	35	0	35
"A88"	"D63"	"Oth viral infections of central nervous system, NEC"	"Anemia in chronic diseases classified elsewhere"	1	28	0	28
"A88"	"I10"	"Oth viral infections of central nervous system, NEC"	"Essential (primary) hypertension"	1	549	294	843
"A88"	"I21"	"Oth viral infections of central nervous system, NEC"	"Acute myocardial infarction"	1	108	28	136
"A88"	"I70"	"Oth viral infections of central nervous system, NEC"	"Atherosclerosis"	1	59	15	74
"A88"	"J44"	"Oth viral infections of central nervous system, NEC"	"Other chronic obstructive pulmonary disease"	1	136	25	161
"B00"	"B94"	"Herpesviral [herpes simplex] infections"	"Sequelae of other and unsp infectious and parasitic diseases"	1	84	26	110
"B00"	"G96"	"Herpesviral [herpes simplex] infections"	"Other disorders of central nervous system"	1	105	41	146
"B02"	"A49"	"Zoster [herpes zoster]"	"Bacterial infection of unspecified site"	1	320	195	515
"B02"	"E86"	"Zoster [herpes zoster]"	"Volume depletion"	1	1000	641	1641
"B02"	"F05"	"Zoster [herpes zoster]"	"Delirium due to known physiological condition"	1	200	67	267
"B02"	"J96"	"Zoster [herpes zoster]"	"Respiratory failure, not elsewhere classified"	1	635	260	895
"B07"	"K80"	"Viral warts"	"Cholelithiasis"	1	122	48	170
"B07"	"M17"	"Viral warts"	"Osteoarthritis of knee"	1	131	55	186
"B07"	"M23"	"Viral warts"	"Internal derangement of knee"	1	298	109	407
"B07"	"M75"	"Viral warts"	"Shoulder lesions"	1	240	52	292
"B07"	"O34"	"Viral warts"	"Maternal care for abnormality of pelvic organs"	1	40	0	40
"B07"	"O80"	"Viral warts"	"Encounter for full-term uncomplicated delivery"	1	291	146	437
"B07"	"O82"	"Viral warts"	"Encounter for cesarean delivery without indication"	1	132	27	159
"B07"	"O99"	"Viral warts"	"Oth maternal diseases classd elsw but compl preg/chldbrth"	1	194	0	194
"B17"	"C22"	"Other acute viral hepatitis"	"Malignant neoplasm of liver and intrahepatic bile ducts"	1	34	3	37
"B18"	"A26"	"Chronic viral hepatitis"	"Erysipeloid"	1	27	2	29
"B18"	"A49"	"Chronic viral hepatitis"	"Bacterial infection of unspecified site"	1	265	147	412
"B18"	"C77"	"Chronic viral hepatitis"	"Secondary and unspecified malignant neoplasm of lymph nodes"	1	47	7	54
"B18"	"C78"	"Chronic viral hepatitis"	"Secondary malignant neoplasm of resp and digestive organs"	1	117	5	122
"B18"	"E66"	"Chronic viral hepatitis"	"Overweight and obesity"	1	265	160	425
"B18"	"F05"	"Chronic viral hepatitis"	"Delirium due to known physiological condition"	1	86	20	106
"B18"	"G93"	"Chronic viral hepatitis"	"Other disorders of brain"	1	72	21	93
"B18"	"I46"	"Chronic viral hepatitis"	"Cardiac arrest"	1	181	24	205
"B18"	"I48"	"Chronic viral hepatitis"	"Atrial fibrillation and flutter"	1	187	60	247
"B18"	"I85"	"Chronic viral hepatitis"	"Esophageal varices"	1	427	177	604
"B18"	"J15"	"Chronic viral hepatitis"	"Bacterial pneumonia, not elsewhere classified"	1	346	159	505
"B18"	"J22"	"Chronic viral hepatitis"	"Unspecified acute lower respiratory infection"	1	56	12	68
"B18"	"K57"	"Chronic viral hepatitis"	"Diverticular disease of intestine"	1	96	33	129
"B18"	"K64"	"Chronic viral hepatitis"	"Hemorrhoids and perianal venous thrombosis"	1	110	3	113
"B18"	"K65"	"Chronic viral hepatitis"	"Peritonitis"	1	174	81	255
"B18"	"K76"	"Chronic viral hepatitis"	"Other diseases of liver"	1	471	277	748
"B18"	"L30"	"Chronic viral hepatitis"	"Other and unspecified dermatitis"	1	136	61	197
"B18"	"M48"	"Chronic viral hepatitis"	"Other spondylopathies"	1	109	28	137
"B20"	"E86"	"Human immunodeficiency virus [HIV] disease"	"Volume depletion"	1	68	20	88
"B20"	"I10"	"Human immunodeficiency virus [HIV] disease"	"Essential (primary) hypertension"	1	81	26	107
"B20"	"J44"	"Human immunodeficiency virus [HIV] disease"	"Other chronic obstructive pulmonary disease"	1	80	22	102
"B20"	"M81"	"Human immunodeficiency virus [HIV] disease"	"Osteoporosis without current pathological fracture"	1	42	0	42
"B25"	"E89"	"Cytomegaloviral disease"	"Postproc endocrine and metabolic comp and disorders, NEC"	1	36	3	39
"B25"	"H26"	"Cytomegaloviral disease"	"Other cataract"	1	58	14	72
"B27"	"E11"	"Infectious mononucleosis"	"Type 2 diabetes mellitus"	1	70	3	73
"B27"	"E66"	"Infectious mononucleosis"	"Overweight and obesity"	1	318	0	318
"B27"	"E78"	"Infectious mononucleosis"	"Disorders of lipoprotein metabolism and other lipidemias"	1	65	1	66
"B27"	"F10"	"Infectious mononucleosis"	"Alcohol related disorders"	1	340	111	451
"B27"	"F33"	"Infectious mononucleosis"	"Major depressive disorder, recurrent"	1	28	0	28
"B27"	"F43"	"Infectious mononucleosis"	"Reaction to severe stress, and adjustment disorders"	1	87	15	102
"B27"	"G43"	"Infectious mononucleosis"	"Migraine"	1	142	43	185
"B27"	"G47"	"Infectious mononucleosis"	"Sleep disorders"	1	113	7	120
"B27"	"I80"	"Infectious mononucleosis"	"Phlebitis and thrombophlebitis"	1	59	5	64
"B27"	"J34"	"Infectious mononucleosis"	"Other and unspecified disorders of nose and nasal sinuses"	1	104	17	121
"B27"	"J35"	"Infectious mononucleosis"	"Chronic diseases of tonsils and adenoids"	1	1331	617	1948
"B27"	"K21"	"Infectious mononucleosis"	"Gastro-esophageal reflux disease"	1	134	29	163
"B27"	"K61"	"Infectious mononucleosis"	"Abscess of anal and rectal regions"	1	40	4	44
"B27"	"L02"	"Infectious mononucleosis"	"Cutaneous abscess, furuncle and carbuncle"	1	196	72	268
"B27"	"L90"	"Infectious mononucleosis"	"Atrophic disorders of skin"	1	95	16	111
"B27"	"M17"	"Infectious mononucleosis"	"Osteoarthritis of knee"	1	40	0	40
"B27"	"M23"	"Infectious mononucleosis"	"Internal derangement of knee"	1	478	103	581
"B27"	"M24"	"Infectious mononucleosis"	"Other specific joint derangements"	1	102	33	135
"B27"	"M25"	"Infectious mononucleosis"	"Other joint disorder, not elsewhere classified"	1	148	41	189
"B27"	"M51"	"Infectious mononucleosis"	"Thoracic, thoracolum, and lumbosacral intvrt disc disorders"	1	134	0	134
"B27"	"M54"	"Infectious mononucleosis"	"Dorsalgia"	1	442	43	485
"B27"	"M65"	"Infectious mononucleosis"	"Synovitis and tenosynovitis"	1	150	40	190
"B27"	"M67"	"Infectious mononucleosis"	"Other disorders of synovium and tendon"	1	190	44	234
"B27"	"N83"	"Infectious mononucleosis"	"Noninflammatory disord of ovary, fallop and broad ligament"	1	135	1	136
"B27"	"N92"	"Infectious mononucleosis"	"Excessive, frequent and irregular menstruation"	1	152	2	154
"B27"	"N97"	"Infectious mononucleosis"	"Female infertility"	1	88	0	88
"B27"	"O08"	"Infectious mononucleosis"	"Complications following ectopic and molar pregnancy"	1	71	0	71
"B27"	"O23"	"Infectious mononucleosis"	"Infections of genitourinary tract in pregnancy"	1	100	0	100
"B27"	"O24"	"Infectious mononucleosis"	"Diabetes in pregnancy, childbirth, and the puerperium"	1	30	0	30
"B27"	"O32"	"Infectious mononucleosis"	"Maternal care for malpresentation of fetus"	1	42	0	42
"B27"	"O34"	"Infectious mononucleosis"	"Maternal care for abnormality of pelvic organs"	1	45	0	45
"B27"	"O36"	"Infectious mononucleosis"	"Maternal care for other fetal problems"	1	96	0	96
"B27"	"O48"	"Infectious mononucleosis"	"Late pregnancy"	1	59	0	59
"B27"	"O68"	"Infectious mononucleosis"	"Labor and delivery comp by abnlt of fetal acid-base balance"	1	199	0	199
"B27"	"O70"	"Infectious mononucleosis"	"Perineal laceration during delivery"	1	373	0	373
"B27"	"O75"	"Infectious mononucleosis"	"Oth complications of labor and delivery, NEC"	1	48	0	48
"B27"	"O80"	"Infectious mononucleosis"	"Encounter for full-term uncomplicated delivery"	1	605	0	605
"B27"	"O82"	"Infectious mononucleosis"	"Encounter for cesarean delivery without indication"	1	166	0	166
"B27"	"O90"	"Infectious mononucleosis"	"Complications of the puerperium, not elsewhere classified"	1	29	0	29
"B34"	"A68"	"Viral infection of unspecified site"	"Relapsing fevers"	1	204	93	297
"B34"	"B00"	"Viral infection of unspecified site"	"Herpesviral [herpes simplex] infections"	1	389	249	638
"B34"	"C79"	"Viral infection of unspecified site"	"Secondary malignant neoplasm of other and unspecified sites"	1	102	24	126
"B34"	"D12"	"Viral infection of unspecified site"	"Benign neoplasm of colon, rectum, anus and anal canal"	1	304	157	461
"B34"	"D16"	"Viral infection of unspecified site"	"Benign neoplasm of bone and articular cartilage"	1	107	33	140
"B34"	"D68"	"Viral infection of unspecified site"	"Other coagulation defects"	1	138	64	202
"B34"	"E89"	"Viral infection of unspecified site"	"Postproc endocrine and metabolic comp and disorders, NEC"	1	85	31	116
"B34"	"F43"	"Viral infection of unspecified site"	"Reaction to severe stress, and adjustment disorders"	1	437	153	590
"B34"	"F72"	"Viral infection of unspecified site"	"Severe intellectual disabilities"	1	99	21	120
"B34"	"F79"	"Viral infection of unspecified site"	"Unspecified intellectual disabilities"	1	305	68	373
"B34"	"H00"	"Viral infection of unspecified site"	"Hordeolum and chalazion"	1	391	187	578
"B34"	"H50"	"Viral infection of unspecified site"	"Other strabismus"	1	939	297	1236
"B34"	"H60"	"Viral infection of unspecified site"	"Otitis externa"	1	494	263	757
"B34"	"J03"	"Viral infection of unspecified site"	"Acute tonsillitis"	1	6189	3673	9862
"B34"	"J15"	"Viral infection of unspecified site"	"Bacterial pneumonia, not elsewhere classified"	1	1742	899	2641
"B34"	"K00"	"Viral infection of unspecified site"	"Disorders of tooth development and eruption"	1	237	0	237
"B34"	"K01"	"Viral infection of unspecified site"	"Embedded and impacted teeth"	1	111	12	123
"B34"	"K64"	"Viral infection of unspecified site"	"Hemorrhoids and perianal venous thrombosis"	1	323	45	368
"B34"	"L90"	"Viral infection of unspecified site"	"Atrophic disorders of skin"	1	220	79	299
"B34"	"L97"	"Viral infection of unspecified site"	"Non-pressure chronic ulcer of lower limb, NEC"	1	112	40	152
"B34"	"M67"	"Viral infection of unspecified site"	"Other disorders of synovium and tendon"	1	531	217	748
"B34"	"N47"	"Viral infection of unspecified site"	"Disorders of prepuce"	1	1292	320	1612
"B34"	"O72"	"Viral infection of unspecified site"	"Postpartum hemorrhage"	1	1214	773	1987
"B34"	"Q17"	"Viral infection of unspecified site"	"Other congenital malformations of ear"	1	180	40	220
"B34"	"Q53"	"Viral infection of unspecified site"	"Undescended and ectopic testicle"	1	943	548	1491
"B34"	"Q66"	"Viral infection of unspecified site"	"Congenital deformities of feet"	1	539	378	917
"B54"	"E66"	"Unspecified malaria"	"Overweight and obesity"	1	28	1	29
"B91"	"C78"	"Sequelae of poliomyelitis"	"Secondary malignant neoplasm of resp and digestive organs"	1	33	0	33
"B91"	"G09"	"Sequelae of poliomyelitis"	"Sequelae of inflammatory diseases of central nervous system"	1	53	10	63
"B91"	"L89"	"Sequelae of poliomyelitis"	"Pressure ulcer"	1	56	7	63
"B91"	"M81"	"Sequelae of poliomyelitis"	"Osteoporosis without current pathological fracture"	1	140	48	188
"B91"	"N30"	"Sequelae of poliomyelitis"	"Cystitis"	1	195	97	292
"C00"	"I50"	"Malignant neoplasm of lip"	"Heart failure"	1	122	27	149
"C00"	"L57"	"Malignant neoplasm of lip"	"Skin changes due to chronic expsr to nonionizing radiation"	1	60	13	73
"C00"	"M81"	"Malignant neoplasm of lip"	"Osteoporosis without current pathological fracture"	1	35	5	40
"C00"	"N30"	"Malignant neoplasm of lip"	"Cystitis"	1	69	19	88
"C00"	"N39"	"Malignant neoplasm of lip"	"Other disorders of urinary system"	1	47	2	49
"C01"	"F41"	"Malignant neoplasm of base of tongue"	"Other anxiety disorders"	1	67	14	81
"C01"	"G47"	"Malignant neoplasm of base of tongue"	"Sleep disorders"	1	69	14	83
"C02"	"C34"	"Malignant neoplasm of other and unspecified parts of tongue"	"Malignant neoplasm of bronchus and lung"	1	139	44	183
"C02"	"C78"	"Malignant neoplasm of other and unspecified parts of tongue"	"Secondary malignant neoplasm of resp and digestive organs"	1	113	38	151
"C02"	"E64"	"Malignant neoplasm of other and unspecified parts of tongue"	"Sequelae of malnutrition and other nutritional deficiencies"	1	164	55	219
"C02"	"G47"	"Malignant neoplasm of other and unspecified parts of tongue"	"Sleep disorders"	1	110	26	136
"C02"	"J96"	"Malignant neoplasm of other and unspecified parts of tongue"	"Respiratory failure, not elsewhere classified"	1	157	46	203
"C02"	"K02"	"Malignant neoplasm of other and unspecified parts of tongue"	"Dental caries"	1	314	186	500
"C02"	"K12"	"Malignant neoplasm of other and unspecified parts of tongue"	"Stomatitis and related lesions"	1	175	47	222
"C02"	"K59"	"Malignant neoplasm of other and unspecified parts of tongue"	"Other functional intestinal disorders"	1	235	76	311
"C04"	"C34"	"Malignant neoplasm of floor of mouth"	"Malignant neoplasm of bronchus and lung"	1	110	37	147
"C04"	"C78"	"Malignant neoplasm of floor of mouth"	"Secondary malignant neoplasm of resp and digestive organs"	1	105	27	132
"C04"	"E64"	"Malignant neoplasm of floor of mouth"	"Sequelae of malnutrition and other nutritional deficiencies"	1	120	46	166
"C04"	"G47"	"Malignant neoplasm of floor of mouth"	"Sleep disorders"	1	78	14	92
"C04"	"K12"	"Malignant neoplasm of floor of mouth"	"Stomatitis and related lesions"	1	137	49	186
"C04"	"K59"	"Malignant neoplasm of floor of mouth"	"Other functional intestinal disorders"	1	173	56	229
"C06"	"A49"	"Malignant neoplasm of other and unspecified parts of mouth"	"Bacterial infection of unspecified site"	1	147	57	204
"C06"	"C15"	"Malignant neoplasm of other and unspecified parts of mouth"	"Malignant neoplasm of esophagus"	1	103	31	134
"C06"	"E83"	"Malignant neoplasm of other and unspecified parts of mouth"	"Disorders of mineral metabolism"	1	82	29	111
"C06"	"E86"	"Malignant neoplasm of other and unspecified parts of mouth"	"Volume depletion"	1	486	194	680
"C06"	"F41"	"Malignant neoplasm of other and unspecified parts of mouth"	"Other anxiety disorders"	1	186	45	231
"C06"	"G47"	"Malignant neoplasm of other and unspecified parts of mouth"	"Sleep disorders"	1	228	47	275
"C06"	"I89"	"Malignant neoplasm of other and unspecified parts of mouth"	"Oth noninfective disorders of lymphatic vessels and nodes"	1	192	47	239
"C06"	"J18"	"Malignant neoplasm of other and unspecified parts of mouth"	"Pneumonia, unspecified organism"	1	552	326	878
"C06"	"J69"	"Malignant neoplasm of other and unspecified parts of mouth"	"Pneumonitis due to solids and liquids"	1	62	6	68
"C06"	"K08"	"Malignant neoplasm of other and unspecified parts of mouth"	"Other disorders of teeth and supporting structures"	1	697	355	1052
"C06"	"K12"	"Malignant neoplasm of other and unspecified parts of mouth"	"Stomatitis and related lesions"	1	408	167	575
"C07"	"C78"	"Malignant neoplasm of parotid gland"	"Secondary malignant neoplasm of resp and digestive organs"	1	119	27	146
"C07"	"C79"	"Malignant neoplasm of parotid gland"	"Secondary malignant neoplasm of other and unspecified sites"	1	104	19	123
"C07"	"E86"	"Malignant neoplasm of parotid gland"	"Volume depletion"	1	86	20	106
"C07"	"H02"	"Malignant neoplasm of parotid gland"	"Other disorders of eyelid"	1	135	21	156
"C07"	"K02"	"Malignant neoplasm of parotid gland"	"Dental caries"	1	82	23	105
"C07"	"K04"	"Malignant neoplasm of parotid gland"	"Diseases of pulp and periapical tissues"	1	106	35	141
"C07"	"K12"	"Malignant neoplasm of parotid gland"	"Stomatitis and related lesions"	1	61	12	73
"C09"	"A41"	"Malignant neoplasm of tonsil"	"Other sepsis"	1	152	43	195
"C09"	"B37"	"Malignant neoplasm of tonsil"	"Candidiasis"	1	163	42	205
"C09"	"C14"	"Malignant neoplasm of tonsil"	"Malig neoplasm of sites in the lip, oral cavity and pharynx"	1	195	102	297
"C09"	"C15"	"Malignant neoplasm of tonsil"	"Malignant neoplasm of esophagus"	1	60	14	74
"C09"	"D63"	"Malignant neoplasm of tonsil"	"Anemia in chronic diseases classified elsewhere"	1	113	24	137
"C09"	"E41"	"Malignant neoplasm of tonsil"	"Nutritional marasmus"	1	57	12	69
"C09"	"E83"	"Malignant neoplasm of tonsil"	"Disorders of mineral metabolism"	1	110	20	130
"C09"	"F41"	"Malignant neoplasm of tonsil"	"Other anxiety disorders"	1	122	19	141
"C09"	"G95"	"Malignant neoplasm of tonsil"	"Other and unspecified diseases of spinal cord"	1	66	8	74
"C09"	"H90"	"Malignant neoplasm of tonsil"	"Conductive and sensorineural hearing loss"	1	109	40	149
"C09"	"I89"	"Malignant neoplasm of tonsil"	"Oth noninfective disorders of lymphatic vessels and nodes"	1	94	23	117
"C09"	"J15"	"Malignant neoplasm of tonsil"	"Bacterial pneumonia, not elsewhere classified"	1	206	35	241
"C09"	"J69"	"Malignant neoplasm of tonsil"	"Pneumonitis due to solids and liquids"	1	47	1	48
"C09"	"K02"	"Malignant neoplasm of tonsil"	"Dental caries"	1	553	265	818
"C09"	"K05"	"Malignant neoplasm of tonsil"	"Gingivitis and periodontal diseases"	1	841	423	1264
"C09"	"K59"	"Malignant neoplasm of tonsil"	"Other functional intestinal disorders"	1	303	81	384
"C10"	"C34"	"Malignant neoplasm of oropharynx"	"Malignant neoplasm of bronchus and lung"	1	183	65	248
"C10"	"C79"	"Malignant neoplasm of oropharynx"	"Secondary malignant neoplasm of other and unspecified sites"	1	131	39	170
"C10"	"E41"	"Malignant neoplasm of oropharynx"	"Nutritional marasmus"	1	68	20	88
"C10"	"E83"	"Malignant neoplasm of oropharynx"	"Disorders of mineral metabolism"	1	92	29	121
"C10"	"F41"	"Malignant neoplasm of oropharynx"	"Other anxiety disorders"	1	154	39	193
"C10"	"J96"	"Malignant neoplasm of oropharynx"	"Respiratory failure, not elsewhere classified"	1	229	124	353
"C11"	"B37"	"Malignant neoplasm of nasopharynx"	"Candidiasis"	1	35	3	38
"C11"	"E86"	"Malignant neoplasm of nasopharynx"	"Volume depletion"	1	93	28	121
"C11"	"H65"	"Malignant neoplasm of nasopharynx"	"Nonsuppurative otitis media"	1	77	24	101
"C11"	"H91"	"Malignant neoplasm of nasopharynx"	"Other and unspecified hearing loss"	1	140	65	205
"C11"	"J15"	"Malignant neoplasm of nasopharynx"	"Bacterial pneumonia, not elsewhere classified"	1	55	11	66
"C11"	"J18"	"Malignant neoplasm of nasopharynx"	"Pneumonia, unspecified organism"	1	119	47	166
"C11"	"K59"	"Malignant neoplasm of nasopharynx"	"Other functional intestinal disorders"	1	82	19	101
"C13"	"C34"	"Malignant neoplasm of hypopharynx"	"Malignant neoplasm of bronchus and lung"	1	163	64	227
"C13"	"D63"	"Malignant neoplasm of hypopharynx"	"Anemia in chronic diseases classified elsewhere"	1	106	31	137
"C13"	"E64"	"Malignant neoplasm of hypopharynx"	"Sequelae of malnutrition and other nutritional deficiencies"	1	245	69	314
"C13"	"E83"	"Malignant neoplasm of hypopharynx"	"Disorders of mineral metabolism"	1	79	21	100
"C13"	"E86"	"Malignant neoplasm of hypopharynx"	"Volume depletion"	1	268	140	408
"C13"	"J18"	"Malignant neoplasm of hypopharynx"	"Pneumonia, unspecified organism"	1	417	258	675
"C13"	"J69"	"Malignant neoplasm of hypopharynx"	"Pneumonitis due to solids and liquids"	1	55	11	66
"C13"	"K59"	"Malignant neoplasm of hypopharynx"	"Other functional intestinal disorders"	1	212	88	300
"C15"	"A41"	"Malignant neoplasm of esophagus"	"Other sepsis"	1	452	290	742
"C15"	"C78"	"Malignant neoplasm of esophagus"	"Secondary malignant neoplasm of resp and digestive organs"	1	1372	696	2068
"C15"	"D63"	"Malignant neoplasm of esophagus"	"Anemia in chronic diseases classified elsewhere"	1	912	246	1158
"C15"	"E41"	"Malignant neoplasm of esophagus"	"Nutritional marasmus"	1	137	53	190
"C15"	"E64"	"Malignant neoplasm of esophagus"	"Sequelae of malnutrition and other nutritional deficiencies"	1	584	137	721
"C15"	"E83"	"Malignant neoplasm of esophagus"	"Disorders of mineral metabolism"	1	252	74	326
"C15"	"E86"	"Malignant neoplasm of esophagus"	"Volume depletion"	1	1348	618	1966
"C15"	"G95"	"Malignant neoplasm of esophagus"	"Other and unspecified diseases of spinal cord"	1	266	73	339
"C15"	"I46"	"Malignant neoplasm of esophagus"	"Cardiac arrest"	1	136	45	181
"C15"	"J15"	"Malignant neoplasm of esophagus"	"Bacterial pneumonia, not elsewhere classified"	1	573	300	873
"C15"	"J69"	"Malignant neoplasm of esophagus"	"Pneumonitis due to solids and liquids"	1	165	58	223
"C15"	"J90"	"Malignant neoplasm of esophagus"	"Pleural effusion, not elsewhere classified"	1	223	97	320
"C15"	"J91"	"Malignant neoplasm of esophagus"	"Pleural effusion in conditions classified elsewhere"	1	166	68	234
"C16"	"A41"	"Malignant neoplasm of stomach"	"Other sepsis"	1	562	324	886
"C16"	"C78"	"Malignant neoplasm of stomach"	"Secondary malignant neoplasm of resp and digestive organs"	1	1977	1189	3166
"C16"	"E46"	"Malignant neoplasm of stomach"	"Unspecified protein-calorie malnutrition"	1	67	17	84
"C16"	"E64"	"Malignant neoplasm of stomach"	"Sequelae of malnutrition and other nutritional deficiencies"	1	575	108	683
"C16"	"E83"	"Malignant neoplasm of stomach"	"Disorders of mineral metabolism"	1	150	73	223
"C16"	"G47"	"Malignant neoplasm of stomach"	"Sleep disorders"	1	603	216	819
"C16"	"G95"	"Malignant neoplasm of stomach"	"Other and unspecified diseases of spinal cord"	1	188	70	258
"C16"	"I46"	"Malignant neoplasm of stomach"	"Cardiac arrest"	1	117	30	147
"C16"	"J94"	"Malignant neoplasm of stomach"	"Other pleural conditions"	1	130	50	180
"C16"	"K83"	"Malignant neoplasm of stomach"	"Other diseases of biliary tract"	1	181	87	268
"C16"	"K91"	"Malignant neoplasm of stomach"	"Intraop and postproc comp and disorders of dgstv sys, NEC"	1	247	53	300
"C18"	"A41"	"Malignant neoplasm of colon"	"Other sepsis"	1	3392	1640	5032
"C18"	"C22"	"Malignant neoplasm of colon"	"Malignant neoplasm of liver and intrahepatic bile ducts"	1	270	137	407
"C18"	"C34"	"Malignant neoplasm of colon"	"Malignant neoplasm of bronchus and lung"	1	1015	467	1482
"C18"	"C78"	"Malignant neoplasm of colon"	"Secondary malignant neoplasm of resp and digestive organs"	1	12704	7742	20446
"C18"	"C80"	"Malignant neoplasm of colon"	"Malignant neoplasm without specification of site"	1	373	159	532
"C18"	"D63"	"Malignant neoplasm of colon"	"Anemia in chronic diseases classified elsewhere"	1	2386	1029	3415
"C18"	"D70"	"Malignant neoplasm of colon"	"Neutropenia"	1	103	31	134
"C18"	"E83"	"Malignant neoplasm of colon"	"Disorders of mineral metabolism"	1	404	126	530
"C18"	"E86"	"Malignant neoplasm of colon"	"Volume depletion"	1	7193	0	7193
"C18"	"F01"	"Malignant neoplasm of colon"	"Vascular dementia"	1	149	39	188
"C18"	"G30"	"Malignant neoplasm of colon"	"Alzheimer's disease"	1	222	31	253
"C18"	"G47"	"Malignant neoplasm of colon"	"Sleep disorders"	1	1391	474	1865
"C18"	"G95"	"Malignant neoplasm of colon"	"Other and unspecified diseases of spinal cord"	1	479	136	615
"C18"	"G96"	"Malignant neoplasm of colon"	"Other disorders of central nervous system"	1	213	107	320
"C18"	"I26"	"Malignant neoplasm of colon"	"Pulmonary embolism"	1	1183	823	2006
"C18"	"I46"	"Malignant neoplasm of colon"	"Cardiac arrest"	1	613	148	761
"C18"	"I82"	"Malignant neoplasm of colon"	"Other venous embolism and thrombosis"	1	403	198	601
"C18"	"I95"	"Malignant neoplasm of colon"	"Hypotension"	1	464	254	718
"C18"	"J09"	"Malignant neoplasm of colon"	"Influenza due to certain identified influenza viruses"	1	51	6	57
"C18"	"J22"	"Malignant neoplasm of colon"	"Unspecified acute lower respiratory infection"	1	161	76	237
"C18"	"J69"	"Malignant neoplasm of colon"	"Pneumonitis due to solids and liquids"	1	299	157	456
"C18"	"J81"	"Malignant neoplasm of colon"	"Pulmonary edema"	1	392	179	571
"C18"	"K43"	"Malignant neoplasm of colon"	"Ventral hernia"	1	3120	883	4003
"C18"	"K46"	"Malignant neoplasm of colon"	"Unspecified abdominal hernia"	1	152	60	212
"C18"	"K52"	"Malignant neoplasm of colon"	"Other and unsp noninfective gastroenteritis and colitis"	1	1823	934	2757
"C18"	"K59"	"Malignant neoplasm of colon"	"Other functional intestinal disorders"	1	5739	2668	8407
"C18"	"K83"	"Malignant neoplasm of colon"	"Other diseases of biliary tract"	1	610	253	863
"C18"	"K91"	"Malignant neoplasm of colon"	"Intraop and postproc comp and disorders of dgstv sys, NEC"	1	1408	454	1862
"C18"	"L97"	"Malignant neoplasm of colon"	"Non-pressure chronic ulcer of lower limb, NEC"	1	247	145	392
"C18"	"M80"	"Malignant neoplasm of colon"	"Osteoporosis with current pathological fracture"	1	501	293	794
"C18"	"N13"	"Malignant neoplasm of colon"	"Obstructive and reflux uropathy"	1	1686	682	2368
"C19"	"C79"	"Malignant neoplasm of rectosigmoid junction"	"Secondary malignant neoplasm of other and unspecified sites"	1	114	47	161
"C19"	"D63"	"Malignant neoplasm of rectosigmoid junction"	"Anemia in chronic diseases classified elsewhere"	1	93	30	123
"C19"	"K59"	"Malignant neoplasm of rectosigmoid junction"	"Other functional intestinal disorders"	1	193	56	249
"C19"	"N30"	"Malignant neoplasm of rectosigmoid junction"	"Cystitis"	1	107	34	141
"C20"	"A04"	"Malignant neoplasm of rectum"	"Other bacterial intestinal infections"	1	206	46	252
"C20"	"A09"	"Malignant neoplasm of rectum"	"Infectious gastroenteritis and colitis, unspecified"	1	440	248	688
"C20"	"B37"	"Malignant neoplasm of rectum"	"Candidiasis"	1	320	106	426
"C20"	"C34"	"Malignant neoplasm of rectum"	"Malignant neoplasm of bronchus and lung"	1	680	179	859
"C20"	"C77"	"Malignant neoplasm of rectum"	"Secondary and unspecified malignant neoplasm of lymph nodes"	1	1049	356	1405
"C20"	"C79"	"Malignant neoplasm of rectum"	"Secondary malignant neoplasm of other and unspecified sites"	1	1727	319	2046
"C20"	"D63"	"Malignant neoplasm of rectum"	"Anemia in chronic diseases classified elsewhere"	1	1413	279	1692
"C20"	"D64"	"Malignant neoplasm of rectum"	"Other anemias"	1	1925	787	2712
"C20"	"E83"	"Malignant neoplasm of rectum"	"Disorders of mineral metabolism"	1	254	45	299
"C20"	"E86"	"Malignant neoplasm of rectum"	"Volume depletion"	1	3878	0	3878
"C20"	"F01"	"Malignant neoplasm of rectum"	"Vascular dementia"	1	70	16	86
"C20"	"F05"	"Malignant neoplasm of rectum"	"Delirium due to known physiological condition"	1	364	35	399
"C20"	"I46"	"Malignant neoplasm of rectum"	"Cardiac arrest"	1	337	41	378
"C20"	"I50"	"Malignant neoplasm of rectum"	"Heart failure"	1	1087	821	1908
"C20"	"I61"	"Malignant neoplasm of rectum"	"Nontraumatic intracerebral hemorrhage"	1	161	76	237
"C20"	"J15"	"Malignant neoplasm of rectum"	"Bacterial pneumonia, not elsewhere classified"	1	933	226	1159
"C20"	"J18"	"Malignant neoplasm of rectum"	"Pneumonia, unspecified organism"	1	2513	1096	3609
"C20"	"J69"	"Malignant neoplasm of rectum"	"Pneumonitis due to solids and liquids"	1	175	27	202
"C20"	"K45"	"Malignant neoplasm of rectum"	"Other abdominal hernia"	1	278	42	320
"C20"	"K60"	"Malignant neoplasm of rectum"	"Fissure and fistula of anal and rectal regions"	1	327	149	476
"C20"	"K63"	"Malignant neoplasm of rectum"	"Other diseases of intestine"	1	956	309	1265
"C20"	"K65"	"Malignant neoplasm of rectum"	"Peritonitis"	1	1039	328	1367
"C20"	"K66"	"Malignant neoplasm of rectum"	"Other disorders of peritoneum"	1	87	23	110
"C20"	"K91"	"Malignant neoplasm of rectum"	"Intraop and postproc comp and disorders of dgstv sys, NEC"	1	2208	0	2208
"C20"	"L97"	"Malignant neoplasm of rectum"	"Non-pressure chronic ulcer of lower limb, NEC"	1	148	66	214
"C20"	"M80"	"Malignant neoplasm of rectum"	"Osteoporosis with current pathological fracture"	1	235	86	321
"C20"	"M81"	"Malignant neoplasm of rectum"	"Osteoporosis without current pathological fracture"	1	427	256	683
"C20"	"N28"	"Malignant neoplasm of rectum"	"Oth disorders of kidney and ureter, not elsewhere classified"	1	121	37	158
"C20"	"N82"	"Malignant neoplasm of rectum"	"Fistulae involving female genital tract"	1	297	84	381
"C21"	"A49"	"Malignant neoplasm of anus and anal canal"	"Bacterial infection of unspecified site"	1	83	22	105
"C21"	"C77"	"Malignant neoplasm of anus and anal canal"	"Secondary and unspecified malignant neoplasm of lymph nodes"	1	199	59	258
"C21"	"C78"	"Malignant neoplasm of anus and anal canal"	"Secondary malignant neoplasm of resp and digestive organs"	1	277	134	411
"C21"	"D63"	"Malignant neoplasm of anus and anal canal"	"Anemia in chronic diseases classified elsewhere"	1	138	28	166
"C21"	"E83"	"Malignant neoplasm of anus and anal canal"	"Disorders of mineral metabolism"	1	43	5	48
"C21"	"K59"	"Malignant neoplasm of anus and anal canal"	"Other functional intestinal disorders"	1	292	105	397
"C21"	"N13"	"Malignant neoplasm of anus and anal canal"	"Obstructive and reflux uropathy"	1	110	37	147
"C22"	"G47"	"Malignant neoplasm of liver and intrahepatic bile ducts"	"Sleep disorders"	1	325	139	464
"C24"	"K59"	"Malignant neoplasm of other and unsp parts of biliary tract"	"Other functional intestinal disorders"	1	497	277	774
"C25"	"D63"	"Malignant neoplasm of pancreas"	"Anemia in chronic diseases classified elsewhere"	1	939	273	1212
"C25"	"E86"	"Malignant neoplasm of pancreas"	"Volume depletion"	1	1222	819	2041
"C25"	"G47"	"Malignant neoplasm of pancreas"	"Sleep disorders"	1	1074	302	1376
"C30"	"A41"	"Malignant neoplasm of nasal cavity and middle ear"	"Other sepsis"	1	70	14	84
"C30"	"C78"	"Malignant neoplasm of nasal cavity and middle ear"	"Secondary malignant neoplasm of resp and digestive organs"	1	86	19	105
"C30"	"H04"	"Malignant neoplasm of nasal cavity and middle ear"	"Disorders of lacrimal system"	1	86	17	103
"C30"	"I69"	"Malignant neoplasm of nasal cavity and middle ear"	"Sequelae of cerebrovascular disease"	1	53	11	64
"C30"	"K02"	"Malignant neoplasm of nasal cavity and middle ear"	"Dental caries"	1	98	34	132
"C30"	"K12"	"Malignant neoplasm of nasal cavity and middle ear"	"Stomatitis and related lesions"	1	70	21	91
"C32"	"A41"	"Malignant neoplasm of larynx"	"Other sepsis"	1	291	38	329
"C32"	"B37"	"Malignant neoplasm of larynx"	"Candidiasis"	1	175	48	223
"C32"	"C14"	"Malignant neoplasm of larynx"	"Malig neoplasm of sites in the lip, oral cavity and pharynx"	1	357	126	483
"C32"	"C15"	"Malignant neoplasm of larynx"	"Malignant neoplasm of esophagus"	1	127	34	161
"C32"	"C78"	"Malignant neoplasm of larynx"	"Secondary malignant neoplasm of resp and digestive organs"	1	360	56	416
"C32"	"C79"	"Malignant neoplasm of larynx"	"Secondary malignant neoplasm of other and unspecified sites"	1	234	32	266
"C32"	"D63"	"Malignant neoplasm of larynx"	"Anemia in chronic diseases classified elsewhere"	1	169	25	194
"C32"	"E03"	"Malignant neoplasm of larynx"	"Other hypothyroidism"	1	122	18	140
"C32"	"E83"	"Malignant neoplasm of larynx"	"Disorders of mineral metabolism"	1	72	19	91
"C32"	"F03"	"Malignant neoplasm of larynx"	"Unspecified dementia"	1	58	15	73
"C32"	"I50"	"Malignant neoplasm of larynx"	"Heart failure"	1	239	104	343
"C32"	"I63"	"Malignant neoplasm of larynx"	"Cerebral infarction"	1	152	75	227
"C32"	"I69"	"Malignant neoplasm of larynx"	"Sequelae of cerebrovascular disease"	1	171	65	236
"C32"	"I71"	"Malignant neoplasm of larynx"	"Aortic aneurysm and dissection"	1	95	16	111
"C32"	"J22"	"Malignant neoplasm of larynx"	"Unspecified acute lower respiratory infection"	1	54	6	60
"C32"	"J69"	"Malignant neoplasm of larynx"	"Pneumonitis due to solids and liquids"	1	118	11	129
"C32"	"J95"	"Malignant neoplasm of larynx"	"Intraop and postproc comp and disorders of resp sys, NEC"	1	546	42	588
"C32"	"J96"	"Malignant neoplasm of larynx"	"Respiratory failure, not elsewhere classified"	1	617	99	716
"C32"	"K05"	"Malignant neoplasm of larynx"	"Gingivitis and periodontal diseases"	1	926	512	1438
"C32"	"K12"	"Malignant neoplasm of larynx"	"Stomatitis and related lesions"	1	357	68	425
"C32"	"K56"	"Malignant neoplasm of larynx"	"Paralytic ileus and intestinal obstruction without hernia"	1	93	29	122
"C32"	"K59"	"Malignant neoplasm of larynx"	"Other functional intestinal disorders"	1	369	103	472
"C32"	"N18"	"Malignant neoplasm of larynx"	"Chronic kidney disease (CKD)"	1	70	12	82
"C34"	"A49"	"Malignant neoplasm of bronchus and lung"	"Bacterial infection of unspecified site"	1	1781	826	2607
"C34"	"C78"	"Malignant neoplasm of bronchus and lung"	"Secondary malignant neoplasm of resp and digestive organs"	1	19604	0	19604
"C34"	"D02"	"Malignant neoplasm of bronchus and lung"	"Carcinoma in situ of middle ear and respiratory system"	1	283	172	455
"C34"	"D61"	"Malignant neoplasm of bronchus and lung"	"Oth aplastic anemias and other bone marrow failure syndromes"	1	246	107	353
"C34"	"D69"	"Malignant neoplasm of bronchus and lung"	"Purpura and other hemorrhagic conditions"	1	544	308	852
"C34"	"D71"	"Malignant neoplasm of bronchus and lung"	"Functional disorders of polymorphonuclear neutrophils"	1	284	34	318
"C34"	"E61"	"Malignant neoplasm of bronchus and lung"	"Deficiency of other nutrient elements"	1	103	41	144
"C34"	"E83"	"Malignant neoplasm of bronchus and lung"	"Disorders of mineral metabolism"	1	1422	614	2036
"C34"	"F05"	"Malignant neoplasm of bronchus and lung"	"Delirium due to known physiological condition"	1	1250	378	1628
"C34"	"F41"	"Malignant neoplasm of bronchus and lung"	"Other anxiety disorders"	1	5180	0	5180
"C34"	"G95"	"Malignant neoplasm of bronchus and lung"	"Other and unspecified diseases of spinal cord"	1	2266	1273	3539
"C34"	"J86"	"Malignant neoplasm of bronchus and lung"	"Pyothorax"	1	723	534	1257
"C34"	"J96"	"Malignant neoplasm of bronchus and lung"	"Respiratory failure, not elsewhere classified"	1	6568	3860	10428
"C34"	"K59"	"Malignant neoplasm of bronchus and lung"	"Other functional intestinal disorders"	1	10828	0	10828
"C40"	"A41"	"Malignant neoplasm of bone and articular cartilage of limbs"	"Other sepsis"	1	181	47	228
"C40"	"A49"	"Malignant neoplasm of bone and articular cartilage of limbs"	"Bacterial infection of unspecified site"	1	50	10	60
"C40"	"D63"	"Malignant neoplasm of bone and articular cartilage of limbs"	"Anemia in chronic diseases classified elsewhere"	1	100	29	129
"C40"	"J96"	"Malignant neoplasm of bone and articular cartilage of limbs"	"Respiratory failure, not elsewhere classified"	1	63	13	76
"C40"	"K59"	"Malignant neoplasm of bone and articular cartilage of limbs"	"Other functional intestinal disorders"	1	108	29	137
"C41"	"F41"	"Malignant neoplasm of bone/artic cartl of and unsp sites"	"Other anxiety disorders"	1	79	14	93
"C41"	"G47"	"Malignant neoplasm of bone/artic cartl of and unsp sites"	"Sleep disorders"	1	85	23	108
"C41"	"K59"	"Malignant neoplasm of bone/artic cartl of and unsp sites"	"Other functional intestinal disorders"	1	196	101	297
"C43"	"C15"	"Malignant melanoma of skin"	"Malignant neoplasm of esophagus"	1	50	5	55
"C43"	"C16"	"Malignant melanoma of skin"	"Malignant neoplasm of stomach"	1	71	11	82
"C43"	"C18"	"Malignant melanoma of skin"	"Malignant neoplasm of colon"	1	213	108	321
"C43"	"C22"	"Malignant melanoma of skin"	"Malignant neoplasm of liver and intrahepatic bile ducts"	1	42	5	47
"C43"	"C44"	"Malignant melanoma of skin"	"Other and unspecified malignant neoplasm of skin"	1	2177	1624	3801
"C43"	"C77"	"Malignant melanoma of skin"	"Secondary and unspecified malignant neoplasm of lymph nodes"	1	5613	0	5613
"C43"	"C79"	"Malignant melanoma of skin"	"Secondary malignant neoplasm of other and unspecified sites"	1	4000	0	4000
"C43"	"C80"	"Malignant melanoma of skin"	"Malignant neoplasm without specification of site"	1	159	45	204
"C43"	"D04"	"Malignant melanoma of skin"	"Carcinoma in situ of skin"	1	143	56	199
"C43"	"D09"	"Malignant melanoma of skin"	"Carcinoma in situ of other and unspecified sites"	1	38	5	43
"C43"	"D12"	"Malignant melanoma of skin"	"Benign neoplasm of colon, rectum, anus and anal canal"	1	637	276	913
"C43"	"D23"	"Malignant melanoma of skin"	"Other benign neoplasms of skin"	1	2626	868	3494
"C43"	"D36"	"Malignant melanoma of skin"	"Benign neoplasm of other and unspecified sites"	1	411	214	625
"C43"	"E27"	"Malignant melanoma of skin"	"Other disorders of adrenal gland"	1	89	17	106
"C43"	"E55"	"Malignant melanoma of skin"	"Vitamin D deficiency"	1	72	9	81
"C43"	"E83"	"Malignant melanoma of skin"	"Disorders of mineral metabolism"	1	102	25	127
"C43"	"E86"	"Malignant melanoma of skin"	"Volume depletion"	1	1036	155	1191
"C43"	"E87"	"Malignant melanoma of skin"	"Other disorders of fluid, electrolyte and acid-base balance"	1	467	86	553
"C43"	"F02"	"Malignant melanoma of skin"	"Dementia in other diseases classified elsewhere"	1	29	1	30
"C43"	"F06"	"Malignant melanoma of skin"	"Other mental disorders due to known physiological condition"	1	49	10	59
"C43"	"G95"	"Malignant melanoma of skin"	"Other and unspecified diseases of spinal cord"	1	264	43	307
"C43"	"G96"	"Malignant melanoma of skin"	"Other disorders of central nervous system"	1	190	37	227
"C43"	"G98"	"Malignant melanoma of skin"	"Other disorders of nervous system not elsewhere classified"	1	63	9	72
"C43"	"I35"	"Malignant melanoma of skin"	"Nonrheumatic aortic valve disorders"	1	329	120	449
"C43"	"I50"	"Malignant melanoma of skin"	"Heart failure"	1	677	326	1003
"C43"	"I71"	"Malignant melanoma of skin"	"Aortic aneurysm and dissection"	1	162	61	223
"C43"	"I89"	"Malignant melanoma of skin"	"Oth noninfective disorders of lymphatic vessels and nodes"	1	619	75	694
"C43"	"I95"	"Malignant melanoma of skin"	"Hypotension"	1	137	51	188
"C43"	"J09"	"Malignant melanoma of skin"	"Influenza due to certain identified influenza viruses"	1	29	2	31
"C43"	"J15"	"Malignant melanoma of skin"	"Bacterial pneumonia, not elsewhere classified"	1	555	123	678
"C43"	"K59"	"Malignant melanoma of skin"	"Other functional intestinal disorders"	1	1174	346	1520
"C43"	"K64"	"Malignant melanoma of skin"	"Hemorrhoids and perianal venous thrombosis"	1	252	18	270
"C43"	"L57"	"Malignant melanoma of skin"	"Skin changes due to chronic expsr to nonionizing radiation"	1	686	177	863
"C43"	"L81"	"Malignant melanoma of skin"	"Other disorders of pigmentation"	1	196	86	282
"C43"	"L89"	"Malignant melanoma of skin"	"Pressure ulcer"	1	97	21	118
"C43"	"L90"	"Malignant melanoma of skin"	"Atrophic disorders of skin"	1	845	241	1086
"C43"	"M80"	"Malignant melanoma of skin"	"Osteoporosis with current pathological fracture"	1	212	51	263
"C43"	"M81"	"Malignant melanoma of skin"	"Osteoporosis without current pathological fracture"	1	491	207	698
"C43"	"M85"	"Malignant melanoma of skin"	"Other disorders of bone density and structure"	1	243	80	323
"C43"	"M90"	"Malignant melanoma of skin"	"Osteopathies in diseases classified elsewhere"	1	32	2	34
"C43"	"M96"	"Malignant melanoma of skin"	"Intraop and postproc comp and disorders of ms sys, NEC"	1	205	42	247
"C43"	"N17"	"Malignant melanoma of skin"	"Acute kidney failure"	1	144	29	173
"C43"	"N19"	"Malignant melanoma of skin"	"Unspecified kidney failure"	1	136	43	179
"C43"	"N39"	"Malignant melanoma of skin"	"Other disorders of urinary system"	1	688	288	976
"C43"	"Q82"	"Malignant melanoma of skin"	"Other congenital malformations of skin"	1	339	139	478
"C44"	"A04"	"Other and unspecified malignant neoplasm of skin"	"Other bacterial intestinal infections"	1	426	200	626
"C44"	"C16"	"Other and unspecified malignant neoplasm of skin"	"Malignant neoplasm of stomach"	1	211	60	271
"C44"	"C24"	"Other and unspecified malignant neoplasm of skin"	"Malignant neoplasm of other and unsp parts of biliary tract"	1	73	9	82
"C44"	"C34"	"Other and unspecified malignant neoplasm of skin"	"Malignant neoplasm of bronchus and lung"	1	1737	346	2083
"C44"	"C77"	"Other and unspecified malignant neoplasm of skin"	"Secondary and unspecified malignant neoplasm of lymph nodes"	1	1245	671	1916
"C44"	"C78"	"Other and unspecified malignant neoplasm of skin"	"Secondary malignant neoplasm of resp and digestive organs"	1	1499	233	1732
"C44"	"C80"	"Other and unspecified malignant neoplasm of skin"	"Malignant neoplasm without specification of site"	1	290	65	355
"C44"	"D04"	"Other and unspecified malignant neoplasm of skin"	"Carcinoma in situ of skin"	1	929	640	1569
"C44"	"D64"	"Other and unspecified malignant neoplasm of skin"	"Other anemias"	1	2702	1385	4087
"C44"	"E83"	"Other and unspecified malignant neoplasm of skin"	"Disorders of mineral metabolism"	1	325	125	450
"C44"	"G30"	"Other and unspecified malignant neoplasm of skin"	"Alzheimer's disease"	1	529	110	639
"C44"	"G47"	"Other and unspecified malignant neoplasm of skin"	"Sleep disorders"	1	645	446	1091
"C44"	"G95"	"Other and unspecified malignant neoplasm of skin"	"Other and unspecified diseases of spinal cord"	1	246	93	339
"C44"	"I35"	"Other and unspecified malignant neoplasm of skin"	"Nonrheumatic aortic valve disorders"	1	1480	871	2351
"C44"	"I46"	"Other and unspecified malignant neoplasm of skin"	"Cardiac arrest"	1	790	57	847
"C44"	"I69"	"Other and unspecified malignant neoplasm of skin"	"Sequelae of cerebrovascular disease"	1	1778	1482	3260
"C44"	"I71"	"Other and unspecified malignant neoplasm of skin"	"Aortic aneurysm and dissection"	1	597	397	994
"C44"	"I95"	"Other and unspecified malignant neoplasm of skin"	"Hypotension"	1	664	304	968
"C44"	"J18"	"Other and unspecified malignant neoplasm of skin"	"Pneumonia, unspecified organism"	1	5536	3326	8862
"C44"	"J81"	"Other and unspecified malignant neoplasm of skin"	"Pulmonary edema"	1	500	153	653
"C44"	"J90"	"Other and unspecified malignant neoplasm of skin"	"Pleural effusion, not elsewhere classified"	1	628	233	861
"C44"	"J95"	"Other and unspecified malignant neoplasm of skin"	"Intraop and postproc comp and disorders of resp sys, NEC"	1	116	43	159
"C44"	"K55"	"Other and unspecified malignant neoplasm of skin"	"Vascular disorders of intestine"	1	169	69	238
"C44"	"K59"	"Other and unspecified malignant neoplasm of skin"	"Other functional intestinal disorders"	1	2372	1499	3871
"C44"	"K64"	"Other and unspecified malignant neoplasm of skin"	"Hemorrhoids and perianal venous thrombosis"	1	582	156	738
"C44"	"K92"	"Other and unspecified malignant neoplasm of skin"	"Other diseases of digestive system"	1	1109	669	1778
"C44"	"L57"	"Other and unspecified malignant neoplasm of skin"	"Skin changes due to chronic expsr to nonionizing radiation"	1	4276	2471	6747
"C44"	"L59"	"Other and unspecified malignant neoplasm of skin"	"Oth disorders of skin, subcu related to radiation"	1	88	25	113
"C44"	"L82"	"Other and unspecified malignant neoplasm of skin"	"Seborrheic keratosis"	1	1284	790	2074
"C44"	"L89"	"Other and unspecified malignant neoplasm of skin"	"Pressure ulcer"	1	516	164	680
"C44"	"L90"	"Other and unspecified malignant neoplasm of skin"	"Atrophic disorders of skin"	1	1359	535	1894
"C44"	"L97"	"Other and unspecified malignant neoplasm of skin"	"Non-pressure chronic ulcer of lower limb, NEC"	1	627	444	1071
"C44"	"L98"	"Other and unspecified malignant neoplasm of skin"	"Oth disorders of skin, subcu, not elsewhere classified"	1	891	621	1512
"C44"	"N17"	"Other and unspecified malignant neoplasm of skin"	"Acute kidney failure"	1	608	201	809
"C44"	"N18"	"Other and unspecified malignant neoplasm of skin"	"Chronic kidney disease (CKD)"	1	1319	769	2088
"C44"	"N30"	"Other and unspecified malignant neoplasm of skin"	"Cystitis"	1	2999	2437	5436
"C44"	"N39"	"Other and unspecified malignant neoplasm of skin"	"Other disorders of urinary system"	1	2489	1704	4193
"C45"	"A49"	"Mesothelioma"	"Bacterial infection of unspecified site"	1	99	21	120
"C45"	"C79"	"Mesothelioma"	"Secondary malignant neoplasm of other and unspecified sites"	1	110	37	147
"C45"	"D64"	"Mesothelioma"	"Other anemias"	1	308	107	415
"C45"	"K59"	"Mesothelioma"	"Other functional intestinal disorders"	1	404	104	508
"C48"	"D63"	"Malignant neoplasm of retroperitoneum and peritoneum"	"Anemia in chronic diseases classified elsewhere"	1	175	57	232
"C48"	"F41"	"Malignant neoplasm of retroperitoneum and peritoneum"	"Other anxiety disorders"	1	100	30	130
"C48"	"K59"	"Malignant neoplasm of retroperitoneum and peritoneum"	"Other functional intestinal disorders"	1	249	140	389
"C49"	"C78"	"Malignant neoplasm of other connective and soft tissue"	"Secondary malignant neoplasm of resp and digestive organs"	1	743	541	1284
"C49"	"D63"	"Malignant neoplasm of other connective and soft tissue"	"Anemia in chronic diseases classified elsewhere"	1	386	104	490
"C49"	"E86"	"Malignant neoplasm of other connective and soft tissue"	"Volume depletion"	1	297	105	402
"C49"	"J15"	"Malignant neoplasm of other connective and soft tissue"	"Bacterial pneumonia, not elsewhere classified"	1	188	72	260
"C49"	"K59"	"Malignant neoplasm of other connective and soft tissue"	"Other functional intestinal disorders"	1	492	201	693
"C50"	"A09"	"Malignant neoplasm of breast"	"Infectious gastroenteritis and colitis, unspecified"	1	898	487	1385
"C50"	"A41"	"Malignant neoplasm of breast"	"Other sepsis"	1	2966	0	2966
"C50"	"B34"	"Malignant neoplasm of breast"	"Viral infection of unspecified site"	1	208	107	315
"C50"	"C15"	"Malignant neoplasm of breast"	"Malignant neoplasm of esophagus"	1	103	10	113
"C50"	"C16"	"Malignant neoplasm of breast"	"Malignant neoplasm of stomach"	1	187	21	208
"C50"	"C17"	"Malignant neoplasm of breast"	"Malignant neoplasm of small intestine"	1	52	6	58
"C50"	"C18"	"Malignant neoplasm of breast"	"Malignant neoplasm of colon"	1	819	315	1134
"C50"	"C20"	"Malignant neoplasm of breast"	"Malignant neoplasm of rectum"	1	273	162	435
"C50"	"C22"	"Malignant neoplasm of breast"	"Malignant neoplasm of liver and intrahepatic bile ducts"	1	106	9	115
"C50"	"C24"	"Malignant neoplasm of breast"	"Malignant neoplasm of other and unsp parts of biliary tract"	1	78	5	83
"C50"	"C34"	"Malignant neoplasm of breast"	"Malignant neoplasm of bronchus and lung"	1	1730	350	2080
"C50"	"C40"	"Malignant neoplasm of breast"	"Malignant neoplasm of bone and articular cartilage of limbs"	1	112	37	149
"C50"	"C41"	"Malignant neoplasm of breast"	"Malignant neoplasm of bone/artic cartl of and unsp sites"	1	271	81	352
"C50"	"C44"	"Malignant neoplasm of breast"	"Other and unspecified malignant neoplasm of skin"	1	1140	395	1535
"C50"	"C48"	"Malignant neoplasm of breast"	"Malignant neoplasm of retroperitoneum and peritoneum"	1	49	4	53
"C50"	"C64"	"Malignant neoplasm of breast"	"Malignant neoplasm of kidney, except renal pelvis"	1	186	56	242
"C50"	"C70"	"Malignant neoplasm of breast"	"Malignant neoplasm of meninges"	1	56	3	59
"C50"	"C72"	"Malignant neoplasm of breast"	"Malig neoplm of spinal cord, cranial nerves and oth prt cnsl"	1	58	15	73
"C50"	"C78"	"Malignant neoplasm of breast"	"Secondary malignant neoplasm of resp and digestive organs"	1	8054	0	8054
"C50"	"C83"	"Malignant neoplasm of breast"	"Non-follicular lymphoma"	1	160	58	218
"C50"	"C90"	"Malignant neoplasm of breast"	"Multiple myeloma and malignant plasma cell neoplasms"	1	115	24	139
"C50"	"C92"	"Malignant neoplasm of breast"	"Myeloid leukemia"	1	129	17	146
"C50"	"D09"	"Malignant neoplasm of breast"	"Carcinoma in situ of other and unspecified sites"	1	63	5	68
"C50"	"D10"	"Malignant neoplasm of breast"	"Benign neoplasm of mouth and pharynx"	1	161	81	242
"C50"	"D32"	"Malignant neoplasm of breast"	"Benign neoplasm of meninges"	1	151	61	212
"C50"	"D35"	"Malignant neoplasm of breast"	"Benign neoplasm of other and unspecified endocrine glands"	1	169	45	214
"C50"	"D47"	"Malignant neoplasm of breast"	"Oth neoplm of uncrt behav of lymphoid, hematpoetc & rel tiss"	1	177	16	193
"C50"	"D50"	"Malignant neoplasm of breast"	"Iron deficiency anemia"	1	657	206	863
"C50"	"D63"	"Malignant neoplasm of breast"	"Anemia in chronic diseases classified elsewhere"	1	1758	0	1758
"C50"	"D70"	"Malignant neoplasm of breast"	"Neutropenia"	1	499	33	532
"C50"	"D71"	"Malignant neoplasm of breast"	"Functional disorders of polymorphonuclear neutrophils"	1	228	9	237
"C50"	"E10"	"Malignant neoplasm of breast"	"Type 1 diabetes mellitus"	1	850	649	1499
"C50"	"E21"	"Malignant neoplasm of breast"	"Hyperparathyroidism and other disorders of parathyroid gland"	1	443	119	562
"C50"	"E27"	"Malignant neoplasm of breast"	"Other disorders of adrenal gland"	1	91	26	117
"C50"	"E34"	"Malignant neoplasm of breast"	"Other endocrine disorders"	1	115	22	137
"C50"	"E41"	"Malignant neoplasm of breast"	"Nutritional marasmus"	1	83	0	83
"C50"	"E83"	"Malignant neoplasm of breast"	"Disorders of mineral metabolism"	1	812	69	881
"C50"	"F03"	"Malignant neoplasm of breast"	"Unspecified dementia"	1	1382	187	1569
"C50"	"F17"	"Malignant neoplasm of breast"	"Nicotine dependence"	1	593	211	804
"C50"	"F33"	"Malignant neoplasm of breast"	"Major depressive disorder, recurrent"	1	775	267	1042
"C50"	"F43"	"Malignant neoplasm of breast"	"Reaction to severe stress, and adjustment disorders"	1	808	255	1063
"C50"	"G20"	"Malignant neoplasm of breast"	"Parkinson's disease"	1	257	92	349
"C50"	"G25"	"Malignant neoplasm of breast"	"Other extrapyramidal and movement disorders"	1	142	48	190
"C50"	"G30"	"Malignant neoplasm of breast"	"Alzheimer's disease"	1	330	0	330
"C50"	"G40"	"Malignant neoplasm of breast"	"Epilepsy and recurrent seizures"	1	550	371	921
"C50"	"G55"	"Malignant neoplasm of breast"	"Nerve root and plexus compressions in diseases classd elswhr"	1	216	39	255
"C50"	"G95"	"Malignant neoplasm of breast"	"Other and unspecified diseases of spinal cord"	1	1698	0	1698
"C50"	"G96"	"Malignant neoplasm of breast"	"Other disorders of central nervous system"	1	466	34	500
"C50"	"G98"	"Malignant neoplasm of breast"	"Other disorders of nervous system not elsewhere classified"	1	144	30	174
"C50"	"H02"	"Malignant neoplasm of breast"	"Other disorders of eyelid"	1	638	337	975
"C50"	"H25"	"Malignant neoplasm of breast"	"Age-related cataract"	1	4961	2332	7293
"C50"	"H43"	"Malignant neoplasm of breast"	"Disorders of vitreous body"	1	355	216	571
"C50"	"H49"	"Malignant neoplasm of breast"	"Paralytic strabismus"	1	134	49	183
"C50"	"H57"	"Malignant neoplasm of breast"	"Other disorders of eye and adnexa"	1	254	66	320
"C50"	"H91"	"Malignant neoplasm of breast"	"Other and unspecified hearing loss"	1	2443	2015	4458
"C50"	"I10"	"Malignant neoplasm of breast"	"Essential (primary) hypertension"	1	6985	5408	12393
"C50"	"I26"	"Malignant neoplasm of breast"	"Pulmonary embolism"	1	1440	250	1690
"C50"	"I31"	"Malignant neoplasm of breast"	"Other diseases of pericardium"	1	230	31	261
"C50"	"I46"	"Malignant neoplasm of breast"	"Cardiac arrest"	1	520	0	520
"C50"	"I50"	"Malignant neoplasm of breast"	"Heart failure"	1	3044	940	3984
"C50"	"I61"	"Malignant neoplasm of breast"	"Nontraumatic intracerebral hemorrhage"	1	444	99	543
"C50"	"I70"	"Malignant neoplasm of breast"	"Atherosclerosis"	1	712	523	1235
"C50"	"I71"	"Malignant neoplasm of breast"	"Aortic aneurysm and dissection"	1	371	60	431
"C50"	"I78"	"Malignant neoplasm of breast"	"Diseases of capillaries"	1	456	100	556
"C50"	"I80"	"Malignant neoplasm of breast"	"Phlebitis and thrombophlebitis"	1	1545	678	2223
"C50"	"I87"	"Malignant neoplasm of breast"	"Other disorders of veins"	1	160	60	220
"C50"	"I88"	"Malignant neoplasm of breast"	"Nonspecific lymphadenitis"	1	253	96	349
"C50"	"I89"	"Malignant neoplasm of breast"	"Oth noninfective disorders of lymphatic vessels and nodes"	1	3331	0	3331
"C50"	"I95"	"Malignant neoplasm of breast"	"Hypotension"	1	491	51	542
"C50"	"I97"	"Malignant neoplasm of breast"	"Intraop and postproc comp and disorders of circ sys, NEC"	1	3057	0	3057
"C50"	"J09"	"Malignant neoplasm of breast"	"Influenza due to certain identified influenza viruses"	1	72	0	72
"C50"	"J10"	"Malignant neoplasm of breast"	"Influenza due to other identified influenza virus"	1	79	0	79
"C50"	"J14"	"Malignant neoplasm of breast"	"Pneumonia due to Hemophilus influenzae"	1	64	7	71
"C50"	"J18"	"Malignant neoplasm of breast"	"Pneumonia, unspecified organism"	1	7694	0	7694
"C50"	"J22"	"Malignant neoplasm of breast"	"Unspecified acute lower respiratory infection"	1	251	16	267
"C50"	"J44"	"Malignant neoplasm of breast"	"Other chronic obstructive pulmonary disease"	1	2673	1345	4018
"C50"	"J47"	"Malignant neoplasm of breast"	"Bronchiectasis"	1	122	25	147
"C50"	"J69"	"Malignant neoplasm of breast"	"Pneumonitis due to solids and liquids"	1	163	0	163
"C50"	"J84"	"Malignant neoplasm of breast"	"Other interstitial pulmonary diseases"	1	359	72	431
"C50"	"J85"	"Malignant neoplasm of breast"	"Abscess of lung and mediastinum"	1	55	8	63
"C50"	"J86"	"Malignant neoplasm of breast"	"Pyothorax"	1	103	41	144
"C50"	"J90"	"Malignant neoplasm of breast"	"Pleural effusion, not elsewhere classified"	1	1685	0	1685
"C50"	"J94"	"Malignant neoplasm of breast"	"Other pleural conditions"	1	597	114	711
"C50"	"J96"	"Malignant neoplasm of breast"	"Respiratory failure, not elsewhere classified"	1	2320	0	2320
"C50"	"K04"	"Malignant neoplasm of breast"	"Diseases of pulp and periapical tissues"	1	534	155	689
"C50"	"K08"	"Malignant neoplasm of breast"	"Other disorders of teeth and supporting structures"	1	260	133	393
"C50"	"K25"	"Malignant neoplasm of breast"	"Gastric ulcer"	1	756	501	1257
"C50"	"K31"	"Malignant neoplasm of breast"	"Other diseases of stomach and duodenum"	1	181	37	218
"C50"	"K55"	"Malignant neoplasm of breast"	"Vascular disorders of intestine"	1	155	19	174
"C50"	"K56"	"Malignant neoplasm of breast"	"Paralytic ileus and intestinal obstruction without hernia"	1	1136	256	1392
"C50"	"K57"	"Malignant neoplasm of breast"	"Diverticular disease of intestine"	1	1854	685	2539
"C50"	"K63"	"Malignant neoplasm of breast"	"Other diseases of intestine"	1	290	48	338
"C50"	"K64"	"Malignant neoplasm of breast"	"Hemorrhoids and perianal venous thrombosis"	1	611	16	627
"C50"	"K86"	"Malignant neoplasm of breast"	"Other diseases of pancreas"	1	162	70	232
"C50"	"K91"	"Malignant neoplasm of breast"	"Intraop and postproc comp and disorders of dgstv sys, NEC"	1	124	42	166
"C50"	"L30"	"Malignant neoplasm of breast"	"Other and unspecified dermatitis"	1	451	175	626
"C50"	"L57"	"Malignant neoplasm of breast"	"Skin changes due to chronic expsr to nonionizing radiation"	1	284	54	338
"C50"	"L97"	"Malignant neoplasm of breast"	"Non-pressure chronic ulcer of lower limb, NEC"	1	423	81	504
"C50"	"M00"	"Malignant neoplasm of breast"	"Pyogenic arthritis"	1	99	32	131
"C50"	"M13"	"Malignant neoplasm of breast"	"Other arthritis"	1	281	165	446
"C50"	"M16"	"Malignant neoplasm of breast"	"Osteoarthritis of hip"	1	1320	959	2279
"C50"	"M18"	"Malignant neoplasm of breast"	"Osteoarthritis of first carpometacarpal joint"	1	309	167	476
"C50"	"M19"	"Malignant neoplasm of breast"	"Other and unspecified osteoarthritis"	1	1116	580	1696
"C50"	"M49"	"Malignant neoplasm of breast"	"Spondylopathies in diseases classified elsewhere"	1	94	19	113
"C50"	"M80"	"Malignant neoplasm of breast"	"Osteoporosis with current pathological fracture"	1	1341	170	1511
"C50"	"M89"	"Malignant neoplasm of breast"	"Other disorders of bone"	1	925	435	1360
"C50"	"M90"	"Malignant neoplasm of breast"	"Osteopathies in diseases classified elsewhere"	1	489	43	532
"C50"	"N12"	"Malignant neoplasm of breast"	"Tubulo-interstitial nephritis, not spcf as acute or chronic"	1	94	28	122
"C50"	"N61"	"Malignant neoplasm of breast"	"Inflammatory disorders of breast"	1	978	407	1385
"C50"	"N62"	"Malignant neoplasm of breast"	"Hypertrophy of breast"	1	1936	459	2395
"C51"	"A49"	"Malignant neoplasm of vulva"	"Bacterial infection of unspecified site"	1	58	11	69
"C51"	"E83"	"Malignant neoplasm of vulva"	"Disorders of mineral metabolism"	1	35	4	39
"C51"	"E86"	"Malignant neoplasm of vulva"	"Volume depletion"	1	141	34	175
"C51"	"I89"	"Malignant neoplasm of vulva"	"Oth noninfective disorders of lymphatic vessels and nodes"	1	103	14	117
"C51"	"J15"	"Malignant neoplasm of vulva"	"Bacterial pneumonia, not elsewhere classified"	1	64	17	81
"C51"	"J96"	"Malignant neoplasm of vulva"	"Respiratory failure, not elsewhere classified"	1	63	6	69
"C51"	"K59"	"Malignant neoplasm of vulva"	"Other functional intestinal disorders"	1	145	44	189
"C53"	"A09"	"Malignant neoplasm of cervix uteri"	"Infectious gastroenteritis and colitis, unspecified"	1	125	48	173
"C53"	"A49"	"Malignant neoplasm of cervix uteri"	"Bacterial infection of unspecified site"	1	196	13	209
"C53"	"C34"	"Malignant neoplasm of cervix uteri"	"Malignant neoplasm of bronchus and lung"	1	206	8	214
"C53"	"C77"	"Malignant neoplasm of cervix uteri"	"Secondary and unspecified malignant neoplasm of lymph nodes"	1	383	69	452
"C53"	"C78"	"Malignant neoplasm of cervix uteri"	"Secondary malignant neoplasm of resp and digestive organs"	1	722	160	882
"C53"	"D63"	"Malignant neoplasm of cervix uteri"	"Anemia in chronic diseases classified elsewhere"	1	583	72	655
"C53"	"D69"	"Malignant neoplasm of cervix uteri"	"Purpura and other hemorrhagic conditions"	1	74	23	97
"C53"	"E03"	"Malignant neoplasm of cervix uteri"	"Other hypothyroidism"	1	111	48	159
"C53"	"E61"	"Malignant neoplasm of cervix uteri"	"Deficiency of other nutrient elements"	1	34	3	37
"C53"	"E64"	"Malignant neoplasm of cervix uteri"	"Sequelae of malnutrition and other nutritional deficiencies"	1	55	2	57
"C53"	"E83"	"Malignant neoplasm of cervix uteri"	"Disorders of mineral metabolism"	1	193	16	209
"C53"	"E86"	"Malignant neoplasm of cervix uteri"	"Volume depletion"	1	566	56	622
"C53"	"E87"	"Malignant neoplasm of cervix uteri"	"Other disorders of fluid, electrolyte and acid-base balance"	1	296	38	334
"C53"	"F52"	"Malignant neoplasm of cervix uteri"	"Sexual dysfnct not due to a substance or known physiol cond"	1	66	8	74
"C53"	"G95"	"Malignant neoplasm of cervix uteri"	"Other and unspecified diseases of spinal cord"	1	77	7	84
"C53"	"G96"	"Malignant neoplasm of cervix uteri"	"Other disorders of central nervous system"	1	29	0	29
"C53"	"H25"	"Malignant neoplasm of cervix uteri"	"Age-related cataract"	1	209	105	314
"C53"	"H93"	"Malignant neoplasm of cervix uteri"	"Other disorders of ear, not elsewhere classified"	1	117	51	168
"C53"	"I21"	"Malignant neoplasm of cervix uteri"	"Acute myocardial infarction"	1	112	39	151
"C53"	"I34"	"Malignant neoplasm of cervix uteri"	"Nonrheumatic mitral valve disorders"	1	30	3	33
"C53"	"I63"	"Malignant neoplasm of cervix uteri"	"Cerebral infarction"	1	112	35	147
"C53"	"I74"	"Malignant neoplasm of cervix uteri"	"Arterial embolism and thrombosis"	1	54	9	63
"C53"	"I89"	"Malignant neoplasm of cervix uteri"	"Oth noninfective disorders of lymphatic vessels and nodes"	1	460	25	485
"C53"	"J15"	"Malignant neoplasm of cervix uteri"	"Bacterial pneumonia, not elsewhere classified"	1	156	20	176
"C53"	"J44"	"Malignant neoplasm of cervix uteri"	"Other chronic obstructive pulmonary disease"	1	229	86	315
"C53"	"K52"	"Malignant neoplasm of cervix uteri"	"Other and unsp noninfective gastroenteritis and colitis"	1	453	54	507
"C53"	"K56"	"Malignant neoplasm of cervix uteri"	"Paralytic ileus and intestinal obstruction without hernia"	1	752	114	866
"C53"	"K57"	"Malignant neoplasm of cervix uteri"	"Diverticular disease of intestine"	1	144	32	176
"C53"	"K62"	"Malignant neoplasm of cervix uteri"	"Other diseases of anus and rectum"	1	527	94	621
"C53"	"K63"	"Malignant neoplasm of cervix uteri"	"Other diseases of intestine"	1	139	16	155
"C53"	"K65"	"Malignant neoplasm of cervix uteri"	"Peritonitis"	1	181	26	207
"C53"	"K91"	"Malignant neoplasm of cervix uteri"	"Intraop and postproc comp and disorders of dgstv sys, NEC"	1	170	18	188
"C53"	"M48"	"Malignant neoplasm of cervix uteri"	"Other spondylopathies"	1	67	16	83
"C53"	"M75"	"Malignant neoplasm of cervix uteri"	"Shoulder lesions"	1	110	37	147
"C53"	"M80"	"Malignant neoplasm of cervix uteri"	"Osteoporosis with current pathological fracture"	1	77	15	92
"C53"	"N13"	"Malignant neoplasm of cervix uteri"	"Obstructive and reflux uropathy"	1	976	290	1266
"C53"	"N17"	"Malignant neoplasm of cervix uteri"	"Acute kidney failure"	1	135	28	163
"C53"	"N28"	"Malignant neoplasm of cervix uteri"	"Oth disorders of kidney and ureter, not elsewhere classified"	1	49	4	53
"C54"	"A08"	"Malignant neoplasm of corpus uteri"	"Viral and other specified intestinal infections"	1	56	10	66
"C54"	"A09"	"Malignant neoplasm of corpus uteri"	"Infectious gastroenteritis and colitis, unspecified"	1	224	56	280
"C54"	"A46"	"Malignant neoplasm of corpus uteri"	"Erysipelas"	1	198	63	261
"C54"	"B37"	"Malignant neoplasm of corpus uteri"	"Candidiasis"	1	90	27	117
"C54"	"C55"	"Malignant neoplasm of corpus uteri"	"Malignant neoplasm of uterus, part unspecified"	1	643	332	975
"C54"	"C64"	"Malignant neoplasm of corpus uteri"	"Malignant neoplasm of kidney, except renal pelvis"	1	77	21	98
"C54"	"C77"	"Malignant neoplasm of corpus uteri"	"Secondary and unspecified malignant neoplasm of lymph nodes"	1	348	87	435
"C54"	"C78"	"Malignant neoplasm of corpus uteri"	"Secondary malignant neoplasm of resp and digestive organs"	1	1290	206	1496
"C54"	"C79"	"Malignant neoplasm of corpus uteri"	"Secondary malignant neoplasm of other and unspecified sites"	1	667	109	776
"C54"	"C80"	"Malignant neoplasm of corpus uteri"	"Malignant neoplasm without specification of site"	1	100	25	125
"C54"	"D47"	"Malignant neoplasm of corpus uteri"	"Oth neoplm of uncrt behav of lymphoid, hematpoetc & rel tiss"	1	29	1	30
"C54"	"D50"	"Malignant neoplasm of corpus uteri"	"Iron deficiency anemia"	1	195	70	265
"C54"	"D63"	"Malignant neoplasm of corpus uteri"	"Anemia in chronic diseases classified elsewhere"	1	601	77	678
"C54"	"D64"	"Malignant neoplasm of corpus uteri"	"Other anemias"	1	903	160	1063
"C54"	"E55"	"Malignant neoplasm of corpus uteri"	"Vitamin D deficiency"	1	41	1	42
"C54"	"F33"	"Malignant neoplasm of corpus uteri"	"Major depressive disorder, recurrent"	1	139	65	204
"C54"	"G95"	"Malignant neoplasm of corpus uteri"	"Other and unspecified diseases of spinal cord"	1	88	24	112
"C54"	"G96"	"Malignant neoplasm of corpus uteri"	"Other disorders of central nervous system"	1	76	7	83
"C54"	"H25"	"Malignant neoplasm of corpus uteri"	"Age-related cataract"	1	889	397	1286
"C54"	"H35"	"Malignant neoplasm of corpus uteri"	"Other retinal disorders"	1	271	93	364
"C54"	"I21"	"Malignant neoplasm of corpus uteri"	"Acute myocardial infarction"	1	257	108	365
"C54"	"I35"	"Malignant neoplasm of corpus uteri"	"Nonrheumatic aortic valve disorders"	1	189	37	226
"C54"	"I50"	"Malignant neoplasm of corpus uteri"	"Heart failure"	1	494	136	630
"C54"	"I61"	"Malignant neoplasm of corpus uteri"	"Nontraumatic intracerebral hemorrhage"	1	68	8	76
"C54"	"I69"	"Malignant neoplasm of corpus uteri"	"Sequelae of cerebrovascular disease"	1	302	76	378
"C54"	"I80"	"Malignant neoplasm of corpus uteri"	"Phlebitis and thrombophlebitis"	1	434	200	634
"C54"	"I82"	"Malignant neoplasm of corpus uteri"	"Other venous embolism and thrombosis"	1	92	29	121
"C54"	"I89"	"Malignant neoplasm of corpus uteri"	"Oth noninfective disorders of lymphatic vessels and nodes"	1	267	51	318
"C54"	"I95"	"Malignant neoplasm of corpus uteri"	"Hypotension"	1	100	10	110
"C54"	"J22"	"Malignant neoplasm of corpus uteri"	"Unspecified acute lower respiratory infection"	1	25	1	26
"C54"	"J90"	"Malignant neoplasm of corpus uteri"	"Pleural effusion, not elsewhere classified"	1	170	24	194
"C54"	"J96"	"Malignant neoplasm of corpus uteri"	"Respiratory failure, not elsewhere classified"	1	345	8	353
"C54"	"J98"	"Malignant neoplasm of corpus uteri"	"Other respiratory disorders"	1	69	20	89
"C54"	"K25"	"Malignant neoplasm of corpus uteri"	"Gastric ulcer"	1	185	78	263
"C54"	"K43"	"Malignant neoplasm of corpus uteri"	"Ventral hernia"	1	402	127	529
"C54"	"K56"	"Malignant neoplasm of corpus uteri"	"Paralytic ileus and intestinal obstruction without hernia"	1	949	150	1099
"C54"	"K57"	"Malignant neoplasm of corpus uteri"	"Diverticular disease of intestine"	1	414	138	552
"C54"	"K59"	"Malignant neoplasm of corpus uteri"	"Other functional intestinal disorders"	1	1040	186	1226
"C54"	"K91"	"Malignant neoplasm of corpus uteri"	"Intraop and postproc comp and disorders of dgstv sys, NEC"	1	128	22	150
"C54"	"L97"	"Malignant neoplasm of corpus uteri"	"Non-pressure chronic ulcer of lower limb, NEC"	1	77	16	93
"C54"	"L98"	"Malignant neoplasm of corpus uteri"	"Oth disorders of skin, subcu, not elsewhere classified"	1	81	24	105
"C54"	"M81"	"Malignant neoplasm of corpus uteri"	"Osteoporosis without current pathological fracture"	1	462	81	543
"C54"	"M85"	"Malignant neoplasm of corpus uteri"	"Other disorders of bone density and structure"	1	146	33	179
"C54"	"N13"	"Malignant neoplasm of corpus uteri"	"Obstructive and reflux uropathy"	1	553	164	717
"C54"	"N18"	"Malignant neoplasm of corpus uteri"	"Chronic kidney disease (CKD)"	1	242	19	261
"C54"	"N30"	"Malignant neoplasm of corpus uteri"	"Cystitis"	1	1040	299	1339
"C56"	"A04"	"Malignant neoplasm of ovary"	"Other bacterial intestinal infections"	1	79	27	106
"C56"	"A41"	"Malignant neoplasm of ovary"	"Other sepsis"	1	776	193	969
"C56"	"B37"	"Malignant neoplasm of ovary"	"Candidiasis"	1	161	52	213
"C56"	"C78"	"Malignant neoplasm of ovary"	"Secondary malignant neoplasm of resp and digestive organs"	1	2994	1208	4202
"C56"	"D46"	"Malignant neoplasm of ovary"	"Myelodysplastic syndromes"	1	32	1	33
"C56"	"D61"	"Malignant neoplasm of ovary"	"Oth aplastic anemias and other bone marrow failure syndromes"	1	57	12	69
"C56"	"D63"	"Malignant neoplasm of ovary"	"Anemia in chronic diseases classified elsewhere"	1	1227	185	1412
"C56"	"D69"	"Malignant neoplasm of ovary"	"Purpura and other hemorrhagic conditions"	1	154	43	197
"C56"	"E61"	"Malignant neoplasm of ovary"	"Deficiency of other nutrient elements"	1	103	8	111
"C56"	"E86"	"Malignant neoplasm of ovary"	"Volume depletion"	1	1196	222	1418
"C56"	"F03"	"Malignant neoplasm of ovary"	"Unspecified dementia"	1	100	36	136
"C56"	"F41"	"Malignant neoplasm of ovary"	"Other anxiety disorders"	1	470	87	557
"C56"	"G47"	"Malignant neoplasm of ovary"	"Sleep disorders"	1	524	61	585
"C56"	"G96"	"Malignant neoplasm of ovary"	"Other disorders of central nervous system"	1	43	6	49
"C56"	"I26"	"Malignant neoplasm of ovary"	"Pulmonary embolism"	1	413	243	656
"C56"	"J18"	"Malignant neoplasm of ovary"	"Pneumonia, unspecified organism"	1	707	416	1123
"C56"	"J94"	"Malignant neoplasm of ovary"	"Other pleural conditions"	1	226	123	349
"C56"	"J96"	"Malignant neoplasm of ovary"	"Respiratory failure, not elsewhere classified"	1	337	85	422
"C56"	"K43"	"Malignant neoplasm of ovary"	"Ventral hernia"	1	405	117	522
"C56"	"K52"	"Malignant neoplasm of ovary"	"Other and unsp noninfective gastroenteritis and colitis"	1	243	107	350
"C56"	"K56"	"Malignant neoplasm of ovary"	"Paralytic ileus and intestinal obstruction without hernia"	1	2256	662	2918
"C56"	"K63"	"Malignant neoplasm of ovary"	"Other diseases of intestine"	1	208	50	258
"C56"	"K91"	"Malignant neoplasm of ovary"	"Intraop and postproc comp and disorders of dgstv sys, NEC"	1	306	62	368
"C56"	"N17"	"Malignant neoplasm of ovary"	"Acute kidney failure"	1	96	31	127
"C56"	"N18"	"Malignant neoplasm of ovary"	"Chronic kidney disease (CKD)"	1	148	41	189
"C56"	"N39"	"Malignant neoplasm of ovary"	"Other disorders of urinary system"	1	589	294	883
"C61"	"B95"	"Malignant neoplasm of prostate"	"Strep as the cause of diseases classified elsewhere"	1	56	13	69
"C61"	"C25"	"Malignant neoplasm of prostate"	"Malignant neoplasm of pancreas"	1	291	72	363
"C61"	"D46"	"Malignant neoplasm of prostate"	"Myelodysplastic syndromes"	1	140	34	174
"C61"	"D50"	"Malignant neoplasm of prostate"	"Iron deficiency anemia"	1	641	334	975
"C61"	"D62"	"Malignant neoplasm of prostate"	"Acute posthemorrhagic anemia"	1	405	192	597
"C61"	"D63"	"Malignant neoplasm of prostate"	"Anemia in chronic diseases classified elsewhere"	1	5039	0	5039
"C61"	"D64"	"Malignant neoplasm of prostate"	"Other anemias"	1	6502	0	6502
"C61"	"D69"	"Malignant neoplasm of prostate"	"Purpura and other hemorrhagic conditions"	1	244	140	384
"C61"	"E41"	"Malignant neoplasm of prostate"	"Nutritional marasmus"	1	74	15	89
"C61"	"E64"	"Malignant neoplasm of prostate"	"Sequelae of malnutrition and other nutritional deficiencies"	1	182	64	246
"C61"	"F01"	"Malignant neoplasm of prostate"	"Vascular dementia"	1	209	61	270
"C61"	"G23"	"Malignant neoplasm of prostate"	"Other degenerative diseases of basal ganglia"	1	38	2	40
"C61"	"G31"	"Malignant neoplasm of prostate"	"Oth degenerative diseases of nervous system, NEC"	1	159	60	219
"C61"	"G47"	"Malignant neoplasm of prostate"	"Sleep disorders"	1	1338	589	1927
"C61"	"G55"	"Malignant neoplasm of prostate"	"Nerve root and plexus compressions in diseases classd elswhr"	1	449	109	558
"C61"	"G83"	"Malignant neoplasm of prostate"	"Other paralytic syndromes"	1	221	98	319
"C61"	"G95"	"Malignant neoplasm of prostate"	"Other and unspecified diseases of spinal cord"	1	3108	0	3108
"C61"	"G96"	"Malignant neoplasm of prostate"	"Other disorders of central nervous system"	1	401	167	568
"C61"	"I26"	"Malignant neoplasm of prostate"	"Pulmonary embolism"	1	874	497	1371
"C61"	"I35"	"Malignant neoplasm of prostate"	"Nonrheumatic aortic valve disorders"	1	1174	715	1889
"C61"	"I89"	"Malignant neoplasm of prostate"	"Oth noninfective disorders of lymphatic vessels and nodes"	1	554	118	672
"C61"	"I95"	"Malignant neoplasm of prostate"	"Hypotension"	1	570	250	820
"C61"	"J10"	"Malignant neoplasm of prostate"	"Influenza due to other identified influenza virus"	1	53	6	59
"C61"	"J18"	"Malignant neoplasm of prostate"	"Pneumonia, unspecified organism"	1	5284	3119	8403
"C61"	"J81"	"Malignant neoplasm of prostate"	"Pulmonary edema"	1	493	172	665
"C61"	"J95"	"Malignant neoplasm of prostate"	"Intraop and postproc comp and disorders of resp sys, NEC"	1	106	40	146
"C61"	"J96"	"Malignant neoplasm of prostate"	"Respiratory failure, not elsewhere classified"	1	1811	431	2242
"C61"	"K59"	"Malignant neoplasm of prostate"	"Other functional intestinal disorders"	1	6027	0	6027
"C61"	"K92"	"Malignant neoplasm of prostate"	"Other diseases of digestive system"	1	1042	634	1676
"C61"	"L89"	"Malignant neoplasm of prostate"	"Pressure ulcer"	1	385	98	483
"C61"	"M49"	"Malignant neoplasm of prostate"	"Spondylopathies in diseases classified elsewhere"	1	97	33	130
"C61"	"M80"	"Malignant neoplasm of prostate"	"Osteoporosis with current pathological fracture"	1	449	187	636
"C61"	"N12"	"Malignant neoplasm of prostate"	"Tubulo-interstitial nephritis, not spcf as acute or chronic"	1	112	44	156
"C61"	"N13"	"Malignant neoplasm of prostate"	"Obstructive and reflux uropathy"	1	2630	1082	3712
"C61"	"N42"	"Malignant neoplasm of prostate"	"Other and unspecified disorders of prostate"	1	287	143	430
"C61"	"N48"	"Malignant neoplasm of prostate"	"Other disorders of penis"	1	2225	775	3000
"C61"	"N49"	"Malignant neoplasm of prostate"	"Inflammatory disorders of male genital organs, NEC"	1	280	137	417
"C61"	"N99"	"Malignant neoplasm of prostate"	"Intraop and postproc comp and disorders of GU sys, NEC"	1	904	408	1312
"C62"	"A46"	"Malignant neoplasm of testis"	"Erysipelas"	1	53	4	57
"C62"	"C77"	"Malignant neoplasm of testis"	"Secondary and unspecified malignant neoplasm of lymph nodes"	1	437	160	597
"C62"	"C78"	"Malignant neoplasm of testis"	"Secondary malignant neoplasm of resp and digestive organs"	1	909	221	1130
"C62"	"D69"	"Malignant neoplasm of testis"	"Purpura and other hemorrhagic conditions"	1	53	10	63
"C62"	"E10"	"Malignant neoplasm of testis"	"Type 1 diabetes mellitus"	1	54	13	67
"C62"	"E29"	"Malignant neoplasm of testis"	"Testicular dysfunction"	1	469	14	483
"C62"	"E78"	"Malignant neoplasm of testis"	"Disorders of lipoprotein metabolism and other lipidemias"	1	107	0	107
"C62"	"E83"	"Malignant neoplasm of testis"	"Disorders of mineral metabolism"	1	95	7	102
"C62"	"E87"	"Malignant neoplasm of testis"	"Other disorders of fluid, electrolyte and acid-base balance"	1	100	0	100
"C62"	"E89"	"Malignant neoplasm of testis"	"Postproc endocrine and metabolic comp and disorders, NEC"	1	511	12	523
"C62"	"F17"	"Malignant neoplasm of testis"	"Nicotine dependence"	1	53	0	53
"C62"	"G47"	"Malignant neoplasm of testis"	"Sleep disorders"	1	94	0	94
"C62"	"H26"	"Malignant neoplasm of testis"	"Other cataract"	1	35	2	37
"C62"	"H35"	"Malignant neoplasm of testis"	"Other retinal disorders"	1	36	2	38
"C62"	"H93"	"Malignant neoplasm of testis"	"Other disorders of ear, not elsewhere classified"	1	152	14	166
"C62"	"I10"	"Malignant neoplasm of testis"	"Essential (primary) hypertension"	1	246	1	247
"C62"	"I21"	"Malignant neoplasm of testis"	"Acute myocardial infarction"	1	94	0	94
"C62"	"I48"	"Malignant neoplasm of testis"	"Atrial fibrillation and flutter"	1	113	0	113
"C62"	"I49"	"Malignant neoplasm of testis"	"Other cardiac arrhythmias"	1	27	2	29
"C62"	"I50"	"Malignant neoplasm of testis"	"Heart failure"	1	97	1	98
"C62"	"I63"	"Malignant neoplasm of testis"	"Cerebral infarction"	1	54	3	57
"C62"	"I69"	"Malignant neoplasm of testis"	"Sequelae of cerebrovascular disease"	1	51	6	57
"C62"	"I70"	"Malignant neoplasm of testis"	"Atherosclerosis"	1	50	3	53
"C62"	"I83"	"Malignant neoplasm of testis"	"Varicose veins of lower extremities"	1	39	5	44
"C62"	"J15"	"Malignant neoplasm of testis"	"Bacterial pneumonia, not elsewhere classified"	1	68	0	68
"C62"	"J44"	"Malignant neoplasm of testis"	"Other chronic obstructive pulmonary disease"	1	73	1	74
"C62"	"J84"	"Malignant neoplasm of testis"	"Other interstitial pulmonary diseases"	1	63	8	71
"C62"	"J96"	"Malignant neoplasm of testis"	"Respiratory failure, not elsewhere classified"	1	84	0	84
"C62"	"K43"	"Malignant neoplasm of testis"	"Ventral hernia"	1	110	1	111
"C62"	"K52"	"Malignant neoplasm of testis"	"Other and unsp noninfective gastroenteritis and colitis"	1	54	13	67
"C62"	"K57"	"Malignant neoplasm of testis"	"Diverticular disease of intestine"	1	68	0	68
"C62"	"K58"	"Malignant neoplasm of testis"	"Irritable bowel syndrome"	1	39	4	43
"C62"	"K92"	"Malignant neoplasm of testis"	"Other diseases of digestive system"	1	51	4	55
"C62"	"L02"	"Malignant neoplasm of testis"	"Cutaneous abscess, furuncle and carbuncle"	1	88	32	120
"C62"	"L90"	"Malignant neoplasm of testis"	"Atrophic disorders of skin"	1	44	8	52
"C62"	"M17"	"Malignant neoplasm of testis"	"Osteoarthritis of knee"	1	77	0	77
"C62"	"M47"	"Malignant neoplasm of testis"	"Spondylosis"	1	47	0	47
"C62"	"M48"	"Malignant neoplasm of testis"	"Other spondylopathies"	1	35	0	35
"C62"	"M51"	"Malignant neoplasm of testis"	"Thoracic, thoracolum, and lumbosacral intvrt disc disorders"	1	102	28	130
"C62"	"M54"	"Malignant neoplasm of testis"	"Dorsalgia"	1	159	70	229
"C62"	"M75"	"Malignant neoplasm of testis"	"Shoulder lesions"	1	147	17	164
"C62"	"N18"	"Malignant neoplasm of testis"	"Chronic kidney disease (CKD)"	1	62	0	62
"C62"	"N19"	"Malignant neoplasm of testis"	"Unspecified kidney failure"	1	33	1	34
"C62"	"N20"	"Malignant neoplasm of testis"	"Calculus of kidney and ureter"	1	64	17	81
"C62"	"N30"	"Malignant neoplasm of testis"	"Cystitis"	1	101	11	112
"C62"	"N50"	"Malignant neoplasm of testis"	"Other and unspecified disorders of male genital organs"	1	227	107	334
"C64"	"D63"	"Malignant neoplasm of kidney, except renal pelvis"	"Anemia in chronic diseases classified elsewhere"	1	910	290	1200
"C64"	"D64"	"Malignant neoplasm of kidney, except renal pelvis"	"Other anemias"	1	899	662	1561
"C64"	"E27"	"Malignant neoplasm of kidney, except renal pelvis"	"Other disorders of adrenal gland"	1	100	31	131
"C64"	"E83"	"Malignant neoplasm of kidney, except renal pelvis"	"Disorders of mineral metabolism"	1	250	124	374
"C64"	"E86"	"Malignant neoplasm of kidney, except renal pelvis"	"Volume depletion"	1	926	342	1268
"C64"	"G95"	"Malignant neoplasm of kidney, except renal pelvis"	"Other and unspecified diseases of spinal cord"	1	384	212	596
"C64"	"I46"	"Malignant neoplasm of kidney, except renal pelvis"	"Cardiac arrest"	1	120	26	146
"C64"	"J15"	"Malignant neoplasm of kidney, except renal pelvis"	"Bacterial pneumonia, not elsewhere classified"	1	462	240	702
"C64"	"J96"	"Malignant neoplasm of kidney, except renal pelvis"	"Respiratory failure, not elsewhere classified"	1	463	229	692
"C64"	"K43"	"Malignant neoplasm of kidney, except renal pelvis"	"Ventral hernia"	1	345	182	527
"C64"	"N17"	"Malignant neoplasm of kidney, except renal pelvis"	"Acute kidney failure"	1	246	135	381
"C64"	"N19"	"Malignant neoplasm of kidney, except renal pelvis"	"Unspecified kidney failure"	1	365	228	593
"C65"	"D63"	"Malignant neoplasm of renal pelvis"	"Anemia in chronic diseases classified elsewhere"	1	220	96	316
"C65"	"N18"	"Malignant neoplasm of renal pelvis"	"Chronic kidney disease (CKD)"	1	198	82	280
"C66"	"C79"	"Malignant neoplasm of ureter"	"Secondary malignant neoplasm of other and unspecified sites"	1	122	48	170
"C67"	"A04"	"Malignant neoplasm of bladder"	"Other bacterial intestinal infections"	1	153	42	195
"C67"	"A41"	"Malignant neoplasm of bladder"	"Other sepsis"	1	3806	0	3806
"C67"	"C15"	"Malignant neoplasm of bladder"	"Malignant neoplasm of esophagus"	1	70	12	82
"C67"	"C22"	"Malignant neoplasm of bladder"	"Malignant neoplasm of liver and intrahepatic bile ducts"	1	61	10	71
"C67"	"C23"	"Malignant neoplasm of bladder"	"Malignant neoplasm of gallbladder"	1	74	14	88
"C67"	"C25"	"Malignant neoplasm of bladder"	"Malignant neoplasm of pancreas"	1	111	7	118
"C67"	"C71"	"Malignant neoplasm of bladder"	"Malignant neoplasm of brain"	1	97	14	111
"C67"	"C77"	"Malignant neoplasm of bladder"	"Secondary and unspecified malignant neoplasm of lymph nodes"	1	761	195	956
"C67"	"D09"	"Malignant neoplasm of bladder"	"Carcinoma in situ of other and unspecified sites"	1	1374	774	2148
"C67"	"D64"	"Malignant neoplasm of bladder"	"Other anemias"	1	1907	694	2601
"C67"	"D67"	"Malignant neoplasm of bladder"	"Hereditary factor IX deficiency"	1	62	12	74
"C67"	"D69"	"Malignant neoplasm of bladder"	"Purpura and other hemorrhagic conditions"	1	199	63	262
"C67"	"E83"	"Malignant neoplasm of bladder"	"Disorders of mineral metabolism"	1	257	69	326
"C67"	"E86"	"Malignant neoplasm of bladder"	"Volume depletion"	1	1970	358	2328
"C67"	"F01"	"Malignant neoplasm of bladder"	"Vascular dementia"	1	75	11	86
"C67"	"F41"	"Malignant neoplasm of bladder"	"Other anxiety disorders"	1	449	61	510
"C67"	"G20"	"Malignant neoplasm of bladder"	"Parkinson's disease"	1	99	36	135
"C67"	"G30"	"Malignant neoplasm of bladder"	"Alzheimer's disease"	1	68	5	73
"C67"	"G47"	"Malignant neoplasm of bladder"	"Sleep disorders"	1	479	150	629
"C67"	"G95"	"Malignant neoplasm of bladder"	"Other and unspecified diseases of spinal cord"	1	311	82	393
"C67"	"I50"	"Malignant neoplasm of bladder"	"Heart failure"	1	1156	763	1919
"C67"	"I69"	"Malignant neoplasm of bladder"	"Sequelae of cerebrovascular disease"	1	532	331	863
"C67"	"I71"	"Malignant neoplasm of bladder"	"Aortic aneurysm and dissection"	1	358	222	580
"C67"	"I80"	"Malignant neoplasm of bladder"	"Phlebitis and thrombophlebitis"	1	664	369	1033
"C67"	"I82"	"Malignant neoplasm of bladder"	"Other venous embolism and thrombosis"	1	172	66	238
"C67"	"J15"	"Malignant neoplasm of bladder"	"Bacterial pneumonia, not elsewhere classified"	1	751	214	965
"C67"	"J18"	"Malignant neoplasm of bladder"	"Pneumonia, unspecified organism"	1	2163	1016	3179
"C67"	"J81"	"Malignant neoplasm of bladder"	"Pulmonary edema"	1	280	79	359
"C67"	"J90"	"Malignant neoplasm of bladder"	"Pleural effusion, not elsewhere classified"	1	225	66	291
"C67"	"J93"	"Malignant neoplasm of bladder"	"Pneumothorax and air leak"	1	143	65	208
"C67"	"J96"	"Malignant neoplasm of bladder"	"Respiratory failure, not elsewhere classified"	1	835	167	1002
"C67"	"K63"	"Malignant neoplasm of bladder"	"Other diseases of intestine"	1	234	51	285
"C67"	"K64"	"Malignant neoplasm of bladder"	"Hemorrhoids and perianal venous thrombosis"	1	70	19	89
"C67"	"K91"	"Malignant neoplasm of bladder"	"Intraop and postproc comp and disorders of dgstv sys, NEC"	1	152	42	194
"C67"	"L89"	"Malignant neoplasm of bladder"	"Pressure ulcer"	1	167	46	213
"C67"	"M90"	"Malignant neoplasm of bladder"	"Osteopathies in diseases classified elsewhere"	1	61	10	71
"C67"	"N17"	"Malignant neoplasm of bladder"	"Acute kidney failure"	1	529	195	724
"C67"	"N19"	"Malignant neoplasm of bladder"	"Unspecified kidney failure"	1	866	297	1163
"C67"	"N39"	"Malignant neoplasm of bladder"	"Other disorders of urinary system"	1	2140	820	2960
"C67"	"N48"	"Malignant neoplasm of bladder"	"Other disorders of penis"	1	262	125	387
"C69"	"C43"	"Malignant neoplasm of eye and adnexa"	"Malignant melanoma of skin"	1	356	57	413
"C69"	"E87"	"Malignant neoplasm of eye and adnexa"	"Other disorders of fluid, electrolyte and acid-base balance"	1	35	4	39
"C69"	"H44"	"Malignant neoplasm of eye and adnexa"	"Disorders of globe"	1	190	33	223
"C69"	"J15"	"Malignant neoplasm of eye and adnexa"	"Bacterial pneumonia, not elsewhere classified"	1	53	9	62
"C69"	"J96"	"Malignant neoplasm of eye and adnexa"	"Respiratory failure, not elsewhere classified"	1	69	10	79
"C71"	"E89"	"Malignant neoplasm of brain"	"Postproc endocrine and metabolic comp and disorders, NEC"	1	222	48	270
"C71"	"G47"	"Malignant neoplasm of brain"	"Sleep disorders"	1	575	157	732
"C71"	"H53"	"Malignant neoplasm of brain"	"Visual disturbances"	1	464	234	698
"C71"	"I46"	"Malignant neoplasm of brain"	"Cardiac arrest"	1	92	29	121
"C71"	"J15"	"Malignant neoplasm of brain"	"Bacterial pneumonia, not elsewhere classified"	1	329	178	507
"C71"	"K59"	"Malignant neoplasm of brain"	"Other functional intestinal disorders"	1	894	381	1275
"C73"	"C77"	"Malignant neoplasm of thyroid gland"	"Secondary and unspecified malignant neoplasm of lymph nodes"	1	431	270	701
"C73"	"D63"	"Malignant neoplasm of thyroid gland"	"Anemia in chronic diseases classified elsewhere"	1	54	13	67
"C73"	"E03"	"Malignant neoplasm of thyroid gland"	"Other hypothyroidism"	1	849	18	867
"C73"	"E20"	"Malignant neoplasm of thyroid gland"	"Hypoparathyroidism"	1	88	8	96
"C73"	"J91"	"Malignant neoplasm of thyroid gland"	"Pleural effusion in conditions classified elsewhere"	1	28	2	30
"C73"	"N39"	"Malignant neoplasm of thyroid gland"	"Other disorders of urinary system"	1	105	39	144
"C76"	"F41"	"Malignant neoplasm of other and ill-defined sites"	"Other anxiety disorders"	1	93	29	122
"C77"	"B37"	"Secondary and unspecified malignant neoplasm of lymph nodes"	"Candidiasis"	1	395	251	646
"C77"	"C80"	"Secondary and unspecified malignant neoplasm of lymph nodes"	"Malignant neoplasm without specification of site"	1	1150	440	1590
"C77"	"D22"	"Secondary and unspecified malignant neoplasm of lymph nodes"	"Melanocytic nevi"	1	432	207	639
"C77"	"D64"	"Secondary and unspecified malignant neoplasm of lymph nodes"	"Other anemias"	1	1535	1236	2771
"C77"	"D70"	"Secondary and unspecified malignant neoplasm of lymph nodes"	"Neutropenia"	1	259	127	386
"C77"	"D71"	"Secondary and unspecified malignant neoplasm of lymph nodes"	"Functional disorders of polymorphonuclear neutrophils"	1	71	21	92
"C77"	"E83"	"Secondary and unspecified malignant neoplasm of lymph nodes"	"Disorders of mineral metabolism"	1	623	296	919
"C77"	"E89"	"Secondary and unspecified malignant neoplasm of lymph nodes"	"Postproc endocrine and metabolic comp and disorders, NEC"	1	160	69	229
"C77"	"F32"	"Secondary and unspecified malignant neoplasm of lymph nodes"	"Depressive episode"	1	684	403	1087
"C77"	"J91"	"Secondary and unspecified malignant neoplasm of lymph nodes"	"Pleural effusion in conditions classified elsewhere"	1	478	258	736
"C77"	"J96"	"Secondary and unspecified malignant neoplasm of lymph nodes"	"Respiratory failure, not elsewhere classified"	1	1263	607	1870
"C77"	"K02"	"Secondary and unspecified malignant neoplasm of lymph nodes"	"Dental caries"	1	544	386	930
"C77"	"K59"	"Secondary and unspecified malignant neoplasm of lymph nodes"	"Other functional intestinal disorders"	1	3178	1403	4581
"C77"	"K64"	"Secondary and unspecified malignant neoplasm of lymph nodes"	"Hemorrhoids and perianal venous thrombosis"	1	140	54	194
"C77"	"L59"	"Secondary and unspecified malignant neoplasm of lymph nodes"	"Oth disorders of skin, subcu related to radiation"	1	106	40	146
"C77"	"L82"	"Secondary and unspecified malignant neoplasm of lymph nodes"	"Seborrheic keratosis"	1	183	80	263
"C77"	"M90"	"Secondary and unspecified malignant neoplasm of lymph nodes"	"Osteopathies in diseases classified elsewhere"	1	126	52	178
"C77"	"M96"	"Secondary and unspecified malignant neoplasm of lymph nodes"	"Intraop and postproc comp and disorders of ms sys, NEC"	1	183	64	247
"C78"	"A49"	"Secondary malignant neoplasm of resp and digestive organs"	"Bacterial infection of unspecified site"	1	1676	1271	2947
"C78"	"F05"	"Secondary malignant neoplasm of resp and digestive organs"	"Delirium due to known physiological condition"	1	898	416	1314
"C78"	"F41"	"Secondary malignant neoplasm of resp and digestive organs"	"Other anxiety disorders"	1	3169	877	4046
"C78"	"G47"	"Secondary malignant neoplasm of resp and digestive organs"	"Sleep disorders"	1	3681	1150	4831
"C78"	"I46"	"Secondary malignant neoplasm of resp and digestive organs"	"Cardiac arrest"	1	452	266	718
"C79"	"F05"	"Secondary malignant neoplasm of other and unspecified sites"	"Delirium due to known physiological condition"	1	868	405	1273
"C79"	"G47"	"Secondary malignant neoplasm of other and unspecified sites"	"Sleep disorders"	1	2865	857	3722
"C79"	"I46"	"Secondary malignant neoplasm of other and unspecified sites"	"Cardiac arrest"	1	365	168	533
"C79"	"K59"	"Secondary malignant neoplasm of other and unspecified sites"	"Other functional intestinal disorders"	1	4880	3134	8014
"C81"	"A41"	"Hodgkin lymphoma"	"Other sepsis"	1	595	158	753
"C81"	"D61"	"Hodgkin lymphoma"	"Oth aplastic anemias and other bone marrow failure syndromes"	1	99	28	127
"C81"	"E03"	"Hodgkin lymphoma"	"Other hypothyroidism"	1	141	0	141
"C81"	"G62"	"Hodgkin lymphoma"	"Other and unspecified polyneuropathies"	1	67	20	87
"C81"	"I48"	"Hodgkin lymphoma"	"Atrial fibrillation and flutter"	1	170	54	224
"C81"	"I82"	"Hodgkin lymphoma"	"Other venous embolism and thrombosis"	1	44	5	49
"C81"	"J15"	"Hodgkin lymphoma"	"Bacterial pneumonia, not elsewhere classified"	1	219	44	263
"C81"	"J44"	"Hodgkin lymphoma"	"Other chronic obstructive pulmonary disease"	1	126	53	179
"C81"	"J84"	"Hodgkin lymphoma"	"Other interstitial pulmonary diseases"	1	105	20	125
"C81"	"J96"	"Hodgkin lymphoma"	"Respiratory failure, not elsewhere classified"	1	210	36	246
"C81"	"K01"	"Hodgkin lymphoma"	"Embedded and impacted teeth"	1	103	28	131
"C81"	"K02"	"Hodgkin lymphoma"	"Dental caries"	1	151	34	185
"C81"	"K04"	"Hodgkin lymphoma"	"Diseases of pulp and periapical tissues"	1	121	38	159
"C81"	"L90"	"Hodgkin lymphoma"	"Atrophic disorders of skin"	1	74	13	87
"C81"	"N17"	"Hodgkin lymphoma"	"Acute kidney failure"	1	64	14	78
"C81"	"N46"	"Hodgkin lymphoma"	"Male infertility"	1	111	6	117
"C81"	"N97"	"Hodgkin lymphoma"	"Female infertility"	1	159	49	208
"C81"	"O72"	"Hodgkin lymphoma"	"Postpartum hemorrhage"	1	62	5	67
"C81"	"O99"	"Hodgkin lymphoma"	"Oth maternal diseases classd elsw but compl preg/chldbrth"	1	66	17	83
"C82"	"A04"	"Follicular lymphoma"	"Other bacterial intestinal infections"	1	76	11	87
"C82"	"A49"	"Follicular lymphoma"	"Bacterial infection of unspecified site"	1	194	38	232
"C82"	"B02"	"Follicular lymphoma"	"Zoster [herpes zoster]"	1	142	41	183
"C82"	"C78"	"Follicular lymphoma"	"Secondary malignant neoplasm of resp and digestive organs"	1	137	33	170
"C82"	"D46"	"Follicular lymphoma"	"Myelodysplastic syndromes"	1	42	3	45
"C82"	"D61"	"Follicular lymphoma"	"Oth aplastic anemias and other bone marrow failure syndromes"	1	111	44	155
"C82"	"D64"	"Follicular lymphoma"	"Other anemias"	1	236	128	364
"C82"	"D70"	"Follicular lymphoma"	"Neutropenia"	1	74	18	92
"C82"	"E87"	"Follicular lymphoma"	"Other disorders of fluid, electrolyte and acid-base balance"	1	112	20	132
"C82"	"F03"	"Follicular lymphoma"	"Unspecified dementia"	1	40	4	44
"C82"	"I48"	"Follicular lymphoma"	"Atrial fibrillation and flutter"	1	251	124	375
"C82"	"I50"	"Follicular lymphoma"	"Heart failure"	1	233	102	335
"C82"	"J15"	"Follicular lymphoma"	"Bacterial pneumonia, not elsewhere classified"	1	318	30	348
"C82"	"J18"	"Follicular lymphoma"	"Pneumonia, unspecified organism"	1	776	252	1028
"C82"	"N17"	"Follicular lymphoma"	"Acute kidney failure"	1	77	12	89
"C82"	"N30"	"Follicular lymphoma"	"Cystitis"	1	215	96	311
"C82"	"N39"	"Follicular lymphoma"	"Other disorders of urinary system"	1	198	73	271
"C83"	"B00"	"Non-follicular lymphoma"	"Herpesviral [herpes simplex] infections"	1	198	67	265
"C83"	"B02"	"Non-follicular lymphoma"	"Zoster [herpes zoster]"	1	358	114	472
"C83"	"B44"	"Non-follicular lymphoma"	"Aspergillosis"	1	72	21	93
"C83"	"B96"	"Non-follicular lymphoma"	"Oth bacterial agents as the cause of diseases classd elswhr"	1	81	24	105
"C83"	"C34"	"Non-follicular lymphoma"	"Malignant neoplasm of bronchus and lung"	1	213	107	320
"C83"	"C78"	"Non-follicular lymphoma"	"Secondary malignant neoplasm of resp and digestive organs"	1	274	98	372
"C83"	"D46"	"Non-follicular lymphoma"	"Myelodysplastic syndromes"	1	91	32	123
"C83"	"D69"	"Non-follicular lymphoma"	"Purpura and other hemorrhagic conditions"	1	288	173	461
"C83"	"F03"	"Non-follicular lymphoma"	"Unspecified dementia"	1	112	35	147
"C83"	"I26"	"Non-follicular lymphoma"	"Pulmonary embolism"	1	293	162	455
"C83"	"J06"	"Non-follicular lymphoma"	"Acute upper resp infections of multiple and unsp sites"	1	81	19	100
"C83"	"J09"	"Non-follicular lymphoma"	"Influenza due to certain identified influenza viruses"	1	91	14	105
"C83"	"J10"	"Non-follicular lymphoma"	"Influenza due to other identified influenza virus"	1	85	7	92
"C83"	"J15"	"Non-follicular lymphoma"	"Bacterial pneumonia, not elsewhere classified"	1	783	285	1068
"C83"	"J96"	"Non-follicular lymphoma"	"Respiratory failure, not elsewhere classified"	1	582	199	781
"C83"	"K04"	"Non-follicular lymphoma"	"Diseases of pulp and periapical tissues"	1	297	170	467
"C83"	"N39"	"Non-follicular lymphoma"	"Other disorders of urinary system"	1	510	313	823
"C84"	"A04"	"Mature T/NK-cell lymphomas"	"Other bacterial intestinal infections"	1	53	5	58
"C84"	"B37"	"Mature T/NK-cell lymphomas"	"Candidiasis"	1	84	26	110
"C84"	"J18"	"Mature T/NK-cell lymphomas"	"Pneumonia, unspecified organism"	1	323	186	509
"C85"	"A04"	"Oth and unspecified types of non-Hodgkin lymphoma"	"Other bacterial intestinal infections"	1	214	66	280
"C85"	"A09"	"Oth and unspecified types of non-Hodgkin lymphoma"	"Infectious gastroenteritis and colitis, unspecified"	1	273	158	431
"C85"	"A41"	"Oth and unspecified types of non-Hodgkin lymphoma"	"Other sepsis"	1	1761	672	2433
"C85"	"B37"	"Oth and unspecified types of non-Hodgkin lymphoma"	"Candidiasis"	1	342	147	489
"C85"	"B59"	"Oth and unspecified types of non-Hodgkin lymphoma"	"Pneumocystosis"	1	99	18	117
"C85"	"C34"	"Oth and unspecified types of non-Hodgkin lymphoma"	"Malignant neoplasm of bronchus and lung"	1	278	108	386
"C85"	"C44"	"Oth and unspecified types of non-Hodgkin lymphoma"	"Other and unspecified malignant neoplasm of skin"	1	274	156	430
"C85"	"C92"	"Oth and unspecified types of non-Hodgkin lymphoma"	"Myeloid leukemia"	1	123	40	163
"C85"	"D70"	"Oth and unspecified types of non-Hodgkin lymphoma"	"Neutropenia"	1	190	92	282
"C85"	"I26"	"Oth and unspecified types of non-Hodgkin lymphoma"	"Pulmonary embolism"	1	261	120	381
"C85"	"I35"	"Oth and unspecified types of non-Hodgkin lymphoma"	"Nonrheumatic aortic valve disorders"	1	198	86	284
"C85"	"I42"	"Oth and unspecified types of non-Hodgkin lymphoma"	"Cardiomyopathy"	1	133	48	181
"C85"	"I50"	"Oth and unspecified types of non-Hodgkin lymphoma"	"Heart failure"	1	656	353	1009
"C85"	"J06"	"Oth and unspecified types of non-Hodgkin lymphoma"	"Acute upper resp infections of multiple and unsp sites"	1	80	14	94
"C85"	"J09"	"Oth and unspecified types of non-Hodgkin lymphoma"	"Influenza due to certain identified influenza viruses"	1	47	7	54
"C85"	"J18"	"Oth and unspecified types of non-Hodgkin lymphoma"	"Pneumonia, unspecified organism"	1	1878	1021	2899
"C85"	"M81"	"Oth and unspecified types of non-Hodgkin lymphoma"	"Osteoporosis without current pathological fracture"	1	272	154	426
"C85"	"N17"	"Oth and unspecified types of non-Hodgkin lymphoma"	"Acute kidney failure"	1	218	107	325
"C88"	"A41"	"Malig immunoproliferative dis and certain oth B-cell lymph"	"Other sepsis"	1	272	124	396
"C88"	"J15"	"Malig immunoproliferative dis and certain oth B-cell lymph"	"Bacterial pneumonia, not elsewhere classified"	1	197	80	277
"C90"	"A04"	"Multiple myeloma and malignant plasma cell neoplasms"	"Other bacterial intestinal infections"	1	223	45	268
"C90"	"A32"	"Multiple myeloma and malignant plasma cell neoplasms"	"Listeriosis"	1	27	1	28
"C90"	"A40"	"Multiple myeloma and malignant plasma cell neoplasms"	"Streptococcal sepsis"	1	184	87	271
"C90"	"B59"	"Multiple myeloma and malignant plasma cell neoplasms"	"Pneumocystosis"	1	66	8	74
"C90"	"B96"	"Multiple myeloma and malignant plasma cell neoplasms"	"Oth bacterial agents as the cause of diseases classd elswhr"	1	63	13	76
"C90"	"D61"	"Multiple myeloma and malignant plasma cell neoplasms"	"Oth aplastic anemias and other bone marrow failure syndromes"	1	187	74	261
"C90"	"D63"	"Multiple myeloma and malignant plasma cell neoplasms"	"Anemia in chronic diseases classified elsewhere"	1	587	232	819
"C90"	"I26"	"Multiple myeloma and malignant plasma cell neoplasms"	"Pulmonary embolism"	1	225	110	335
"C90"	"J10"	"Multiple myeloma and malignant plasma cell neoplasms"	"Influenza due to other identified influenza virus"	1	99	4	103
"C90"	"J12"	"Multiple myeloma and malignant plasma cell neoplasms"	"Viral pneumonia, not elsewhere classified"	1	54	9	63
"C90"	"J15"	"Multiple myeloma and malignant plasma cell neoplasms"	"Bacterial pneumonia, not elsewhere classified"	1	827	303	1130
"C90"	"J18"	"Multiple myeloma and malignant plasma cell neoplasms"	"Pneumonia, unspecified organism"	1	2248	1128	3376
"C90"	"J20"	"Multiple myeloma and malignant plasma cell neoplasms"	"Acute bronchitis"	1	130	44	174
"C90"	"J81"	"Multiple myeloma and malignant plasma cell neoplasms"	"Pulmonary edema"	1	114	36	150
"C90"	"K01"	"Multiple myeloma and malignant plasma cell neoplasms"	"Embedded and impacted teeth"	1	123	51	174
"C90"	"K02"	"Multiple myeloma and malignant plasma cell neoplasms"	"Dental caries"	1	374	129	503
"C90"	"K04"	"Multiple myeloma and malignant plasma cell neoplasms"	"Diseases of pulp and periapical tissues"	1	589	216	805
"C90"	"M87"	"Multiple myeloma and malignant plasma cell neoplasms"	"Osteonecrosis"	1	120	9	129
"C91"	"A40"	"Lymphoid leukemia"	"Streptococcal sepsis"	1	166	49	215
"C91"	"B00"	"Lymphoid leukemia"	"Herpesviral [herpes simplex] infections"	1	192	31	223
"C91"	"B25"	"Lymphoid leukemia"	"Cytomegaloviral disease"	1	155	16	171
"C91"	"B34"	"Lymphoid leukemia"	"Viral infection of unspecified site"	1	187	79	266
"C91"	"B37"	"Lymphoid leukemia"	"Candidiasis"	1	303	79	382
"C91"	"C44"	"Lymphoid leukemia"	"Other and unspecified malignant neoplasm of skin"	1	402	204	606
"C91"	"C79"	"Lymphoid leukemia"	"Secondary malignant neoplasm of other and unspecified sites"	1	161	53	214
"C91"	"D04"	"Lymphoid leukemia"	"Carcinoma in situ of skin"	1	57	9	66
"C91"	"D69"	"Lymphoid leukemia"	"Purpura and other hemorrhagic conditions"	1	323	184	507
"C91"	"E29"	"Lymphoid leukemia"	"Testicular dysfunction"	1	36	2	38
"C91"	"E64"	"Lymphoid leukemia"	"Sequelae of malnutrition and other nutritional deficiencies"	1	76	16	92
"C91"	"E83"	"Lymphoid leukemia"	"Disorders of mineral metabolism"	1	93	27	120
"C91"	"E86"	"Lymphoid leukemia"	"Volume depletion"	1	675	210	885
"C91"	"F03"	"Lymphoid leukemia"	"Unspecified dementia"	1	160	74	234
"C91"	"F41"	"Lymphoid leukemia"	"Other anxiety disorders"	1	85	20	105
"C91"	"F43"	"Lymphoid leukemia"	"Reaction to severe stress, and adjustment disorders"	1	104	21	125
"C91"	"G30"	"Lymphoid leukemia"	"Alzheimer's disease"	1	48	9	57
"C91"	"H57"	"Lymphoid leukemia"	"Other disorders of eye and adnexa"	1	79	15	94
"C91"	"I26"	"Lymphoid leukemia"	"Pulmonary embolism"	1	206	104	310
"C91"	"J01"	"Lymphoid leukemia"	"Acute sinusitis"	1	136	37	173
"C91"	"J06"	"Lymphoid leukemia"	"Acute upper resp infections of multiple and unsp sites"	1	120	16	136
"C91"	"J13"	"Lymphoid leukemia"	"Pneumonia due to Streptococcus pneumoniae"	1	111	31	142
"C91"	"J15"	"Lymphoid leukemia"	"Bacterial pneumonia, not elsewhere classified"	1	845	218	1063
"C91"	"J16"	"Lymphoid leukemia"	"Pneumonia due to oth infectious organisms, NEC"	1	47	8	55
"C91"	"J84"	"Lymphoid leukemia"	"Other interstitial pulmonary diseases"	1	106	41	147
"C91"	"K00"	"Lymphoid leukemia"	"Disorders of tooth development and eruption"	1	25	0	25
"C91"	"K12"	"Lymphoid leukemia"	"Stomatitis and related lesions"	1	97	35	132
"C91"	"L57"	"Lymphoid leukemia"	"Skin changes due to chronic expsr to nonionizing radiation"	1	142	19	161
"C91"	"L90"	"Lymphoid leukemia"	"Atrophic disorders of skin"	1	55	12	67
"C91"	"L98"	"Lymphoid leukemia"	"Oth disorders of skin, subcu, not elsewhere classified"	1	156	47	203
"C91"	"N18"	"Lymphoid leukemia"	"Chronic kidney disease (CKD)"	1	253	83	336
"C91"	"N19"	"Lymphoid leukemia"	"Unspecified kidney failure"	1	158	56	214
"C91"	"N39"	"Lymphoid leukemia"	"Other disorders of urinary system"	1	477	247	724
"C92"	"A41"	"Myeloid leukemia"	"Other sepsis"	1	1712	1177	2889
"C92"	"B25"	"Myeloid leukemia"	"Cytomegaloviral disease"	1	182	32	214
"C92"	"B37"	"Myeloid leukemia"	"Candidiasis"	1	383	188	571
"C92"	"E89"	"Myeloid leukemia"	"Postproc endocrine and metabolic comp and disorders, NEC"	1	86	14	100
"D05"	"A41"	"Carcinoma in situ of breast"	"Other sepsis"	1	141	18	159
"D05"	"C78"	"Carcinoma in situ of breast"	"Secondary malignant neoplasm of resp and digestive organs"	1	158	17	175
"D05"	"E86"	"Carcinoma in situ of breast"	"Volume depletion"	1	171	27	198
"D05"	"E87"	"Carcinoma in situ of breast"	"Other disorders of fluid, electrolyte and acid-base balance"	1	139	21	160
"D05"	"H25"	"Carcinoma in situ of breast"	"Age-related cataract"	1	320	141	461
"D05"	"I48"	"Carcinoma in situ of breast"	"Atrial fibrillation and flutter"	1	197	73	270
"D05"	"I63"	"Carcinoma in situ of breast"	"Cerebral infarction"	1	97	37	134
"D05"	"I95"	"Carcinoma in situ of breast"	"Hypotension"	1	36	2	38
"D05"	"I97"	"Carcinoma in situ of breast"	"Intraop and postproc comp and disorders of circ sys, NEC"	1	87	18	105
"D05"	"J15"	"Carcinoma in situ of breast"	"Bacterial pneumonia, not elsewhere classified"	1	134	21	155
"D05"	"J96"	"Carcinoma in situ of breast"	"Respiratory failure, not elsewhere classified"	1	116	15	131
"D05"	"K56"	"Carcinoma in situ of breast"	"Paralytic ileus and intestinal obstruction without hernia"	1	52	12	64
"D05"	"K57"	"Carcinoma in situ of breast"	"Diverticular disease of intestine"	1	155	48	203
"D05"	"K64"	"Carcinoma in situ of breast"	"Hemorrhoids and perianal venous thrombosis"	1	61	6	67
"D06"	"C34"	"Carcinoma in situ of cervix uteri"	"Malignant neoplasm of bronchus and lung"	1	52	0	52
"D06"	"C50"	"Carcinoma in situ of cervix uteri"	"Malignant neoplasm of breast"	1	131	0	131
"D06"	"C52"	"Carcinoma in situ of cervix uteri"	"Malignant neoplasm of vagina"	1	30	0	30
"D06"	"C53"	"Carcinoma in situ of cervix uteri"	"Malignant neoplasm of cervix uteri"	1	766	243	1009
"D06"	"D24"	"Carcinoma in situ of cervix uteri"	"Benign neoplasm of breast"	1	127	17	144
"D06"	"D50"	"Carcinoma in situ of cervix uteri"	"Iron deficiency anemia"	1	50	0	50
"D06"	"E10"	"Carcinoma in situ of cervix uteri"	"Type 1 diabetes mellitus"	1	51	9	60
"D06"	"E11"	"Carcinoma in situ of cervix uteri"	"Type 2 diabetes mellitus"	1	113	0	113
"D06"	"F32"	"Carcinoma in situ of cervix uteri"	"Depressive episode"	1	74	0	74
"D06"	"G56"	"Carcinoma in situ of cervix uteri"	"Mononeuropathies of upper limb"	1	192	0	192
"D06"	"H26"	"Carcinoma in situ of cervix uteri"	"Other cataract"	1	35	0	35
"D06"	"H35"	"Carcinoma in situ of cervix uteri"	"Other retinal disorders"	1	39	0	39
"D06"	"H53"	"Carcinoma in situ of cervix uteri"	"Visual disturbances"	1	35	0	35
"D06"	"I20"	"Carcinoma in situ of cervix uteri"	"Angina pectoris"	1	106	0	106
"D06"	"I21"	"Carcinoma in situ of cervix uteri"	"Acute myocardial infarction"	1	49	0	49
"D06"	"I25"	"Carcinoma in situ of cervix uteri"	"Chronic ischemic heart disease"	1	93	0	93
"D06"	"I47"	"Carcinoma in situ of cervix uteri"	"Paroxysmal tachycardia"	1	62	9	71
"D06"	"I63"	"Carcinoma in situ of cervix uteri"	"Cerebral infarction"	1	47	0	47
"D06"	"I83"	"Carcinoma in situ of cervix uteri"	"Varicose veins of lower extremities"	1	201	9	210
"D06"	"J15"	"Carcinoma in situ of cervix uteri"	"Bacterial pneumonia, not elsewhere classified"	1	48	0	48
"D06"	"J18"	"Carcinoma in situ of cervix uteri"	"Pneumonia, unspecified organism"	1	236	0	236
"D06"	"J32"	"Carcinoma in situ of cervix uteri"	"Chronic sinusitis"	1	28	0	28
"D06"	"J42"	"Carcinoma in situ of cervix uteri"	"Unspecified chronic bronchitis"	1	29	1	30
"D06"	"J44"	"Carcinoma in situ of cervix uteri"	"Other chronic obstructive pulmonary disease"	1	132	0	132
"D06"	"J45"	"Carcinoma in situ of cervix uteri"	"Asthma"	1	176	46	222
"D06"	"K30"	"Carcinoma in situ of cervix uteri"	"Functional dyspepsia"	1	154	9	163
"D06"	"K44"	"Carcinoma in situ of cervix uteri"	"Diaphragmatic hernia"	1	79	0	79
"D06"	"K58"	"Carcinoma in situ of cervix uteri"	"Irritable bowel syndrome"	1	101	12	113
"D06"	"K59"	"Carcinoma in situ of cervix uteri"	"Other functional intestinal disorders"	1	195	0	195
"D06"	"K60"	"Carcinoma in situ of cervix uteri"	"Fissure and fistula of anal and rectal regions"	1	48	9	57
"D06"	"K62"	"Carcinoma in situ of cervix uteri"	"Other diseases of anus and rectum"	1	98	0	98
"D06"	"L02"	"Carcinoma in situ of cervix uteri"	"Cutaneous abscess, furuncle and carbuncle"	1	120	26	146
"D06"	"M06"	"Carcinoma in situ of cervix uteri"	"Other rheumatoid arthritis"	1	40	0	40
"D06"	"M16"	"Carcinoma in situ of cervix uteri"	"Osteoarthritis of hip"	1	67	0	67
"D06"	"M17"	"Carcinoma in situ of cervix uteri"	"Osteoarthritis of knee"	1	151	0	151
"D06"	"M20"	"Carcinoma in situ of cervix uteri"	"Acquired deformities of fingers and toes"	1	127	0	127
"D06"	"M21"	"Carcinoma in situ of cervix uteri"	"Other acquired deformities of limbs"	1	31	0	31
"D06"	"M25"	"Carcinoma in situ of cervix uteri"	"Other joint disorder, not elsewhere classified"	1	113	0	113
"D06"	"M35"	"Carcinoma in situ of cervix uteri"	"Other systemic involvement of connective tissue"	1	39	5	44
"D06"	"M47"	"Carcinoma in situ of cervix uteri"	"Spondylosis"	1	64	0	64
"D06"	"M48"	"Carcinoma in situ of cervix uteri"	"Other spondylopathies"	1	39	0	39
"D06"	"M62"	"Carcinoma in situ of cervix uteri"	"Other disorders of muscle"	1	240	76	316
"D06"	"M75"	"Carcinoma in situ of cervix uteri"	"Shoulder lesions"	1	273	0	273
"D06"	"M79"	"Carcinoma in situ of cervix uteri"	"Oth and unsp soft tissue disorders, not elsewhere classified"	1	306	13	319
"D06"	"M85"	"Carcinoma in situ of cervix uteri"	"Other disorders of bone density and structure"	1	34	0	34
"D06"	"N81"	"Carcinoma in situ of cervix uteri"	"Female genital prolapse"	1	133	1	134
"D06"	"N90"	"Carcinoma in situ of cervix uteri"	"Other noninflammatory disorders of vulva and perineum"	1	92	26	118
"D06"	"O82"	"Carcinoma in situ of cervix uteri"	"Encounter for cesarean delivery without indication"	1	403	261	664
"D07"	"C34"	"Carcinoma in situ of other and unspecified genital organs"	"Malignant neoplasm of bronchus and lung"	1	86	0	86
"D07"	"E86"	"Carcinoma in situ of other and unspecified genital organs"	"Volume depletion"	1	189	20	209
"D07"	"H25"	"Carcinoma in situ of other and unspecified genital organs"	"Age-related cataract"	1	207	107	314
"D07"	"J15"	"Carcinoma in situ of other and unspecified genital organs"	"Bacterial pneumonia, not elsewhere classified"	1	93	14	107
"D07"	"J18"	"Carcinoma in situ of other and unspecified genital organs"	"Pneumonia, unspecified organism"	1	268	84	352
"D07"	"J44"	"Carcinoma in situ of other and unspecified genital organs"	"Other chronic obstructive pulmonary disease"	1	178	61	239
"D07"	"M80"	"Carcinoma in situ of other and unspecified genital organs"	"Osteoporosis with current pathological fracture"	1	58	1	59
"D07"	"N18"	"Carcinoma in situ of other and unspecified genital organs"	"Chronic kidney disease (CKD)"	1	70	22	92
"D09"	"D63"	"Carcinoma in situ of other and unspecified sites"	"Anemia in chronic diseases classified elsewhere"	1	129	32	161
"D10"	"A41"	"Benign neoplasm of mouth and pharynx"	"Other sepsis"	1	375	114	489
"D10"	"A49"	"Benign neoplasm of mouth and pharynx"	"Bacterial infection of unspecified site"	1	199	47	246
"D10"	"C34"	"Benign neoplasm of mouth and pharynx"	"Malignant neoplasm of bronchus and lung"	1	298	32	330
"D10"	"C78"	"Benign neoplasm of mouth and pharynx"	"Secondary malignant neoplasm of resp and digestive organs"	1	252	20	272
"D10"	"C79"	"Benign neoplasm of mouth and pharynx"	"Secondary malignant neoplasm of other and unspecified sites"	1	158	26	184
"D10"	"D64"	"Benign neoplasm of mouth and pharynx"	"Other anemias"	1	346	145	491
"D10"	"E87"	"Benign neoplasm of mouth and pharynx"	"Other disorders of fluid, electrolyte and acid-base balance"	1	253	82	335
"D10"	"H25"	"Benign neoplasm of mouth and pharynx"	"Age-related cataract"	1	655	386	1041
"D10"	"I69"	"Benign neoplasm of mouth and pharynx"	"Sequelae of cerebrovascular disease"	1	263	135	398
"D10"	"J15"	"Benign neoplasm of mouth and pharynx"	"Bacterial pneumonia, not elsewhere classified"	1	375	100	475
"D10"	"J18"	"Benign neoplasm of mouth and pharynx"	"Pneumonia, unspecified organism"	1	840	412	1252
"D10"	"M81"	"Benign neoplasm of mouth and pharynx"	"Osteoporosis without current pathological fracture"	1	321	153	474
"D11"	"A41"	"Benign neoplasm of major salivary glands"	"Other sepsis"	1	342	46	388
"D11"	"C07"	"Benign neoplasm of major salivary glands"	"Malignant neoplasm of parotid gland"	1	348	79	427
"D11"	"C08"	"Benign neoplasm of major salivary glands"	"Malignant neoplasm of other and unsp major salivary glands"	1	73	14	87
"D11"	"C25"	"Benign neoplasm of major salivary glands"	"Malignant neoplasm of pancreas"	1	46	3	49
"D11"	"C78"	"Benign neoplasm of major salivary glands"	"Secondary malignant neoplasm of resp and digestive organs"	1	229	12	241
"D11"	"C79"	"Benign neoplasm of major salivary glands"	"Secondary malignant neoplasm of other and unspecified sites"	1	166	9	175
"D11"	"F03"	"Benign neoplasm of major salivary glands"	"Unspecified dementia"	1	159	14	173
"D11"	"G47"	"Benign neoplasm of major salivary glands"	"Sleep disorders"	1	182	66	248
"D11"	"G51"	"Benign neoplasm of major salivary glands"	"Facial nerve disorders"	1	111	47	158
"D11"	"I26"	"Benign neoplasm of major salivary glands"	"Pulmonary embolism"	1	114	27	141
"D11"	"I46"	"Benign neoplasm of major salivary glands"	"Cardiac arrest"	1	91	2	93
"D11"	"I50"	"Benign neoplasm of major salivary glands"	"Heart failure"	1	424	148	572
"D11"	"I51"	"Benign neoplasm of major salivary glands"	"Complications and ill-defined descriptions of heart disease"	1	36	4	40
"D11"	"I61"	"Benign neoplasm of major salivary glands"	"Nontraumatic intracerebral hemorrhage"	1	63	14	77
"D11"	"J18"	"Benign neoplasm of major salivary glands"	"Pneumonia, unspecified organism"	1	693	252	945
"D11"	"J44"	"Benign neoplasm of major salivary glands"	"Other chronic obstructive pulmonary disease"	1	448	251	699
"D11"	"K57"	"Benign neoplasm of major salivary glands"	"Diverticular disease of intestine"	1	285	122	407
"D11"	"K59"	"Benign neoplasm of major salivary glands"	"Other functional intestinal disorders"	1	347	129	476
"D11"	"L89"	"Benign neoplasm of major salivary glands"	"Pressure ulcer"	1	60	4	64
"D11"	"L97"	"Benign neoplasm of major salivary glands"	"Non-pressure chronic ulcer of lower limb, NEC"	1	59	14	73
"D11"	"M80"	"Benign neoplasm of major salivary glands"	"Osteoporosis with current pathological fracture"	1	155	29	184
"D11"	"M81"	"Benign neoplasm of major salivary glands"	"Osteoporosis without current pathological fracture"	1	274	88	362
"D11"	"N17"	"Benign neoplasm of major salivary glands"	"Acute kidney failure"	1	75	9	84
"D11"	"N18"	"Benign neoplasm of major salivary glands"	"Chronic kidney disease (CKD)"	1	160	34	194
"D11"	"N19"	"Benign neoplasm of major salivary glands"	"Unspecified kidney failure"	1	81	15	96
"D11"	"N30"	"Benign neoplasm of major salivary glands"	"Cystitis"	1	376	181	557
"D11"	"N39"	"Benign neoplasm of major salivary glands"	"Other disorders of urinary system"	1	343	124	467
"D12"	"A41"	"Benign neoplasm of colon, rectum, anus and anal canal"	"Other sepsis"	1	5332	0	5332
"D12"	"B96"	"Benign neoplasm of colon, rectum, anus and anal canal"	"Oth bacterial agents as the cause of diseases classd elswhr"	1	178	61	239
"D12"	"C16"	"Benign neoplasm of colon, rectum, anus and anal canal"	"Malignant neoplasm of stomach"	1	478	173	651
"D12"	"C90"	"Benign neoplasm of colon, rectum, anus and anal canal"	"Multiple myeloma and malignant plasma cell neoplasms"	1	260	85	345
"D12"	"D09"	"Benign neoplasm of colon, rectum, anus and anal canal"	"Carcinoma in situ of other and unspecified sites"	1	293	117	410
"D12"	"D46"	"Benign neoplasm of colon, rectum, anus and anal canal"	"Myelodysplastic syndromes"	1	282	57	339
"D12"	"D64"	"Benign neoplasm of colon, rectum, anus and anal canal"	"Other anemias"	1	4505	3277	7782
"D12"	"E64"	"Benign neoplasm of colon, rectum, anus and anal canal"	"Sequelae of malnutrition and other nutritional deficiencies"	1	450	122	572
"D12"	"E83"	"Benign neoplasm of colon, rectum, anus and anal canal"	"Disorders of mineral metabolism"	1	639	213	852
"D12"	"E86"	"Benign neoplasm of colon, rectum, anus and anal canal"	"Volume depletion"	1	6047	0	6047
"D12"	"F01"	"Benign neoplasm of colon, rectum, anus and anal canal"	"Vascular dementia"	1	449	36	485
"D12"	"F03"	"Benign neoplasm of colon, rectum, anus and anal canal"	"Unspecified dementia"	1	1906	0	1906
"D12"	"G23"	"Benign neoplasm of colon, rectum, anus and anal canal"	"Other degenerative diseases of basal ganglia"	1	46	7	53
"D12"	"I27"	"Benign neoplasm of colon, rectum, anus and anal canal"	"Other pulmonary heart diseases"	1	431	247	678
"D12"	"I50"	"Benign neoplasm of colon, rectum, anus and anal canal"	"Heart failure"	1	4116	2905	7021
"D12"	"I95"	"Benign neoplasm of colon, rectum, anus and anal canal"	"Hypotension"	1	1034	353	1387
"D12"	"J22"	"Benign neoplasm of colon, rectum, anus and anal canal"	"Unspecified acute lower respiratory infection"	1	379	158	537
"D12"	"J69"	"Benign neoplasm of colon, rectum, anus and anal canal"	"Pneumonitis due to solids and liquids"	1	453	48	501
"D12"	"J90"	"Benign neoplasm of colon, rectum, anus and anal canal"	"Pleural effusion, not elsewhere classified"	1	894	377	1271
"D12"	"J91"	"Benign neoplasm of colon, rectum, anus and anal canal"	"Pleural effusion in conditions classified elsewhere"	1	344	127	471
"D12"	"J96"	"Benign neoplasm of colon, rectum, anus and anal canal"	"Respiratory failure, not elsewhere classified"	1	4503	0	4503
"D12"	"K31"	"Benign neoplasm of colon, rectum, anus and anal canal"	"Other diseases of stomach and duodenum"	1	427	280	707
"D12"	"K52"	"Benign neoplasm of colon, rectum, anus and anal canal"	"Other and unsp noninfective gastroenteritis and colitis"	1	2404	2053	4457
"D12"	"K55"	"Benign neoplasm of colon, rectum, anus and anal canal"	"Vascular disorders of intestine"	1	896	639	1535
"D12"	"K56"	"Benign neoplasm of colon, rectum, anus and anal canal"	"Paralytic ileus and intestinal obstruction without hernia"	1	2189	1416	3605
"D12"	"K59"	"Benign neoplasm of colon, rectum, anus and anal canal"	"Other functional intestinal disorders"	1	6504	5463	11967
"D12"	"K65"	"Benign neoplasm of colon, rectum, anus and anal canal"	"Peritonitis"	1	784	547	1331
"D12"	"K91"	"Benign neoplasm of colon, rectum, anus and anal canal"	"Intraop and postproc comp and disorders of dgstv sys, NEC"	1	688	312	1000
"D12"	"L57"	"Benign neoplasm of colon, rectum, anus and anal canal"	"Skin changes due to chronic expsr to nonionizing radiation"	1	430	228	658
"D12"	"L97"	"Benign neoplasm of colon, rectum, anus and anal canal"	"Non-pressure chronic ulcer of lower limb, NEC"	1	700	328	1028
"D12"	"M81"	"Benign neoplasm of colon, rectum, anus and anal canal"	"Osteoporosis without current pathological fracture"	1	2954	1947	4901
"D12"	"N39"	"Benign neoplasm of colon, rectum, anus and anal canal"	"Other disorders of urinary system"	1	3741	2517	6258
"D13"	"C16"	"Benign neoplasm of and ill-defined parts of digestive system"	"Malignant neoplasm of stomach"	1	226	129	355
"D13"	"C22"	"Benign neoplasm of and ill-defined parts of digestive system"	"Malignant neoplasm of liver and intrahepatic bile ducts"	1	136	42	178
"D13"	"C49"	"Benign neoplasm of and ill-defined parts of digestive system"	"Malignant neoplasm of other connective and soft tissue"	1	88	29	117
"D13"	"E13"	"Benign neoplasm of and ill-defined parts of digestive system"	"Other specified diabetes mellitus"	1	118	29	147
"D13"	"J18"	"Benign neoplasm of and ill-defined parts of digestive system"	"Pneumonia, unspecified organism"	1	715	503	1218
"D13"	"K59"	"Benign neoplasm of and ill-defined parts of digestive system"	"Other functional intestinal disorders"	1	623	456	1079
"D14"	"A41"	"Benign neoplasm of middle ear and respiratory system"	"Other sepsis"	1	515	63	578
"D14"	"A46"	"Benign neoplasm of middle ear and respiratory system"	"Erysipelas"	1	161	76	237
"D14"	"C22"	"Benign neoplasm of middle ear and respiratory system"	"Malignant neoplasm of liver and intrahepatic bile ducts"	1	35	3	38
"D14"	"C32"	"Benign neoplasm of middle ear and respiratory system"	"Malignant neoplasm of larynx"	1	438	275	713
"D14"	"C78"	"Benign neoplasm of middle ear and respiratory system"	"Secondary malignant neoplasm of resp and digestive organs"	1	399	55	454
"D14"	"D50"	"Benign neoplasm of middle ear and respiratory system"	"Iron deficiency anemia"	1	158	59	217
"D14"	"D63"	"Benign neoplasm of middle ear and respiratory system"	"Anemia in chronic diseases classified elsewhere"	1	143	17	160
"D14"	"D64"	"Benign neoplasm of middle ear and respiratory system"	"Other anemias"	1	486	124	610
"D14"	"E86"	"Benign neoplasm of middle ear and respiratory system"	"Volume depletion"	1	536	37	573
"D14"	"E87"	"Benign neoplasm of middle ear and respiratory system"	"Other disorders of fluid, electrolyte and acid-base balance"	1	345	47	392
"D14"	"F01"	"Benign neoplasm of middle ear and respiratory system"	"Vascular dementia"	1	28	0	28
"D14"	"F05"	"Benign neoplasm of middle ear and respiratory system"	"Delirium due to known physiological condition"	1	81	0	81
"D14"	"F41"	"Benign neoplasm of middle ear and respiratory system"	"Other anxiety disorders"	1	165	38	203
"D14"	"I44"	"Benign neoplasm of middle ear and respiratory system"	"Atrioventricular and left bundle-branch block"	1	109	26	135
"D14"	"I46"	"Benign neoplasm of middle ear and respiratory system"	"Cardiac arrest"	1	150	5	155
"D14"	"I61"	"Benign neoplasm of middle ear and respiratory system"	"Nontraumatic intracerebral hemorrhage"	1	105	21	126
"D14"	"I63"	"Benign neoplasm of middle ear and respiratory system"	"Cerebral infarction"	1	343	124	467
"D14"	"I95"	"Benign neoplasm of middle ear and respiratory system"	"Hypotension"	1	102	23	125
"D14"	"J18"	"Benign neoplasm of middle ear and respiratory system"	"Pneumonia, unspecified organism"	1	1238	527	1765
"D14"	"J44"	"Benign neoplasm of middle ear and respiratory system"	"Other chronic obstructive pulmonary disease"	1	850	535	1385
"D14"	"J81"	"Benign neoplasm of middle ear and respiratory system"	"Pulmonary edema"	1	81	2	83
"D14"	"K57"	"Benign neoplasm of middle ear and respiratory system"	"Diverticular disease of intestine"	1	385	188	573
"D14"	"K63"	"Benign neoplasm of middle ear and respiratory system"	"Other diseases of intestine"	1	65	13	78
"D14"	"K92"	"Benign neoplasm of middle ear and respiratory system"	"Other diseases of digestive system"	1	205	99	304
"D14"	"M10"	"Benign neoplasm of middle ear and respiratory system"	"Gout"	1	120	53	173
"D14"	"N39"	"Benign neoplasm of middle ear and respiratory system"	"Other disorders of urinary system"	1	438	152	590
"D15"	"D86"	"Benign neoplasm of other and unsp intrathoracic organs"	"Sarcoidosis"	1	85	22	107
"D16"	"C34"	"Benign neoplasm of bone and articular cartilage"	"Malignant neoplasm of bronchus and lung"	1	104	3	107
"D16"	"D64"	"Benign neoplasm of bone and articular cartilage"	"Other anemias"	1	164	29	193
"D16"	"E11"	"Benign neoplasm of bone and articular cartilage"	"Type 2 diabetes mellitus"	1	181	75	256
"D16"	"F17"	"Benign neoplasm of bone and articular cartilage"	"Nicotine dependence"	1	67	1	68
"D16"	"F33"	"Benign neoplasm of bone and articular cartilage"	"Major depressive disorder, recurrent"	1	45	2	47
"D16"	"F41"	"Benign neoplasm of bone and articular cartilage"	"Other anxiety disorders"	1	61	5	66
"D16"	"H25"	"Benign neoplasm of bone and articular cartilage"	"Age-related cataract"	1	330	52	382
"D16"	"H26"	"Benign neoplasm of bone and articular cartilage"	"Other cataract"	1	96	19	115
"D16"	"I10"	"Benign neoplasm of bone and articular cartilage"	"Essential (primary) hypertension"	1	580	179	759
"D16"	"I20"	"Benign neoplasm of bone and articular cartilage"	"Angina pectoris"	1	207	113	320
"D16"	"I25"	"Benign neoplasm of bone and articular cartilage"	"Chronic ischemic heart disease"	1	210	75	285
"D16"	"I26"	"Benign neoplasm of bone and articular cartilage"	"Pulmonary embolism"	1	62	12	74
"D16"	"I42"	"Benign neoplasm of bone and articular cartilage"	"Cardiomyopathy"	1	37	5	42
"D16"	"I69"	"Benign neoplasm of bone and articular cartilage"	"Sequelae of cerebrovascular disease"	1	133	17	150
"D16"	"I70"	"Benign neoplasm of bone and articular cartilage"	"Atherosclerosis"	1	92	34	126
"D16"	"J15"	"Benign neoplasm of bone and articular cartilage"	"Bacterial pneumonia, not elsewhere classified"	1	164	4	168
"D16"	"J44"	"Benign neoplasm of bone and articular cartilage"	"Other chronic obstructive pulmonary disease"	1	195	51	246
"D16"	"K56"	"Benign neoplasm of bone and articular cartilage"	"Paralytic ileus and intestinal obstruction without hernia"	1	64	15	79
"D16"	"K62"	"Benign neoplasm of bone and articular cartilage"	"Other diseases of anus and rectum"	1	146	61	207
"D16"	"M19"	"Benign neoplasm of bone and articular cartilage"	"Other and unspecified osteoarthritis"	1	389	160	549
"D16"	"M85"	"Benign neoplasm of bone and articular cartilage"	"Other disorders of bone density and structure"	1	290	175	465
"D16"	"N19"	"Benign neoplasm of bone and articular cartilage"	"Unspecified kidney failure"	1	49	6	55
"D16"	"N30"	"Benign neoplasm of bone and articular cartilage"	"Cystitis"	1	314	106	420
"D16"	"N39"	"Benign neoplasm of bone and articular cartilage"	"Other disorders of urinary system"	1	267	64	331
"D16"	"O70"	"Benign neoplasm of bone and articular cartilage"	"Perineal laceration during delivery"	1	228	108	336
"D16"	"O72"	"Benign neoplasm of bone and articular cartilage"	"Postpartum hemorrhage"	1	379	9	388
"D17"	"A04"	"Benign lipomatous neoplasm"	"Other bacterial intestinal infections"	1	157	35	192
"D17"	"B95"	"Benign lipomatous neoplasm"	"Strep as the cause of diseases classified elsewhere"	1	31	2	33
"D17"	"B96"	"Benign lipomatous neoplasm"	"Oth bacterial agents as the cause of diseases classd elswhr"	1	46	6	52
"D17"	"C18"	"Benign lipomatous neoplasm"	"Malignant neoplasm of colon"	1	318	71	389
"D17"	"C20"	"Benign lipomatous neoplasm"	"Malignant neoplasm of rectum"	1	157	35	192
"D17"	"C22"	"Benign lipomatous neoplasm"	"Malignant neoplasm of liver and intrahepatic bile ducts"	1	68	0	68
"D17"	"C24"	"Benign lipomatous neoplasm"	"Malignant neoplasm of other and unsp parts of biliary tract"	1	45	0	45
"D17"	"C34"	"Benign lipomatous neoplasm"	"Malignant neoplasm of bronchus and lung"	1	681	6	687
"D17"	"C61"	"Benign lipomatous neoplasm"	"Malignant neoplasm of prostate"	1	519	72	591
"D17"	"C64"	"Benign lipomatous neoplasm"	"Malignant neoplasm of kidney, except renal pelvis"	1	132	26	158
"D17"	"C67"	"Benign lipomatous neoplasm"	"Malignant neoplasm of bladder"	1	104	28	132
"D17"	"C78"	"Benign lipomatous neoplasm"	"Secondary malignant neoplasm of resp and digestive organs"	1	660	0	660
"D17"	"C79"	"Benign lipomatous neoplasm"	"Secondary malignant neoplasm of other and unspecified sites"	1	568	0	568
"D17"	"C83"	"Benign lipomatous neoplasm"	"Non-follicular lymphoma"	1	156	42	198
"D17"	"C91"	"Benign lipomatous neoplasm"	"Lymphoid leukemia"	1	86	22	108
"D17"	"D21"	"Benign lipomatous neoplasm"	"Other benign neoplasms of connective and other soft tissue"	1	1438	948	2386
"D17"	"D46"	"Benign lipomatous neoplasm"	"Myelodysplastic syndromes"	1	49	3	52
"D17"	"D64"	"Benign lipomatous neoplasm"	"Other anemias"	1	957	156	1113
"D17"	"E03"	"Benign lipomatous neoplasm"	"Other hypothyroidism"	1	449	228	677
"D17"	"E27"	"Benign lipomatous neoplasm"	"Other disorders of adrenal gland"	1	82	24	106
"D17"	"E78"	"Benign lipomatous neoplasm"	"Disorders of lipoprotein metabolism and other lipidemias"	1	1671	748	2419
"D17"	"E86"	"Benign lipomatous neoplasm"	"Volume depletion"	1	902	47	949
"D17"	"E87"	"Benign lipomatous neoplasm"	"Other disorders of fluid, electrolyte and acid-base balance"	1	629	20	649
"D17"	"F03"	"Benign lipomatous neoplasm"	"Unspecified dementia"	1	295	6	301
"D17"	"G20"	"Benign lipomatous neoplasm"	"Parkinson's disease"	1	131	13	144
"D17"	"G45"	"Benign lipomatous neoplasm"	"Transient cerebral ischemic attacks and related syndromes"	1	574	258	832
"D17"	"G62"	"Benign lipomatous neoplasm"	"Other and unspecified polyneuropathies"	1	305	113	418
"D17"	"H35"	"Benign lipomatous neoplasm"	"Other retinal disorders"	1	722	239	961
"D17"	"H43"	"Benign lipomatous neoplasm"	"Disorders of vitreous body"	1	236	103	339
"D17"	"H57"	"Benign lipomatous neoplasm"	"Other disorders of eye and adnexa"	1	199	79	278
"D17"	"I21"	"Benign lipomatous neoplasm"	"Acute myocardial infarction"	1	691	418	1109
"D17"	"I25"	"Benign lipomatous neoplasm"	"Chronic ischemic heart disease"	1	1199	738	1937
"D17"	"I44"	"Benign lipomatous neoplasm"	"Atrioventricular and left bundle-branch block"	1	240	45	285
"D17"	"I46"	"Benign lipomatous neoplasm"	"Cardiac arrest"	1	214	0	214
"D17"	"I48"	"Benign lipomatous neoplasm"	"Atrial fibrillation and flutter"	1	1751	499	2250
"D17"	"I50"	"Benign lipomatous neoplasm"	"Heart failure"	1	1130	257	1387
"D17"	"I61"	"Benign lipomatous neoplasm"	"Nontraumatic intracerebral hemorrhage"	1	180	29	209
"D17"	"I63"	"Benign lipomatous neoplasm"	"Cerebral infarction"	1	849	162	1011
"D17"	"I69"	"Benign lipomatous neoplasm"	"Sequelae of cerebrovascular disease"	1	768	174	942
"D17"	"I80"	"Benign lipomatous neoplasm"	"Phlebitis and thrombophlebitis"	1	530	347	877
"D17"	"I95"	"Benign lipomatous neoplasm"	"Hypotension"	1	225	30	255
"D17"	"J15"	"Benign lipomatous neoplasm"	"Bacterial pneumonia, not elsewhere classified"	1	842	85	927
"D17"	"J18"	"Benign lipomatous neoplasm"	"Pneumonia, unspecified organism"	1	2066	657	2723
"D17"	"J47"	"Benign lipomatous neoplasm"	"Bronchiectasis"	1	73	11	84
"D17"	"J69"	"Benign lipomatous neoplasm"	"Pneumonitis due to solids and liquids"	1	89	0	89
"D17"	"J90"	"Benign lipomatous neoplasm"	"Pleural effusion, not elsewhere classified"	1	202	17	219
"D17"	"K22"	"Benign lipomatous neoplasm"	"Other diseases of esophagus"	1	216	110	326
"D17"	"K52"	"Benign lipomatous neoplasm"	"Other and unsp noninfective gastroenteritis and colitis"	1	439	209	648
"D17"	"K55"	"Benign lipomatous neoplasm"	"Vascular disorders of intestine"	1	91	14	105
"D17"	"K56"	"Benign lipomatous neoplasm"	"Paralytic ileus and intestinal obstruction without hernia"	1	364	116	480
"D17"	"K62"	"Benign lipomatous neoplasm"	"Other diseases of anus and rectum"	1	772	420	1192
"D17"	"K63"	"Benign lipomatous neoplasm"	"Other diseases of intestine"	1	201	35	236
"D17"	"K72"	"Benign lipomatous neoplasm"	"Hepatic failure, not elsewhere classified"	1	90	7	97
"D17"	"K74"	"Benign lipomatous neoplasm"	"Fibrosis and cirrhosis of liver"	1	89	32	121
"D17"	"L89"	"Benign lipomatous neoplasm"	"Pressure ulcer"	1	156	7	163
"D17"	"L97"	"Benign lipomatous neoplasm"	"Non-pressure chronic ulcer of lower limb, NEC"	1	219	44	263
"D17"	"M10"	"Benign lipomatous neoplasm"	"Gout"	1	312	157	469
"D17"	"M17"	"Benign lipomatous neoplasm"	"Osteoarthritis of knee"	1	1711	1219	2930
"D17"	"M46"	"Benign lipomatous neoplasm"	"Other inflammatory spondylopathies"	1	107	38	145
"D17"	"M47"	"Benign lipomatous neoplasm"	"Spondylosis"	1	805	442	1247
"D17"	"M80"	"Benign lipomatous neoplasm"	"Osteoporosis with current pathological fracture"	1	339	29	368
"D17"	"M85"	"Benign lipomatous neoplasm"	"Other disorders of bone density and structure"	1	607	107	714
"D17"	"N39"	"Benign lipomatous neoplasm"	"Other disorders of urinary system"	1	1281	415	1696
"D18"	"J03"	"Hemangioma and lymphangioma, any site"	"Acute tonsillitis"	1	224	97	321
"D18"	"J18"	"Hemangioma and lymphangioma, any site"	"Pneumonia, unspecified organism"	1	609	383	992
"D18"	"K59"	"Hemangioma and lymphangioma, any site"	"Other functional intestinal disorders"	1	469	227	696
"D18"	"N30"	"Hemangioma and lymphangioma, any site"	"Cystitis"	1	374	224	598
"D21"	"A41"	"Other benign neoplasms of connective and other soft tissue"	"Other sepsis"	1	214	34	248
"D21"	"C34"	"Other benign neoplasms of connective and other soft tissue"	"Malignant neoplasm of bronchus and lung"	1	132	7	139
"D21"	"D63"	"Other benign neoplasms of connective and other soft tissue"	"Anemia in chronic diseases classified elsewhere"	1	69	10	79
"D21"	"D64"	"Other benign neoplasms of connective and other soft tissue"	"Other anemias"	1	253	80	333
"D21"	"G47"	"Other benign neoplasms of connective and other soft tissue"	"Sleep disorders"	1	194	71	265
"D21"	"I69"	"Other benign neoplasms of connective and other soft tissue"	"Sequelae of cerebrovascular disease"	1	170	44	214
"D21"	"I71"	"Other benign neoplasms of connective and other soft tissue"	"Aortic aneurysm and dissection"	1	56	13	69
"D21"	"I95"	"Other benign neoplasms of connective and other soft tissue"	"Hypotension"	1	47	8	55
"D21"	"J18"	"Other benign neoplasms of connective and other soft tissue"	"Pneumonia, unspecified organism"	1	446	218	664
"D21"	"J44"	"Other benign neoplasms of connective and other soft tissue"	"Other chronic obstructive pulmonary disease"	1	243	122	365
"D21"	"J90"	"Other benign neoplasms of connective and other soft tissue"	"Pleural effusion, not elsewhere classified"	1	44	5	49
"D21"	"K57"	"Other benign neoplasms of connective and other soft tissue"	"Diverticular disease of intestine"	1	221	113	334
"D21"	"K59"	"Other benign neoplasms of connective and other soft tissue"	"Other functional intestinal disorders"	1	335	151	486
"D21"	"N18"	"Other benign neoplasms of connective and other soft tissue"	"Chronic kidney disease (CKD)"	1	117	23	140
"D21"	"N30"	"Other benign neoplasms of connective and other soft tissue"	"Cystitis"	1	284	172	456
"D21"	"N39"	"Other benign neoplasms of connective and other soft tissue"	"Other disorders of urinary system"	1	265	141	406
"D22"	"D12"	"Melanocytic nevi"	"Benign neoplasm of colon, rectum, anus and anal canal"	1	422	242	664
"D22"	"G47"	"Melanocytic nevi"	"Sleep disorders"	1	349	207	556
"D22"	"J96"	"Melanocytic nevi"	"Respiratory failure, not elsewhere classified"	1	178	89	267
"D22"	"K64"	"Melanocytic nevi"	"Hemorrhoids and perianal venous thrombosis"	1	442	119	561
"D22"	"O72"	"Melanocytic nevi"	"Postpartum hemorrhage"	1	1654	1107	2761
"D23"	"A41"	"Other benign neoplasms of skin"	"Other sepsis"	1	997	126	1123
"D23"	"A49"	"Other benign neoplasms of skin"	"Bacterial infection of unspecified site"	1	542	82	624
"D23"	"C15"	"Other benign neoplasms of skin"	"Malignant neoplasm of esophagus"	1	78	1	79
"D23"	"C22"	"Other benign neoplasms of skin"	"Malignant neoplasm of liver and intrahepatic bile ducts"	1	67	0	67
"D23"	"C25"	"Other benign neoplasms of skin"	"Malignant neoplasm of pancreas"	1	186	6	192
"D23"	"C34"	"Other benign neoplasms of skin"	"Malignant neoplasm of bronchus and lung"	1	793	30	823
"D23"	"C64"	"Other benign neoplasms of skin"	"Malignant neoplasm of kidney, except renal pelvis"	1	100	30	130
"D23"	"D50"	"Other benign neoplasms of skin"	"Iron deficiency anemia"	1	375	106	481
"D23"	"D62"	"Other benign neoplasms of skin"	"Acute posthemorrhagic anemia"	1	159	46	205
"D23"	"D63"	"Other benign neoplasms of skin"	"Anemia in chronic diseases classified elsewhere"	1	227	20	247
"D23"	"D64"	"Other benign neoplasms of skin"	"Other anemias"	1	1054	227	1281
"D23"	"E03"	"Other benign neoplasms of skin"	"Other hypothyroidism"	1	428	193	621
"D23"	"E11"	"Other benign neoplasms of skin"	"Type 2 diabetes mellitus"	1	996	675	1671
"D23"	"E16"	"Other benign neoplasms of skin"	"Other disorders of pancreatic internal secretion"	1	132	61	193
"D23"	"E66"	"Other benign neoplasms of skin"	"Overweight and obesity"	1	1142	716	1858
"D23"	"E83"	"Other benign neoplasms of skin"	"Disorders of mineral metabolism"	1	158	12	170
"D23"	"F32"	"Other benign neoplasms of skin"	"Depressive episode"	1	441	174	615
"D23"	"F41"	"Other benign neoplasms of skin"	"Other anxiety disorders"	1	274	57	331
"D23"	"G20"	"Other benign neoplasms of skin"	"Parkinson's disease"	1	135	51	186
"D23"	"G95"	"Other benign neoplasms of skin"	"Other and unspecified diseases of spinal cord"	1	132	20	152
"D23"	"H26"	"Other benign neoplasms of skin"	"Other cataract"	1	603	332	935
"D23"	"I21"	"Other benign neoplasms of skin"	"Acute myocardial infarction"	1	623	448	1071
"D23"	"I26"	"Other benign neoplasms of skin"	"Pulmonary embolism"	1	345	96	441
"D23"	"I35"	"Other benign neoplasms of skin"	"Nonrheumatic aortic valve disorders"	1	646	101	747
"D23"	"I44"	"Other benign neoplasms of skin"	"Atrioventricular and left bundle-branch block"	1	250	81	331
"D23"	"I48"	"Other benign neoplasms of skin"	"Atrial fibrillation and flutter"	1	1636	636	2272
"D23"	"I50"	"Other benign neoplasms of skin"	"Heart failure"	1	1251	427	1678
"D23"	"I51"	"Other benign neoplasms of skin"	"Complications and ill-defined descriptions of heart disease"	1	139	53	192
"D23"	"I69"	"Other benign neoplasms of skin"	"Sequelae of cerebrovascular disease"	1	798	270	1068
"D23"	"I71"	"Other benign neoplasms of skin"	"Aortic aneurysm and dissection"	1	304	58	362
"D23"	"I82"	"Other benign neoplasms of skin"	"Other venous embolism and thrombosis"	1	95	21	116
"D23"	"I85"	"Other benign neoplasms of skin"	"Esophageal varices"	1	66	13	79
"D23"	"I95"	"Other benign neoplasms of skin"	"Hypotension"	1	267	48	315
"D23"	"J15"	"Other benign neoplasms of skin"	"Bacterial pneumonia, not elsewhere classified"	1	883	157	1040
"D23"	"J69"	"Other benign neoplasms of skin"	"Pneumonitis due to solids and liquids"	1	115	0	115
"D23"	"J81"	"Other benign neoplasms of skin"	"Pulmonary edema"	1	155	21	176
"D23"	"J84"	"Other benign neoplasms of skin"	"Other interstitial pulmonary diseases"	1	134	39	173
"D23"	"J90"	"Other benign neoplasms of skin"	"Pleural effusion, not elsewhere classified"	1	237	28	265
"D23"	"J91"	"Other benign neoplasms of skin"	"Pleural effusion in conditions classified elsewhere"	1	92	16	108
"D23"	"K52"	"Other benign neoplasms of skin"	"Other and unsp noninfective gastroenteritis and colitis"	1	471	218	689
"D23"	"K55"	"Other benign neoplasms of skin"	"Vascular disorders of intestine"	1	78	13	91
"D23"	"K59"	"Other benign neoplasms of skin"	"Other functional intestinal disorders"	1	1492	487	1979
"D23"	"K62"	"Other benign neoplasms of skin"	"Other diseases of anus and rectum"	1	676	435	1111
"D23"	"K63"	"Other benign neoplasms of skin"	"Other diseases of intestine"	1	191	40	231
"D23"	"K74"	"Other benign neoplasms of skin"	"Fibrosis and cirrhosis of liver"	1	79	28	107
"D23"	"K83"	"Other benign neoplasms of skin"	"Other diseases of biliary tract"	1	139	49	188
"D23"	"L97"	"Other benign neoplasms of skin"	"Non-pressure chronic ulcer of lower limb, NEC"	1	265	68	333
"D23"	"L98"	"Other benign neoplasms of skin"	"Oth disorders of skin, subcu, not elsewhere classified"	1	445	296	741
"D23"	"M16"	"Other benign neoplasms of skin"	"Osteoarthritis of hip"	1	696	488	1184
"D23"	"M47"	"Other benign neoplasms of skin"	"Spondylosis"	1	536	360	896
"D23"	"M80"	"Other benign neoplasms of skin"	"Osteoporosis with current pathological fracture"	1	386	71	457
"D23"	"N13"	"Other benign neoplasms of skin"	"Obstructive and reflux uropathy"	1	222	82	304
"D23"	"N17"	"Other benign neoplasms of skin"	"Acute kidney failure"	1	218	23	241
"D23"	"N18"	"Other benign neoplasms of skin"	"Chronic kidney disease (CKD)"	1	565	141	706
"D24"	"A41"	"Benign neoplasm of breast"	"Other sepsis"	1	450	0	450
"D24"	"A46"	"Benign neoplasm of breast"	"Erysipelas"	1	295	31	326
"D24"	"A49"	"Benign neoplasm of breast"	"Bacterial infection of unspecified site"	1	249	0	249
"D24"	"B37"	"Benign neoplasm of breast"	"Candidiasis"	1	128	33	161
"D24"	"C18"	"Benign neoplasm of breast"	"Malignant neoplasm of colon"	1	203	21	224
"D24"	"C50"	"Benign neoplasm of breast"	"Malignant neoplasm of breast"	1	1841	1115	2956
"D24"	"C54"	"Benign neoplasm of breast"	"Malignant neoplasm of corpus uteri"	1	104	18	122
"D24"	"C83"	"Benign neoplasm of breast"	"Non-follicular lymphoma"	1	65	4	69
"D24"	"C90"	"Benign neoplasm of breast"	"Multiple myeloma and malignant plasma cell neoplasms"	1	29	0	29
"D24"	"D05"	"Benign neoplasm of breast"	"Carcinoma in situ of breast"	1	434	147	581
"D24"	"D17"	"Benign neoplasm of breast"	"Benign lipomatous neoplasm"	1	564	205	769
"D24"	"D25"	"Benign neoplasm of breast"	"Leiomyoma of uterus"	1	835	618	1453
"D24"	"D35"	"Benign neoplasm of breast"	"Benign neoplasm of other and unspecified endocrine glands"	1	83	5	88
"D24"	"D62"	"Benign neoplasm of breast"	"Acute posthemorrhagic anemia"	1	119	17	136
"D24"	"E05"	"Benign neoplasm of breast"	"Thyrotoxicosis [hyperthyroidism]"	1	470	147	617
"D24"	"E10"	"Benign neoplasm of breast"	"Type 1 diabetes mellitus"	1	246	143	389
"D24"	"E16"	"Benign neoplasm of breast"	"Other disorders of pancreatic internal secretion"	1	68	21	89
"D24"	"E68"	"Benign neoplasm of breast"	"Sequelae of hyperalimentation"	1	108	26	134
"D24"	"E78"	"Benign neoplasm of breast"	"Disorders of lipoprotein metabolism and other lipidemias"	1	883	19	902
"D24"	"E86"	"Benign neoplasm of breast"	"Volume depletion"	1	499	0	499
"D24"	"E89"	"Benign neoplasm of breast"	"Postproc endocrine and metabolic comp and disorders, NEC"	1	107	14	121
"D24"	"F06"	"Benign neoplasm of breast"	"Other mental disorders due to known physiological condition"	1	37	0	37
"D24"	"F33"	"Benign neoplasm of breast"	"Major depressive disorder, recurrent"	1	266	16	282
"D24"	"F41"	"Benign neoplasm of breast"	"Other anxiety disorders"	1	263	21	284
"D24"	"F43"	"Benign neoplasm of breast"	"Reaction to severe stress, and adjustment disorders"	1	226	59	285
"D24"	"G20"	"Benign neoplasm of breast"	"Parkinson's disease"	1	69	0	69
"D24"	"G24"	"Benign neoplasm of breast"	"Dystonia"	1	48	7	55
"D24"	"G44"	"Benign neoplasm of breast"	"Other headache syndromes"	1	299	138	437
"D24"	"G45"	"Benign neoplasm of breast"	"Transient cerebral ischemic attacks and related syndromes"	1	319	27	346
"D24"	"G50"	"Benign neoplasm of breast"	"Disorders of trigeminal nerve"	1	67	17	84
"D24"	"G57"	"Benign neoplasm of breast"	"Mononeuropathies of lower limb"	1	135	33	168
"D24"	"G91"	"Benign neoplasm of breast"	"Hydrocephalus"	1	37	1	38
"D24"	"G93"	"Benign neoplasm of breast"	"Other disorders of brain"	1	48	10	58
"D24"	"H25"	"Benign neoplasm of breast"	"Age-related cataract"	1	1416	0	1416
"D24"	"H26"	"Benign neoplasm of breast"	"Other cataract"	1	404	48	452
"D24"	"H35"	"Benign neoplasm of breast"	"Other retinal disorders"	1	495	9	504
"D24"	"H54"	"Benign neoplasm of breast"	"Blindness and low vision"	1	54	1	55
"D24"	"H90"	"Benign neoplasm of breast"	"Conductive and sensorineural hearing loss"	1	311	72	383
"D24"	"H93"	"Benign neoplasm of breast"	"Other disorders of ear, not elsewhere classified"	1	360	109	469
"D24"	"I10"	"Benign neoplasm of breast"	"Essential (primary) hypertension"	1	2763	0	2763
"D24"	"I15"	"Benign neoplasm of breast"	"Secondary hypertension"	1	103	17	120
"D24"	"I21"	"Benign neoplasm of breast"	"Acute myocardial infarction"	1	409	50	459
"D24"	"I27"	"Benign neoplasm of breast"	"Other pulmonary heart diseases"	1	54	1	55
"D24"	"I34"	"Benign neoplasm of breast"	"Nonrheumatic mitral valve disorders"	1	130	4	134
"D24"	"I35"	"Benign neoplasm of breast"	"Nonrheumatic aortic valve disorders"	1	239	0	239
"D24"	"I42"	"Benign neoplasm of breast"	"Cardiomyopathy"	1	82	4	86
"D24"	"I44"	"Benign neoplasm of breast"	"Atrioventricular and left bundle-branch block"	1	109	6	115
"D24"	"I45"	"Benign neoplasm of breast"	"Other conduction disorders"	1	65	19	84
"D24"	"I46"	"Benign neoplasm of breast"	"Cardiac arrest"	1	72	0	72
"D24"	"I47"	"Benign neoplasm of breast"	"Paroxysmal tachycardia"	1	380	145	525
"D24"	"I48"	"Benign neoplasm of breast"	"Atrial fibrillation and flutter"	1	795	30	825
"D24"	"I50"	"Benign neoplasm of breast"	"Heart failure"	1	525	27	552
"D24"	"I61"	"Benign neoplasm of breast"	"Nontraumatic intracerebral hemorrhage"	1	117	0	117
"D24"	"I63"	"Benign neoplasm of breast"	"Cerebral infarction"	1	422	6	428
"D24"	"I69"	"Benign neoplasm of breast"	"Sequelae of cerebrovascular disease"	1	427	4	431
"D24"	"I71"	"Benign neoplasm of breast"	"Aortic aneurysm and dissection"	1	82	0	82
"D24"	"I73"	"Benign neoplasm of breast"	"Other peripheral vascular diseases"	1	228	13	241
"D24"	"I74"	"Benign neoplasm of breast"	"Arterial embolism and thrombosis"	1	51	6	57
"D24"	"I80"	"Benign neoplasm of breast"	"Phlebitis and thrombophlebitis"	1	355	109	464
"D24"	"I83"	"Benign neoplasm of breast"	"Varicose veins of lower extremities"	1	642	394	1036
"D24"	"I89"	"Benign neoplasm of breast"	"Oth noninfective disorders of lymphatic vessels and nodes"	1	137	7	144
"D24"	"I95"	"Benign neoplasm of breast"	"Hypotension"	1	101	0	101
"D24"	"J06"	"Benign neoplasm of breast"	"Acute upper resp infections of multiple and unsp sites"	1	143	3	146
"D24"	"J15"	"Benign neoplasm of breast"	"Bacterial pneumonia, not elsewhere classified"	1	397	0	397
"D24"	"J42"	"Benign neoplasm of breast"	"Unspecified chronic bronchitis"	1	133	60	193
"D24"	"J69"	"Benign neoplasm of breast"	"Pneumonitis due to solids and liquids"	1	29	0	29
"D24"	"J90"	"Benign neoplasm of breast"	"Pleural effusion, not elsewhere classified"	1	116	0	116
"D24"	"J93"	"Benign neoplasm of breast"	"Pneumothorax and air leak"	1	63	16	79
"D24"	"J98"	"Benign neoplasm of breast"	"Other respiratory disorders"	1	79	13	92
"D24"	"K05"	"Benign neoplasm of breast"	"Gingivitis and periodontal diseases"	1	108	22	130
"D24"	"K08"	"Benign neoplasm of breast"	"Other disorders of teeth and supporting structures"	1	110	34	144
"D24"	"K21"	"Benign neoplasm of breast"	"Gastro-esophageal reflux disease"	1	536	163	699
"D24"	"K26"	"Benign neoplasm of breast"	"Duodenal ulcer"	1	144	63	207
"D24"	"K29"	"Benign neoplasm of breast"	"Gastritis and duodenitis"	1	543	221	764
"D24"	"K30"	"Benign neoplasm of breast"	"Functional dyspepsia"	1	559	268	827
"D24"	"K31"	"Benign neoplasm of breast"	"Other diseases of stomach and duodenum"	1	66	6	72
"D24"	"K43"	"Benign neoplasm of breast"	"Ventral hernia"	1	266	70	336
"D24"	"K55"	"Benign neoplasm of breast"	"Vascular disorders of intestine"	1	40	0	40
"D24"	"K59"	"Benign neoplasm of breast"	"Other functional intestinal disorders"	1	1173	140	1313
"D24"	"K63"	"Benign neoplasm of breast"	"Other diseases of intestine"	1	133	3	136
"D24"	"K64"	"Benign neoplasm of breast"	"Hemorrhoids and perianal venous thrombosis"	1	381	0	381
"D24"	"K65"	"Benign neoplasm of breast"	"Peritonitis"	1	99	26	125
"D24"	"K70"	"Benign neoplasm of breast"	"Alcoholic liver disease"	1	110	21	131
"D24"	"K72"	"Benign neoplasm of breast"	"Hepatic failure, not elsewhere classified"	1	58	0	58
"D24"	"K76"	"Benign neoplasm of breast"	"Other diseases of liver"	1	165	32	197
"D24"	"K80"	"Benign neoplasm of breast"	"Cholelithiasis"	1	806	457	1263
"D24"	"K81"	"Benign neoplasm of breast"	"Cholecystitis"	1	115	31	146
"D24"	"K83"	"Benign neoplasm of breast"	"Other diseases of biliary tract"	1	109	21	130
"D24"	"K91"	"Benign neoplasm of breast"	"Intraop and postproc comp and disorders of dgstv sys, NEC"	1	66	6	72
"D24"	"L08"	"Benign neoplasm of breast"	"Other local infections of skin and subcutaneous tissue"	1	271	83	354
"D24"	"L40"	"Benign neoplasm of breast"	"Psoriasis"	1	121	50	171
"D24"	"M06"	"Benign neoplasm of breast"	"Other rheumatoid arthritis"	1	209	69	278
"D24"	"M07"	"Benign neoplasm of breast"	"Enteropathic arthropathies"	1	85	9	94
"D24"	"M13"	"Benign neoplasm of breast"	"Other arthritis"	1	210	37	247
"D24"	"M20"	"Benign neoplasm of breast"	"Acquired deformities of fingers and toes"	1	550	193	743
"D24"	"M24"	"Benign neoplasm of breast"	"Other specific joint derangements"	1	161	72	233
"D24"	"M47"	"Benign neoplasm of breast"	"Spondylosis"	1	461	95	556
"D24"	"M48"	"Benign neoplasm of breast"	"Other spondylopathies"	1	450	10	460
"D24"	"M51"	"Benign neoplasm of breast"	"Thoracic, thoracolum, and lumbosacral intvrt disc disorders"	1	894	423	1317
"D24"	"M54"	"Benign neoplasm of breast"	"Dorsalgia"	1	1332	800	2132
"D24"	"M65"	"Benign neoplasm of breast"	"Synovitis and tenosynovitis"	1	603	264	867
"D24"	"M67"	"Benign neoplasm of breast"	"Other disorders of synovium and tendon"	1	440	245	685
"D24"	"M72"	"Benign neoplasm of breast"	"Fibroblastic disorders"	1	233	39	272
"D24"	"M80"	"Benign neoplasm of breast"	"Osteoporosis with current pathological fracture"	1	207	0	207
"D24"	"M81"	"Benign neoplasm of breast"	"Osteoporosis without current pathological fracture"	1	863	0	863
"D24"	"N12"	"Benign neoplasm of breast"	"Tubulo-interstitial nephritis, not spcf as acute or chronic"	1	62	11	73
"D24"	"N13"	"Benign neoplasm of breast"	"Obstructive and reflux uropathy"	1	153	35	188
"D24"	"N17"	"Benign neoplasm of breast"	"Acute kidney failure"	1	92	0	92
"D24"	"N30"	"Benign neoplasm of breast"	"Cystitis"	1	1190	362	1552
"D24"	"N81"	"Benign neoplasm of breast"	"Female genital prolapse"	1	738	160	898
"D24"	"N83"	"Benign neoplasm of breast"	"Noninflammatory disord of ovary, fallop and broad ligament"	1	581	398	979
"D25"	"A09"	"Leiomyoma of uterus"	"Infectious gastroenteritis and colitis, unspecified"	1	477	295	772
"D25"	"A41"	"Leiomyoma of uterus"	"Other sepsis"	1	654	0	654
"D25"	"A46"	"Leiomyoma of uterus"	"Erysipelas"	1	369	20	389
"D25"	"A49"	"Leiomyoma of uterus"	"Bacterial infection of unspecified site"	1	404	6	410
"D25"	"B02"	"Leiomyoma of uterus"	"Zoster [herpes zoster]"	1	116	10	126
"D25"	"B37"	"Leiomyoma of uterus"	"Candidiasis"	1	222	60	282
"D25"	"C16"	"Leiomyoma of uterus"	"Malignant neoplasm of stomach"	1	66	2	68
"D25"	"C18"	"Leiomyoma of uterus"	"Malignant neoplasm of colon"	1	433	16	449
"D25"	"C20"	"Leiomyoma of uterus"	"Malignant neoplasm of rectum"	1	155	4	159
"D25"	"C21"	"Leiomyoma of uterus"	"Malignant neoplasm of anus and anal canal"	1	30	0	30
"D25"	"C34"	"Leiomyoma of uterus"	"Malignant neoplasm of bronchus and lung"	1	471	0	471
"D25"	"C54"	"Leiomyoma of uterus"	"Malignant neoplasm of corpus uteri"	1	855	159	1014
"D25"	"C55"	"Leiomyoma of uterus"	"Malignant neoplasm of uterus, part unspecified"	1	142	13	155
"D25"	"C64"	"Leiomyoma of uterus"	"Malignant neoplasm of kidney, except renal pelvis"	1	80	1	81
"D25"	"C67"	"Leiomyoma of uterus"	"Malignant neoplasm of bladder"	1	77	4	81
"D25"	"C78"	"Leiomyoma of uterus"	"Secondary malignant neoplasm of resp and digestive organs"	1	755	0	755
"D25"	"C80"	"Leiomyoma of uterus"	"Malignant neoplasm without specification of site"	1	94	0	94
"D25"	"C92"	"Leiomyoma of uterus"	"Myeloid leukemia"	1	47	6	53
"D25"	"D05"	"Leiomyoma of uterus"	"Carcinoma in situ of breast"	1	221	12	233
"D25"	"D12"	"Leiomyoma of uterus"	"Benign neoplasm of colon, rectum, anus and anal canal"	1	1560	0	1560
"D25"	"D33"	"Leiomyoma of uterus"	"Benign neoplasm of brain and oth prt central nervous system"	1	108	34	142
"D25"	"D35"	"Leiomyoma of uterus"	"Benign neoplasm of other and unspecified endocrine glands"	1	211	23	234
"D25"	"D43"	"Leiomyoma of uterus"	"Neoplasm of uncertain behavior of brain and cnsl"	1	69	5	74
"D25"	"D63"	"Leiomyoma of uterus"	"Anemia in chronic diseases classified elsewhere"	1	252	0	252
"D25"	"D64"	"Leiomyoma of uterus"	"Other anemias"	1	1122	807	1929
"D25"	"D69"	"Leiomyoma of uterus"	"Purpura and other hemorrhagic conditions"	1	197	87	284
"D25"	"D70"	"Leiomyoma of uterus"	"Neutropenia"	1	37	5	42
"D25"	"D75"	"Leiomyoma of uterus"	"Other and unsp diseases of blood and blood-forming organs"	1	95	13	108
"D25"	"E03"	"Leiomyoma of uterus"	"Other hypothyroidism"	1	1246	347	1593
"D25"	"E06"	"Leiomyoma of uterus"	"Thyroiditis"	1	225	82	307
"D25"	"E21"	"Leiomyoma of uterus"	"Hyperparathyroidism and other disorders of parathyroid gland"	1	290	0	290
"D25"	"E23"	"Leiomyoma of uterus"	"Hypofunction and other disorders of the pituitary gland"	1	75	6	81
"D25"	"E27"	"Leiomyoma of uterus"	"Other disorders of adrenal gland"	1	103	2	105
"D25"	"E55"	"Leiomyoma of uterus"	"Vitamin D deficiency"	1	168	24	192
"D25"	"E68"	"Leiomyoma of uterus"	"Sequelae of hyperalimentation"	1	202	92	294
"D25"	"E83"	"Leiomyoma of uterus"	"Disorders of mineral metabolism"	1	161	0	161
"D25"	"E88"	"Leiomyoma of uterus"	"Other and unspecified metabolic disorders"	1	103	19	122
"D25"	"F05"	"Leiomyoma of uterus"	"Delirium due to known physiological condition"	1	81	0	81
"D25"	"F06"	"Leiomyoma of uterus"	"Other mental disorders due to known physiological condition"	1	73	1	74
"D25"	"F32"	"Leiomyoma of uterus"	"Depressive episode"	1	586	169	755
"D25"	"F34"	"Leiomyoma of uterus"	"Persistent mood [affective] disorders"	1	65	16	81
"D25"	"F43"	"Leiomyoma of uterus"	"Reaction to severe stress, and adjustment disorders"	1	463	127	590
"D25"	"G12"	"Leiomyoma of uterus"	"Spinal muscular atrophy and related syndromes"	1	27	2	29
"D25"	"G31"	"Leiomyoma of uterus"	"Oth degenerative diseases of nervous system, NEC"	1	30	0	30
"D25"	"G44"	"Leiomyoma of uterus"	"Other headache syndromes"	1	470	297	767
"D25"	"G45"	"Leiomyoma of uterus"	"Transient cerebral ischemic attacks and related syndromes"	1	556	22	578
"D25"	"G47"	"Leiomyoma of uterus"	"Sleep disorders"	1	755	0	755
"D25"	"G51"	"Leiomyoma of uterus"	"Facial nerve disorders"	1	134	44	178
"D25"	"G56"	"Leiomyoma of uterus"	"Mononeuropathies of upper limb"	1	1756	478	2234
"D25"	"G57"	"Leiomyoma of uterus"	"Mononeuropathies of lower limb"	1	241	58	299
"D25"	"G62"	"Leiomyoma of uterus"	"Other and unspecified polyneuropathies"	1	244	4	248
"D25"	"G91"	"Leiomyoma of uterus"	"Hydrocephalus"	1	79	4	83
"D25"	"G96"	"Leiomyoma of uterus"	"Other disorders of central nervous system"	1	363	0	363
"D25"	"H04"	"Leiomyoma of uterus"	"Disorders of lacrimal system"	1	118	24	142
"D25"	"H18"	"Leiomyoma of uterus"	"Other disorders of cornea"	1	125	7	132
"D25"	"H33"	"Leiomyoma of uterus"	"Retinal detachments and breaks"	1	264	3	267
"D25"	"H34"	"Leiomyoma of uterus"	"Retinal vascular occlusions"	1	88	1	89
"D25"	"H35"	"Leiomyoma of uterus"	"Other retinal disorders"	1	641	0	641
"D25"	"H40"	"Leiomyoma of uterus"	"Glaucoma"	1	256	16	272
"D25"	"H43"	"Leiomyoma of uterus"	"Disorders of vitreous body"	1	328	0	328
"D25"	"H44"	"Leiomyoma of uterus"	"Disorders of globe"	1	99	31	130
"D25"	"H53"	"Leiomyoma of uterus"	"Visual disturbances"	1	321	48	369
"D25"	"H54"	"Leiomyoma of uterus"	"Blindness and low vision"	1	92	6	98
"D25"	"H57"	"Leiomyoma of uterus"	"Other disorders of eye and adnexa"	1	266	12	278
"D25"	"H81"	"Leiomyoma of uterus"	"Disorders of vestibular function"	1	515	179	694
"D25"	"H91"	"Leiomyoma of uterus"	"Other and unspecified hearing loss"	1	1377	110	1487
"D25"	"H93"	"Leiomyoma of uterus"	"Other disorders of ear, not elsewhere classified"	1	724	140	864
"D25"	"I10"	"Leiomyoma of uterus"	"Essential (primary) hypertension"	1	9910	0	9910
"D25"	"I25"	"Leiomyoma of uterus"	"Chronic ischemic heart disease"	1	952	120	1072
"D25"	"I26"	"Leiomyoma of uterus"	"Pulmonary embolism"	1	371	67	438
"D25"	"I27"	"Leiomyoma of uterus"	"Other pulmonary heart diseases"	1	106	11	117
"D25"	"I31"	"Leiomyoma of uterus"	"Other diseases of pericardium"	1	53	0	53
"D25"	"I35"	"Leiomyoma of uterus"	"Nonrheumatic aortic valve disorders"	1	350	0	350
"D25"	"I44"	"Leiomyoma of uterus"	"Atrioventricular and left bundle-branch block"	1	134	12	146
"D25"	"I46"	"Leiomyoma of uterus"	"Cardiac arrest"	1	111	0	111
"D25"	"I49"	"Leiomyoma of uterus"	"Other cardiac arrhythmias"	1	572	107	679
"D25"	"I51"	"Leiomyoma of uterus"	"Complications and ill-defined descriptions of heart disease"	1	176	37	213
"D25"	"I61"	"Leiomyoma of uterus"	"Nontraumatic intracerebral hemorrhage"	1	165	0	165
"D25"	"I65"	"Leiomyoma of uterus"	"Occls and stenosis of precerb art, not rslt in cereb infrc"	1	67	5	72
"D25"	"I67"	"Leiomyoma of uterus"	"Other cerebrovascular diseases"	1	116	14	130
"D25"	"I69"	"Leiomyoma of uterus"	"Sequelae of cerebrovascular disease"	1	627	8	635
"D25"	"I70"	"Leiomyoma of uterus"	"Atherosclerosis"	1	285	58	343
"D25"	"I72"	"Leiomyoma of uterus"	"Other aneurysm"	1	50	3	53
"D25"	"I78"	"Leiomyoma of uterus"	"Diseases of capillaries"	1	207	70	277
"D25"	"I80"	"Leiomyoma of uterus"	"Phlebitis and thrombophlebitis"	1	635	284	919
"D25"	"J06"	"Leiomyoma of uterus"	"Acute upper resp infections of multiple and unsp sites"	1	178	0	178
"D25"	"J10"	"Leiomyoma of uterus"	"Influenza due to other identified influenza virus"	1	31	0	31
"D25"	"J15"	"Leiomyoma of uterus"	"Bacterial pneumonia, not elsewhere classified"	1	539	0	539
"D25"	"J43"	"Leiomyoma of uterus"	"Emphysema"	1	92	10	102
"D25"	"J47"	"Leiomyoma of uterus"	"Bronchiectasis"	1	92	0	92
"D25"	"J69"	"Leiomyoma of uterus"	"Pneumonitis due to solids and liquids"	1	35	0	35
"D25"	"J91"	"Leiomyoma of uterus"	"Pleural effusion in conditions classified elsewhere"	1	62	0	62
"D25"	"K04"	"Leiomyoma of uterus"	"Diseases of pulp and periapical tissues"	1	200	72	272
"D25"	"K08"	"Leiomyoma of uterus"	"Other disorders of teeth and supporting structures"	1	165	37	202
"D25"	"K13"	"Leiomyoma of uterus"	"Other diseases of lip and oral mucosa"	1	109	26	135
"D25"	"K21"	"Leiomyoma of uterus"	"Gastro-esophageal reflux disease"	1	1040	342	1382
"D25"	"K30"	"Leiomyoma of uterus"	"Functional dyspepsia"	1	939	625	1564
"D25"	"K43"	"Leiomyoma of uterus"	"Ventral hernia"	1	1067	218	1285
"D25"	"K59"	"Leiomyoma of uterus"	"Other functional intestinal disorders"	1	2548	0	2548
"D25"	"K62"	"Leiomyoma of uterus"	"Other diseases of anus and rectum"	1	1068	192	1260
"D25"	"K63"	"Leiomyoma of uterus"	"Other diseases of intestine"	1	207	6	213
"D25"	"K65"	"Leiomyoma of uterus"	"Peritonitis"	1	309	77	386
"D25"	"K70"	"Leiomyoma of uterus"	"Alcoholic liver disease"	1	150	20	170
"D25"	"K71"	"Leiomyoma of uterus"	"Toxic liver disease"	1	48	10	58
"D25"	"K72"	"Leiomyoma of uterus"	"Hepatic failure, not elsewhere classified"	1	74	0	74
"D25"	"K73"	"Leiomyoma of uterus"	"Chronic hepatitis, not elsewhere classified"	1	37	5	42
"D25"	"K74"	"Leiomyoma of uterus"	"Fibrosis and cirrhosis of liver"	1	116	7	123
"D25"	"K75"	"Leiomyoma of uterus"	"Other inflammatory liver diseases"	1	36	3	39
"D25"	"K80"	"Leiomyoma of uterus"	"Cholelithiasis"	1	1730	966	2696
"D25"	"K81"	"Leiomyoma of uterus"	"Cholecystitis"	1	254	76	330
"D25"	"K83"	"Leiomyoma of uterus"	"Other diseases of biliary tract"	1	155	25	180
"D25"	"K86"	"Leiomyoma of uterus"	"Other diseases of pancreas"	1	110	19	129
"D25"	"K91"	"Leiomyoma of uterus"	"Intraop and postproc comp and disorders of dgstv sys, NEC"	1	164	20	184
"D25"	"L02"	"Leiomyoma of uterus"	"Cutaneous abscess, furuncle and carbuncle"	1	560	401	961
"D25"	"L30"	"Leiomyoma of uterus"	"Other and unspecified dermatitis"	1	353	77	430
"D25"	"L59"	"Leiomyoma of uterus"	"Oth disorders of skin, subcu related to radiation"	1	26	0	26
"D25"	"L72"	"Leiomyoma of uterus"	"Follicular cysts of skin and subcutaneous tissue"	1	173	47	220
"D25"	"L81"	"Leiomyoma of uterus"	"Other disorders of pigmentation"	1	88	23	111
"D25"	"M05"	"Leiomyoma of uterus"	"Rheumatoid arthritis with rheumatoid factor"	1	317	46	363
"D25"	"M10"	"Leiomyoma of uterus"	"Gout"	1	134	7	141
"D25"	"M13"	"Leiomyoma of uterus"	"Other arthritis"	1	370	87	457
"D25"	"M15"	"Leiomyoma of uterus"	"Polyosteoarthritis"	1	375	9	384
"D25"	"M17"	"Leiomyoma of uterus"	"Osteoarthritis of knee"	1	2665	0	2665
"D25"	"M18"	"Leiomyoma of uterus"	"Osteoarthritis of first carpometacarpal joint"	1	462	0	462
"D25"	"M21"	"Leiomyoma of uterus"	"Other acquired deformities of limbs"	1	413	86	499
"D25"	"M23"	"Leiomyoma of uterus"	"Internal derangement of knee"	1	2147	949	3096
"D25"	"M35"	"Leiomyoma of uterus"	"Other systemic involvement of connective tissue"	1	441	203	644
"D25"	"M43"	"Leiomyoma of uterus"	"Other deforming dorsopathies"	1	315	77	392
"D25"	"M65"	"Leiomyoma of uterus"	"Synovitis and tenosynovitis"	1	1350	362	1712
"D25"	"M72"	"Leiomyoma of uterus"	"Fibroblastic disorders"	1	443	70	513
"D25"	"M75"	"Leiomyoma of uterus"	"Shoulder lesions"	1	3813	0	3813
"D25"	"M77"	"Leiomyoma of uterus"	"Other enthesopathies"	1	827	436	1263
"D25"	"M85"	"Leiomyoma of uterus"	"Other disorders of bone density and structure"	1	921	0	921
"D25"	"M87"	"Leiomyoma of uterus"	"Osteonecrosis"	1	39	0	39
"D25"	"N17"	"Leiomyoma of uterus"	"Acute kidney failure"	1	168	0	168
"D25"	"N18"	"Leiomyoma of uterus"	"Chronic kidney disease (CKD)"	1	265	0	265
"D25"	"N19"	"Leiomyoma of uterus"	"Unspecified kidney failure"	1	115	2	117
"D25"	"N28"	"Leiomyoma of uterus"	"Oth disorders of kidney and ureter, not elsewhere classified"	1	108	15	123
"D25"	"N31"	"Leiomyoma of uterus"	"Neuromuscular dysfunction of bladder, NEC"	1	149	68	217
"D25"	"N63"	"Leiomyoma of uterus"	"Unspecified lump in breast"	1	912	542	1454
"D25"	"N64"	"Leiomyoma of uterus"	"Other disorders of breast"	1	530	276	806
"D25"	"N81"	"Leiomyoma of uterus"	"Female genital prolapse"	1	2096	1515	3611
"D25"	"N82"	"Leiomyoma of uterus"	"Fistulae involving female genital tract"	1	276	72	348
"D26"	"M54"	"Other benign neoplasms of uterus"	"Dorsalgia"	1	94	33	127
"D26"	"M79"	"Other benign neoplasms of uterus"	"Oth and unsp soft tissue disorders, not elsewhere classified"	1	79	18	97
"D26"	"M81"	"Other benign neoplasms of uterus"	"Osteoporosis without current pathological fracture"	1	53	0	53
"D26"	"N30"	"Other benign neoplasms of uterus"	"Cystitis"	1	71	22	93
"D27"	"A04"	"Benign neoplasm of ovary"	"Other bacterial intestinal infections"	1	128	16	144
"D27"	"A41"	"Benign neoplasm of ovary"	"Other sepsis"	1	601	37	638
"D27"	"A46"	"Benign neoplasm of ovary"	"Erysipelas"	1	274	35	309
"D27"	"A49"	"Benign neoplasm of ovary"	"Bacterial infection of unspecified site"	1	309	12	321
"D27"	"C25"	"Benign neoplasm of ovary"	"Malignant neoplasm of pancreas"	1	107	0	107
"D27"	"C44"	"Benign neoplasm of ovary"	"Other and unspecified malignant neoplasm of skin"	1	283	19	302
"D27"	"C50"	"Benign neoplasm of ovary"	"Malignant neoplasm of breast"	1	502	282	784
"D27"	"C78"	"Benign neoplasm of ovary"	"Secondary malignant neoplasm of resp and digestive organs"	1	584	14	598
"D27"	"C79"	"Benign neoplasm of ovary"	"Secondary malignant neoplasm of other and unspecified sites"	1	370	2	372
"D27"	"D17"	"Benign neoplasm of ovary"	"Benign lipomatous neoplasm"	1	284	91	375
"D27"	"D50"	"Benign neoplasm of ovary"	"Iron deficiency anemia"	1	293	86	379
"D27"	"E05"	"Benign neoplasm of ovary"	"Thyrotoxicosis [hyperthyroidism]"	1	450	220	670
"D27"	"E55"	"Benign neoplasm of ovary"	"Vitamin D deficiency"	1	111	6	117
"D27"	"E86"	"Benign neoplasm of ovary"	"Volume depletion"	1	761	4	765
"D27"	"E87"	"Benign neoplasm of ovary"	"Other disorders of fluid, electrolyte and acid-base balance"	1	469	3	472
"D27"	"E89"	"Benign neoplasm of ovary"	"Postproc endocrine and metabolic comp and disorders, NEC"	1	72	17	89
"D27"	"F32"	"Benign neoplasm of ovary"	"Depressive episode"	1	401	108	509
"D27"	"F41"	"Benign neoplasm of ovary"	"Other anxiety disorders"	1	330	37	367
"D27"	"F43"	"Benign neoplasm of ovary"	"Reaction to severe stress, and adjustment disorders"	1	180	39	219
"D27"	"G44"	"Benign neoplasm of ovary"	"Other headache syndromes"	1	239	106	345
"D27"	"G45"	"Benign neoplasm of ovary"	"Transient cerebral ischemic attacks and related syndromes"	1	337	64	401
"D27"	"G56"	"Benign neoplasm of ovary"	"Mononeuropathies of upper limb"	1	631	221	852
"D27"	"G95"	"Benign neoplasm of ovary"	"Other and unspecified diseases of spinal cord"	1	79	2	81
"D27"	"H02"	"Benign neoplasm of ovary"	"Other disorders of eyelid"	1	297	67	364
"D27"	"H53"	"Benign neoplasm of ovary"	"Visual disturbances"	1	192	44	236
"D27"	"H81"	"Benign neoplasm of ovary"	"Disorders of vestibular function"	1	228	110	338
"D27"	"H90"	"Benign neoplasm of ovary"	"Conductive and sensorineural hearing loss"	1	278	103	381
"D27"	"H91"	"Benign neoplasm of ovary"	"Other and unspecified hearing loss"	1	785	324	1109
"D27"	"H93"	"Benign neoplasm of ovary"	"Other disorders of ear, not elsewhere classified"	1	254	119	373
"D27"	"I10"	"Benign neoplasm of ovary"	"Essential (primary) hypertension"	1	2779	1608	4387
"D27"	"I21"	"Benign neoplasm of ovary"	"Acute myocardial infarction"	1	363	87	450
"D27"	"I27"	"Benign neoplasm of ovary"	"Other pulmonary heart diseases"	1	75	22	97
"D27"	"I46"	"Benign neoplasm of ovary"	"Cardiac arrest"	1	106	0	106
"D27"	"I49"	"Benign neoplasm of ovary"	"Other cardiac arrhythmias"	1	327	89	416
"D27"	"I50"	"Benign neoplasm of ovary"	"Heart failure"	1	565	115	680
"D27"	"I63"	"Benign neoplasm of ovary"	"Cerebral infarction"	1	420	36	456
"D27"	"I73"	"Benign neoplasm of ovary"	"Other peripheral vascular diseases"	1	269	46	315
"D27"	"I74"	"Benign neoplasm of ovary"	"Arterial embolism and thrombosis"	1	51	9	60
"D27"	"I80"	"Benign neoplasm of ovary"	"Phlebitis and thrombophlebitis"	1	340	168	508
"D27"	"I95"	"Benign neoplasm of ovary"	"Hypotension"	1	136	18	154
"D27"	"J15"	"Benign neoplasm of ovary"	"Bacterial pneumonia, not elsewhere classified"	1	468	4	472
"D27"	"J81"	"Benign neoplasm of ovary"	"Pulmonary edema"	1	75	9	84
"D27"	"J90"	"Benign neoplasm of ovary"	"Pleural effusion, not elsewhere classified"	1	135	11	146
"D27"	"J96"	"Benign neoplasm of ovary"	"Respiratory failure, not elsewhere classified"	1	510	0	510
"D27"	"K05"	"Benign neoplasm of ovary"	"Gingivitis and periodontal diseases"	1	82	21	103
"D27"	"K21"	"Benign neoplasm of ovary"	"Gastro-esophageal reflux disease"	1	431	194	625
"D27"	"K22"	"Benign neoplasm of ovary"	"Other diseases of esophagus"	1	106	23	129
"D27"	"K25"	"Benign neoplasm of ovary"	"Gastric ulcer"	1	250	141	391
"D27"	"K43"	"Benign neoplasm of ovary"	"Ventral hernia"	1	908	194	1102
"D27"	"K52"	"Benign neoplasm of ovary"	"Other and unsp noninfective gastroenteritis and colitis"	1	428	128	556
"D27"	"K62"	"Benign neoplasm of ovary"	"Other diseases of anus and rectum"	1	566	156	722
"D27"	"K66"	"Benign neoplasm of ovary"	"Other disorders of peritoneum"	1	427	275	702
"D27"	"K83"	"Benign neoplasm of ovary"	"Other diseases of biliary tract"	1	127	38	165
"D27"	"K86"	"Benign neoplasm of ovary"	"Other diseases of pancreas"	1	91	32	123
"D27"	"K92"	"Benign neoplasm of ovary"	"Other diseases of digestive system"	1	304	68	372
"D27"	"L89"	"Benign neoplasm of ovary"	"Pressure ulcer"	1	93	1	94
"D27"	"L98"	"Benign neoplasm of ovary"	"Oth disorders of skin, subcu, not elsewhere classified"	1	181	42	223
"D27"	"M06"	"Benign neoplasm of ovary"	"Other rheumatoid arthritis"	1	191	95	286
"D27"	"M15"	"Benign neoplasm of ovary"	"Polyosteoarthritis"	1	155	31	186
"D27"	"M16"	"Benign neoplasm of ovary"	"Osteoarthritis of hip"	1	569	139	708
"D27"	"M17"	"Benign neoplasm of ovary"	"Osteoarthritis of knee"	1	979	224	1203
"D27"	"M19"	"Benign neoplasm of ovary"	"Other and unspecified osteoarthritis"	1	613	61	674
"D27"	"M20"	"Benign neoplasm of ovary"	"Acquired deformities of fingers and toes"	1	414	169	583
"D27"	"M48"	"Benign neoplasm of ovary"	"Other spondylopathies"	1	443	41	484
"D27"	"M53"	"Benign neoplasm of ovary"	"Other and unspecified dorsopathies, not elsewhere classified"	1	178	78	256
"D27"	"M67"	"Benign neoplasm of ovary"	"Other disorders of synovium and tendon"	1	333	195	528
"D27"	"M72"	"Benign neoplasm of ovary"	"Fibroblastic disorders"	1	162	41	203
"D27"	"M76"	"Benign neoplasm of ovary"	"Enthesopathies, lower limb, excluding foot"	1	228	88	316
"D27"	"M77"	"Benign neoplasm of ovary"	"Other enthesopathies"	1	291	129	420
"D27"	"M80"	"Benign neoplasm of ovary"	"Osteoporosis with current pathological fracture"	1	329	0	329
"D27"	"M85"	"Benign neoplasm of ovary"	"Other disorders of bone density and structure"	1	517	0	517
"D27"	"N17"	"Benign neoplasm of ovary"	"Acute kidney failure"	1	140	4	144
"D27"	"N18"	"Benign neoplasm of ovary"	"Chronic kidney disease (CKD)"	1	285	35	320
"D27"	"N19"	"Benign neoplasm of ovary"	"Unspecified kidney failure"	1	153	32	185
"D27"	"O72"	"Benign neoplasm of ovary"	"Postpartum hemorrhage"	1	1680	611	2291
"D28"	"A41"	"Benign neoplasm of other and unsp female genital organs"	"Other sepsis"	1	59	0	59
"D28"	"C34"	"Benign neoplasm of other and unsp female genital organs"	"Malignant neoplasm of bronchus and lung"	1	54	0	54
"D28"	"D25"	"Benign neoplasm of other and unsp female genital organs"	"Leiomyoma of uterus"	1	539	372	911
"D28"	"E11"	"Benign neoplasm of other and unsp female genital organs"	"Type 2 diabetes mellitus"	1	111	21	132
"D28"	"I50"	"Benign neoplasm of other and unsp female genital organs"	"Heart failure"	1	66	7	73
"D28"	"J96"	"Benign neoplasm of other and unsp female genital organs"	"Respiratory failure, not elsewhere classified"	1	57	0	57
"D28"	"M51"	"Benign neoplasm of other and unsp female genital organs"	"Thoracic, thoracolum, and lumbosacral intvrt disc disorders"	1	146	59	205
"D28"	"M81"	"Benign neoplasm of other and unsp female genital organs"	"Osteoporosis without current pathological fracture"	1	129	5	134
"D28"	"O72"	"Benign neoplasm of other and unsp female genital organs"	"Postpartum hemorrhage"	1	195	96	291
"D29"	"I50"	"Benign neoplasm of male genital organs"	"Heart failure"	1	108	34	142
"D30"	"A04"	"Benign neoplasm of urinary organs"	"Other bacterial intestinal infections"	1	217	15	232
"D30"	"A08"	"Benign neoplasm of urinary organs"	"Viral and other specified intestinal infections"	1	89	28	117
"D30"	"A09"	"Benign neoplasm of urinary organs"	"Infectious gastroenteritis and colitis, unspecified"	1	358	133	491
"D30"	"A41"	"Benign neoplasm of urinary organs"	"Other sepsis"	1	2301	0	2301
"D30"	"A46"	"Benign neoplasm of urinary organs"	"Erysipelas"	1	311	102	413
"D30"	"A49"	"Benign neoplasm of urinary organs"	"Bacterial infection of unspecified site"	1	523	36	559
"D30"	"B02"	"Benign neoplasm of urinary organs"	"Zoster [herpes zoster]"	1	92	28	120
"D30"	"C41"	"Benign neoplasm of urinary organs"	"Malignant neoplasm of bone/artic cartl of and unsp sites"	1	54	12	66
"D30"	"C44"	"Benign neoplasm of urinary organs"	"Other and unspecified malignant neoplasm of skin"	1	446	198	644
"D30"	"C45"	"Benign neoplasm of urinary organs"	"Mesothelioma"	1	30	1	31
"D30"	"C66"	"Benign neoplasm of urinary organs"	"Malignant neoplasm of ureter"	1	273	121	394
"D30"	"C67"	"Benign neoplasm of urinary organs"	"Malignant neoplasm of bladder"	1	3306	2470	5776
"D30"	"C68"	"Benign neoplasm of urinary organs"	"Malignant neoplasm of other and unspecified urinary organs"	1	73	3	76
"D30"	"C83"	"Benign neoplasm of urinary organs"	"Non-follicular lymphoma"	1	93	30	123
"D30"	"C90"	"Benign neoplasm of urinary organs"	"Multiple myeloma and malignant plasma cell neoplasms"	1	71	11	82
"D30"	"C91"	"Benign neoplasm of urinary organs"	"Lymphoid leukemia"	1	72	20	92
"D30"	"C92"	"Benign neoplasm of urinary organs"	"Myeloid leukemia"	1	67	1	68
"D30"	"D09"	"Benign neoplasm of urinary organs"	"Carcinoma in situ of other and unspecified sites"	1	2937	0	2937
"D30"	"D69"	"Benign neoplasm of urinary organs"	"Purpura and other hemorrhagic conditions"	1	113	45	158
"D30"	"E16"	"Benign neoplasm of urinary organs"	"Other disorders of pancreatic internal secretion"	1	136	43	179
"D30"	"E87"	"Benign neoplasm of urinary organs"	"Other disorders of fluid, electrolyte and acid-base balance"	1	771	63	834
"D30"	"F01"	"Benign neoplasm of urinary organs"	"Vascular dementia"	1	111	0	111
"D30"	"F02"	"Benign neoplasm of urinary organs"	"Dementia in other diseases classified elsewhere"	1	33	2	35
"D30"	"F06"	"Benign neoplasm of urinary organs"	"Other mental disorders due to known physiological condition"	1	61	7	68
"D30"	"F33"	"Benign neoplasm of urinary organs"	"Major depressive disorder, recurrent"	1	180	27	207
"D30"	"F41"	"Benign neoplasm of urinary organs"	"Other anxiety disorders"	1	199	27	226
"D30"	"G20"	"Benign neoplasm of urinary organs"	"Parkinson's disease"	1	188	27	215
"D30"	"G31"	"Benign neoplasm of urinary organs"	"Oth degenerative diseases of nervous system, NEC"	1	57	6	63
"D30"	"G45"	"Benign neoplasm of urinary organs"	"Transient cerebral ischemic attacks and related syndromes"	1	463	309	772
"D30"	"H02"	"Benign neoplasm of urinary organs"	"Other disorders of eyelid"	1	214	104	318
"D30"	"I11"	"Benign neoplasm of urinary organs"	"Hypertensive heart disease"	1	191	66	257
"D30"	"I21"	"Benign neoplasm of urinary organs"	"Acute myocardial infarction"	1	901	646	1547
"D30"	"I26"	"Benign neoplasm of urinary organs"	"Pulmonary embolism"	1	361	85	446
"D30"	"I49"	"Benign neoplasm of urinary organs"	"Other cardiac arrhythmias"	1	360	211	571
"D30"	"I71"	"Benign neoplasm of urinary organs"	"Aortic aneurysm and dissection"	1	541	206	747
"D30"	"J13"	"Benign neoplasm of urinary organs"	"Pneumonia due to Streptococcus pneumoniae"	1	75	18	93
"D30"	"J44"	"Benign neoplasm of urinary organs"	"Other chronic obstructive pulmonary disease"	1	1740	701	2441
"D30"	"J84"	"Benign neoplasm of urinary organs"	"Other interstitial pulmonary diseases"	1	140	38	178
"D30"	"J91"	"Benign neoplasm of urinary organs"	"Pleural effusion in conditions classified elsewhere"	1	91	12	103
"D30"	"J93"	"Benign neoplasm of urinary organs"	"Pneumothorax and air leak"	1	139	40	179
"D30"	"J96"	"Benign neoplasm of urinary organs"	"Respiratory failure, not elsewhere classified"	1	1088	46	1134
"D30"	"J98"	"Benign neoplasm of urinary organs"	"Other respiratory disorders"	1	185	64	249
"D30"	"K22"	"Benign neoplasm of urinary organs"	"Other diseases of esophagus"	1	167	82	249
"D30"	"K56"	"Benign neoplasm of urinary organs"	"Paralytic ileus and intestinal obstruction without hernia"	1	547	117	664
"D30"	"K59"	"Benign neoplasm of urinary organs"	"Other functional intestinal disorders"	1	1475	265	1740
"D30"	"K83"	"Benign neoplasm of urinary organs"	"Other diseases of biliary tract"	1	134	39	173
"D30"	"L57"	"Benign neoplasm of urinary organs"	"Skin changes due to chronic expsr to nonionizing radiation"	1	92	23	115
"D30"	"L89"	"Benign neoplasm of urinary organs"	"Pressure ulcer"	1	165	10	175
"D30"	"M10"	"Benign neoplasm of urinary organs"	"Gout"	1	281	100	381
"D30"	"M80"	"Benign neoplasm of urinary organs"	"Osteoporosis with current pathological fracture"	1	410	41	451
"D30"	"N10"	"Benign neoplasm of urinary organs"	"Acute pyelonephritis"	1	353	128	481
"D30"	"N12"	"Benign neoplasm of urinary organs"	"Tubulo-interstitial nephritis, not spcf as acute or chronic"	1	110	25	135
"D30"	"N19"	"Benign neoplasm of urinary organs"	"Unspecified kidney failure"	1	632	76	708
"D30"	"N28"	"Benign neoplasm of urinary organs"	"Oth disorders of kidney and ureter, not elsewhere classified"	1	243	83	326
"D30"	"N35"	"Benign neoplasm of urinary organs"	"Urethral stricture"	1	610	248	858
"D30"	"N45"	"Benign neoplasm of urinary organs"	"Orchitis and epididymitis"	1	279	146	425
"D31"	"A41"	"Benign neoplasm of eye and adnexa"	"Other sepsis"	1	141	34	175
"D31"	"C78"	"Benign neoplasm of eye and adnexa"	"Secondary malignant neoplasm of resp and digestive organs"	1	75	8	83
"D31"	"N39"	"Benign neoplasm of eye and adnexa"	"Other disorders of urinary system"	1	145	67	212
"D32"	"C34"	"Benign neoplasm of meninges"	"Malignant neoplasm of bronchus and lung"	1	136	50	186
"D32"	"E23"	"Benign neoplasm of meninges"	"Hypofunction and other disorders of the pituitary gland"	1	211	65	276
"D32"	"F03"	"Benign neoplasm of meninges"	"Unspecified dementia"	1	196	93	289
"D32"	"G96"	"Benign neoplasm of meninges"	"Other disorders of central nervous system"	1	310	164	474
"D33"	"A41"	"Benign neoplasm of brain and oth prt central nervous system"	"Other sepsis"	1	298	35	333
"D33"	"A46"	"Benign neoplasm of brain and oth prt central nervous system"	"Erysipelas"	1	88	28	116
"D33"	"C34"	"Benign neoplasm of brain and oth prt central nervous system"	"Malignant neoplasm of bronchus and lung"	1	131	40	171
"D33"	"D12"	"Benign neoplasm of brain and oth prt central nervous system"	"Benign neoplasm of colon, rectum, anus and anal canal"	1	149	74	223
"D33"	"D50"	"Benign neoplasm of brain and oth prt central nervous system"	"Iron deficiency anemia"	1	70	19	89
"D33"	"D63"	"Benign neoplasm of brain and oth prt central nervous system"	"Anemia in chronic diseases classified elsewhere"	1	52	3	55
"D33"	"D64"	"Benign neoplasm of brain and oth prt central nervous system"	"Other anemias"	1	193	35	228
"D33"	"E27"	"Benign neoplasm of brain and oth prt central nervous system"	"Other disorders of adrenal gland"	1	69	10	79
"D33"	"E89"	"Benign neoplasm of brain and oth prt central nervous system"	"Postproc endocrine and metabolic comp and disorders, NEC"	1	152	37	189
"D33"	"F06"	"Benign neoplasm of brain and oth prt central nervous system"	"Other mental disorders due to known physiological condition"	1	57	14	71
"D33"	"G47"	"Benign neoplasm of brain and oth prt central nervous system"	"Sleep disorders"	1	206	40	246
"D33"	"G51"	"Benign neoplasm of brain and oth prt central nervous system"	"Facial nerve disorders"	1	260	105	365
"D33"	"G96"	"Benign neoplasm of brain and oth prt central nervous system"	"Other disorders of central nervous system"	1	304	107	411
"D33"	"G97"	"Benign neoplasm of brain and oth prt central nervous system"	"Intraop and postproc comp and disorders of nervous sys, NEC"	1	54	13	67
"D33"	"H02"	"Benign neoplasm of brain and oth prt central nervous system"	"Other disorders of eyelid"	1	302	68	370
"D33"	"H50"	"Benign neoplasm of brain and oth prt central nervous system"	"Other strabismus"	1	146	59	205
"D33"	"H53"	"Benign neoplasm of brain and oth prt central nervous system"	"Visual disturbances"	1	422	127	549
"D33"	"H90"	"Benign neoplasm of brain and oth prt central nervous system"	"Conductive and sensorineural hearing loss"	1	746	398	1144
"D33"	"I35"	"Benign neoplasm of brain and oth prt central nervous system"	"Nonrheumatic aortic valve disorders"	1	86	26	112
"D33"	"I48"	"Benign neoplasm of brain and oth prt central nervous system"	"Atrial fibrillation and flutter"	1	242	120	362
"D33"	"I50"	"Benign neoplasm of brain and oth prt central nervous system"	"Heart failure"	1	210	58	268
"D33"	"I69"	"Benign neoplasm of brain and oth prt central nervous system"	"Sequelae of cerebrovascular disease"	1	398	143	541
"D33"	"J15"	"Benign neoplasm of brain and oth prt central nervous system"	"Bacterial pneumonia, not elsewhere classified"	1	247	24	271
"D33"	"J18"	"Benign neoplasm of brain and oth prt central nervous system"	"Pneumonia, unspecified organism"	1	678	199	877
"D33"	"K64"	"Benign neoplasm of brain and oth prt central nervous system"	"Hemorrhoids and perianal venous thrombosis"	1	70	3	73
"D33"	"K92"	"Benign neoplasm of brain and oth prt central nervous system"	"Other diseases of digestive system"	1	92	24	116
"D33"	"N18"	"Benign neoplasm of brain and oth prt central nervous system"	"Chronic kidney disease (CKD)"	1	69	9	78
"D33"	"N31"	"Benign neoplasm of brain and oth prt central nervous system"	"Neuromuscular dysfunction of bladder, NEC"	1	189	38	227
"D34"	"C73"	"Benign neoplasm of thyroid gland"	"Malignant neoplasm of thyroid gland"	1	183	65	248
"D34"	"C78"	"Benign neoplasm of thyroid gland"	"Secondary malignant neoplasm of resp and digestive organs"	1	68	5	73
"D34"	"E78"	"Benign neoplasm of thyroid gland"	"Disorders of lipoprotein metabolism and other lipidemias"	1	102	40	142
"D34"	"G47"	"Benign neoplasm of thyroid gland"	"Sleep disorders"	1	60	14	74
"D34"	"I48"	"Benign neoplasm of thyroid gland"	"Atrial fibrillation and flutter"	1	118	45	163
"D34"	"I69"	"Benign neoplasm of thyroid gland"	"Sequelae of cerebrovascular disease"	1	55	13	68
"D34"	"J18"	"Benign neoplasm of thyroid gland"	"Pneumonia, unspecified organism"	1	156	67	223
"D34"	"J96"	"Benign neoplasm of thyroid gland"	"Respiratory failure, not elsewhere classified"	1	66	10	76
"D34"	"N39"	"Benign neoplasm of thyroid gland"	"Other disorders of urinary system"	1	114	45	159
"D35"	"A41"	"Benign neoplasm of other and unspecified endocrine glands"	"Other sepsis"	1	416	176	592
"D35"	"E89"	"Benign neoplasm of other and unspecified endocrine glands"	"Postproc endocrine and metabolic comp and disorders, NEC"	1	651	137	788
"D35"	"G47"	"Benign neoplasm of other and unspecified endocrine glands"	"Sleep disorders"	1	269	147	416
"D35"	"H47"	"Benign neoplasm of other and unspecified endocrine glands"	"Other disorders of optic [2nd] nerve and visual pathways"	1	182	78	260
"D35"	"H57"	"Benign neoplasm of other and unspecified endocrine glands"	"Other disorders of eye and adnexa"	1	306	121	427
"D36"	"A41"	"Benign neoplasm of other and unspecified sites"	"Other sepsis"	1	104	8	112
"D36"	"C49"	"Benign neoplasm of other and unspecified sites"	"Malignant neoplasm of other connective and soft tissue"	1	75	11	86
"D36"	"D22"	"Benign neoplasm of other and unspecified sites"	"Melanocytic nevi"	1	129	40	169
"D36"	"E78"	"Benign neoplasm of other and unspecified sites"	"Disorders of lipoprotein metabolism and other lipidemias"	1	127	48	175
"D36"	"I69"	"Benign neoplasm of other and unspecified sites"	"Sequelae of cerebrovascular disease"	1	78	10	88
"D36"	"J44"	"Benign neoplasm of other and unspecified sites"	"Other chronic obstructive pulmonary disease"	1	144	42	186
"D36"	"N30"	"Benign neoplasm of other and unspecified sites"	"Cystitis"	1	116	44	160
"D37"	"C22"	"Neoplasm of uncrt behavior of oral cavity and dgstv organs"	"Malignant neoplasm of liver and intrahepatic bile ducts"	1	164	69	233
"D37"	"C34"	"Neoplasm of uncrt behavior of oral cavity and dgstv organs"	"Malignant neoplasm of bronchus and lung"	1	158	23	181
"D37"	"C77"	"Neoplasm of uncrt behavior of oral cavity and dgstv organs"	"Secondary and unspecified malignant neoplasm of lymph nodes"	1	121	43	164
"D37"	"C78"	"Neoplasm of uncrt behavior of oral cavity and dgstv organs"	"Secondary malignant neoplasm of resp and digestive organs"	1	776	295	1071
"D37"	"D63"	"Neoplasm of uncrt behavior of oral cavity and dgstv organs"	"Anemia in chronic diseases classified elsewhere"	1	229	101	330
"D37"	"E86"	"Neoplasm of uncrt behavior of oral cavity and dgstv organs"	"Volume depletion"	1	453	166	619
"D37"	"F41"	"Neoplasm of uncrt behavior of oral cavity and dgstv organs"	"Other anxiety disorders"	1	108	29	137
"D37"	"K43"	"Neoplasm of uncrt behavior of oral cavity and dgstv organs"	"Ventral hernia"	1	186	50	236
"D38"	"C78"	"Neoplm of uncrt behav of mid ear & resp and intrathorac org"	"Secondary malignant neoplasm of resp and digestive organs"	1	488	234	722
"D38"	"C79"	"Neoplm of uncrt behav of mid ear & resp and intrathorac org"	"Secondary malignant neoplasm of other and unspecified sites"	1	440	297	737
"D38"	"F41"	"Neoplm of uncrt behav of mid ear & resp and intrathorac org"	"Other anxiety disorders"	1	154	38	192
"D39"	"A46"	"Neoplasm of uncertain behavior of female genital organs"	"Erysipelas"	1	40	4	44
"D39"	"C79"	"Neoplasm of uncertain behavior of female genital organs"	"Secondary malignant neoplasm of other and unspecified sites"	1	131	29	160
"D39"	"I50"	"Neoplasm of uncertain behavior of female genital organs"	"Heart failure"	1	126	35	161
"D39"	"I69"	"Neoplasm of uncertain behavior of female genital organs"	"Sequelae of cerebrovascular disease"	1	72	17	89
"D39"	"J96"	"Neoplasm of uncertain behavior of female genital organs"	"Respiratory failure, not elsewhere classified"	1	91	10	101
"D39"	"M17"	"Neoplasm of uncertain behavior of female genital organs"	"Osteoarthritis of knee"	1	109	20	129
"D39"	"M75"	"Neoplasm of uncertain behavior of female genital organs"	"Shoulder lesions"	1	89	21	110
"D39"	"M79"	"Neoplasm of uncertain behavior of female genital organs"	"Oth and unsp soft tissue disorders, not elsewhere classified"	1	110	32	142
"D39"	"N30"	"Neoplasm of uncertain behavior of female genital organs"	"Cystitis"	1	206	71	277
"D39"	"N99"	"Neoplasm of uncertain behavior of female genital organs"	"Intraop and postproc comp and disorders of GU sys, NEC"	1	73	13	86
"D40"	"C62"	"Neoplasm of uncertain behavior of male genital organs"	"Malignant neoplasm of testis"	1	240	69	309
"D41"	"A41"	"Neoplasm of uncertain behavior of urinary organs"	"Other sepsis"	1	285	155	440
"D41"	"C65"	"Neoplasm of uncertain behavior of urinary organs"	"Malignant neoplasm of renal pelvis"	1	207	70	277
"D41"	"D30"	"Neoplasm of uncertain behavior of urinary organs"	"Benign neoplasm of urinary organs"	1	871	539	1410
"D41"	"D63"	"Neoplasm of uncertain behavior of urinary organs"	"Anemia in chronic diseases classified elsewhere"	1	164	49	213
"D41"	"J18"	"Neoplasm of uncertain behavior of urinary organs"	"Pneumonia, unspecified organism"	1	426	219	645
"D43"	"C80"	"Neoplasm of uncertain behavior of brain and cnsl"	"Malignant neoplasm without specification of site"	1	137	57	194
"D43"	"D32"	"Neoplasm of uncertain behavior of brain and cnsl"	"Benign neoplasm of meninges"	1	663	445	1108
"D43"	"E23"	"Neoplasm of uncertain behavior of brain and cnsl"	"Hypofunction and other disorders of the pituitary gland"	1	202	64	266
"D43"	"F05"	"Neoplasm of uncertain behavior of brain and cnsl"	"Delirium due to known physiological condition"	1	114	41	155
"D43"	"G81"	"Neoplasm of uncertain behavior of brain and cnsl"	"Hemiplegia and hemiparesis"	1	100	37	137
"D43"	"J15"	"Neoplasm of uncertain behavior of brain and cnsl"	"Bacterial pneumonia, not elsewhere classified"	1	179	78	257
"D43"	"J18"	"Neoplasm of uncertain behavior of brain and cnsl"	"Pneumonia, unspecified organism"	1	500	332	832
"D45"	"A04"	"Polycythemia vera"	"Other bacterial intestinal infections"	1	38	1	39
"D45"	"C34"	"Polycythemia vera"	"Malignant neoplasm of bronchus and lung"	1	106	12	118
"D45"	"D64"	"Polycythemia vera"	"Other anemias"	1	270	66	336
"D45"	"J18"	"Polycythemia vera"	"Pneumonia, unspecified organism"	1	515	215	730
"D45"	"K92"	"Polycythemia vera"	"Other diseases of digestive system"	1	147	56	203
"D46"	"A41"	"Myelodysplastic syndromes"	"Other sepsis"	1	1049	673	1722
"D46"	"B44"	"Myelodysplastic syndromes"	"Aspergillosis"	1	59	15	74
"D47"	"A04"	"Oth neoplm of uncrt behav of lymphoid, hematpoetc & rel tiss"	"Other bacterial intestinal infections"	1	153	67	220
"D47"	"A41"	"Oth neoplm of uncrt behav of lymphoid, hematpoetc & rel tiss"	"Other sepsis"	1	792	448	1240
"D47"	"C90"	"Oth neoplm of uncrt behav of lymphoid, hematpoetc & rel tiss"	"Multiple myeloma and malignant plasma cell neoplasms"	1	401	253	654
"D47"	"C92"	"Oth neoplm of uncrt behav of lymphoid, hematpoetc & rel tiss"	"Myeloid leukemia"	1	307	176	483
"D47"	"D63"	"Oth neoplm of uncrt behav of lymphoid, hematpoetc & rel tiss"	"Anemia in chronic diseases classified elsewhere"	1	324	195	519
"D47"	"F03"	"Oth neoplm of uncrt behav of lymphoid, hematpoetc & rel tiss"	"Unspecified dementia"	1	229	82	311
"D48"	"A09"	"Neoplasm of uncertain behavior of other and unsp sites"	"Infectious gastroenteritis and colitis, unspecified"	1	126	55	181
"D48"	"C34"	"Neoplasm of uncertain behavior of other and unsp sites"	"Malignant neoplasm of bronchus and lung"	1	302	114	416
"D48"	"C44"	"Neoplasm of uncertain behavior of other and unsp sites"	"Other and unspecified malignant neoplasm of skin"	1	256	108	364
"D48"	"C49"	"Neoplasm of uncertain behavior of other and unsp sites"	"Malignant neoplasm of other connective and soft tissue"	1	234	96	330
"D48"	"C77"	"Neoplasm of uncertain behavior of other and unsp sites"	"Secondary and unspecified malignant neoplasm of lymph nodes"	1	292	102	394
"D48"	"D12"	"Neoplasm of uncertain behavior of other and unsp sites"	"Benign neoplasm of colon, rectum, anus and anal canal"	1	150	11	161
"D48"	"D17"	"Neoplasm of uncertain behavior of other and unsp sites"	"Benign lipomatous neoplasm"	1	254	149	403
"D48"	"D21"	"Neoplasm of uncertain behavior of other and unsp sites"	"Other benign neoplasms of connective and other soft tissue"	1	146	69	215
"D48"	"E66"	"Neoplasm of uncertain behavior of other and unsp sites"	"Overweight and obesity"	1	147	12	159
"D48"	"G56"	"Neoplasm of uncertain behavior of other and unsp sites"	"Mononeuropathies of upper limb"	1	128	4	132
"D48"	"H25"	"Neoplasm of uncertain behavior of other and unsp sites"	"Age-related cataract"	1	374	116	490
"D48"	"H26"	"Neoplasm of uncertain behavior of other and unsp sites"	"Other cataract"	1	121	37	158
"D48"	"I10"	"Neoplasm of uncertain behavior of other and unsp sites"	"Essential (primary) hypertension"	1	652	158	810
"D48"	"I21"	"Neoplasm of uncertain behavior of other and unsp sites"	"Acute myocardial infarction"	1	160	71	231
"D48"	"I47"	"Neoplasm of uncertain behavior of other and unsp sites"	"Paroxysmal tachycardia"	1	94	33	127
"D48"	"I48"	"Neoplasm of uncertain behavior of other and unsp sites"	"Atrial fibrillation and flutter"	1	358	150	508
"D48"	"I63"	"Neoplasm of uncertain behavior of other and unsp sites"	"Cerebral infarction"	1	157	46	203
"D48"	"I69"	"Neoplasm of uncertain behavior of other and unsp sites"	"Sequelae of cerebrovascular disease"	1	193	53	246
"D48"	"I73"	"Neoplasm of uncertain behavior of other and unsp sites"	"Other peripheral vascular diseases"	1	63	6	69
"D48"	"I83"	"Neoplasm of uncertain behavior of other and unsp sites"	"Varicose veins of lower extremities"	1	118	33	151
"D48"	"J18"	"Neoplasm of uncertain behavior of other and unsp sites"	"Pneumonia, unspecified organism"	1	692	200	892
"D48"	"J45"	"Neoplasm of uncertain behavior of other and unsp sites"	"Asthma"	1	138	55	193
"D48"	"K21"	"Neoplasm of uncertain behavior of other and unsp sites"	"Gastro-esophageal reflux disease"	1	136	18	154
"D48"	"K57"	"Neoplasm of uncertain behavior of other and unsp sites"	"Diverticular disease of intestine"	1	190	17	207
"D48"	"M17"	"Neoplasm of uncertain behavior of other and unsp sites"	"Osteoarthritis of knee"	1	212	41	253
"D48"	"M23"	"Neoplasm of uncertain behavior of other and unsp sites"	"Internal derangement of knee"	1	182	12	194
"D48"	"M48"	"Neoplasm of uncertain behavior of other and unsp sites"	"Other spondylopathies"	1	119	12	131
"D48"	"M51"	"Neoplasm of uncertain behavior of other and unsp sites"	"Thoracic, thoracolum, and lumbosacral intvrt disc disorders"	1	173	65	238
"D48"	"M75"	"Neoplasm of uncertain behavior of other and unsp sites"	"Shoulder lesions"	1	181	0	181
"D48"	"M77"	"Neoplasm of uncertain behavior of other and unsp sites"	"Other enthesopathies"	1	46	1	47
"D48"	"M79"	"Neoplasm of uncertain behavior of other and unsp sites"	"Oth and unsp soft tissue disorders, not elsewhere classified"	1	259	41	300
"D48"	"N60"	"Neoplasm of uncertain behavior of other and unsp sites"	"Benign mammary dysplasia"	1	472	139	611
"D48"	"N61"	"Neoplasm of uncertain behavior of other and unsp sites"	"Inflammatory disorders of breast"	1	82	23	105
"D48"	"N81"	"Neoplasm of uncertain behavior of other and unsp sites"	"Female genital prolapse"	1	118	22	140
"D48"	"N92"	"Neoplasm of uncertain behavior of other and unsp sites"	"Excessive, frequent and irregular menstruation"	1	178	70	248
"D48"	"O72"	"Neoplasm of uncertain behavior of other and unsp sites"	"Postpartum hemorrhage"	1	47	0	47
"D50"	"A04"	"Iron deficiency anemia"	"Other bacterial intestinal infections"	1	695	445	1140
"D50"	"C17"	"Iron deficiency anemia"	"Malignant neoplasm of small intestine"	1	207	74	281
"D50"	"C79"	"Iron deficiency anemia"	"Secondary malignant neoplasm of other and unspecified sites"	1	605	264	869
"D50"	"D46"	"Iron deficiency anemia"	"Myelodysplastic syndromes"	1	349	146	495
"D50"	"E41"	"Iron deficiency anemia"	"Nutritional marasmus"	1	166	81	247
"D50"	"E61"	"Iron deficiency anemia"	"Deficiency of other nutrient elements"	1	290	177	467
"D50"	"F05"	"Iron deficiency anemia"	"Delirium due to known physiological condition"	1	755	412	1167
"D50"	"G47"	"Iron deficiency anemia"	"Sleep disorders"	1	579	390	969
"D50"	"J81"	"Iron deficiency anemia"	"Pulmonary edema"	1	595	422	1017
"D50"	"J96"	"Iron deficiency anemia"	"Respiratory failure, not elsewhere classified"	1	2655	1315	3970
"D50"	"K55"	"Iron deficiency anemia"	"Vascular disorders of intestine"	1	901	532	1433
"D50"	"K72"	"Iron deficiency anemia"	"Hepatic failure, not elsewhere classified"	1	413	201	614
"D50"	"N18"	"Iron deficiency anemia"	"Chronic kidney disease (CKD)"	1	2170	1534	3704
"D50"	"N19"	"Iron deficiency anemia"	"Unspecified kidney failure"	1	1113	720	1833
"D51"	"A04"	"Vitamin B12 deficiency anemia"	"Other bacterial intestinal infections"	1	168	64	232
"D51"	"A41"	"Vitamin B12 deficiency anemia"	"Other sepsis"	1	935	393	1328
"D51"	"C25"	"Vitamin B12 deficiency anemia"	"Malignant neoplasm of pancreas"	1	45	4	49
"D51"	"C78"	"Vitamin B12 deficiency anemia"	"Secondary malignant neoplasm of resp and digestive organs"	1	184	39	223
"D51"	"C79"	"Vitamin B12 deficiency anemia"	"Secondary malignant neoplasm of other and unspecified sites"	1	118	31	149
"D51"	"L97"	"Vitamin B12 deficiency anemia"	"Non-pressure chronic ulcer of lower limb, NEC"	1	221	125	346
"D51"	"N17"	"Vitamin B12 deficiency anemia"	"Acute kidney failure"	1	227	70	297
"D53"	"C92"	"Other nutritional anemias"	"Myeloid leukemia"	1	55	14	69
"D59"	"J15"	"Acquired hemolytic anemia"	"Bacterial pneumonia, not elsewhere classified"	1	251	143	394
"D61"	"J10"	"Oth aplastic anemias and other bone marrow failure syndromes"	"Influenza due to other identified influenza virus"	1	48	9	57
"D62"	"A49"	"Acute posthemorrhagic anemia"	"Bacterial infection of unspecified site"	1	688	433	1121
"D62"	"C34"	"Acute posthemorrhagic anemia"	"Malignant neoplasm of bronchus and lung"	1	349	176	525
"D62"	"E86"	"Acute posthemorrhagic anemia"	"Volume depletion"	1	1993	1684	3677
"D62"	"J96"	"Acute posthemorrhagic anemia"	"Respiratory failure, not elsewhere classified"	1	1378	964	2342
"D63"	"F41"	"Anemia in chronic diseases classified elsewhere"	"Other anxiety disorders"	1	1129	254	1383
"D63"	"G47"	"Anemia in chronic diseases classified elsewhere"	"Sleep disorders"	1	1003	307	1310
"D63"	"J69"	"Anemia in chronic diseases classified elsewhere"	"Pneumonitis due to solids and liquids"	1	148	70	218
"D64"	"A04"	"Other anemias"	"Other bacterial intestinal infections"	1	2545	1549	4094
"D64"	"A41"	"Other anemias"	"Other sepsis"	1	12032	8331	20363
"D64"	"B95"	"Other anemias"	"Strep as the cause of diseases classified elsewhere"	1	257	144	401
"D64"	"C78"	"Other anemias"	"Secondary malignant neoplasm of resp and digestive organs"	1	3479	3059	6538
"D64"	"C92"	"Other anemias"	"Myeloid leukemia"	1	1242	823	2065
"D64"	"D46"	"Other anemias"	"Myelodysplastic syndromes"	1	2559	1041	3600
"D64"	"D59"	"Other anemias"	"Acquired hemolytic anemia"	1	860	618	1478
"D64"	"E41"	"Other anemias"	"Nutritional marasmus"	1	616	338	954
"D64"	"F41"	"Other anemias"	"Other anxiety disorders"	1	2082	1021	3103
"D64"	"J69"	"Other anemias"	"Pneumonitis due to solids and liquids"	1	1318	548	1866
"D64"	"K63"	"Other anemias"	"Other diseases of intestine"	1	1432	1118	2550
"D64"	"K64"	"Other anemias"	"Hemorrhoids and perianal venous thrombosis"	1	1143	516	1659
"D64"	"K72"	"Other anemias"	"Hepatic failure, not elsewhere classified"	1	1355	754	2109
"D64"	"L89"	"Other anemias"	"Pressure ulcer"	1	2181	1549	3730
"D64"	"N08"	"Other anemias"	"Glomerular disorders in diseases classified elsewhere"	1	254	143	397
"D64"	"N18"	"Other anemias"	"Chronic kidney disease (CKD)"	1	8529	6737	15266
"D64"	"N19"	"Other anemias"	"Unspecified kidney failure"	1	4650	4088	8738
"D66"	"B18"	"Hereditary factor VIII deficiency"	"Chronic viral hepatitis"	1	49	8	57
"D66"	"K02"	"Hereditary factor VIII deficiency"	"Dental caries"	1	46	9	55
"D68"	"G47"	"Other coagulation defects"	"Sleep disorders"	1	287	134	421
"D68"	"I46"	"Other coagulation defects"	"Cardiac arrest"	1	214	43	257
"D68"	"O72"	"Other coagulation defects"	"Postpartum hemorrhage"	1	1380	754	2134
"D69"	"M85"	"Purpura and other hemorrhagic conditions"	"Other disorders of bone density and structure"	1	196	101	297
"D72"	"D47"	"Other disorders of white blood cells"	"Oth neoplm of uncrt behav of lymphoid, hematpoetc & rel tiss"	1	190	77	267
"D75"	"C34"	"Other and unsp diseases of blood and blood-forming organs"	"Malignant neoplasm of bronchus and lung"	1	193	31	224
"D75"	"C78"	"Other and unsp diseases of blood and blood-forming organs"	"Secondary malignant neoplasm of resp and digestive organs"	1	135	25	160
"D75"	"C92"	"Other and unsp diseases of blood and blood-forming organs"	"Myeloid leukemia"	1	170	53	223
"D75"	"D47"	"Other and unsp diseases of blood and blood-forming organs"	"Oth neoplm of uncrt behav of lymphoid, hematpoetc & rel tiss"	1	918	332	1250
"D75"	"E87"	"Other and unsp diseases of blood and blood-forming organs"	"Other disorders of fluid, electrolyte and acid-base balance"	1	270	161	431
"D76"	"C96"	"Oth dis with lymphoreticular and reticulohistiocytic tissue"	"Oth & unsp malig neoplm of lymphoid, hematpoetc and rel tiss"	1	53	9	62
"D86"	"A41"	"Sarcoidosis"	"Other sepsis"	1	297	61	358
"D86"	"B44"	"Sarcoidosis"	"Aspergillosis"	1	39	0	39
"D86"	"C79"	"Sarcoidosis"	"Secondary malignant neoplasm of other and unspecified sites"	1	79	12	91
"D86"	"G62"	"Sarcoidosis"	"Other and unspecified polyneuropathies"	1	129	35	164
"D86"	"H01"	"Sarcoidosis"	"Other inflammation of eyelid"	1	51	11	62
"D86"	"I35"	"Sarcoidosis"	"Nonrheumatic aortic valve disorders"	1	153	41	194
"D86"	"I51"	"Sarcoidosis"	"Complications and ill-defined descriptions of heart disease"	1	70	18	88
"D86"	"J18"	"Sarcoidosis"	"Pneumonia, unspecified organism"	1	795	507	1302
"D86"	"J47"	"Sarcoidosis"	"Bronchiectasis"	1	91	14	105
"D86"	"J86"	"Sarcoidosis"	"Pyothorax"	1	124	36	160
"D86"	"M81"	"Sarcoidosis"	"Osteoporosis without current pathological fracture"	1	501	77	578
"D86"	"N18"	"Sarcoidosis"	"Chronic kidney disease (CKD)"	1	251	97	348
"D86"	"N39"	"Sarcoidosis"	"Other disorders of urinary system"	1	297	125	422
"E01"	"E03"	"Iodine-deficiency related thyroid disorders and allied cond"	"Other hypothyroidism"	1	140	19	159
"E01"	"J38"	"Iodine-deficiency related thyroid disorders and allied cond"	"Diseases of vocal cords and larynx, not elsewhere classified"	1	54	9	63
"E03"	"A04"	"Other hypothyroidism"	"Other bacterial intestinal infections"	1	521	308	829
"E03"	"A41"	"Other hypothyroidism"	"Other sepsis"	1	2573	1252	3825
"E03"	"C34"	"Other hypothyroidism"	"Malignant neoplasm of bronchus and lung"	1	744	303	1047
"E03"	"C78"	"Other hypothyroidism"	"Secondary malignant neoplasm of resp and digestive organs"	1	893	320	1213
"E03"	"E41"	"Other hypothyroidism"	"Nutritional marasmus"	1	139	55	194
"E03"	"E86"	"Other hypothyroidism"	"Volume depletion"	1	4092	2457	6549
"E03"	"E87"	"Other hypothyroidism"	"Other disorders of fluid, electrolyte and acid-base balance"	1	2236	1685	3921
"E03"	"F01"	"Other hypothyroidism"	"Vascular dementia"	1	415	229	644
"E03"	"F05"	"Other hypothyroidism"	"Delirium due to known physiological condition"	1	724	343	1067
"E03"	"G96"	"Other hypothyroidism"	"Other disorders of central nervous system"	1	640	344	984
"E03"	"J22"	"Other hypothyroidism"	"Unspecified acute lower respiratory infection"	1	298	166	464
"E03"	"J69"	"Other hypothyroidism"	"Pneumonitis due to solids and liquids"	1	320	88	408
"E03"	"J81"	"Other hypothyroidism"	"Pulmonary edema"	1	500	248	748
"E03"	"J96"	"Other hypothyroidism"	"Respiratory failure, not elsewhere classified"	1	2294	987	3281
"E03"	"N28"	"Other hypothyroidism"	"Oth disorders of kidney and ureter, not elsewhere classified"	1	353	204	557
"E04"	"A41"	"Other nontoxic goiter"	"Other sepsis"	1	1080	125	1205
"E04"	"A46"	"Other nontoxic goiter"	"Erysipelas"	1	484	181	665
"E04"	"A49"	"Other nontoxic goiter"	"Bacterial infection of unspecified site"	1	496	70	566
"E04"	"B96"	"Other nontoxic goiter"	"Oth bacterial agents as the cause of diseases classd elswhr"	1	75	8	83
"E04"	"C16"	"Other nontoxic goiter"	"Malignant neoplasm of stomach"	1	97	24	121
"E04"	"C22"	"Other nontoxic goiter"	"Malignant neoplasm of liver and intrahepatic bile ducts"	1	76	1	77
"E04"	"C34"	"Other nontoxic goiter"	"Malignant neoplasm of bronchus and lung"	1	845	97	942
"E04"	"C49"	"Other nontoxic goiter"	"Malignant neoplasm of other connective and soft tissue"	1	82	20	102
"E04"	"C71"	"Other nontoxic goiter"	"Malignant neoplasm of brain"	1	105	16	121
"E04"	"C78"	"Other nontoxic goiter"	"Secondary malignant neoplasm of resp and digestive organs"	1	886	33	919
"E04"	"C79"	"Other nontoxic goiter"	"Secondary malignant neoplasm of other and unspecified sites"	1	624	21	645
"E04"	"C90"	"Other nontoxic goiter"	"Multiple myeloma and malignant plasma cell neoplasms"	1	85	16	101
"E04"	"C92"	"Other nontoxic goiter"	"Myeloid leukemia"	1	64	10	74
"E04"	"D09"	"Other nontoxic goiter"	"Carcinoma in situ of other and unspecified sites"	1	48	5	53
"E04"	"D12"	"Other nontoxic goiter"	"Benign neoplasm of colon, rectum, anus and anal canal"	1	1371	350	1721
"E04"	"D46"	"Other nontoxic goiter"	"Myelodysplastic syndromes"	1	43	6	49
"E04"	"D64"	"Other nontoxic goiter"	"Other anemias"	1	1224	347	1571
"E04"	"E16"	"Other nontoxic goiter"	"Other disorders of pancreatic internal secretion"	1	165	72	237
"E04"	"E20"	"Other nontoxic goiter"	"Hypoparathyroidism"	1	194	29	223
"E04"	"E41"	"Other nontoxic goiter"	"Nutritional marasmus"	1	39	0	39
"E04"	"E55"	"Other nontoxic goiter"	"Vitamin D deficiency"	1	369	120	489
"E04"	"E78"	"Other nontoxic goiter"	"Disorders of lipoprotein metabolism and other lipidemias"	1	1840	786	2626
"E04"	"E83"	"Other nontoxic goiter"	"Disorders of mineral metabolism"	1	560	127	687
"E04"	"E88"	"Other nontoxic goiter"	"Other and unspecified metabolic disorders"	1	170	59	229
"E04"	"E89"	"Other nontoxic goiter"	"Postproc endocrine and metabolic comp and disorders, NEC"	1	3481	0	3481
"E04"	"F03"	"Other nontoxic goiter"	"Unspecified dementia"	1	587	15	602
"E04"	"F05"	"Other nontoxic goiter"	"Delirium due to known physiological condition"	1	244	0	244
"E04"	"F17"	"Other nontoxic goiter"	"Nicotine dependence"	1	416	176	592
"E04"	"F33"	"Other nontoxic goiter"	"Major depressive disorder, recurrent"	1	422	92	514
"E04"	"F41"	"Other nontoxic goiter"	"Other anxiety disorders"	1	453	125	578
"E04"	"F43"	"Other nontoxic goiter"	"Reaction to severe stress, and adjustment disorders"	1	252	141	393
"E04"	"G31"	"Other nontoxic goiter"	"Oth degenerative diseases of nervous system, NEC"	1	59	5	64
"E04"	"G45"	"Other nontoxic goiter"	"Transient cerebral ischemic attacks and related syndromes"	1	568	354	922
"E04"	"G95"	"Other nontoxic goiter"	"Other and unspecified diseases of spinal cord"	1	160	13	173
"E04"	"G98"	"Other nontoxic goiter"	"Other disorders of nervous system not elsewhere classified"	1	153	23	176
"E04"	"H25"	"Other nontoxic goiter"	"Age-related cataract"	1	2734	963	3697
"E04"	"H26"	"Other nontoxic goiter"	"Other cataract"	1	755	279	1034
"E04"	"H54"	"Other nontoxic goiter"	"Blindness and low vision"	1	108	34	142
"E04"	"I25"	"Other nontoxic goiter"	"Chronic ischemic heart disease"	1	1425	970	2395
"E04"	"I26"	"Other nontoxic goiter"	"Pulmonary embolism"	1	474	184	658
"E04"	"I27"	"Other nontoxic goiter"	"Other pulmonary heart diseases"	1	176	44	220
"E04"	"I34"	"Other nontoxic goiter"	"Nonrheumatic mitral valve disorders"	1	330	92	422
"E04"	"I35"	"Other nontoxic goiter"	"Nonrheumatic aortic valve disorders"	1	768	122	890
"E04"	"I61"	"Other nontoxic goiter"	"Nontraumatic intracerebral hemorrhage"	1	239	45	284
"E04"	"I67"	"Other nontoxic goiter"	"Other cerebrovascular diseases"	1	126	58	184
"E04"	"I69"	"Other nontoxic goiter"	"Sequelae of cerebrovascular disease"	1	1002	273	1275
"E04"	"I71"	"Other nontoxic goiter"	"Aortic aneurysm and dissection"	1	279	78	357
"E04"	"I73"	"Other nontoxic goiter"	"Other peripheral vascular diseases"	1	469	156	625
"E04"	"I89"	"Other nontoxic goiter"	"Oth noninfective disorders of lymphatic vessels and nodes"	1	177	46	223
"E04"	"J15"	"Other nontoxic goiter"	"Bacterial pneumonia, not elsewhere classified"	1	1082	145	1227
"E04"	"J22"	"Other nontoxic goiter"	"Unspecified acute lower respiratory infection"	1	158	6	164
"E04"	"J38"	"Other nontoxic goiter"	"Diseases of vocal cords and larynx, not elsewhere classified"	1	1315	693	2008
"E04"	"J47"	"Other nontoxic goiter"	"Bronchiectasis"	1	162	18	180
"E04"	"J69"	"Other nontoxic goiter"	"Pneumonitis due to solids and liquids"	1	100	7	107
"E04"	"J81"	"Other nontoxic goiter"	"Pulmonary edema"	1	197	30	227
"E04"	"J90"	"Other nontoxic goiter"	"Pleural effusion, not elsewhere classified"	1	275	48	323
"E04"	"J91"	"Other nontoxic goiter"	"Pleural effusion in conditions classified elsewhere"	1	126	16	142
"E04"	"K59"	"Other nontoxic goiter"	"Other functional intestinal disorders"	1	1917	545	2462
"E04"	"K62"	"Other nontoxic goiter"	"Other diseases of anus and rectum"	1	819	423	1242
"E04"	"K63"	"Other nontoxic goiter"	"Other diseases of intestine"	1	202	55	257
"E04"	"K83"	"Other nontoxic goiter"	"Other diseases of biliary tract"	1	165	61	226
"E04"	"K92"	"Other nontoxic goiter"	"Other diseases of digestive system"	1	463	141	604
"E04"	"L08"	"Other nontoxic goiter"	"Other local infections of skin and subcutaneous tissue"	1	299	187	486
"E04"	"L89"	"Other nontoxic goiter"	"Pressure ulcer"	1	178	8	186
"E04"	"M10"	"Other nontoxic goiter"	"Gout"	1	261	103	364
"E04"	"M75"	"Other nontoxic goiter"	"Shoulder lesions"	1	1722	1065	2787
"E04"	"M79"	"Other nontoxic goiter"	"Oth and unsp soft tissue disorders, not elsewhere classified"	1	1596	1279	2875
"E04"	"M80"	"Other nontoxic goiter"	"Osteoporosis with current pathological fracture"	1	717	118	835
"E04"	"N17"	"Other nontoxic goiter"	"Acute kidney failure"	1	276	25	301
"E04"	"N18"	"Other nontoxic goiter"	"Chronic kidney disease (CKD)"	1	663	116	779
"E04"	"N19"	"Other nontoxic goiter"	"Unspecified kidney failure"	1	277	59	336
"E04"	"N30"	"Other nontoxic goiter"	"Cystitis"	1	1991	1014	3005
"E04"	"N39"	"Other nontoxic goiter"	"Other disorders of urinary system"	1	1930	667	2597
"E04"	"N95"	"Other nontoxic goiter"	"Menopausal and other perimenopausal disorders"	1	760	377	1137
"E05"	"A41"	"Thyrotoxicosis [hyperthyroidism]"	"Other sepsis"	1	2081	428	2509
"E05"	"A46"	"Thyrotoxicosis [hyperthyroidism]"	"Erysipelas"	1	725	395	1120
"E05"	"A49"	"Thyrotoxicosis [hyperthyroidism]"	"Bacterial infection of unspecified site"	1	816	167	983
"E05"	"C15"	"Thyrotoxicosis [hyperthyroidism]"	"Malignant neoplasm of esophagus"	1	121	31	152
"E05"	"C18"	"Thyrotoxicosis [hyperthyroidism]"	"Malignant neoplasm of colon"	1	596	289	885
"E05"	"C22"	"Thyrotoxicosis [hyperthyroidism]"	"Malignant neoplasm of liver and intrahepatic bile ducts"	1	92	6	98
"E05"	"C24"	"Thyrotoxicosis [hyperthyroidism]"	"Malignant neoplasm of other and unsp parts of biliary tract"	1	65	2	67
"E05"	"C44"	"Thyrotoxicosis [hyperthyroidism]"	"Other and unspecified malignant neoplasm of skin"	1	591	241	832
"E05"	"C61"	"Thyrotoxicosis [hyperthyroidism]"	"Malignant neoplasm of prostate"	1	260	132	392
"E05"	"C79"	"Thyrotoxicosis [hyperthyroidism]"	"Secondary malignant neoplasm of other and unspecified sites"	1	719	63	782
"E05"	"D09"	"Thyrotoxicosis [hyperthyroidism]"	"Carcinoma in situ of other and unspecified sites"	1	60	6	66
"E05"	"D12"	"Thyrotoxicosis [hyperthyroidism]"	"Benign neoplasm of colon, rectum, anus and anal canal"	1	1246	534	1780
"E05"	"D63"	"Thyrotoxicosis [hyperthyroidism]"	"Anemia in chronic diseases classified elsewhere"	1	528	91	619
"E05"	"E20"	"Thyrotoxicosis [hyperthyroidism]"	"Hypoparathyroidism"	1	158	45	203
"E05"	"E34"	"Thyrotoxicosis [hyperthyroidism]"	"Other endocrine disorders"	1	334	125	459
"E05"	"E53"	"Thyrotoxicosis [hyperthyroidism]"	"Deficiency of other B group vitamins"	1	202	73	275
"E05"	"E55"	"Thyrotoxicosis [hyperthyroidism]"	"Vitamin D deficiency"	1	648	317	965
"E05"	"E88"	"Thyrotoxicosis [hyperthyroidism]"	"Other and unspecified metabolic disorders"	1	278	114	392
"E05"	"F01"	"Thyrotoxicosis [hyperthyroidism]"	"Vascular dementia"	1	378	82	460
"E05"	"F03"	"Thyrotoxicosis [hyperthyroidism]"	"Unspecified dementia"	1	1611	376	1987
"E05"	"F05"	"Thyrotoxicosis [hyperthyroidism]"	"Delirium due to known physiological condition"	1	593	80	673
"E05"	"F17"	"Thyrotoxicosis [hyperthyroidism]"	"Nicotine dependence"	1	439	223	662
"E05"	"F33"	"Thyrotoxicosis [hyperthyroidism]"	"Major depressive disorder, recurrent"	1	680	245	925
"E05"	"G62"	"Thyrotoxicosis [hyperthyroidism]"	"Other and unspecified polyneuropathies"	1	340	178	518
"E05"	"H05"	"Thyrotoxicosis [hyperthyroidism]"	"Disorders of orbit"	1	1466	745	2211
"E05"	"H25"	"Thyrotoxicosis [hyperthyroidism]"	"Age-related cataract"	1	3725	2394	6119
"E05"	"H50"	"Thyrotoxicosis [hyperthyroidism]"	"Other strabismus"	1	625	314	939
"E05"	"H57"	"Thyrotoxicosis [hyperthyroidism]"	"Other disorders of eye and adnexa"	1	510	187	697
"E05"	"I69"	"Thyrotoxicosis [hyperthyroidism]"	"Sequelae of cerebrovascular disease"	1	2137	1082	3219
"E05"	"J22"	"Thyrotoxicosis [hyperthyroidism]"	"Unspecified acute lower respiratory infection"	1	291	77	368
"E05"	"J47"	"Thyrotoxicosis [hyperthyroidism]"	"Bronchiectasis"	1	115	39	154
"E05"	"J94"	"Thyrotoxicosis [hyperthyroidism]"	"Other pleural conditions"	1	216	85	301
"E05"	"K55"	"Thyrotoxicosis [hyperthyroidism]"	"Vascular disorders of intestine"	1	158	47	205
"E05"	"K56"	"Thyrotoxicosis [hyperthyroidism]"	"Paralytic ileus and intestinal obstruction without hernia"	1	694	309	1003
"E05"	"K57"	"Thyrotoxicosis [hyperthyroidism]"	"Diverticular disease of intestine"	1	1389	769	2158
"E05"	"K62"	"Thyrotoxicosis [hyperthyroidism]"	"Other diseases of anus and rectum"	1	988	615	1603
"E05"	"K72"	"Thyrotoxicosis [hyperthyroidism]"	"Hepatic failure, not elsewhere classified"	1	105	34	139
"E05"	"K92"	"Thyrotoxicosis [hyperthyroidism]"	"Other diseases of digestive system"	1	995	371	1366
"E05"	"L57"	"Thyrotoxicosis [hyperthyroidism]"	"Skin changes due to chronic expsr to nonionizing radiation"	1	147	36	183
"E05"	"L98"	"Thyrotoxicosis [hyperthyroidism]"	"Oth disorders of skin, subcu, not elsewhere classified"	1	425	160	585
"E05"	"M48"	"Thyrotoxicosis [hyperthyroidism]"	"Other spondylopathies"	1	796	438	1234
"E05"	"M81"	"Thyrotoxicosis [hyperthyroidism]"	"Osteoporosis without current pathological fracture"	1	3210	1638	4848
"E05"	"N13"	"Thyrotoxicosis [hyperthyroidism]"	"Obstructive and reflux uropathy"	1	362	190	552
"E05"	"N19"	"Thyrotoxicosis [hyperthyroidism]"	"Unspecified kidney failure"	1	522	156	678
"E06"	"A41"	"Thyroiditis"	"Other sepsis"	1	134	51	185
"E06"	"I69"	"Thyroiditis"	"Sequelae of cerebrovascular disease"	1	128	52	180
"E06"	"J96"	"Thyroiditis"	"Respiratory failure, not elsewhere classified"	1	126	43	169
"E06"	"N39"	"Thyroiditis"	"Other disorders of urinary system"	1	262	149	411
"E07"	"E89"	"Other disorders of thyroid"	"Postproc endocrine and metabolic comp and disorders, NEC"	1	83	25	108
"E10"	"A04"	"Type 1 diabetes mellitus"	"Other bacterial intestinal infections"	1	1039	244	1283
"E10"	"A08"	"Type 1 diabetes mellitus"	"Viral and other specified intestinal infections"	1	893	415	1308
"E10"	"A09"	"Type 1 diabetes mellitus"	"Infectious gastroenteritis and colitis, unspecified"	1	2947	1487	4434
"E10"	"A26"	"Type 1 diabetes mellitus"	"Erysipeloid"	1	120	9	129
"E10"	"A40"	"Type 1 diabetes mellitus"	"Streptococcal sepsis"	1	398	184	582
"E10"	"A41"	"Type 1 diabetes mellitus"	"Other sepsis"	1	9464	0	9464
"E10"	"A49"	"Type 1 diabetes mellitus"	"Bacterial infection of unspecified site"	1	3049	0	3049
"E10"	"A63"	"Type 1 diabetes mellitus"	"Oth predominantly sexually transmitted diseases, NEC"	1	310	140	450
"E10"	"B37"	"Type 1 diabetes mellitus"	"Candidiasis"	1	907	502	1409
"E10"	"B95"	"Type 1 diabetes mellitus"	"Strep as the cause of diseases classified elsewhere"	1	198	38	236
"E10"	"B96"	"Type 1 diabetes mellitus"	"Oth bacterial agents as the cause of diseases classd elswhr"	1	288	51	339
"E10"	"C16"	"Type 1 diabetes mellitus"	"Malignant neoplasm of stomach"	1	245	128	373
"E10"	"C22"	"Type 1 diabetes mellitus"	"Malignant neoplasm of liver and intrahepatic bile ducts"	1	398	122	520
"E10"	"C34"	"Type 1 diabetes mellitus"	"Malignant neoplasm of bronchus and lung"	1	1383	498	1881
"E10"	"C44"	"Type 1 diabetes mellitus"	"Other and unspecified malignant neoplasm of skin"	1	923	576	1499
"E10"	"C77"	"Type 1 diabetes mellitus"	"Secondary and unspecified malignant neoplasm of lymph nodes"	1	487	230	717
"E10"	"C78"	"Type 1 diabetes mellitus"	"Secondary malignant neoplasm of resp and digestive organs"	1	1863	717	2580
"E10"	"D09"	"Type 1 diabetes mellitus"	"Carcinoma in situ of other and unspecified sites"	1	111	31	142
"E10"	"D10"	"Type 1 diabetes mellitus"	"Benign neoplasm of mouth and pharynx"	1	228	132	360
"E10"	"D12"	"Type 1 diabetes mellitus"	"Benign neoplasm of colon, rectum, anus and anal canal"	1	1614	1032	2646
"E10"	"D22"	"Type 1 diabetes mellitus"	"Melanocytic nevi"	1	209	46	255
"E10"	"D62"	"Type 1 diabetes mellitus"	"Acute posthemorrhagic anemia"	1	943	448	1391
"E10"	"D64"	"Type 1 diabetes mellitus"	"Other anemias"	1	5794	2506	8300
"E10"	"E03"	"Type 1 diabetes mellitus"	"Other hypothyroidism"	1	1973	1389	3362
"E10"	"E27"	"Type 1 diabetes mellitus"	"Other disorders of adrenal gland"	1	278	121	399
"E10"	"E41"	"Type 1 diabetes mellitus"	"Nutritional marasmus"	1	157	24	181
"E10"	"E64"	"Type 1 diabetes mellitus"	"Sequelae of malnutrition and other nutritional deficiencies"	1	571	220	791
"E10"	"E70"	"Type 1 diabetes mellitus"	"Disorders of aromatic amino-acid metabolism"	1	205	76	281
"E10"	"E72"	"Type 1 diabetes mellitus"	"Other disorders of amino-acid metabolism"	1	137	29	166
"E10"	"E83"	"Type 1 diabetes mellitus"	"Disorders of mineral metabolism"	1	658	225	883
"E10"	"E86"	"Type 1 diabetes mellitus"	"Volume depletion"	1	8630	0	8630
"E10"	"F02"	"Type 1 diabetes mellitus"	"Dementia in other diseases classified elsewhere"	1	164	50	214
"E10"	"F03"	"Type 1 diabetes mellitus"	"Unspecified dementia"	1	2348	866	3214
"E10"	"F32"	"Type 1 diabetes mellitus"	"Depressive episode"	1	1852	1261	3113
"E10"	"F33"	"Type 1 diabetes mellitus"	"Major depressive disorder, recurrent"	1	957	443	1400
"E10"	"G20"	"Type 1 diabetes mellitus"	"Parkinson's disease"	1	432	245	677
"E10"	"G25"	"Type 1 diabetes mellitus"	"Other extrapyramidal and movement disorders"	1	197	90	287
"E10"	"G56"	"Type 1 diabetes mellitus"	"Mononeuropathies of upper limb"	1	1823	987	2810
"E10"	"G63"	"Type 1 diabetes mellitus"	"Polyneuropathy in diseases classified elsewhere"	1	1232	194	1426
"E10"	"G90"	"Type 1 diabetes mellitus"	"Disorders of autonomic nervous system"	1	119	51	170
"E10"	"G93"	"Type 1 diabetes mellitus"	"Other disorders of brain"	1	330	135	465
"E10"	"G95"	"Type 1 diabetes mellitus"	"Other and unspecified diseases of spinal cord"	1	288	152	440
"E10"	"H01"	"Type 1 diabetes mellitus"	"Other inflammation of eyelid"	1	138	55	193
"E10"	"H16"	"Type 1 diabetes mellitus"	"Keratitis"	1	272	127	399
"E10"	"H25"	"Type 1 diabetes mellitus"	"Age-related cataract"	1	7299	4128	11427
"E10"	"H26"	"Type 1 diabetes mellitus"	"Other cataract"	1	2586	878	3464
"E10"	"H28"	"Type 1 diabetes mellitus"	"Cataract in diseases classified elsewhere"	1	477	183	660
"E10"	"H34"	"Type 1 diabetes mellitus"	"Retinal vascular occlusions"	1	399	226	625
"E10"	"H35"	"Type 1 diabetes mellitus"	"Other retinal disorders"	1	2762	1372	4134
"E10"	"H36"	"Type 1 diabetes mellitus"	"Retinal disorders in diseases classified elsewhere"	1	15896	0	15896
"E10"	"H49"	"Type 1 diabetes mellitus"	"Paralytic strabismus"	1	210	110	320
"E10"	"H53"	"Type 1 diabetes mellitus"	"Visual disturbances"	1	596	357	953
"E10"	"H57"	"Type 1 diabetes mellitus"	"Other disorders of eye and adnexa"	1	821	35	856
"E10"	"H60"	"Type 1 diabetes mellitus"	"Otitis externa"	1	284	175	459
"E10"	"I11"	"Type 1 diabetes mellitus"	"Hypertensive heart disease"	1	1517	1216	2733
"E10"	"I35"	"Type 1 diabetes mellitus"	"Nonrheumatic aortic valve disorders"	1	1926	967	2893
"E10"	"I38"	"Type 1 diabetes mellitus"	"Endocarditis, valve unspecified"	1	178	40	218
"E10"	"I46"	"Type 1 diabetes mellitus"	"Cardiac arrest"	1	2156	0	2156
"E10"	"I61"	"Type 1 diabetes mellitus"	"Nontraumatic intracerebral hemorrhage"	1	892	638	1530
"E10"	"I69"	"Type 1 diabetes mellitus"	"Sequelae of cerebrovascular disease"	1	5267	3225	8492
"E10"	"I73"	"Type 1 diabetes mellitus"	"Other peripheral vascular diseases"	1	2606	1175	3781
"E10"	"I82"	"Type 1 diabetes mellitus"	"Other venous embolism and thrombosis"	1	325	182	507
"E10"	"I95"	"Type 1 diabetes mellitus"	"Hypotension"	1	1350	354	1704
"E10"	"J06"	"Type 1 diabetes mellitus"	"Acute upper resp infections of multiple and unsp sites"	1	328	53	381
"E10"	"J09"	"Type 1 diabetes mellitus"	"Influenza due to certain identified influenza viruses"	1	146	0	146
"E10"	"J10"	"Type 1 diabetes mellitus"	"Influenza due to other identified influenza virus"	1	143	1	144
"E10"	"J69"	"Type 1 diabetes mellitus"	"Pneumonitis due to solids and liquids"	1	621	102	723
"E10"	"J90"	"Type 1 diabetes mellitus"	"Pleural effusion, not elsewhere classified"	1	1069	251	1320
"E10"	"J91"	"Type 1 diabetes mellitus"	"Pleural effusion in conditions classified elsewhere"	1	454	133	587
"E10"	"J96"	"Type 1 diabetes mellitus"	"Respiratory failure, not elsewhere classified"	1	5969	0	5969
"E10"	"K02"	"Type 1 diabetes mellitus"	"Dental caries"	1	505	226	731
"E10"	"K05"	"Type 1 diabetes mellitus"	"Gingivitis and periodontal diseases"	1	593	302	895
"E10"	"K31"	"Type 1 diabetes mellitus"	"Other diseases of stomach and duodenum"	1	512	177	689
"E10"	"K55"	"Type 1 diabetes mellitus"	"Vascular disorders of intestine"	1	511	167	678
"E10"	"K64"	"Type 1 diabetes mellitus"	"Hemorrhoids and perianal venous thrombosis"	1	460	19	479
"E10"	"K65"	"Type 1 diabetes mellitus"	"Peritonitis"	1	932	581	1513
"E10"	"K72"	"Type 1 diabetes mellitus"	"Hepatic failure, not elsewhere classified"	1	634	344	978
"E10"	"K92"	"Type 1 diabetes mellitus"	"Other diseases of digestive system"	1	2541	1514	4055
"E10"	"L14"	"Type 1 diabetes mellitus"	"Bullous disorders in diseases classified elsewhere"	1	34	4	38
"E10"	"L21"	"Type 1 diabetes mellitus"	"Seborrheic dermatitis"	1	168	79	247
"E10"	"L30"	"Type 1 diabetes mellitus"	"Other and unspecified dermatitis"	1	655	320	975
"E10"	"L60"	"Type 1 diabetes mellitus"	"Nail disorders"	1	390	214	604
"E10"	"L89"	"Type 1 diabetes mellitus"	"Pressure ulcer"	1	1987	437	2424
"E10"	"L90"	"Type 1 diabetes mellitus"	"Atrophic disorders of skin"	1	333	157	490
"E10"	"L98"	"Type 1 diabetes mellitus"	"Oth disorders of skin, subcu, not elsewhere classified"	1	1926	702	2628
"E10"	"M00"	"Type 1 diabetes mellitus"	"Pyogenic arthritis"	1	322	173	495
"E10"	"M13"	"Type 1 diabetes mellitus"	"Other arthritis"	1	531	318	849
"E10"	"M14"	"Type 1 diabetes mellitus"	"Arthropathies in other diseases classified elsewhere"	1	601	73	674
"E10"	"M19"	"Type 1 diabetes mellitus"	"Other and unspecified osteoarthritis"	1	1335	915	2250
"E10"	"M46"	"Type 1 diabetes mellitus"	"Other inflammatory spondylopathies"	1	238	108	346
"E10"	"M48"	"Type 1 diabetes mellitus"	"Other spondylopathies"	1	1164	822	1986
"E10"	"M72"	"Type 1 diabetes mellitus"	"Fibroblastic disorders"	1	787	450	1237
"E10"	"M86"	"Type 1 diabetes mellitus"	"Osteomyelitis"	1	928	307	1235
"E10"	"N10"	"Type 1 diabetes mellitus"	"Acute pyelonephritis"	1	935	501	1436
"E10"	"N12"	"Type 1 diabetes mellitus"	"Tubulo-interstitial nephritis, not spcf as acute or chronic"	1	251	67	318
"E10"	"N17"	"Type 1 diabetes mellitus"	"Acute kidney failure"	1	2355	811	3166
"E10"	"N28"	"Type 1 diabetes mellitus"	"Oth disorders of kidney and ureter, not elsewhere classified"	1	999	169	1168
"E10"	"O10"	"Type 1 diabetes mellitus"	"Pre-existing hypertension compl preg/chldbrth"	1	90	20	110
"E10"	"O24"	"Type 1 diabetes mellitus"	"Diabetes in pregnancy, childbirth, and the puerperium"	1	1088	626	1714
"E11"	"A26"	"Type 2 diabetes mellitus"	"Erysipeloid"	1	258	37	295
"E11"	"A40"	"Type 2 diabetes mellitus"	"Streptococcal sepsis"	1	777	329	1106
"E11"	"A46"	"Type 2 diabetes mellitus"	"Erysipelas"	1	4995	3633	8628
"E11"	"B86"	"Type 2 diabetes mellitus"	"Scabies"	1	110	36	146
"E11"	"B96"	"Type 2 diabetes mellitus"	"Oth bacterial agents as the cause of diseases classd elswhr"	1	606	156	762
"E11"	"B99"	"Type 2 diabetes mellitus"	"Other and unspecified infectious diseases"	1	232	103	335
"E11"	"C10"	"Type 2 diabetes mellitus"	"Malignant neoplasm of oropharynx"	1	134	31	165
"E11"	"C13"	"Type 2 diabetes mellitus"	"Malignant neoplasm of hypopharynx"	1	91	29	120
"E11"	"C15"	"Type 2 diabetes mellitus"	"Malignant neoplasm of esophagus"	1	559	179	738
"E11"	"C16"	"Type 2 diabetes mellitus"	"Malignant neoplasm of stomach"	1	704	230	934
"E11"	"C25"	"Type 2 diabetes mellitus"	"Malignant neoplasm of pancreas"	1	1986	921	2907
"E11"	"C38"	"Type 2 diabetes mellitus"	"Malignant neoplasm of heart, mediastinum and pleura"	1	106	36	142
"E11"	"C61"	"Type 2 diabetes mellitus"	"Malignant neoplasm of prostate"	1	1995	1348	3343
"E11"	"C79"	"Type 2 diabetes mellitus"	"Secondary malignant neoplasm of other and unspecified sites"	1	2427	729	3156
"E11"	"C80"	"Type 2 diabetes mellitus"	"Malignant neoplasm without specification of site"	1	602	104	706
"E11"	"C93"	"Type 2 diabetes mellitus"	"Monocytic leukemia"	1	57	14	71
"E11"	"D09"	"Type 2 diabetes mellitus"	"Carcinoma in situ of other and unspecified sites"	1	352	65	417
"E11"	"D12"	"Type 2 diabetes mellitus"	"Benign neoplasm of colon, rectum, anus and anal canal"	1	4843	2989	7832
"E11"	"D47"	"Type 2 diabetes mellitus"	"Oth neoplm of uncrt behav of lymphoid, hematpoetc & rel tiss"	1	621	174	795
"E11"	"D50"	"Type 2 diabetes mellitus"	"Iron deficiency anemia"	1	6435	0	6435
"E11"	"D51"	"Type 2 diabetes mellitus"	"Vitamin B12 deficiency anemia"	1	942	613	1555
"E11"	"D62"	"Type 2 diabetes mellitus"	"Acute posthemorrhagic anemia"	1	2288	808	3096
"E11"	"D63"	"Type 2 diabetes mellitus"	"Anemia in chronic diseases classified elsewhere"	1	3688	0	3688
"E11"	"D65"	"Type 2 diabetes mellitus"	"Disseminated intravascular coagulation"	1	158	65	223
"E11"	"D68"	"Type 2 diabetes mellitus"	"Other coagulation defects"	1	734	458	1192
"E11"	"D69"	"Type 2 diabetes mellitus"	"Purpura and other hemorrhagic conditions"	1	887	538	1425
"E11"	"D72"	"Type 2 diabetes mellitus"	"Other disorders of white blood cells"	1	289	173	462
"E11"	"E10"	"Type 2 diabetes mellitus"	"Type 1 diabetes mellitus"	1	44580	0	44580
"E11"	"E13"	"Type 2 diabetes mellitus"	"Other specified diabetes mellitus"	1	4260	0	4260
"E11"	"E15"	"Type 2 diabetes mellitus"	"Nondiabetic hypoglycemic coma"	1	927	448	1375
"E11"	"E16"	"Type 2 diabetes mellitus"	"Other disorders of pancreatic internal secretion"	1	11555	0	11555
"E11"	"E21"	"Type 2 diabetes mellitus"	"Hyperparathyroidism and other disorders of parathyroid gland"	1	979	634	1613
"E11"	"E25"	"Type 2 diabetes mellitus"	"Adrenogenital disorders"	1	406	72	478
"E11"	"E53"	"Type 2 diabetes mellitus"	"Deficiency of other B group vitamins"	1	687	277	964
"E11"	"E61"	"Type 2 diabetes mellitus"	"Deficiency of other nutrient elements"	1	252	73	325
"E11"	"E63"	"Type 2 diabetes mellitus"	"Other nutritional deficiencies"	1	226	75	301
"E11"	"E72"	"Type 2 diabetes mellitus"	"Other disorders of amino-acid metabolism"	1	173	75	248
"E11"	"E83"	"Type 2 diabetes mellitus"	"Disorders of mineral metabolism"	1	1595	458	2053
"E11"	"E87"	"Type 2 diabetes mellitus"	"Other disorders of fluid, electrolyte and acid-base balance"	1	12377	0	12377
"E11"	"F01"	"Type 2 diabetes mellitus"	"Vascular dementia"	1	1616	340	1956
"E11"	"F03"	"Type 2 diabetes mellitus"	"Unspecified dementia"	1	8157	0	8157
"E11"	"G20"	"Type 2 diabetes mellitus"	"Parkinson's disease"	1	1197	682	1879
"E11"	"G23"	"Type 2 diabetes mellitus"	"Other degenerative diseases of basal ganglia"	1	112	13	125
"E11"	"G25"	"Type 2 diabetes mellitus"	"Other extrapyramidal and movement disorders"	1	525	268	793
"E11"	"G30"	"Type 2 diabetes mellitus"	"Alzheimer's disease"	1	1304	160	1464
"E11"	"G31"	"Type 2 diabetes mellitus"	"Oth degenerative diseases of nervous system, NEC"	1	681	241	922
"E11"	"G62"	"Type 2 diabetes mellitus"	"Other and unspecified polyneuropathies"	1	2387	1334	3721
"E11"	"G93"	"Type 2 diabetes mellitus"	"Other disorders of brain"	1	688	281	969
"E11"	"G95"	"Type 2 diabetes mellitus"	"Other and unspecified diseases of spinal cord"	1	686	290	976
"E11"	"G96"	"Type 2 diabetes mellitus"	"Other disorders of central nervous system"	1	2152	616	2768
"E11"	"H25"	"Type 2 diabetes mellitus"	"Age-related cataract"	1	15421	10309	25730
"E11"	"H26"	"Type 2 diabetes mellitus"	"Other cataract"	1	4083	2553	6636
"E11"	"H28"	"Type 2 diabetes mellitus"	"Cataract in diseases classified elsewhere"	1	537	232	769
"E11"	"H35"	"Type 2 diabetes mellitus"	"Other retinal disorders"	1	5140	3384	8524
"E11"	"H36"	"Type 2 diabetes mellitus"	"Retinal disorders in diseases classified elsewhere"	1	21578	0	21578
"E11"	"H43"	"Type 2 diabetes mellitus"	"Disorders of vitreous body"	1	1934	898	2832
"E11"	"H57"	"Type 2 diabetes mellitus"	"Other disorders of eye and adnexa"	1	977	385	1362
"E11"	"I13"	"Type 2 diabetes mellitus"	"Hypertensive heart and chronic kidney disease"	1	352	148	500
"E11"	"I15"	"Type 2 diabetes mellitus"	"Secondary hypertension"	1	2648	1641	4289
"E11"	"I26"	"Type 2 diabetes mellitus"	"Pulmonary embolism"	1	2495	1769	4264
"E11"	"I33"	"Type 2 diabetes mellitus"	"Acute and subacute endocarditis"	1	674	276	950
"E11"	"I34"	"Type 2 diabetes mellitus"	"Nonrheumatic mitral valve disorders"	1	1653	1269	2922
"E11"	"I35"	"Type 2 diabetes mellitus"	"Nonrheumatic aortic valve disorders"	1	5655	2854	8509
"E11"	"I44"	"Type 2 diabetes mellitus"	"Atrioventricular and left bundle-branch block"	1	3338	1610	4948
"E11"	"I50"	"Type 2 diabetes mellitus"	"Heart failure"	1	19186	16520	35706
"E11"	"I69"	"Type 2 diabetes mellitus"	"Sequelae of cerebrovascular disease"	1	20231	0	20231
"E11"	"I70"	"Type 2 diabetes mellitus"	"Atherosclerosis"	1	9961	6716	16677
"E11"	"I72"	"Type 2 diabetes mellitus"	"Other aneurysm"	1	477	319	796
"E11"	"I73"	"Type 2 diabetes mellitus"	"Other peripheral vascular diseases"	1	5414	2717	8131
"E11"	"I81"	"Type 2 diabetes mellitus"	"Portal vein thrombosis"	1	214	88	302
"E11"	"J09"	"Type 2 diabetes mellitus"	"Influenza due to certain identified influenza viruses"	1	386	44	430
"E11"	"J22"	"Type 2 diabetes mellitus"	"Unspecified acute lower respiratory infection"	1	1380	419	1799
"E11"	"J47"	"Type 2 diabetes mellitus"	"Bronchiectasis"	1	308	124	432
"E11"	"J84"	"Type 2 diabetes mellitus"	"Other interstitial pulmonary diseases"	1	964	611	1575
"E11"	"J96"	"Type 2 diabetes mellitus"	"Respiratory failure, not elsewhere classified"	1	12964	0	12964
"E11"	"K22"	"Type 2 diabetes mellitus"	"Other diseases of esophagus"	1	1258	854	2112
"E11"	"K28"	"Type 2 diabetes mellitus"	"Gastrojejunal ulcer"	1	326	167	493
"E11"	"K55"	"Type 2 diabetes mellitus"	"Vascular disorders of intestine"	1	1006	248	1254
"E11"	"K57"	"Type 2 diabetes mellitus"	"Diverticular disease of intestine"	1	4863	4112	8975
"E11"	"K64"	"Type 2 diabetes mellitus"	"Hemorrhoids and perianal venous thrombosis"	1	1533	205	1738
"E11"	"K72"	"Type 2 diabetes mellitus"	"Hepatic failure, not elsewhere classified"	1	1322	446	1768
"E11"	"K74"	"Type 2 diabetes mellitus"	"Fibrosis and cirrhosis of liver"	1	1598	845	2443
"E11"	"K82"	"Type 2 diabetes mellitus"	"Other diseases of gallbladder"	1	149	69	218
"E11"	"K83"	"Type 2 diabetes mellitus"	"Other diseases of biliary tract"	1	1472	977	2449
"E11"	"L12"	"Type 2 diabetes mellitus"	"Pemphigoid"	1	187	73	260
"E11"	"L28"	"Type 2 diabetes mellitus"	"Lichen simplex chronicus and prurigo"	1	335	198	533
"E11"	"L29"	"Type 2 diabetes mellitus"	"Pruritus"	1	365	158	523
"E11"	"L57"	"Type 2 diabetes mellitus"	"Skin changes due to chronic expsr to nonionizing radiation"	1	585	143	728
"E11"	"L82"	"Type 2 diabetes mellitus"	"Seborrheic keratosis"	1	355	126	481
"E11"	"L89"	"Type 2 diabetes mellitus"	"Pressure ulcer"	1	3929	0	3929
"E11"	"M10"	"Type 2 diabetes mellitus"	"Gout"	1	3587	2733	6320
"E11"	"M14"	"Type 2 diabetes mellitus"	"Arthropathies in other diseases classified elsewhere"	1	834	117	951
"E11"	"M48"	"Type 2 diabetes mellitus"	"Other spondylopathies"	1	3180	2275	5455
"E11"	"M85"	"Type 2 diabetes mellitus"	"Other disorders of bone density and structure"	1	1749	654	2403
"E11"	"M86"	"Type 2 diabetes mellitus"	"Osteomyelitis"	1	1149	423	1572
"E11"	"M87"	"Type 2 diabetes mellitus"	"Osteonecrosis"	1	215	115	330
"E11"	"M90"	"Type 2 diabetes mellitus"	"Osteopathies in diseases classified elsewhere"	1	111	34	145
"E11"	"N10"	"Type 2 diabetes mellitus"	"Acute pyelonephritis"	1	1709	1163	2872
"E11"	"N13"	"Type 2 diabetes mellitus"	"Obstructive and reflux uropathy"	1	1775	982	2757
"E11"	"N16"	"Type 2 diabetes mellitus"	"Renal tubulo-interstitial disord in diseases classd elswhr"	1	231	26	257
"E11"	"N17"	"Type 2 diabetes mellitus"	"Acute kidney failure"	1	6119	0	6119
"E11"	"N28"	"Type 2 diabetes mellitus"	"Oth disorders of kidney and ureter, not elsewhere classified"	1	1781	240	2021
"E11"	"N39"	"Type 2 diabetes mellitus"	"Other disorders of urinary system"	1	18868	0	18868
"E13"	"G98"	"Other specified diabetes mellitus"	"Other disorders of nervous system not elsewhere classified"	1	64	17	81
"E13"	"I46"	"Other specified diabetes mellitus"	"Cardiac arrest"	1	160	55	215
"E15"	"I46"	"Nondiabetic hypoglycemic coma"	"Cardiac arrest"	1	99	9	108
"E15"	"L89"	"Nondiabetic hypoglycemic coma"	"Pressure ulcer"	1	92	18	110
"E15"	"L97"	"Nondiabetic hypoglycemic coma"	"Non-pressure chronic ulcer of lower limb, NEC"	1	161	66	227
"E15"	"N39"	"Nondiabetic hypoglycemic coma"	"Other disorders of urinary system"	1	241	124	365
"E16"	"A04"	"Other disorders of pancreatic internal secretion"	"Other bacterial intestinal infections"	1	330	114	444
"E16"	"A49"	"Other disorders of pancreatic internal secretion"	"Bacterial infection of unspecified site"	1	738	280	1018
"E16"	"C34"	"Other disorders of pancreatic internal secretion"	"Malignant neoplasm of bronchus and lung"	1	282	133	415
"E16"	"C79"	"Other disorders of pancreatic internal secretion"	"Secondary malignant neoplasm of other and unspecified sites"	1	172	80	252
"E16"	"E41"	"Other disorders of pancreatic internal secretion"	"Nutritional marasmus"	1	80	16	96
"E16"	"F01"	"Other disorders of pancreatic internal secretion"	"Vascular dementia"	1	218	92	310
"E16"	"F05"	"Other disorders of pancreatic internal secretion"	"Delirium due to known physiological condition"	1	392	152	544
"E16"	"F41"	"Other disorders of pancreatic internal secretion"	"Other anxiety disorders"	1	199	107	306
"E16"	"I61"	"Other disorders of pancreatic internal secretion"	"Nontraumatic intracerebral hemorrhage"	1	243	132	375
"E16"	"J15"	"Other disorders of pancreatic internal secretion"	"Bacterial pneumonia, not elsewhere classified"	1	1178	543	1721
"E16"	"J81"	"Other disorders of pancreatic internal secretion"	"Pulmonary edema"	1	319	181	500
"E16"	"K64"	"Other disorders of pancreatic internal secretion"	"Hemorrhoids and perianal venous thrombosis"	1	123	8	131
"E16"	"L89"	"Other disorders of pancreatic internal secretion"	"Pressure ulcer"	1	585	200	785
"E16"	"L97"	"Other disorders of pancreatic internal secretion"	"Non-pressure chronic ulcer of lower limb, NEC"	1	888	455	1343
"E16"	"N08"	"Other disorders of pancreatic internal secretion"	"Glomerular disorders in diseases classified elsewhere"	1	193	48	241
"E16"	"N17"	"Other disorders of pancreatic internal secretion"	"Acute kidney failure"	1	698	318	1016
"E16"	"N18"	"Other disorders of pancreatic internal secretion"	"Chronic kidney disease (CKD)"	1	1541	717	2258
"E16"	"N19"	"Other disorders of pancreatic internal secretion"	"Unspecified kidney failure"	1	921	432	1353
"E16"	"N39"	"Other disorders of pancreatic internal secretion"	"Other disorders of urinary system"	1	1575	1182	2757
"E16"	"O72"	"Other disorders of pancreatic internal secretion"	"Postpartum hemorrhage"	1	229	12	241
"E21"	"A41"	"Hyperparathyroidism and other disorders of parathyroid gland"	"Other sepsis"	1	625	421	1046
"E21"	"C34"	"Hyperparathyroidism and other disorders of parathyroid gland"	"Malignant neoplasm of bronchus and lung"	1	222	96	318
"E21"	"C79"	"Hyperparathyroidism and other disorders of parathyroid gland"	"Secondary malignant neoplasm of other and unspecified sites"	1	148	38	186
"E21"	"D35"	"Hyperparathyroidism and other disorders of parathyroid gland"	"Benign neoplasm of other and unspecified endocrine glands"	1	774	417	1191
"E21"	"E89"	"Hyperparathyroidism and other disorders of parathyroid gland"	"Postproc endocrine and metabolic comp and disorders, NEC"	1	335	115	450
"E21"	"F03"	"Hyperparathyroidism and other disorders of parathyroid gland"	"Unspecified dementia"	1	448	196	644
"E21"	"J15"	"Hyperparathyroidism and other disorders of parathyroid gland"	"Bacterial pneumonia, not elsewhere classified"	1	455	271	726
"E22"	"E89"	"Hyperfunction of pituitary gland"	"Postproc endocrine and metabolic comp and disorders, NEC"	1	141	51	192
"E22"	"O99"	"Hyperfunction of pituitary gland"	"Oth maternal diseases classd elsw but compl preg/chldbrth"	1	506	314	820
"E24"	"A41"	"Cushing's syndrome"	"Other sepsis"	1	95	27	122
"E24"	"E23"	"Cushing's syndrome"	"Hypofunction and other disorders of the pituitary gland"	1	102	39	141
"E24"	"E27"	"Cushing's syndrome"	"Other disorders of adrenal gland"	1	178	89	267
"E28"	"E68"	"Ovarian dysfunction"	"Sequelae of hyperalimentation"	1	242	10	252
"E28"	"I10"	"Ovarian dysfunction"	"Essential (primary) hypertension"	1	376	194	570
"E28"	"I83"	"Ovarian dysfunction"	"Varicose veins of lower extremities"	1	139	36	175
"E28"	"N93"	"Ovarian dysfunction"	"Other abnormal uterine and vaginal bleeding"	1	223	123	346
"E28"	"O24"	"Ovarian dysfunction"	"Diabetes in pregnancy, childbirth, and the puerperium"	1	651	283	934
"E28"	"O26"	"Ovarian dysfunction"	"Maternal care for oth conditions predom related to pregnancy"	1	682	446	1128
"E28"	"O40"	"Ovarian dysfunction"	"Polyhydramnios"	1	110	39	149
"E28"	"O60"	"Ovarian dysfunction"	"Preterm labor"	1	152	76	228
"E28"	"O72"	"Ovarian dysfunction"	"Postpartum hemorrhage"	1	5151	0	5151
"E28"	"O82"	"Ovarian dysfunction"	"Encounter for cesarean delivery without indication"	1	1439	747	2186
"E28"	"O99"	"Ovarian dysfunction"	"Oth maternal diseases classd elsw but compl preg/chldbrth"	1	2833	1700	4533
"E30"	"E22"	"Disorders of puberty, not elsewhere classified"	"Hyperfunction of pituitary gland"	1	366	202	568
"E30"	"L68"	"Disorders of puberty, not elsewhere classified"	"Hypertrichosis"	1	49	1	50
"E30"	"M22"	"Disorders of puberty, not elsewhere classified"	"Disorder of patella"	1	98	0	98
"E30"	"M23"	"Disorders of puberty, not elsewhere classified"	"Internal derangement of knee"	1	169	0	169
"E30"	"M65"	"Disorders of puberty, not elsewhere classified"	"Synovitis and tenosynovitis"	1	39	4	43
"E30"	"N91"	"Disorders of puberty, not elsewhere classified"	"Absent, scanty and rare menstruation"	1	63	13	76
"E34"	"E23"	"Other endocrine disorders"	"Hypofunction and other disorders of the pituitary gland"	1	362	236	598
"E34"	"O72"	"Other endocrine disorders"	"Postpartum hemorrhage"	1	331	68	399
"E55"	"A41"	"Vitamin D deficiency"	"Other sepsis"	1	1367	997	2364
"E55"	"J96"	"Vitamin D deficiency"	"Respiratory failure, not elsewhere classified"	1	1052	798	1850
"E64"	"F41"	"Sequelae of malnutrition and other nutritional deficiencies"	"Other anxiety disorders"	1	278	150	428
"E64"	"O72"	"Sequelae of malnutrition and other nutritional deficiencies"	"Postpartum hemorrhage"	1	134	60	194
"E65"	"C34"	"Localized adiposity"	"Malignant neoplasm of bronchus and lung"	1	48	1	49
"E65"	"C44"	"Localized adiposity"	"Other and unspecified malignant neoplasm of skin"	1	50	9	59
"E65"	"C78"	"Localized adiposity"	"Secondary malignant neoplasm of resp and digestive organs"	1	48	1	49
"E65"	"D63"	"Localized adiposity"	"Anemia in chronic diseases classified elsewhere"	1	26	0	26
"E65"	"D64"	"Localized adiposity"	"Other anemias"	1	320	76	396
"E65"	"J18"	"Localized adiposity"	"Pneumonia, unspecified organism"	1	330	155	485
"E65"	"M81"	"Localized adiposity"	"Osteoporosis without current pathological fracture"	1	146	22	168
"E66"	"A04"	"Overweight and obesity"	"Other bacterial intestinal infections"	1	813	282	1095
"E66"	"A26"	"Overweight and obesity"	"Erysipeloid"	1	222	15	237
"E66"	"B37"	"Overweight and obesity"	"Candidiasis"	1	753	530	1283
"E66"	"C09"	"Overweight and obesity"	"Malignant neoplasm of tonsil"	1	50	8	58
"E66"	"C18"	"Overweight and obesity"	"Malignant neoplasm of colon"	1	1195	787	1982
"E66"	"C22"	"Overweight and obesity"	"Malignant neoplasm of liver and intrahepatic bile ducts"	1	289	3	292
"E66"	"C24"	"Overweight and obesity"	"Malignant neoplasm of other and unsp parts of biliary tract"	1	151	14	165
"E66"	"C25"	"Overweight and obesity"	"Malignant neoplasm of pancreas"	1	482	26	508
"E66"	"C34"	"Overweight and obesity"	"Malignant neoplasm of bronchus and lung"	1	1404	121	1525
"E66"	"C55"	"Overweight and obesity"	"Malignant neoplasm of uterus, part unspecified"	1	145	53	198
"E66"	"C61"	"Overweight and obesity"	"Malignant neoplasm of prostate"	1	671	342	1013
"E66"	"C71"	"Overweight and obesity"	"Malignant neoplasm of brain"	1	227	80	307
"E66"	"C77"	"Overweight and obesity"	"Secondary and unspecified malignant neoplasm of lymph nodes"	1	836	264	1100
"E66"	"C78"	"Overweight and obesity"	"Secondary malignant neoplasm of resp and digestive organs"	1	2366	0	2366
"E66"	"C79"	"Overweight and obesity"	"Secondary malignant neoplasm of other and unspecified sites"	1	1211	92	1303
"E66"	"C80"	"Overweight and obesity"	"Malignant neoplasm without specification of site"	1	230	21	251
"E66"	"D09"	"Overweight and obesity"	"Carcinoma in situ of other and unspecified sites"	1	156	19	175
"E66"	"D12"	"Overweight and obesity"	"Benign neoplasm of colon, rectum, anus and anal canal"	1	3892	1963	5855
"E66"	"D46"	"Overweight and obesity"	"Myelodysplastic syndromes"	1	171	15	186
"E66"	"D62"	"Overweight and obesity"	"Acute posthemorrhagic anemia"	1	962	524	1486
"E66"	"E13"	"Overweight and obesity"	"Other specified diabetes mellitus"	1	793	367	1160
"E66"	"E27"	"Overweight and obesity"	"Other disorders of adrenal gland"	1	364	227	591
"E66"	"E46"	"Overweight and obesity"	"Unspecified protein-calorie malnutrition"	1	58	11	69
"E66"	"E55"	"Overweight and obesity"	"Vitamin D deficiency"	1	1413	774	2187
"E66"	"E64"	"Overweight and obesity"	"Sequelae of malnutrition and other nutritional deficiencies"	1	499	132	631
"E66"	"E65"	"Overweight and obesity"	"Localized adiposity"	1	2604	1307	3911
"E66"	"E83"	"Overweight and obesity"	"Disorders of mineral metabolism"	1	856	155	1011
"E66"	"G23"	"Overweight and obesity"	"Other degenerative diseases of basal ganglia"	1	60	4	64
"E66"	"G25"	"Overweight and obesity"	"Other extrapyramidal and movement disorders"	1	336	187	523
"E66"	"G31"	"Overweight and obesity"	"Oth degenerative diseases of nervous system, NEC"	1	210	52	262
"E66"	"G47"	"Overweight and obesity"	"Sleep disorders"	1	6578	5159	11737
"E66"	"G63"	"Overweight and obesity"	"Polyneuropathy in diseases classified elsewhere"	1	454	95	549
"E66"	"G95"	"Overweight and obesity"	"Other and unspecified diseases of spinal cord"	1	402	113	515
"E66"	"H26"	"Overweight and obesity"	"Other cataract"	1	1597	875	2472
"E66"	"H57"	"Overweight and obesity"	"Other disorders of eye and adnexa"	1	809	360	1169
"E66"	"I11"	"Overweight and obesity"	"Hypertensive heart disease"	1	1722	881	2603
"E66"	"I13"	"Overweight and obesity"	"Hypertensive heart and chronic kidney disease"	1	125	55	180
"E66"	"I44"	"Overweight and obesity"	"Atrioventricular and left bundle-branch block"	1	1050	470	1520
"E66"	"I48"	"Overweight and obesity"	"Atrial fibrillation and flutter"	1	6798	5516	12314
"E66"	"I61"	"Overweight and obesity"	"Nontraumatic intracerebral hemorrhage"	1	544	358	902
"E66"	"I63"	"Overweight and obesity"	"Cerebral infarction"	1	2684	1815	4499
"E66"	"I69"	"Overweight and obesity"	"Sequelae of cerebrovascular disease"	1	3357	2043	5400
"E66"	"I73"	"Overweight and obesity"	"Other peripheral vascular diseases"	1	1441	1011	2452
"E66"	"I89"	"Overweight and obesity"	"Oth noninfective disorders of lymphatic vessels and nodes"	1	934	327	1261
"E66"	"J15"	"Overweight and obesity"	"Bacterial pneumonia, not elsewhere classified"	1	3675	1158	4833
"E66"	"J81"	"Overweight and obesity"	"Pulmonary edema"	1	679	214	893
"E66"	"J90"	"Overweight and obesity"	"Pleural effusion, not elsewhere classified"	1	805	228	1033
"E66"	"J94"	"Overweight and obesity"	"Other pleural conditions"	1	217	104	321
"E66"	"J96"	"Overweight and obesity"	"Respiratory failure, not elsewhere classified"	1	7100	0	7100
"E66"	"K45"	"Overweight and obesity"	"Other abdominal hernia"	1	1098	597	1695
"E66"	"K46"	"Overweight and obesity"	"Unspecified abdominal hernia"	1	354	164	518
"E66"	"K56"	"Overweight and obesity"	"Paralytic ileus and intestinal obstruction without hernia"	1	2472	993	3465
"E66"	"K59"	"Overweight and obesity"	"Other functional intestinal disorders"	1	6450	4305	10755
"E66"	"K65"	"Overweight and obesity"	"Peritonitis"	1	967	632	1599
"E66"	"K72"	"Overweight and obesity"	"Hepatic failure, not elsewhere classified"	1	454	123	577
"E66"	"K92"	"Overweight and obesity"	"Other diseases of digestive system"	1	1830	1210	3040
"E66"	"L30"	"Overweight and obesity"	"Other and unspecified dermatitis"	1	1091	847	1938
"E66"	"L57"	"Overweight and obesity"	"Skin changes due to chronic expsr to nonionizing radiation"	1	309	107	416
"E66"	"L82"	"Overweight and obesity"	"Seborrheic keratosis"	1	255	103	358
"E66"	"L97"	"Overweight and obesity"	"Non-pressure chronic ulcer of lower limb, NEC"	1	1717	480	2197
"E66"	"M07"	"Overweight and obesity"	"Enteropathic arthropathies"	1	579	395	974
"E66"	"M14"	"Overweight and obesity"	"Arthropathies in other diseases classified elsewhere"	1	215	97	312
"E66"	"M18"	"Overweight and obesity"	"Osteoarthritis of first carpometacarpal joint"	1	547	349	896
"E66"	"M19"	"Overweight and obesity"	"Other and unspecified osteoarthritis"	1	3843	3339	7182
"E66"	"M48"	"Overweight and obesity"	"Other spondylopathies"	1	2475	1653	4128
"E66"	"M80"	"Overweight and obesity"	"Osteoporosis with current pathological fracture"	1	985	300	1285
"E66"	"M81"	"Overweight and obesity"	"Osteoporosis without current pathological fracture"	1	2212	1087	3299
"E66"	"M85"	"Overweight and obesity"	"Other disorders of bone density and structure"	1	1378	512	1890
"E66"	"N12"	"Overweight and obesity"	"Tubulo-interstitial nephritis, not spcf as acute or chronic"	1	330	192	522
"E66"	"N13"	"Overweight and obesity"	"Obstructive and reflux uropathy"	1	1009	669	1678
"E66"	"N18"	"Overweight and obesity"	"Chronic kidney disease (CKD)"	1	4336	0	4336
"E66"	"O72"	"Overweight and obesity"	"Postpartum hemorrhage"	1	51925	0	51925
"E66"	"O91"	"Overweight and obesity"	"Infect of breast assoc w pregnancy, the puerp and lactation"	1	1174	683	1857
"E68"	"D12"	"Sequelae of hyperalimentation"	"Benign neoplasm of colon, rectum, anus and anal canal"	1	105	30	135
"E68"	"D50"	"Sequelae of hyperalimentation"	"Iron deficiency anemia"	1	433	235	668
"E78"	"A04"	"Disorders of lipoprotein metabolism and other lipidemias"	"Other bacterial intestinal infections"	1	1858	434	2292
"E78"	"A49"	"Disorders of lipoprotein metabolism and other lipidemias"	"Bacterial infection of unspecified site"	1	5313	0	5313
"E78"	"B37"	"Disorders of lipoprotein metabolism and other lipidemias"	"Candidiasis"	1	1360	674	2034
"E78"	"B44"	"Disorders of lipoprotein metabolism and other lipidemias"	"Aspergillosis"	1	69	13	82
"E78"	"B95"	"Disorders of lipoprotein metabolism and other lipidemias"	"Strep as the cause of diseases classified elsewhere"	1	263	62	325
"E78"	"C13"	"Disorders of lipoprotein metabolism and other lipidemias"	"Malignant neoplasm of hypopharynx"	1	98	28	126
"E78"	"C14"	"Disorders of lipoprotein metabolism and other lipidemias"	"Malig neoplasm of sites in the lip, oral cavity and pharynx"	1	74	12	86
"E78"	"C15"	"Disorders of lipoprotein metabolism and other lipidemias"	"Malignant neoplasm of esophagus"	1	602	109	711
"E78"	"C18"	"Disorders of lipoprotein metabolism and other lipidemias"	"Malignant neoplasm of colon"	1	2162	1342	3504
"E78"	"C24"	"Disorders of lipoprotein metabolism and other lipidemias"	"Malignant neoplasm of other and unsp parts of biliary tract"	1	262	29	291
"E78"	"C25"	"Disorders of lipoprotein metabolism and other lipidemias"	"Malignant neoplasm of pancreas"	1	1102	104	1206
"E78"	"C34"	"Disorders of lipoprotein metabolism and other lipidemias"	"Malignant neoplasm of bronchus and lung"	1	4779	0	4779
"E78"	"C38"	"Disorders of lipoprotein metabolism and other lipidemias"	"Malignant neoplasm of heart, mediastinum and pleura"	1	79	23	102
"E78"	"C45"	"Disorders of lipoprotein metabolism and other lipidemias"	"Mesothelioma"	1	109	17	126
"E78"	"C48"	"Disorders of lipoprotein metabolism and other lipidemias"	"Malignant neoplasm of retroperitoneum and peritoneum"	1	104	26	130
"E78"	"C67"	"Disorders of lipoprotein metabolism and other lipidemias"	"Malignant neoplasm of bladder"	1	690	448	1138
"E78"	"C78"	"Disorders of lipoprotein metabolism and other lipidemias"	"Secondary malignant neoplasm of resp and digestive organs"	1	3897	0	3897
"E78"	"C80"	"Disorders of lipoprotein metabolism and other lipidemias"	"Malignant neoplasm without specification of site"	1	505	34	539
"E78"	"C90"	"Disorders of lipoprotein metabolism and other lipidemias"	"Multiple myeloma and malignant plasma cell neoplasms"	1	331	90	421
"E78"	"C92"	"Disorders of lipoprotein metabolism and other lipidemias"	"Myeloid leukemia"	1	238	46	284
"E78"	"C93"	"Disorders of lipoprotein metabolism and other lipidemias"	"Monocytic leukemia"	1	50	5	55
"E78"	"D46"	"Disorders of lipoprotein metabolism and other lipidemias"	"Myelodysplastic syndromes"	1	329	40	369
"E78"	"D53"	"Disorders of lipoprotein metabolism and other lipidemias"	"Other nutritional anemias"	1	136	52	188
"E78"	"D61"	"Disorders of lipoprotein metabolism and other lipidemias"	"Oth aplastic anemias and other bone marrow failure syndromes"	1	187	59	246
"E78"	"D68"	"Disorders of lipoprotein metabolism and other lipidemias"	"Other coagulation defects"	1	1379	861	2240
"E78"	"E13"	"Disorders of lipoprotein metabolism and other lipidemias"	"Other specified diabetes mellitus"	1	1034	764	1798
"E78"	"E25"	"Disorders of lipoprotein metabolism and other lipidemias"	"Adrenogenital disorders"	1	584	113	697
"E78"	"E34"	"Disorders of lipoprotein metabolism and other lipidemias"	"Other endocrine disorders"	1	416	166	582
"E78"	"E35"	"Disorders of lipoprotein metabolism and other lipidemias"	"Disorders of endocrine glands in diseases classd elswhr"	1	112	47	159
"E78"	"E41"	"Disorders of lipoprotein metabolism and other lipidemias"	"Nutritional marasmus"	1	365	21	386
"E78"	"E46"	"Disorders of lipoprotein metabolism and other lipidemias"	"Unspecified protein-calorie malnutrition"	1	173	27	200
"E78"	"E53"	"Disorders of lipoprotein metabolism and other lipidemias"	"Deficiency of other B group vitamins"	1	656	450	1106
"E78"	"E55"	"Disorders of lipoprotein metabolism and other lipidemias"	"Vitamin D deficiency"	1	1578	928	2506
"E78"	"E64"	"Disorders of lipoprotein metabolism and other lipidemias"	"Sequelae of malnutrition and other nutritional deficiencies"	1	967	302	1269
"E78"	"E70"	"Disorders of lipoprotein metabolism and other lipidemias"	"Disorders of aromatic amino-acid metabolism"	1	252	106	358
"E78"	"E83"	"Disorders of lipoprotein metabolism and other lipidemias"	"Disorders of mineral metabolism"	1	1262	300	1562
"E78"	"E86"	"Disorders of lipoprotein metabolism and other lipidemias"	"Volume depletion"	1	13714	0	13714
"E78"	"F02"	"Disorders of lipoprotein metabolism and other lipidemias"	"Dementia in other diseases classified elsewhere"	1	269	74	343
"E78"	"F33"	"Disorders of lipoprotein metabolism and other lipidemias"	"Major depressive disorder, recurrent"	1	2629	1961	4590
"E78"	"F41"	"Disorders of lipoprotein metabolism and other lipidemias"	"Other anxiety disorders"	1	2182	997	3179
"E78"	"G12"	"Disorders of lipoprotein metabolism and other lipidemias"	"Spinal muscular atrophy and related syndromes"	1	164	46	210
"E78"	"G25"	"Disorders of lipoprotein metabolism and other lipidemias"	"Other extrapyramidal and movement disorders"	1	558	371	929
"E78"	"G63"	"Disorders of lipoprotein metabolism and other lipidemias"	"Polyneuropathy in diseases classified elsewhere"	1	595	329	924
"E78"	"G96"	"Disorders of lipoprotein metabolism and other lipidemias"	"Other disorders of central nervous system"	1	4289	3040	7329
"E78"	"G98"	"Disorders of lipoprotein metabolism and other lipidemias"	"Other disorders of nervous system not elsewhere classified"	1	1026	374	1400
"E78"	"H54"	"Disorders of lipoprotein metabolism and other lipidemias"	"Blindness and low vision"	1	732	476	1208
"E78"	"H57"	"Disorders of lipoprotein metabolism and other lipidemias"	"Other disorders of eye and adnexa"	1	1034	745	1779
"E78"	"I11"	"Disorders of lipoprotein metabolism and other lipidemias"	"Hypertensive heart disease"	1	2691	1943	4634
"E78"	"I13"	"Disorders of lipoprotein metabolism and other lipidemias"	"Hypertensive heart and chronic kidney disease"	1	265	132	397
"E78"	"I26"	"Disorders of lipoprotein metabolism and other lipidemias"	"Pulmonary embolism"	1	2452	1614	4066
"E78"	"I31"	"Disorders of lipoprotein metabolism and other lipidemias"	"Other diseases of pericardium"	1	694	472	1166
"E78"	"I44"	"Disorders of lipoprotein metabolism and other lipidemias"	"Atrioventricular and left bundle-branch block"	1	3105	2177	5282
"E78"	"I46"	"Disorders of lipoprotein metabolism and other lipidemias"	"Cardiac arrest"	1	4321	0	4321
"E78"	"I50"	"Disorders of lipoprotein metabolism and other lipidemias"	"Heart failure"	1	15813	13972	29785
"E78"	"I72"	"Disorders of lipoprotein metabolism and other lipidemias"	"Other aneurysm"	1	980	571	1551
"E78"	"I73"	"Disorders of lipoprotein metabolism and other lipidemias"	"Other peripheral vascular diseases"	1	5354	4527	9881
"E78"	"I82"	"Disorders of lipoprotein metabolism and other lipidemias"	"Other venous embolism and thrombosis"	1	654	426	1080
"E78"	"I85"	"Disorders of lipoprotein metabolism and other lipidemias"	"Esophageal varices"	1	329	96	425
"E78"	"I89"	"Disorders of lipoprotein metabolism and other lipidemias"	"Oth noninfective disorders of lymphatic vessels and nodes"	1	481	284	765
"E78"	"J10"	"Disorders of lipoprotein metabolism and other lipidemias"	"Influenza due to other identified influenza virus"	1	343	30	373
"E78"	"J18"	"Disorders of lipoprotein metabolism and other lipidemias"	"Pneumonia, unspecified organism"	1	27414	0	27414
"E78"	"J47"	"Disorders of lipoprotein metabolism and other lipidemias"	"Bronchiectasis"	1	410	154	564
"E78"	"J84"	"Disorders of lipoprotein metabolism and other lipidemias"	"Other interstitial pulmonary diseases"	1	989	426	1415
"E78"	"J86"	"Disorders of lipoprotein metabolism and other lipidemias"	"Pyothorax"	1	353	224	577
"E78"	"J90"	"Disorders of lipoprotein metabolism and other lipidemias"	"Pleural effusion, not elsewhere classified"	1	2626	743	3369
"E78"	"J93"	"Disorders of lipoprotein metabolism and other lipidemias"	"Pneumothorax and air leak"	1	708	446	1154
"E78"	"J94"	"Disorders of lipoprotein metabolism and other lipidemias"	"Other pleural conditions"	1	616	257	873
"E78"	"J98"	"Disorders of lipoprotein metabolism and other lipidemias"	"Other respiratory disorders"	1	1190	841	2031
"E78"	"K31"	"Disorders of lipoprotein metabolism and other lipidemias"	"Other diseases of stomach and duodenum"	1	535	278	813
"E78"	"K52"	"Disorders of lipoprotein metabolism and other lipidemias"	"Other and unsp noninfective gastroenteritis and colitis"	1	2951	1711	4662
"E78"	"K55"	"Disorders of lipoprotein metabolism and other lipidemias"	"Vascular disorders of intestine"	1	987	240	1227
"E78"	"K56"	"Disorders of lipoprotein metabolism and other lipidemias"	"Paralytic ileus and intestinal obstruction without hernia"	1	2325	1357	3682
"E78"	"K59"	"Disorders of lipoprotein metabolism and other lipidemias"	"Other functional intestinal disorders"	1	14107	0	14107
"E78"	"K74"	"Disorders of lipoprotein metabolism and other lipidemias"	"Fibrosis and cirrhosis of liver"	1	561	194	755
"E78"	"K83"	"Disorders of lipoprotein metabolism and other lipidemias"	"Other diseases of biliary tract"	1	977	490	1467
"E78"	"K92"	"Disorders of lipoprotein metabolism and other lipidemias"	"Other diseases of digestive system"	1	4444	2022	6466
"E78"	"L57"	"Disorders of lipoprotein metabolism and other lipidemias"	"Skin changes due to chronic expsr to nonionizing radiation"	1	812	275	1087
"E78"	"L97"	"Disorders of lipoprotein metabolism and other lipidemias"	"Non-pressure chronic ulcer of lower limb, NEC"	1	2478	921	3399
"E78"	"M10"	"Disorders of lipoprotein metabolism and other lipidemias"	"Gout"	1	3171	2323	5494
"E78"	"M48"	"Disorders of lipoprotein metabolism and other lipidemias"	"Other spondylopathies"	1	3627	2897	6524
"E78"	"M49"	"Disorders of lipoprotein metabolism and other lipidemias"	"Spondylopathies in diseases classified elsewhere"	1	67	20	87
"E78"	"M80"	"Disorders of lipoprotein metabolism and other lipidemias"	"Osteoporosis with current pathological fracture"	1	3102	1163	4265
"E78"	"N08"	"Disorders of lipoprotein metabolism and other lipidemias"	"Glomerular disorders in diseases classified elsewhere"	1	276	86	362
"E78"	"N13"	"Disorders of lipoprotein metabolism and other lipidemias"	"Obstructive and reflux uropathy"	1	1280	765	2045
"E78"	"N17"	"Disorders of lipoprotein metabolism and other lipidemias"	"Acute kidney failure"	1	4533	0	4533
"E78"	"N18"	"Disorders of lipoprotein metabolism and other lipidemias"	"Chronic kidney disease (CKD)"	1	10071	0	10071
"E78"	"N28"	"Disorders of lipoprotein metabolism and other lipidemias"	"Oth disorders of kidney and ureter, not elsewhere classified"	1	1660	389	2049
"E78"	"Q61"	"Disorders of lipoprotein metabolism and other lipidemias"	"Cystic kidney disease"	1	539	242	781
"E80"	"A41"	"Disorders of porphyrin and bilirubin metabolism"	"Other sepsis"	1	128	58	186
"E83"	"G47"	"Disorders of mineral metabolism"	"Sleep disorders"	1	447	265	712
"E84"	"A41"	"Cystic fibrosis"	"Other sepsis"	1	35	4	39
"E84"	"E10"	"Cystic fibrosis"	"Type 1 diabetes mellitus"	1	76	0	76
"E86"	"G47"	"Volume depletion"	"Sleep disorders"	1	1672	1135	2807
"E86"	"J69"	"Volume depletion"	"Pneumonitis due to solids and liquids"	1	2219	1191	3410
"E86"	"K64"	"Volume depletion"	"Hemorrhoids and perianal venous thrombosis"	1	497	303	800
"E87"	"K64"	"Other disorders of fluid, electrolyte and acid-base balance"	"Hemorrhoids and perianal venous thrombosis"	1	465	296	761
"E88"	"C78"	"Other and unspecified metabolic disorders"	"Secondary malignant neoplasm of resp and digestive organs"	1	82	24	106
"E88"	"J96"	"Other and unspecified metabolic disorders"	"Respiratory failure, not elsewhere classified"	1	375	140	515
"E88"	"N17"	"Other and unspecified metabolic disorders"	"Acute kidney failure"	1	67	20	87
"E88"	"N18"	"Other and unspecified metabolic disorders"	"Chronic kidney disease (CKD)"	1	133	50	183
"E89"	"I35"	"Postproc endocrine and metabolic comp and disorders, NEC"	"Nonrheumatic aortic valve disorders"	1	161	71	232
"E89"	"I46"	"Postproc endocrine and metabolic comp and disorders, NEC"	"Cardiac arrest"	1	81	13	94
"E89"	"J22"	"Postproc endocrine and metabolic comp and disorders, NEC"	"Unspecified acute lower respiratory infection"	1	61	10	71
"F01"	"J69"	"Vascular dementia"	"Pneumonitis due to solids and liquids"	1	247	113	360
"F03"	"F01"	"Unspecified dementia"	"Vascular dementia"	1	2472	2104	4576
"F03"	"J96"	"Unspecified dementia"	"Respiratory failure, not elsewhere classified"	1	2321	1983	4304
"F03"	"L89"	"Unspecified dementia"	"Pressure ulcer"	1	1236	974	2210
"F04"	"G30"	"Amnestic disorder due to known physiological condition"	"Alzheimer's disease"	1	190	10	200
"F06"	"G30"	"Other mental disorders due to known physiological condition"	"Alzheimer's disease"	1	457	124	581
"F10"	"A04"	"Alcohol related disorders"	"Other bacterial intestinal infections"	1	1262	193	1455
"F10"	"A46"	"Alcohol related disorders"	"Erysipelas"	1	3327	1190	4517
"F10"	"B19"	"Alcohol related disorders"	"Unspecified viral hepatitis"	1	152	71	223
"F10"	"B36"	"Alcohol related disorders"	"Other superficial mycoses"	1	157	18	175
"F10"	"B37"	"Alcohol related disorders"	"Candidiasis"	1	1456	394	1850
"F10"	"B44"	"Alcohol related disorders"	"Aspergillosis"	1	46	9	55
"F10"	"B48"	"Alcohol related disorders"	"Other mycoses, not elsewhere classified"	1	55	14	69
"F10"	"B86"	"Alcohol related disorders"	"Scabies"	1	111	21	132
"F10"	"B95"	"Alcohol related disorders"	"Strep as the cause of diseases classified elsewhere"	1	205	28	233
"F10"	"C03"	"Alcohol related disorders"	"Malignant neoplasm of gum"	1	71	12	83
"F10"	"C06"	"Alcohol related disorders"	"Malignant neoplasm of other and unspecified parts of mouth"	1	549	82	631
"F10"	"C10"	"Alcohol related disorders"	"Malignant neoplasm of oropharynx"	1	445	1	446
"F10"	"C13"	"Alcohol related disorders"	"Malignant neoplasm of hypopharynx"	1	355	0	355
"F10"	"C14"	"Alcohol related disorders"	"Malig neoplasm of sites in the lip, oral cavity and pharynx"	1	137	0	137
"F10"	"C16"	"Alcohol related disorders"	"Malignant neoplasm of stomach"	1	311	53	364
"F10"	"C17"	"Alcohol related disorders"	"Malignant neoplasm of small intestine"	1	69	12	81
"F10"	"C25"	"Alcohol related disorders"	"Malignant neoplasm of pancreas"	1	521	57	578
"F10"	"C38"	"Alcohol related disorders"	"Malignant neoplasm of heart, mediastinum and pleura"	1	53	9	62
"F10"	"C45"	"Alcohol related disorders"	"Mesothelioma"	1	40	2	42
"F10"	"C49"	"Alcohol related disorders"	"Malignant neoplasm of other connective and soft tissue"	1	61	17	78
"F10"	"C64"	"Alcohol related disorders"	"Malignant neoplasm of kidney, except renal pelvis"	1	257	28	285
"F10"	"C67"	"Alcohol related disorders"	"Malignant neoplasm of bladder"	1	286	107	393
"F10"	"C71"	"Alcohol related disorders"	"Malignant neoplasm of brain"	1	300	39	339
"F10"	"C76"	"Alcohol related disorders"	"Malignant neoplasm of other and ill-defined sites"	1	123	26	149
"F10"	"C77"	"Alcohol related disorders"	"Secondary and unspecified malignant neoplasm of lymph nodes"	1	928	45	973
"F10"	"C78"	"Alcohol related disorders"	"Secondary malignant neoplasm of resp and digestive organs"	1	1768	0	1768
"F10"	"C80"	"Alcohol related disorders"	"Malignant neoplasm without specification of site"	1	340	6	346
"F10"	"D03"	"Alcohol related disorders"	"Melanoma in situ"	1	74	17	91
"F10"	"D14"	"Alcohol related disorders"	"Benign neoplasm of middle ear and respiratory system"	1	319	153	472
"F10"	"D21"	"Alcohol related disorders"	"Other benign neoplasms of connective and other soft tissue"	1	168	76	244
"F10"	"D32"	"Alcohol related disorders"	"Benign neoplasm of meninges"	1	145	57	202
"F10"	"D35"	"Alcohol related disorders"	"Benign neoplasm of other and unspecified endocrine glands"	1	221	39	260
"F10"	"D50"	"Alcohol related disorders"	"Iron deficiency anemia"	1	2072	535	2607
"F10"	"D51"	"Alcohol related disorders"	"Vitamin B12 deficiency anemia"	1	398	252	650
"F10"	"D62"	"Alcohol related disorders"	"Acute posthemorrhagic anemia"	1	1503	489	1992
"F10"	"D64"	"Alcohol related disorders"	"Other anemias"	1	9163	0	9163
"F10"	"D65"	"Alcohol related disorders"	"Disseminated intravascular coagulation"	1	241	80	321
"F10"	"E13"	"Alcohol related disorders"	"Other specified diabetes mellitus"	1	749	112	861
"F10"	"E22"	"Alcohol related disorders"	"Hyperfunction of pituitary gland"	1	90	32	122
"F10"	"E27"	"Alcohol related disorders"	"Other disorders of adrenal gland"	1	240	50	290
"F10"	"E41"	"Alcohol related disorders"	"Nutritional marasmus"	1	537	69	606
"F10"	"E46"	"Alcohol related disorders"	"Unspecified protein-calorie malnutrition"	1	269	40	309
"F10"	"E51"	"Alcohol related disorders"	"Thiamine deficiency"	1	974	582	1556
"F10"	"E53"	"Alcohol related disorders"	"Deficiency of other B group vitamins"	1	362	191	553
"F10"	"E63"	"Alcohol related disorders"	"Other nutritional deficiencies"	1	293	99	392
"F10"	"E78"	"Alcohol related disorders"	"Disorders of lipoprotein metabolism and other lipidemias"	1	4027	2696	6723
"F10"	"E83"	"Alcohol related disorders"	"Disorders of mineral metabolism"	1	1142	215	1357
"F10"	"E87"	"Alcohol related disorders"	"Other disorders of fluid, electrolyte and acid-base balance"	1	10096	0	10096
"F10"	"F01"	"Alcohol related disorders"	"Vascular dementia"	1	721	194	915
"F10"	"F06"	"Alcohol related disorders"	"Other mental disorders due to known physiological condition"	1	860	277	1137
"F10"	"F09"	"Alcohol related disorders"	"Unsp mental disorder due to known physiological condition"	1	177	56	233
"F10"	"F12"	"Alcohol related disorders"	"Cannabis related disorders"	1	1380	1102	2482
"F10"	"F14"	"Alcohol related disorders"	"Cocaine related disorders"	1	645	463	1108
"F10"	"F19"	"Alcohol related disorders"	"Other psychoactive substance related disorders"	1	1196	463	1659
"F10"	"F20"	"Alcohol related disorders"	"Schizophrenia"	1	1465	669	2134
"F10"	"F22"	"Alcohol related disorders"	"Delusional disorders"	1	372	146	518
"F10"	"F25"	"Alcohol related disorders"	"Schizoaffective disorders"	1	130	33	163
"F10"	"F29"	"Alcohol related disorders"	"Unsp psychosis not due to a substance or known physiol cond"	1	208	107	315
"F10"	"F30"	"Alcohol related disorders"	"Manic episode"	1	120	49	169
"F10"	"F31"	"Alcohol related disorders"	"Bipolar disorder"	1	992	365	1357
"F10"	"F32"	"Alcohol related disorders"	"Depressive episode"	1	5650	3842	9492
"F10"	"F33"	"Alcohol related disorders"	"Major depressive disorder, recurrent"	1	4112	1669	5781
"F10"	"F39"	"Alcohol related disorders"	"Unspecified mood [affective] disorder"	1	196	94	290
"F10"	"F42"	"Alcohol related disorders"	"Obsessive-compulsive disorder"	1	132	46	178
"F10"	"F51"	"Alcohol related disorders"	"Sleep disorders not due to a substance or known physiol cond"	1	159	48	207
"F10"	"F52"	"Alcohol related disorders"	"Sexual dysfnct not due to a substance or known physiol cond"	1	87	19	106
"F10"	"F99"	"Alcohol related disorders"	"Mental disorder, not otherwise specified"	1	1173	583	1756
"F10"	"G20"	"Alcohol related disorders"	"Parkinson's disease"	1	373	105	478
"F10"	"G23"	"Alcohol related disorders"	"Other degenerative diseases of basal ganglia"	1	61	5	66
"F10"	"G31"	"Alcohol related disorders"	"Oth degenerative diseases of nervous system, NEC"	1	1579	514	2093
"F10"	"G44"	"Alcohol related disorders"	"Other headache syndromes"	1	788	347	1135
"F10"	"G47"	"Alcohol related disorders"	"Sleep disorders"	1	1843	254	2097
"F10"	"G56"	"Alcohol related disorders"	"Mononeuropathies of upper limb"	1	1989	1088	3077
"F10"	"G62"	"Alcohol related disorders"	"Other and unspecified polyneuropathies"	1	3554	1698	5252
"F10"	"G64"	"Alcohol related disorders"	"Other disorders of peripheral nervous system"	1	148	49	197
"F10"	"G83"	"Alcohol related disorders"	"Other paralytic syndromes"	1	195	91	286
"F10"	"G93"	"Alcohol related disorders"	"Other disorders of brain"	1	999	253	1252
"F10"	"G95"	"Alcohol related disorders"	"Other and unspecified diseases of spinal cord"	1	432	35	467
"F10"	"G96"	"Alcohol related disorders"	"Other disorders of central nervous system"	1	2029	311	2340
"F10"	"G98"	"Alcohol related disorders"	"Other disorders of nervous system not elsewhere classified"	1	531	70	601
"F10"	"H02"	"Alcohol related disorders"	"Other disorders of eyelid"	1	690	268	958
"F10"	"H18"	"Alcohol related disorders"	"Other disorders of cornea"	1	188	64	252
"F10"	"H25"	"Alcohol related disorders"	"Age-related cataract"	1	4282	1630	5912
"F10"	"H35"	"Alcohol related disorders"	"Other retinal disorders"	1	1147	521	1668
"F10"	"H43"	"Alcohol related disorders"	"Disorders of vitreous body"	1	357	144	501
"F10"	"H44"	"Alcohol related disorders"	"Disorders of globe"	1	130	58	188
"F10"	"H49"	"Alcohol related disorders"	"Paralytic strabismus"	1	171	57	228
"F10"	"H52"	"Alcohol related disorders"	"Disorders of refraction and accommodation"	1	525	285	810
"F10"	"H53"	"Alcohol related disorders"	"Visual disturbances"	1	752	270	1022
"F10"	"H57"	"Alcohol related disorders"	"Other disorders of eye and adnexa"	1	572	103	675
"F10"	"I12"	"Alcohol related disorders"	"Hypertensive chronic kidney disease"	1	140	57	197
"F10"	"I15"	"Alcohol related disorders"	"Secondary hypertension"	1	524	207	731
"F10"	"I21"	"Alcohol related disorders"	"Acute myocardial infarction"	1	2321	1574	3895
"F10"	"I24"	"Alcohol related disorders"	"Other acute ischemic heart diseases"	1	279	108	387
"F10"	"I25"	"Alcohol related disorders"	"Chronic ischemic heart disease"	1	3820	2653	6473
"F10"	"I31"	"Alcohol related disorders"	"Other diseases of pericardium"	1	166	65	231
"F10"	"I34"	"Alcohol related disorders"	"Nonrheumatic mitral valve disorders"	1	420	195	615
"F10"	"I60"	"Alcohol related disorders"	"Nontraumatic subarachnoid hemorrhage"	1	574	314	888
"F10"	"I61"	"Alcohol related disorders"	"Nontraumatic intracerebral hemorrhage"	1	1931	686	2617
"F10"	"I65"	"Alcohol related disorders"	"Occls and stenosis of precerb art, not rslt in cereb infrc"	1	328	208	536
"F10"	"I69"	"Alcohol related disorders"	"Sequelae of cerebrovascular disease"	1	7942	0	7942
"F10"	"I70"	"Alcohol related disorders"	"Atherosclerosis"	1	2580	1245	3825
"F10"	"I71"	"Alcohol related disorders"	"Aortic aneurysm and dissection"	1	697	256	953
"F10"	"I80"	"Alcohol related disorders"	"Phlebitis and thrombophlebitis"	1	2204	1226	3430
"F10"	"I85"	"Alcohol related disorders"	"Esophageal varices"	1	3015	1425	4440
"F10"	"I86"	"Alcohol related disorders"	"Varicose veins of other sites"	1	367	124	491
"F10"	"I89"	"Alcohol related disorders"	"Oth noninfective disorders of lymphatic vessels and nodes"	1	328	85	413
"F10"	"I95"	"Alcohol related disorders"	"Hypotension"	1	1706	469	2175
"F10"	"J01"	"Alcohol related disorders"	"Acute sinusitis"	1	339	139	478
"F10"	"J06"	"Alcohol related disorders"	"Acute upper resp infections of multiple and unsp sites"	1	458	40	498
"F10"	"J13"	"Alcohol related disorders"	"Pneumonia due to Streptococcus pneumoniae"	1	715	357	1072
"F10"	"J14"	"Alcohol related disorders"	"Pneumonia due to Hemophilus influenzae"	1	205	82	287
"F10"	"J16"	"Alcohol related disorders"	"Pneumonia due to oth infectious organisms, NEC"	1	161	71	232
"F10"	"J22"	"Alcohol related disorders"	"Unspecified acute lower respiratory infection"	1	765	77	842
"F10"	"J38"	"Alcohol related disorders"	"Diseases of vocal cords and larynx, not elsewhere classified"	1	477	265	742
"F10"	"J44"	"Alcohol related disorders"	"Other chronic obstructive pulmonary disease"	1	12567	0	12567
"F10"	"J47"	"Alcohol related disorders"	"Bronchiectasis"	1	139	19	158
"F10"	"J69"	"Alcohol related disorders"	"Pneumonitis due to solids and liquids"	1	1445	196	1641
"F10"	"J80"	"Alcohol related disorders"	"Acute respiratory distress syndrome"	1	225	84	309
"F10"	"J93"	"Alcohol related disorders"	"Pneumothorax and air leak"	1	970	366	1336
"F10"	"J98"	"Alcohol related disorders"	"Other respiratory disorders"	1	848	326	1174
"F10"	"K04"	"Alcohol related disorders"	"Diseases of pulp and periapical tissues"	1	1041	313	1354
"F10"	"K05"	"Alcohol related disorders"	"Gingivitis and periodontal diseases"	1	1177	246	1423
"F10"	"K11"	"Alcohol related disorders"	"Diseases of salivary glands"	1	286	142	428
"F10"	"K20"	"Alcohol related disorders"	"Esophagitis"	1	2561	1342	3903
"F10"	"K22"	"Alcohol related disorders"	"Other diseases of esophagus"	1	2093	733	2826
"F10"	"K27"	"Alcohol related disorders"	"Peptic ulcer, site unspecified"	1	1170	642	1812
"F10"	"K28"	"Alcohol related disorders"	"Gastrojejunal ulcer"	1	339	133	472
"F10"	"K29"	"Alcohol related disorders"	"Gastritis and duodenitis"	1	5599	3930	9529
"F10"	"K31"	"Alcohol related disorders"	"Other diseases of stomach and duodenum"	1	506	134	640
"F10"	"K37"	"Alcohol related disorders"	"Unspecified appendicitis"	1	164	40	204
"F10"	"K43"	"Alcohol related disorders"	"Ventral hernia"	1	1185	539	1724
"F10"	"K52"	"Alcohol related disorders"	"Other and unsp noninfective gastroenteritis and colitis"	1	2128	906	3034
"F10"	"K56"	"Alcohol related disorders"	"Paralytic ileus and intestinal obstruction without hernia"	1	1812	656	2468
"F10"	"K59"	"Alcohol related disorders"	"Other functional intestinal disorders"	1	6689	0	6689
"F10"	"K60"	"Alcohol related disorders"	"Fissure and fistula of anal and rectal regions"	1	611	434	1045
"F10"	"K62"	"Alcohol related disorders"	"Other diseases of anus and rectum"	1	2923	1200	4123
"F10"	"K65"	"Alcohol related disorders"	"Peritonitis"	1	1564	463	2027
"F10"	"K71"	"Alcohol related disorders"	"Toxic liver disease"	1	1028	367	1395
"F10"	"K73"	"Alcohol related disorders"	"Chronic hepatitis, not elsewhere classified"	1	202	100	302
"F10"	"K74"	"Alcohol related disorders"	"Fibrosis and cirrhosis of liver"	1	3138	1196	4334
"F10"	"K76"	"Alcohol related disorders"	"Other diseases of liver"	1	2936	1062	3998
"F10"	"K83"	"Alcohol related disorders"	"Other diseases of biliary tract"	1	672	136	808
"F10"	"L02"	"Alcohol related disorders"	"Cutaneous abscess, furuncle and carbuncle"	1	3023	2143	5166
"F10"	"L21"	"Alcohol related disorders"	"Seborrheic dermatitis"	1	250	115	365
"F10"	"L28"	"Alcohol related disorders"	"Lichen simplex chronicus and prurigo"	1	162	61	223
"F10"	"L30"	"Alcohol related disorders"	"Other and unspecified dermatitis"	1	1075	501	1576
"F10"	"L98"	"Alcohol related disorders"	"Oth disorders of skin, subcu, not elsewhere classified"	1	1154	305	1459
"F10"	"M07"	"Alcohol related disorders"	"Enteropathic arthropathies"	1	201	75	276
"F10"	"M17"	"Alcohol related disorders"	"Osteoarthritis of knee"	1	1832	1293	3125
"F10"	"M18"	"Alcohol related disorders"	"Osteoarthritis of first carpometacarpal joint"	1	216	96	312
"F10"	"M19"	"Alcohol related disorders"	"Other and unspecified osteoarthritis"	1	1969	822	2791
"F10"	"M20"	"Alcohol related disorders"	"Acquired deformities of fingers and toes"	1	948	449	1397
"F10"	"M23"	"Alcohol related disorders"	"Internal derangement of knee"	1	2799	2060	4859
"F10"	"M47"	"Alcohol related disorders"	"Spondylosis"	1	1129	693	1822
"F10"	"M53"	"Alcohol related disorders"	"Other and unspecified dorsopathies, not elsewhere classified"	1	496	205	701
"F10"	"M54"	"Alcohol related disorders"	"Dorsalgia"	1	5514	3858	9372
"F10"	"M80"	"Alcohol related disorders"	"Osteoporosis with current pathological fracture"	1	2049	466	2515
"F10"	"M81"	"Alcohol related disorders"	"Osteoporosis without current pathological fracture"	1	3871	0	3871
"F10"	"M84"	"Alcohol related disorders"	"Disorder of continuity of bone"	1	504	185	689
"F10"	"M86"	"Alcohol related disorders"	"Osteomyelitis"	1	418	139	557
"F10"	"M90"	"Alcohol related disorders"	"Osteopathies in diseases classified elsewhere"	1	38	4	42
"F10"	"M96"	"Alcohol related disorders"	"Intraop and postproc comp and disorders of ms sys, NEC"	1	149	46	195
"F10"	"M99"	"Alcohol related disorders"	"Biomechanical lesions, not elsewhere classified"	1	312	119	431
"F10"	"N10"	"Alcohol related disorders"	"Acute pyelonephritis"	1	753	360	1113
"F10"	"N12"	"Alcohol related disorders"	"Tubulo-interstitial nephritis, not spcf as acute or chronic"	1	217	53	270
"F10"	"N17"	"Alcohol related disorders"	"Acute kidney failure"	1	2355	593	2948
"F10"	"N28"	"Alcohol related disorders"	"Oth disorders of kidney and ureter, not elsewhere classified"	1	390	65	455
"F10"	"N30"	"Alcohol related disorders"	"Cystitis"	1	9416	0	9416
"F10"	"N35"	"Alcohol related disorders"	"Urethral stricture"	1	214	107	321
"F10"	"N39"	"Alcohol related disorders"	"Other disorders of urinary system"	1	6697	0	6697
"F10"	"N40"	"Alcohol related disorders"	"Benign prostatic hyperplasia"	1	1500	1135	2635
"F10"	"N46"	"Alcohol related disorders"	"Male infertility"	1	399	16	415
"F10"	"N48"	"Alcohol related disorders"	"Other disorders of penis"	1	453	282	735
"F10"	"N80"	"Alcohol related disorders"	"Endometriosis"	1	208	93	301
"F10"	"N94"	"Alcohol related disorders"	"Pain and oth cond assoc w fem gntl org and menstrual cycle"	1	512	269	781
"F10"	"O02"	"Alcohol related disorders"	"Other abnormal products of conception"	1	753	177	930
"F10"	"O08"	"Alcohol related disorders"	"Complications following ectopic and molar pregnancy"	1	494	111	605
"F10"	"O10"	"Alcohol related disorders"	"Pre-existing hypertension compl preg/chldbrth"	1	42	7	49
"F10"	"O23"	"Alcohol related disorders"	"Infections of genitourinary tract in pregnancy"	1	483	58	541
"F10"	"O28"	"Alcohol related disorders"	"Abnormal findings on antenatal screening of mother"	1	145	7	152
"F10"	"O30"	"Alcohol related disorders"	"Multiple gestation"	1	150	13	163
"F10"	"O34"	"Alcohol related disorders"	"Maternal care for abnormality of pelvic organs"	1	304	0	304
"F10"	"O35"	"Alcohol related disorders"	"Maternal care for known or suspected fetal abnlt and damage"	1	117	0	117
"F10"	"O41"	"Alcohol related disorders"	"Other disorders of amniotic fluid and membranes"	1	127	18	145
"F10"	"O46"	"Alcohol related disorders"	"Antepartum hemorrhage, not elsewhere classified"	1	206	42	248
"F10"	"O47"	"Alcohol related disorders"	"False labor"	1	716	116	832
"F10"	"O64"	"Alcohol related disorders"	"Obstructed labor due to malposition and malpresent of fetus"	1	234	53	287
"F10"	"O66"	"Alcohol related disorders"	"Other obstructed labor"	1	140	11	151
"F10"	"O70"	"Alcohol related disorders"	"Perineal laceration during delivery"	1	2458	0	2458
"F10"	"O71"	"Alcohol related disorders"	"Other obstetric trauma"	1	444	79	523
"F10"	"O73"	"Alcohol related disorders"	"Retained placenta and membranes, without hemorrhage"	1	80	2	82
"F10"	"O75"	"Alcohol related disorders"	"Oth complications of labor and delivery, NEC"	1	372	6	378
"F10"	"O80"	"Alcohol related disorders"	"Encounter for full-term uncomplicated delivery"	1	3458	1126	4584
"F10"	"O85"	"Alcohol related disorders"	"Puerperal sepsis"	1	70	6	76
"F10"	"O87"	"Alcohol related disorders"	"Venous complications and hemorrhoids in the puerperium"	1	33	0	33
"F10"	"O90"	"Alcohol related disorders"	"Complications of the puerperium, not elsewhere classified"	1	189	0	189
"F10"	"O91"	"Alcohol related disorders"	"Infect of breast assoc w pregnancy, the puerp and lactation"	1	131	0	131
"F11"	"A41"	"Opioid related disorders"	"Other sepsis"	1	542	259	801
"F11"	"A46"	"Opioid related disorders"	"Erysipelas"	1	435	239	674
"F11"	"A49"	"Opioid related disorders"	"Bacterial infection of unspecified site"	1	265	105	370
"F11"	"B18"	"Opioid related disorders"	"Chronic viral hepatitis"	1	923	401	1324
"F11"	"C22"	"Opioid related disorders"	"Malignant neoplasm of liver and intrahepatic bile ducts"	1	35	0	35
"F11"	"F19"	"Opioid related disorders"	"Other psychoactive substance related disorders"	1	399	249	648
"F11"	"G96"	"Opioid related disorders"	"Other disorders of central nervous system"	1	87	24	111
"F11"	"I46"	"Opioid related disorders"	"Cardiac arrest"	1	206	16	222
"F11"	"I87"	"Opioid related disorders"	"Other disorders of veins"	1	73	15	88
"F11"	"J15"	"Opioid related disorders"	"Bacterial pneumonia, not elsewhere classified"	1	390	192	582
"F11"	"J22"	"Opioid related disorders"	"Unspecified acute lower respiratory infection"	1	56	12	68
"F11"	"K72"	"Opioid related disorders"	"Hepatic failure, not elsewhere classified"	1	160	32	192
"F11"	"K75"	"Opioid related disorders"	"Other inflammatory liver diseases"	1	26	2	28
"F11"	"L97"	"Opioid related disorders"	"Non-pressure chronic ulcer of lower limb, NEC"	1	131	49	180
"F12"	"J96"	"Cannabis related disorders"	"Respiratory failure, not elsewhere classified"	1	145	64	209
"F13"	"A41"	"Sedative, hypnotic, or anxiolytic related disorders"	"Other sepsis"	1	304	179	483
"F13"	"C79"	"Sedative, hypnotic, or anxiolytic related disorders"	"Secondary malignant neoplasm of other and unspecified sites"	1	37	2	39
"F13"	"F03"	"Sedative, hypnotic, or anxiolytic related disorders"	"Unspecified dementia"	1	142	66	208
"F17"	"A04"	"Nicotine dependence"	"Other bacterial intestinal infections"	1	529	332	861
"F17"	"C22"	"Nicotine dependence"	"Malignant neoplasm of liver and intrahepatic bile ducts"	1	209	88	297
"F17"	"C77"	"Nicotine dependence"	"Secondary and unspecified malignant neoplasm of lymph nodes"	1	352	196	548
"F17"	"D63"	"Nicotine dependence"	"Anemia in chronic diseases classified elsewhere"	1	419	212	631
"F17"	"E13"	"Nicotine dependence"	"Other specified diabetes mellitus"	1	250	129	379
"F17"	"F05"	"Nicotine dependence"	"Delirium due to known physiological condition"	1	717	277	994
"F17"	"G47"	"Nicotine dependence"	"Sleep disorders"	1	1256	674	1930
"F17"	"J69"	"Nicotine dependence"	"Pneumonitis due to solids and liquids"	1	356	166	522
"F17"	"J96"	"Nicotine dependence"	"Respiratory failure, not elsewhere classified"	1	2824	1508	4332
"F17"	"M80"	"Nicotine dependence"	"Osteoporosis with current pathological fracture"	1	616	381	997
"F17"	"M81"	"Nicotine dependence"	"Osteoporosis without current pathological fracture"	1	1462	966	2428
"F17"	"N17"	"Nicotine dependence"	"Acute kidney failure"	1	631	366	997
"F17"	"O72"	"Nicotine dependence"	"Postpartum hemorrhage"	1	2502	1029	3531
"F19"	"E87"	"Other psychoactive substance related disorders"	"Other disorders of fluid, electrolyte and acid-base balance"	1	172	74	246
"F19"	"I46"	"Other psychoactive substance related disorders"	"Cardiac arrest"	1	115	15	130
"F19"	"J15"	"Other psychoactive substance related disorders"	"Bacterial pneumonia, not elsewhere classified"	1	216	91	307
"F19"	"J96"	"Other psychoactive substance related disorders"	"Respiratory failure, not elsewhere classified"	1	267	120	387
"F19"	"N39"	"Other psychoactive substance related disorders"	"Other disorders of urinary system"	1	140	68	208
"F20"	"A41"	"Schizophrenia"	"Other sepsis"	1	727	355	1082
"F20"	"A49"	"Schizophrenia"	"Bacterial infection of unspecified site"	1	312	152	464
"F20"	"E87"	"Schizophrenia"	"Other disorders of fluid, electrolyte and acid-base balance"	1	681	421	1102
"F20"	"G96"	"Schizophrenia"	"Other disorders of central nervous system"	1	231	105	336
"F20"	"I46"	"Schizophrenia"	"Cardiac arrest"	1	311	64	375
"F20"	"J15"	"Schizophrenia"	"Bacterial pneumonia, not elsewhere classified"	1	754	371	1125
"F20"	"O72"	"Schizophrenia"	"Postpartum hemorrhage"	1	237	59	296
"F23"	"I46"	"Brief psychotic disorder"	"Cardiac arrest"	1	83	19	102
"F23"	"J96"	"Brief psychotic disorder"	"Respiratory failure, not elsewhere classified"	1	197	74	271
"F29"	"A41"	"Unsp psychosis not due to a substance or known physiol cond"	"Other sepsis"	1	101	20	121
"F31"	"A41"	"Bipolar disorder"	"Other sepsis"	1	493	214	707
"F31"	"A49"	"Bipolar disorder"	"Bacterial infection of unspecified site"	1	188	94	282
"F31"	"E86"	"Bipolar disorder"	"Volume depletion"	1	702	477	1179
"F31"	"I46"	"Bipolar disorder"	"Cardiac arrest"	1	149	17	166
"F31"	"J96"	"Bipolar disorder"	"Respiratory failure, not elsewhere classified"	1	477	225	702
"F32"	"A04"	"Depressive episode"	"Other bacterial intestinal infections"	1	844	566	1410
"F32"	"F02"	"Depressive episode"	"Dementia in other diseases classified elsewhere"	1	325	170	495
"F32"	"F20"	"Depressive episode"	"Schizophrenia"	1	441	226	667
"F32"	"F31"	"Depressive episode"	"Bipolar disorder"	1	818	419	1237
"F32"	"F33"	"Depressive episode"	"Major depressive disorder, recurrent"	1	4484	2474	6958
"F32"	"F34"	"Depressive episode"	"Persistent mood [affective] disorders"	1	687	466	1153
"F32"	"G30"	"Depressive episode"	"Alzheimer's disease"	1	1125	865	1990
"F32"	"J15"	"Depressive episode"	"Bacterial pneumonia, not elsewhere classified"	1	3650	2096	5746
"F32"	"J69"	"Depressive episode"	"Pneumonitis due to solids and liquids"	1	900	273	1173
"F32"	"J96"	"Depressive episode"	"Respiratory failure, not elsewhere classified"	1	3624	1678	5302
"F32"	"K92"	"Depressive episode"	"Other diseases of digestive system"	1	2007	1633	3640
"F32"	"L89"	"Depressive episode"	"Pressure ulcer"	1	991	450	1441
"F32"	"O72"	"Depressive episode"	"Postpartum hemorrhage"	1	1190	546	1736
"F33"	"A49"	"Major depressive disorder, recurrent"	"Bacterial infection of unspecified site"	1	861	659	1520
"F33"	"C78"	"Major depressive disorder, recurrent"	"Secondary malignant neoplasm of resp and digestive organs"	1	370	226	596
"F33"	"J69"	"Major depressive disorder, recurrent"	"Pneumonitis due to solids and liquids"	1	414	236	650
"F41"	"K64"	"Other anxiety disorders"	"Hemorrhoids and perianal venous thrombosis"	1	312	148	460
"F43"	"A41"	"Reaction to severe stress, and adjustment disorders"	"Other sepsis"	1	534	305	839
"F43"	"C34"	"Reaction to severe stress, and adjustment disorders"	"Malignant neoplasm of bronchus and lung"	1	175	85	260
"F43"	"E87"	"Reaction to severe stress, and adjustment disorders"	"Other disorders of fluid, electrolyte and acid-base balance"	1	472	287	759
"F43"	"F05"	"Reaction to severe stress, and adjustment disorders"	"Delirium due to known physiological condition"	1	164	84	248
"F43"	"G98"	"Reaction to severe stress, and adjustment disorders"	"Other disorders of nervous system not elsewhere classified"	1	228	130	358
"F48"	"F03"	"Other nonpsychotic mental disorders"	"Unspecified dementia"	1	102	29	131
"F48"	"J18"	"Other nonpsychotic mental disorders"	"Pneumonia, unspecified organism"	1	311	102	413
"F48"	"N30"	"Other nonpsychotic mental disorders"	"Cystitis"	1	209	96	305
"F50"	"A49"	"Eating disorders"	"Bacterial infection of unspecified site"	1	82	18	100
"F50"	"F17"	"Eating disorders"	"Nicotine dependence"	1	103	41	144
"F50"	"G56"	"Eating disorders"	"Mononeuropathies of upper limb"	1	62	16	78
"F50"	"M85"	"Eating disorders"	"Other disorders of bone density and structure"	1	117	12	129
"F50"	"N92"	"Eating disorders"	"Excessive, frequent and irregular menstruation"	1	139	36	175
"F50"	"N94"	"Eating disorders"	"Pain and oth cond assoc w fem gntl org and menstrual cycle"	1	68	19	87
"F50"	"O02"	"Eating disorders"	"Other abnormal products of conception"	1	93	19	112
"F50"	"O08"	"Eating disorders"	"Complications following ectopic and molar pregnancy"	1	51	11	62
"F50"	"O32"	"Eating disorders"	"Maternal care for malpresentation of fetus"	1	41	6	47
"F50"	"O36"	"Eating disorders"	"Maternal care for other fetal problems"	1	141	32	173
"F50"	"O42"	"Eating disorders"	"Premature rupture of membranes"	1	113	22	135
"F50"	"O62"	"Eating disorders"	"Abnormalities of forces of labor"	1	279	98	377
"F50"	"O63"	"Eating disorders"	"Long labor"	1	44	5	49
"F50"	"O68"	"Eating disorders"	"Labor and delivery comp by abnlt of fetal acid-base balance"	1	266	50	316
"F50"	"O71"	"Eating disorders"	"Other obstetric trauma"	1	59	7	66
"F50"	"O80"	"Eating disorders"	"Encounter for full-term uncomplicated delivery"	1	581	160	741
"F52"	"J44"	"Sexual dysfnct not due to a substance or known physiol cond"	"Other chronic obstructive pulmonary disease"	1	57	12	69
"F52"	"J96"	"Sexual dysfnct not due to a substance or known physiol cond"	"Respiratory failure, not elsewhere classified"	1	33	1	34
"F55"	"I46"	"Abuse of non-psychoactive substances"	"Cardiac arrest"	1	29	2	31
"F60"	"A41"	"Specific personality disorders"	"Other sepsis"	1	225	81	306
"F79"	"A41"	"Unspecified intellectual disabilities"	"Other sepsis"	1	278	79	357
"F79"	"A49"	"Unspecified intellectual disabilities"	"Bacterial infection of unspecified site"	1	120	40	160
"F79"	"J69"	"Unspecified intellectual disabilities"	"Pneumonitis due to solids and liquids"	1	132	31	163
"F79"	"J96"	"Unspecified intellectual disabilities"	"Respiratory failure, not elsewhere classified"	1	247	91	338
"F95"	"O72"	"Tic disorder"	"Postpartum hemorrhage"	1	29	0	29
"F98"	"M41"	"Oth behav/emotn disord w onset usly occur in chldhd and adol"	"Scoliosis"	1	59	5	64
"F98"	"O80"	"Oth behav/emotn disord w onset usly occur in chldhd and adol"	"Encounter for full-term uncomplicated delivery"	1	66	0	66
"F99"	"C78"	"Mental disorder, not otherwise specified"	"Secondary malignant neoplasm of resp and digestive organs"	1	50	3	53
"F99"	"D64"	"Mental disorder, not otherwise specified"	"Other anemias"	1	200	86	286
"F99"	"I46"	"Mental disorder, not otherwise specified"	"Cardiac arrest"	1	96	10	106
"F99"	"J15"	"Mental disorder, not otherwise specified"	"Bacterial pneumonia, not elsewhere classified"	1	217	51	268
"F99"	"J18"	"Mental disorder, not otherwise specified"	"Pneumonia, unspecified organism"	1	570	241	811
"F99"	"J69"	"Mental disorder, not otherwise specified"	"Pneumonitis due to solids and liquids"	1	64	10	74
"F99"	"K59"	"Mental disorder, not otherwise specified"	"Other functional intestinal disorders"	1	305	183	488
"F99"	"K70"	"Mental disorder, not otherwise specified"	"Alcoholic liver disease"	1	115	44	159
"F99"	"N39"	"Mental disorder, not otherwise specified"	"Other disorders of urinary system"	1	305	116	421
"G00"	"G80"	"Bacterial meningitis, not elsewhere classified"	"Cerebral palsy"	1	99	38	137
"G00"	"H57"	"Bacterial meningitis, not elsewhere classified"	"Other disorders of eye and adnexa"	1	72	14	86
"G00"	"H65"	"Bacterial meningitis, not elsewhere classified"	"Nonsuppurative otitis media"	1	292	163	455
"G00"	"H90"	"Bacterial meningitis, not elsewhere classified"	"Conductive and sensorineural hearing loss"	1	314	142	456
"G00"	"H94"	"Bacterial meningitis, not elsewhere classified"	"Other disorders of ear in diseases classified elsewhere"	1	329	46	375
"G04"	"N31"	"Encephalitis, myelitis and encephalomyelitis"	"Neuromuscular dysfunction of bladder, NEC"	1	103	32	135
"G06"	"G09"	"Intracranial and intraspinal abscess and granuloma"	"Sequelae of inflammatory diseases of central nervous system"	1	74	17	91
"G10"	"J18"	"Huntington's disease"	"Pneumonia, unspecified organism"	1	92	31	123
"G11"	"A41"	"Hereditary ataxia"	"Other sepsis"	1	69	15	84
"G11"	"J69"	"Hereditary ataxia"	"Pneumonitis due to solids and liquids"	1	26	0	26
"G11"	"J96"	"Hereditary ataxia"	"Respiratory failure, not elsewhere classified"	1	87	9	96
"G12"	"A41"	"Spinal muscular atrophy and related syndromes"	"Other sepsis"	1	114	38	152
"G12"	"F41"	"Spinal muscular atrophy and related syndromes"	"Other anxiety disorders"	1	116	24	140
"G12"	"G82"	"Spinal muscular atrophy and related syndromes"	"Paraplegia (paraparesis) and quadriplegia (quadriparesis)"	1	290	111	401
"G12"	"J15"	"Spinal muscular atrophy and related syndromes"	"Bacterial pneumonia, not elsewhere classified"	1	288	91	379
"G12"	"J69"	"Spinal muscular atrophy and related syndromes"	"Pneumonitis due to solids and liquids"	1	86	31	117
"G12"	"J95"	"Spinal muscular atrophy and related syndromes"	"Intraop and postproc comp and disorders of resp sys, NEC"	1	53	5	58
"G12"	"J96"	"Spinal muscular atrophy and related syndromes"	"Respiratory failure, not elsewhere classified"	1	1506	407	1913
"G20"	"A04"	"Parkinson's disease"	"Other bacterial intestinal infections"	1	250	104	354
"G20"	"C78"	"Parkinson's disease"	"Secondary malignant neoplasm of resp and digestive organs"	1	206	72	278
"G20"	"C79"	"Parkinson's disease"	"Secondary malignant neoplasm of other and unspecified sites"	1	158	73	231
"G20"	"D64"	"Parkinson's disease"	"Other anemias"	1	1459	967	2426
"G20"	"E41"	"Parkinson's disease"	"Nutritional marasmus"	1	85	16	101
"G20"	"F02"	"Parkinson's disease"	"Dementia in other diseases classified elsewhere"	1	1410	310	1720
"G20"	"F05"	"Parkinson's disease"	"Delirium due to known physiological condition"	1	564	252	816
"G20"	"G23"	"Parkinson's disease"	"Other degenerative diseases of basal ganglia"	1	597	330	927
"G20"	"I46"	"Parkinson's disease"	"Cardiac arrest"	1	361	51	412
"G20"	"J22"	"Parkinson's disease"	"Unspecified acute lower respiratory infection"	1	172	64	236
"G20"	"J81"	"Parkinson's disease"	"Pulmonary edema"	1	365	129	494
"G20"	"K56"	"Parkinson's disease"	"Paralytic ileus and intestinal obstruction without hernia"	1	460	301	761
"G20"	"N30"	"Parkinson's disease"	"Cystitis"	1	2745	2056	4801
"G20"	"N39"	"Parkinson's disease"	"Other disorders of urinary system"	1	2188	1440	3628
"G21"	"A41"	"Secondary parkinsonism"	"Other sepsis"	1	370	166	536
"G21"	"F02"	"Secondary parkinsonism"	"Dementia in other diseases classified elsewhere"	1	182	78	260
"G21"	"J15"	"Secondary parkinsonism"	"Bacterial pneumonia, not elsewhere classified"	1	308	153	461
"G23"	"J69"	"Other degenerative diseases of basal ganglia"	"Pneumonitis due to solids and liquids"	1	146	44	190
"G23"	"J96"	"Other degenerative diseases of basal ganglia"	"Respiratory failure, not elsewhere classified"	1	185	76	261
"G24"	"C34"	"Dystonia"	"Malignant neoplasm of bronchus and lung"	1	86	15	101
"G24"	"C78"	"Dystonia"	"Secondary malignant neoplasm of resp and digestive organs"	1	62	2	64
"G24"	"C79"	"Dystonia"	"Secondary malignant neoplasm of other and unspecified sites"	1	57	3	60
"G24"	"E86"	"Dystonia"	"Volume depletion"	1	274	120	394
"G24"	"J15"	"Dystonia"	"Bacterial pneumonia, not elsewhere classified"	1	201	103	304
"G24"	"J96"	"Dystonia"	"Respiratory failure, not elsewhere classified"	1	230	127	357
"G24"	"O72"	"Dystonia"	"Postpartum hemorrhage"	1	142	44	186
"G25"	"C34"	"Other extrapyramidal and movement disorders"	"Malignant neoplasm of bronchus and lung"	1	158	60	218
"G25"	"F03"	"Other extrapyramidal and movement disorders"	"Unspecified dementia"	1	277	156	433
"G25"	"F05"	"Other extrapyramidal and movement disorders"	"Delirium due to known physiological condition"	1	178	64	242
"G25"	"J69"	"Other extrapyramidal and movement disorders"	"Pneumonitis due to solids and liquids"	1	107	19	126
"G25"	"J96"	"Other extrapyramidal and movement disorders"	"Respiratory failure, not elsewhere classified"	1	432	195	627
"G30"	"I46"	"Alzheimer's disease"	"Cardiac arrest"	1	144	55	199
"G30"	"J69"	"Alzheimer's disease"	"Pneumonitis due to solids and liquids"	1	293	144	437
"G31"	"J69"	"Oth degenerative diseases of nervous system, NEC"	"Pneumonitis due to solids and liquids"	1	242	91	333
"G31"	"J96"	"Oth degenerative diseases of nervous system, NEC"	"Respiratory failure, not elsewhere classified"	1	504	289	793
"G35"	"A46"	"Multiple sclerosis"	"Erysipelas"	1	206	3	209
"G35"	"C44"	"Multiple sclerosis"	"Other and unspecified malignant neoplasm of skin"	1	68	6	74
"G35"	"C77"	"Multiple sclerosis"	"Secondary and unspecified malignant neoplasm of lymph nodes"	1	45	4	49
"G35"	"D12"	"Multiple sclerosis"	"Benign neoplasm of colon, rectum, anus and anal canal"	1	163	2	165
"G35"	"D50"	"Multiple sclerosis"	"Iron deficiency anemia"	1	104	13	117
"G35"	"D62"	"Multiple sclerosis"	"Acute posthemorrhagic anemia"	1	41	2	43
"G35"	"D63"	"Multiple sclerosis"	"Anemia in chronic diseases classified elsewhere"	1	36	1	37
"G35"	"D64"	"Multiple sclerosis"	"Other anemias"	1	255	5	260
"G35"	"E03"	"Multiple sclerosis"	"Other hypothyroidism"	1	161	57	218
"G35"	"E11"	"Multiple sclerosis"	"Type 2 diabetes mellitus"	1	265	112	377
"G35"	"E78"	"Multiple sclerosis"	"Disorders of lipoprotein metabolism and other lipidemias"	1	260	90	350
"G35"	"E83"	"Multiple sclerosis"	"Disorders of mineral metabolism"	1	33	0	33
"G35"	"E86"	"Multiple sclerosis"	"Volume depletion"	1	404	0	404
"G35"	"F33"	"Multiple sclerosis"	"Major depressive disorder, recurrent"	1	73	21	94
"G35"	"G50"	"Multiple sclerosis"	"Disorders of trigeminal nerve"	1	145	33	178
"G35"	"H02"	"Multiple sclerosis"	"Other disorders of eyelid"	1	78	18	96
"G35"	"H25"	"Multiple sclerosis"	"Age-related cataract"	1	346	24	370
"G35"	"H35"	"Multiple sclerosis"	"Other retinal disorders"	1	140	54	194
"G35"	"H91"	"Multiple sclerosis"	"Other and unspecified hearing loss"	1	253	120	373
"G35"	"I25"	"Multiple sclerosis"	"Chronic ischemic heart disease"	1	245	45	290
"G35"	"I35"	"Multiple sclerosis"	"Nonrheumatic aortic valve disorders"	1	86	3	89
"G35"	"I44"	"Multiple sclerosis"	"Atrioventricular and left bundle-branch block"	1	47	1	48
"G35"	"I47"	"Multiple sclerosis"	"Paroxysmal tachycardia"	1	92	35	127
"G35"	"I49"	"Multiple sclerosis"	"Other cardiac arrhythmias"	1	77	20	97
"G35"	"I61"	"Multiple sclerosis"	"Nontraumatic intracerebral hemorrhage"	1	53	6	59
"G35"	"I63"	"Multiple sclerosis"	"Cerebral infarction"	1	200	105	305
"G35"	"I89"	"Multiple sclerosis"	"Oth noninfective disorders of lymphatic vessels and nodes"	1	27	1	28
"G35"	"J15"	"Multiple sclerosis"	"Bacterial pneumonia, not elsewhere classified"	1	346	0	346
"G35"	"J22"	"Multiple sclerosis"	"Unspecified acute lower respiratory infection"	1	26	0	26
"G35"	"J44"	"Multiple sclerosis"	"Other chronic obstructive pulmonary disease"	1	261	31	292
"G35"	"K02"	"Multiple sclerosis"	"Dental caries"	1	79	10	89
"G35"	"K08"	"Multiple sclerosis"	"Other disorders of teeth and supporting structures"	1	44	6	50
"G35"	"K52"	"Multiple sclerosis"	"Other and unsp noninfective gastroenteritis and colitis"	1	150	36	186
"G35"	"K59"	"Multiple sclerosis"	"Other functional intestinal disorders"	1	738	36	774
"G35"	"K62"	"Multiple sclerosis"	"Other diseases of anus and rectum"	1	179	33	212
"G35"	"K64"	"Multiple sclerosis"	"Hemorrhoids and perianal venous thrombosis"	1	84	0	84
"G35"	"K85"	"Multiple sclerosis"	"Acute pancreatitis"	1	58	8	66
"G35"	"L89"	"Multiple sclerosis"	"Pressure ulcer"	1	506	4	510
"G35"	"L97"	"Multiple sclerosis"	"Non-pressure chronic ulcer of lower limb, NEC"	1	101	0	101
"G35"	"L98"	"Multiple sclerosis"	"Oth disorders of skin, subcu, not elsewhere classified"	1	117	3	120
"G35"	"M19"	"Multiple sclerosis"	"Other and unspecified osteoarthritis"	1	104	27	131
"G35"	"N12"	"Multiple sclerosis"	"Tubulo-interstitial nephritis, not spcf as acute or chronic"	1	34	0	34
"G35"	"N17"	"Multiple sclerosis"	"Acute kidney failure"	1	38	0	38
"G35"	"N18"	"Multiple sclerosis"	"Chronic kidney disease (CKD)"	1	72	0	72
"G35"	"N21"	"Multiple sclerosis"	"Calculus of lower urinary tract"	1	120	0	120
"G35"	"N32"	"Multiple sclerosis"	"Other disorders of bladder"	1	72	17	89
"G35"	"N35"	"Multiple sclerosis"	"Urethral stricture"	1	34	4	38
"G35"	"N48"	"Multiple sclerosis"	"Other disorders of penis"	1	132	56	188
"G35"	"N81"	"Multiple sclerosis"	"Female genital prolapse"	1	111	35	146
"G37"	"C34"	"Other demyelinating diseases of central nervous system"	"Malignant neoplasm of bronchus and lung"	1	37	3	40
"G37"	"G35"	"Other demyelinating diseases of central nervous system"	"Multiple sclerosis"	1	1915	775	2690
"G37"	"I48"	"Other demyelinating diseases of central nervous system"	"Atrial fibrillation and flutter"	1	70	16	86
"G37"	"J15"	"Other demyelinating diseases of central nervous system"	"Bacterial pneumonia, not elsewhere classified"	1	118	28	146
"G37"	"J69"	"Other demyelinating diseases of central nervous system"	"Pneumonitis due to solids and liquids"	1	42	7	49
"G37"	"L89"	"Other demyelinating diseases of central nervous system"	"Pressure ulcer"	1	93	20	113
"G40"	"A40"	"Epilepsy and recurrent seizures"	"Streptococcal sepsis"	1	199	87	286
"G40"	"A54"	"Epilepsy and recurrent seizures"	"Gonococcal infection"	1	31	0	31
"G40"	"B36"	"Epilepsy and recurrent seizures"	"Other superficial mycoses"	1	95	31	126
"G40"	"C15"	"Epilepsy and recurrent seizures"	"Malignant neoplasm of esophagus"	1	114	27	141
"G40"	"C78"	"Epilepsy and recurrent seizures"	"Secondary malignant neoplasm of resp and digestive organs"	1	602	256	858
"G40"	"C80"	"Epilepsy and recurrent seizures"	"Malignant neoplasm without specification of site"	1	116	42	158
"G40"	"D12"	"Epilepsy and recurrent seizures"	"Benign neoplasm of colon, rectum, anus and anal canal"	1	834	378	1212
"G40"	"D22"	"Epilepsy and recurrent seizures"	"Melanocytic nevi"	1	219	53	272
"G40"	"D46"	"Epilepsy and recurrent seizures"	"Myelodysplastic syndromes"	1	70	21	91
"G40"	"E03"	"Epilepsy and recurrent seizures"	"Other hypothyroidism"	1	724	542	1266
"G40"	"E55"	"Epilepsy and recurrent seizures"	"Vitamin D deficiency"	1	383	140	523
"G40"	"F05"	"Epilepsy and recurrent seizures"	"Delirium due to known physiological condition"	1	856	361	1217
"G40"	"F06"	"Epilepsy and recurrent seizures"	"Other mental disorders due to known physiological condition"	1	512	248	760
"G40"	"F33"	"Epilepsy and recurrent seizures"	"Major depressive disorder, recurrent"	1	859	450	1309
"G40"	"F41"	"Epilepsy and recurrent seizures"	"Other anxiety disorders"	1	1030	323	1353
"G40"	"F44"	"Epilepsy and recurrent seizures"	"Dissociative and conversion disorders"	1	831	246	1077
"G40"	"F60"	"Epilepsy and recurrent seizures"	"Specific personality disorders"	1	265	110	375
"G40"	"F70"	"Epilepsy and recurrent seizures"	"Mild intellectual disabilities"	1	563	252	815
"G40"	"F71"	"Epilepsy and recurrent seizures"	"Moderate intellectual disabilities"	1	389	228	617
"G40"	"F72"	"Epilepsy and recurrent seizures"	"Severe intellectual disabilities"	1	483	231	714
"G40"	"F73"	"Epilepsy and recurrent seizures"	"Profound intellectual disabilities"	1	256	148	404
"G40"	"F78"	"Epilepsy and recurrent seizures"	"Other intellectual disabilities"	1	92	30	122
"G40"	"F79"	"Epilepsy and recurrent seizures"	"Unspecified intellectual disabilities"	1	1100	456	1556
"G40"	"F84"	"Epilepsy and recurrent seizures"	"Pervasive developmental disorders"	1	557	310	867
"G40"	"F89"	"Epilepsy and recurrent seizures"	"Unspecified disorder of psychological development"	1	69	15	84
"G40"	"G24"	"Epilepsy and recurrent seizures"	"Dystonia"	1	310	115	425
"G40"	"G62"	"Epilepsy and recurrent seizures"	"Other and unspecified polyneuropathies"	1	619	395	1014
"G40"	"G95"	"Epilepsy and recurrent seizures"	"Other and unspecified diseases of spinal cord"	1	176	85	261
"G40"	"G98"	"Epilepsy and recurrent seizures"	"Other disorders of nervous system not elsewhere classified"	1	1203	876	2079
"G40"	"H47"	"Epilepsy and recurrent seizures"	"Other disorders of optic [2nd] nerve and visual pathways"	1	472	173	645
"G40"	"H52"	"Epilepsy and recurrent seizures"	"Disorders of refraction and accommodation"	1	1119	471	1590
"G40"	"H54"	"Epilepsy and recurrent seizures"	"Blindness and low vision"	1	600	281	881
"G40"	"H55"	"Epilepsy and recurrent seizures"	"Nystagmus and other irregular eye movements"	1	138	56	194
"G40"	"I40"	"Epilepsy and recurrent seizures"	"Acute myocarditis"	1	113	27	140
"G40"	"I50"	"Epilepsy and recurrent seizures"	"Heart failure"	1	2213	1515	3728
"G40"	"I51"	"Epilepsy and recurrent seizures"	"Complications and ill-defined descriptions of heart disease"	1	249	126	375
"G40"	"I89"	"Epilepsy and recurrent seizures"	"Oth noninfective disorders of lymphatic vessels and nodes"	1	123	42	165
"G40"	"I95"	"Epilepsy and recurrent seizures"	"Hypotension"	1	743	400	1143
"G40"	"J09"	"Epilepsy and recurrent seizures"	"Influenza due to certain identified influenza viruses"	1	126	4	130
"G40"	"J15"	"Epilepsy and recurrent seizures"	"Bacterial pneumonia, not elsewhere classified"	1	4312	0	4312
"G40"	"J22"	"Epilepsy and recurrent seizures"	"Unspecified acute lower respiratory infection"	1	372	82	454
"G40"	"J69"	"Epilepsy and recurrent seizures"	"Pneumonitis due to solids and liquids"	1	1207	246	1453
"G40"	"J81"	"Epilepsy and recurrent seizures"	"Pulmonary edema"	1	625	163	788
"G40"	"J90"	"Epilepsy and recurrent seizures"	"Pleural effusion, not elsewhere classified"	1	392	133	525
"G40"	"J93"	"Epilepsy and recurrent seizures"	"Pneumothorax and air leak"	1	243	138	381
"G40"	"J96"	"Epilepsy and recurrent seizures"	"Respiratory failure, not elsewhere classified"	1	3051	1018	4069
"G40"	"J98"	"Epilepsy and recurrent seizures"	"Other respiratory disorders"	1	390	256	646
"G40"	"K08"	"Epilepsy and recurrent seizures"	"Other disorders of teeth and supporting structures"	1	323	122	445
"G40"	"K22"	"Epilepsy and recurrent seizures"	"Other diseases of esophagus"	1	382	206	588
"G40"	"K37"	"Epilepsy and recurrent seizures"	"Unspecified appendicitis"	1	71	5	76
"G40"	"K59"	"Epilepsy and recurrent seizures"	"Other functional intestinal disorders"	1	3549	1466	5015
"G40"	"K63"	"Epilepsy and recurrent seizures"	"Other diseases of intestine"	1	231	80	311
"G40"	"K64"	"Epilepsy and recurrent seizures"	"Hemorrhoids and perianal venous thrombosis"	1	377	0	377
"G40"	"K65"	"Epilepsy and recurrent seizures"	"Peritonitis"	1	306	160	466
"G40"	"K71"	"Epilepsy and recurrent seizures"	"Toxic liver disease"	1	202	97	299
"G40"	"K76"	"Epilepsy and recurrent seizures"	"Other diseases of liver"	1	350	168	518
"G40"	"L05"	"Epilepsy and recurrent seizures"	"Pilonidal cyst and sinus"	1	199	67	266
"G40"	"L27"	"Epilepsy and recurrent seizures"	"Dermatitis due to substances taken internally"	1	257	117	374
"G40"	"L30"	"Epilepsy and recurrent seizures"	"Other and unspecified dermatitis"	1	559	222	781
"G40"	"L97"	"Epilepsy and recurrent seizures"	"Non-pressure chronic ulcer of lower limb, NEC"	1	473	187	660
"G40"	"M21"	"Epilepsy and recurrent seizures"	"Other acquired deformities of limbs"	1	455	198	653
"G40"	"M23"	"Epilepsy and recurrent seizures"	"Internal derangement of knee"	1	1105	727	1832
"G40"	"M41"	"Epilepsy and recurrent seizures"	"Scoliosis"	1	518	131	649
"G40"	"M67"	"Epilepsy and recurrent seizures"	"Other disorders of synovium and tendon"	1	495	252	747
"G40"	"M80"	"Epilepsy and recurrent seizures"	"Osteoporosis with current pathological fracture"	1	859	338	1197
"G40"	"M81"	"Epilepsy and recurrent seizures"	"Osteoporosis without current pathological fracture"	1	1669	580	2249
"G40"	"M85"	"Epilepsy and recurrent seizures"	"Other disorders of bone density and structure"	1	481	72	553
"G40"	"N28"	"Epilepsy and recurrent seizures"	"Oth disorders of kidney and ureter, not elsewhere classified"	1	214	87	301
"G40"	"N39"	"Epilepsy and recurrent seizures"	"Other disorders of urinary system"	1	3858	1665	5523
"G40"	"N46"	"Epilepsy and recurrent seizures"	"Male infertility"	1	133	19	152
"G40"	"N47"	"Epilepsy and recurrent seizures"	"Disorders of prepuce"	1	424	274	698
"G40"	"N50"	"Epilepsy and recurrent seizures"	"Other and unspecified disorders of male genital organs"	1	166	78	244
"G40"	"N64"	"Epilepsy and recurrent seizures"	"Other disorders of breast"	1	198	63	261
"G40"	"N83"	"Epilepsy and recurrent seizures"	"Noninflammatory disord of ovary, fallop and broad ligament"	1	381	210	591
"G40"	"N93"	"Epilepsy and recurrent seizures"	"Other abnormal uterine and vaginal bleeding"	1	166	42	208
"G40"	"N94"	"Epilepsy and recurrent seizures"	"Pain and oth cond assoc w fem gntl org and menstrual cycle"	1	268	125	393
"G40"	"N97"	"Epilepsy and recurrent seizures"	"Female infertility"	1	282	106	388
"G40"	"O02"	"Epilepsy and recurrent seizures"	"Other abnormal products of conception"	1	287	131	418
"G40"	"O14"	"Epilepsy and recurrent seizures"	"Pre-eclampsia"	1	142	62	204
"G40"	"O21"	"Epilepsy and recurrent seizures"	"Excessive vomiting in pregnancy"	1	89	33	122
"G40"	"O24"	"Epilepsy and recurrent seizures"	"Diabetes in pregnancy, childbirth, and the puerperium"	1	107	28	135
"G40"	"O26"	"Epilepsy and recurrent seizures"	"Maternal care for oth conditions predom related to pregnancy"	1	385	127	512
"G40"	"O28"	"Epilepsy and recurrent seizures"	"Abnormal findings on antenatal screening of mother"	1	59	9	68
"G40"	"O36"	"Epilepsy and recurrent seizures"	"Maternal care for other fetal problems"	1	326	77	403
"G40"	"O42"	"Epilepsy and recurrent seizures"	"Premature rupture of membranes"	1	299	71	370
"G40"	"O47"	"Epilepsy and recurrent seizures"	"False labor"	1	291	90	381
"G40"	"O62"	"Epilepsy and recurrent seizures"	"Abnormalities of forces of labor"	1	921	440	1361
"G40"	"O70"	"Epilepsy and recurrent seizures"	"Perineal laceration during delivery"	1	1116	193	1309
"G40"	"O80"	"Epilepsy and recurrent seizures"	"Encounter for full-term uncomplicated delivery"	1	1459	903	2362
"G40"	"Q65"	"Epilepsy and recurrent seizures"	"Congenital deformities of hip"	1	192	95	287
"G43"	"A41"	"Migraine"	"Other sepsis"	1	478	44	522
"G43"	"A49"	"Migraine"	"Bacterial infection of unspecified site"	1	293	74	367
"G43"	"C34"	"Migraine"	"Malignant neoplasm of bronchus and lung"	1	218	0	218
"G43"	"C50"	"Migraine"	"Malignant neoplasm of breast"	1	366	137	503
"G43"	"C77"	"Migraine"	"Secondary and unspecified malignant neoplasm of lymph nodes"	1	105	11	116
"G43"	"C79"	"Migraine"	"Secondary malignant neoplasm of other and unspecified sites"	1	171	9	180
"G43"	"C80"	"Migraine"	"Malignant neoplasm without specification of site"	1	28	0	28
"G43"	"D12"	"Migraine"	"Benign neoplasm of colon, rectum, anus and anal canal"	1	653	58	711
"G43"	"D17"	"Migraine"	"Benign lipomatous neoplasm"	1	279	161	440
"G43"	"D22"	"Migraine"	"Melanocytic nevi"	1	260	151	411
"G43"	"D63"	"Migraine"	"Anemia in chronic diseases classified elsewhere"	1	106	10	116
"G43"	"D64"	"Migraine"	"Other anemias"	1	531	175	706
"G43"	"E13"	"Migraine"	"Other specified diabetes mellitus"	1	52	7	59
"G43"	"E66"	"Migraine"	"Overweight and obesity"	1	1773	1151	2924
"G43"	"E68"	"Migraine"	"Sequelae of hyperalimentation"	1	130	31	161
"G43"	"E83"	"Migraine"	"Disorders of mineral metabolism"	1	115	21	136
"G43"	"F32"	"Migraine"	"Depressive episode"	1	738	468	1206
"G43"	"H25"	"Migraine"	"Age-related cataract"	1	936	143	1079
"G43"	"H26"	"Migraine"	"Other cataract"	1	347	64	411
"G43"	"H36"	"Migraine"	"Retinal disorders in diseases classified elsewhere"	1	128	42	170
"G43"	"H93"	"Migraine"	"Other disorders of ear, not elsewhere classified"	1	453	312	765
"G43"	"I10"	"Migraine"	"Essential (primary) hypertension"	1	3291	2092	5383
"G43"	"I48"	"Migraine"	"Atrial fibrillation and flutter"	1	769	197	966
"G43"	"I50"	"Migraine"	"Heart failure"	1	472	75	547
"G43"	"I73"	"Migraine"	"Other peripheral vascular diseases"	1	274	60	334
"G43"	"I80"	"Migraine"	"Phlebitis and thrombophlebitis"	1	473	192	665
"G43"	"I85"	"Migraine"	"Esophageal varices"	1	36	2	38
"G43"	"J22"	"Migraine"	"Unspecified acute lower respiratory infection"	1	59	3	62
"G43"	"J81"	"Migraine"	"Pulmonary edema"	1	54	6	60
"G43"	"J84"	"Migraine"	"Other interstitial pulmonary diseases"	1	91	6	97
"G43"	"J90"	"Migraine"	"Pleural effusion, not elsewhere classified"	1	94	6	100
"G43"	"J91"	"Migraine"	"Pleural effusion in conditions classified elsewhere"	1	37	2	39
"G43"	"J96"	"Migraine"	"Respiratory failure, not elsewhere classified"	1	451	33	484
"G43"	"K05"	"Migraine"	"Gingivitis and periodontal diseases"	1	110	45	155
"G43"	"K55"	"Migraine"	"Vascular disorders of intestine"	1	42	3	45
"G43"	"K56"	"Migraine"	"Paralytic ileus and intestinal obstruction without hernia"	1	265	108	373
"G43"	"K76"	"Migraine"	"Other diseases of liver"	1	192	59	251
"G43"	"L98"	"Migraine"	"Oth disorders of skin, subcu, not elsewhere classified"	1	163	76	239
"G43"	"M16"	"Migraine"	"Osteoarthritis of hip"	1	467	121	588
"G43"	"M17"	"Migraine"	"Osteoarthritis of knee"	1	1055	311	1366
"G43"	"M50"	"Migraine"	"Cervical disc disorders"	1	546	356	902
"G43"	"N17"	"Migraine"	"Acute kidney failure"	1	104	1	105
"G43"	"N19"	"Migraine"	"Unspecified kidney failure"	1	115	26	141
"G44"	"A46"	"Other headache syndromes"	"Erysipelas"	1	271	142	413
"G44"	"C16"	"Other headache syndromes"	"Malignant neoplasm of stomach"	1	37	2	39
"G44"	"C34"	"Other headache syndromes"	"Malignant neoplasm of bronchus and lung"	1	305	23	328
"G44"	"C77"	"Other headache syndromes"	"Secondary and unspecified malignant neoplasm of lymph nodes"	1	112	20	132
"G44"	"C78"	"Other headache syndromes"	"Secondary malignant neoplasm of resp and digestive organs"	1	194	0	194
"G44"	"D63"	"Other headache syndromes"	"Anemia in chronic diseases classified elsewhere"	1	104	12	116
"G44"	"E55"	"Other headache syndromes"	"Vitamin D deficiency"	1	226	122	348
"G44"	"E78"	"Other headache syndromes"	"Disorders of lipoprotein metabolism and other lipidemias"	1	1245	758	2003
"G44"	"E86"	"Other headache syndromes"	"Volume depletion"	1	615	223	838
"G44"	"F06"	"Other headache syndromes"	"Other mental disorders due to known physiological condition"	1	117	44	161
"G44"	"F33"	"Other headache syndromes"	"Major depressive disorder, recurrent"	1	557	273	830
"G44"	"F41"	"Other headache syndromes"	"Other anxiety disorders"	1	559	304	863
"G44"	"G47"	"Other headache syndromes"	"Sleep disorders"	1	1035	428	1463
"G44"	"G98"	"Other headache syndromes"	"Other disorders of nervous system not elsewhere classified"	1	212	94	306
"G44"	"I25"	"Other headache syndromes"	"Chronic ischemic heart disease"	1	751	485	1236
"G44"	"I35"	"Other headache syndromes"	"Nonrheumatic aortic valve disorders"	1	274	67	341
"G44"	"I46"	"Other headache syndromes"	"Cardiac arrest"	1	144	2	146
"G44"	"I48"	"Other headache syndromes"	"Atrial fibrillation and flutter"	1	667	267	934
"G44"	"I85"	"Other headache syndromes"	"Esophageal varices"	1	39	6	45
"G44"	"J18"	"Other headache syndromes"	"Pneumonia, unspecified organism"	1	1327	810	2137
"G44"	"J84"	"Other headache syndromes"	"Other interstitial pulmonary diseases"	1	102	25	127
"G44"	"J96"	"Other headache syndromes"	"Respiratory failure, not elsewhere classified"	1	558	57	615
"G44"	"K74"	"Other headache syndromes"	"Fibrosis and cirrhosis of liver"	1	60	13	73
"G44"	"K92"	"Other headache syndromes"	"Other diseases of digestive system"	1	321	203	524
"G44"	"L98"	"Other headache syndromes"	"Oth disorders of skin, subcu, not elsewhere classified"	1	178	87	265
"G44"	"M17"	"Other headache syndromes"	"Osteoarthritis of knee"	1	849	567	1416
"G44"	"N17"	"Other headache syndromes"	"Acute kidney failure"	1	127	20	147
"G44"	"N18"	"Other headache syndromes"	"Chronic kidney disease (CKD)"	1	260	41	301
"G44"	"N19"	"Other headache syndromes"	"Unspecified kidney failure"	1	102	40	142
"G44"	"O72"	"Other headache syndromes"	"Postpartum hemorrhage"	1	1602	724	2326
"G45"	"A04"	"Transient cerebral ischemic attacks and related syndromes"	"Other bacterial intestinal infections"	1	756	115	871
"G45"	"A49"	"Transient cerebral ischemic attacks and related syndromes"	"Bacterial infection of unspecified site"	1	1669	196	1865
"G45"	"B95"	"Transient cerebral ischemic attacks and related syndromes"	"Strep as the cause of diseases classified elsewhere"	1	73	21	94
"G45"	"B96"	"Transient cerebral ischemic attacks and related syndromes"	"Oth bacterial agents as the cause of diseases classd elswhr"	1	177	37	214
"G45"	"C13"	"Transient cerebral ischemic attacks and related syndromes"	"Malignant neoplasm of hypopharynx"	1	65	11	76
"G45"	"C25"	"Transient cerebral ischemic attacks and related syndromes"	"Malignant neoplasm of pancreas"	1	411	21	432
"G45"	"C34"	"Transient cerebral ischemic attacks and related syndromes"	"Malignant neoplasm of bronchus and lung"	1	2257	0	2257
"G45"	"C41"	"Transient cerebral ischemic attacks and related syndromes"	"Malignant neoplasm of bone/artic cartl of and unsp sites"	1	43	7	50
"G45"	"C61"	"Transient cerebral ischemic attacks and related syndromes"	"Malignant neoplasm of prostate"	1	1181	531	1712
"G45"	"C64"	"Transient cerebral ischemic attacks and related syndromes"	"Malignant neoplasm of kidney, except renal pelvis"	1	253	91	344
"G45"	"C67"	"Transient cerebral ischemic attacks and related syndromes"	"Malignant neoplasm of bladder"	1	364	232	596
"G45"	"C77"	"Transient cerebral ischemic attacks and related syndromes"	"Secondary and unspecified malignant neoplasm of lymph nodes"	1	473	103	576
"G45"	"C91"	"Transient cerebral ischemic attacks and related syndromes"	"Lymphoid leukemia"	1	166	76	242
"G45"	"D12"	"Transient cerebral ischemic attacks and related syndromes"	"Benign neoplasm of colon, rectum, anus and anal canal"	1	2309	1199	3508
"G45"	"D50"	"Transient cerebral ischemic attacks and related syndromes"	"Iron deficiency anemia"	1	1689	487	2176
"G45"	"D61"	"Transient cerebral ischemic attacks and related syndromes"	"Oth aplastic anemias and other bone marrow failure syndromes"	1	118	36	154
"G45"	"D62"	"Transient cerebral ischemic attacks and related syndromes"	"Acute posthemorrhagic anemia"	1	903	211	1114
"G45"	"D63"	"Transient cerebral ischemic attacks and related syndromes"	"Anemia in chronic diseases classified elsewhere"	1	957	103	1060
"G45"	"D64"	"Transient cerebral ischemic attacks and related syndromes"	"Other anemias"	1	7019	0	7019
"G45"	"E27"	"Transient cerebral ischemic attacks and related syndromes"	"Other disorders of adrenal gland"	1	174	49	223
"G45"	"E34"	"Transient cerebral ischemic attacks and related syndromes"	"Other endocrine disorders"	1	115	41	156
"G45"	"E53"	"Transient cerebral ischemic attacks and related syndromes"	"Deficiency of other B group vitamins"	1	378	141	519
"G45"	"F01"	"Transient cerebral ischemic attacks and related syndromes"	"Vascular dementia"	1	1487	210	1697
"G45"	"F03"	"Transient cerebral ischemic attacks and related syndromes"	"Unspecified dementia"	1	5516	0	5516
"G45"	"G12"	"Transient cerebral ischemic attacks and related syndromes"	"Spinal muscular atrophy and related syndromes"	1	69	14	83
"G45"	"G47"	"Transient cerebral ischemic attacks and related syndromes"	"Sleep disorders"	1	1390	537	1927
"G45"	"G81"	"Transient cerebral ischemic attacks and related syndromes"	"Hemiplegia and hemiparesis"	1	202	100	302
"G45"	"G95"	"Transient cerebral ischemic attacks and related syndromes"	"Other and unspecified diseases of spinal cord"	1	272	64	336
"G45"	"G98"	"Transient cerebral ischemic attacks and related syndromes"	"Other disorders of nervous system not elsewhere classified"	1	572	227	799
"G45"	"H35"	"Transient cerebral ischemic attacks and related syndromes"	"Other retinal disorders"	1	2168	1766	3934
"G45"	"H54"	"Transient cerebral ischemic attacks and related syndromes"	"Blindness and low vision"	1	479	267	746
"G45"	"H57"	"Transient cerebral ischemic attacks and related syndromes"	"Other disorders of eye and adnexa"	1	497	288	785
"G45"	"I27"	"Transient cerebral ischemic attacks and related syndromes"	"Other pulmonary heart diseases"	1	467	188	655
"G45"	"I35"	"Transient cerebral ischemic attacks and related syndromes"	"Nonrheumatic aortic valve disorders"	1	3138	1198	4336
"G45"	"I46"	"Transient cerebral ischemic attacks and related syndromes"	"Cardiac arrest"	1	1327	0	1327
"G45"	"I48"	"Transient cerebral ischemic attacks and related syndromes"	"Atrial fibrillation and flutter"	1	8135	7209	15344
"G45"	"I61"	"Transient cerebral ischemic attacks and related syndromes"	"Nontraumatic intracerebral hemorrhage"	1	2029	788	2817
"G45"	"I63"	"Transient cerebral ischemic attacks and related syndromes"	"Cerebral infarction"	1	9456	7788	17244
"G45"	"I65"	"Transient cerebral ischemic attacks and related syndromes"	"Occls and stenosis of precerb art, not rslt in cereb infrc"	1	4237	3546	7783
"G45"	"I70"	"Transient cerebral ischemic attacks and related syndromes"	"Atherosclerosis"	1	3041	2445	5486
"G45"	"I89"	"Transient cerebral ischemic attacks and related syndromes"	"Oth noninfective disorders of lymphatic vessels and nodes"	1	141	58	199
"G45"	"J10"	"Transient cerebral ischemic attacks and related syndromes"	"Influenza due to other identified influenza virus"	1	109	1	110
"G45"	"J13"	"Transient cerebral ischemic attacks and related syndromes"	"Pneumonia due to Streptococcus pneumoniae"	1	221	103	324
"G45"	"J22"	"Transient cerebral ischemic attacks and related syndromes"	"Unspecified acute lower respiratory infection"	1	530	57	587
"G45"	"J47"	"Transient cerebral ischemic attacks and related syndromes"	"Bronchiectasis"	1	141	47	188
"G45"	"J81"	"Transient cerebral ischemic attacks and related syndromes"	"Pulmonary edema"	1	1080	175	1255
"G45"	"J84"	"Transient cerebral ischemic attacks and related syndromes"	"Other interstitial pulmonary diseases"	1	390	142	532
"G45"	"J90"	"Transient cerebral ischemic attacks and related syndromes"	"Pleural effusion, not elsewhere classified"	1	786	127	913
"G45"	"J91"	"Transient cerebral ischemic attacks and related syndromes"	"Pleural effusion in conditions classified elsewhere"	1	316	53	369
"G45"	"J93"	"Transient cerebral ischemic attacks and related syndromes"	"Pneumothorax and air leak"	1	332	148	480
"G45"	"J94"	"Transient cerebral ischemic attacks and related syndromes"	"Other pleural conditions"	1	259	74	333
"G45"	"J95"	"Transient cerebral ischemic attacks and related syndromes"	"Intraop and postproc comp and disorders of resp sys, NEC"	1	155	29	184
"G45"	"J98"	"Transient cerebral ischemic attacks and related syndromes"	"Other respiratory disorders"	1	457	201	658
"G45"	"K52"	"Transient cerebral ischemic attacks and related syndromes"	"Other and unsp noninfective gastroenteritis and colitis"	1	1401	594	1995
"G45"	"K56"	"Transient cerebral ischemic attacks and related syndromes"	"Paralytic ileus and intestinal obstruction without hernia"	1	1151	394	1545
"G45"	"K59"	"Transient cerebral ischemic attacks and related syndromes"	"Other functional intestinal disorders"	1	5810	0	5810
"G45"	"K65"	"Transient cerebral ischemic attacks and related syndromes"	"Peritonitis"	1	379	150	529
"G45"	"K74"	"Transient cerebral ischemic attacks and related syndromes"	"Fibrosis and cirrhosis of liver"	1	186	85	271
"G45"	"K76"	"Transient cerebral ischemic attacks and related syndromes"	"Other diseases of liver"	1	342	210	552
"G45"	"K83"	"Transient cerebral ischemic attacks and related syndromes"	"Other diseases of biliary tract"	1	394	140	534
"G45"	"L89"	"Transient cerebral ischemic attacks and related syndromes"	"Pressure ulcer"	1	921	76	997
"G45"	"L98"	"Transient cerebral ischemic attacks and related syndromes"	"Oth disorders of skin, subcu, not elsewhere classified"	1	617	274	891
"G45"	"M48"	"Transient cerebral ischemic attacks and related syndromes"	"Other spondylopathies"	1	1313	1018	2331
"G45"	"M80"	"Transient cerebral ischemic attacks and related syndromes"	"Osteoporosis with current pathological fracture"	1	1676	550	2226
"G45"	"M81"	"Transient cerebral ischemic attacks and related syndromes"	"Osteoporosis without current pathological fracture"	1	2673	1367	4040
"G45"	"N13"	"Transient cerebral ischemic attacks and related syndromes"	"Obstructive and reflux uropathy"	1	610	269	879
"G45"	"N17"	"Transient cerebral ischemic attacks and related syndromes"	"Acute kidney failure"	1	999	114	1113
"G45"	"N18"	"Transient cerebral ischemic attacks and related syndromes"	"Chronic kidney disease (CKD)"	1	3053	0	3053
"G45"	"N19"	"Transient cerebral ischemic attacks and related syndromes"	"Unspecified kidney failure"	1	1313	275	1588
"G45"	"N28"	"Transient cerebral ischemic attacks and related syndromes"	"Oth disorders of kidney and ureter, not elsewhere classified"	1	462	116	578
"G45"	"N39"	"Transient cerebral ischemic attacks and related syndromes"	"Other disorders of urinary system"	1	7323	0	7323
"G46"	"I50"	"Vascular syndromes of brain in cerebrovascular diseases"	"Heart failure"	1	200	110	310
"G46"	"I69"	"Vascular syndromes of brain in cerebrovascular diseases"	"Sequelae of cerebrovascular disease"	1	871	466	1337
"G47"	"E68"	"Sleep disorders"	"Sequelae of hyperalimentation"	1	227	117	344
"G47"	"F03"	"Sleep disorders"	"Unspecified dementia"	1	293	152	445
"G47"	"G30"	"Sleep disorders"	"Alzheimer's disease"	1	148	22	170
"G50"	"C25"	"Disorders of trigeminal nerve"	"Malignant neoplasm of pancreas"	1	26	2	28
"G50"	"C78"	"Disorders of trigeminal nerve"	"Secondary malignant neoplasm of resp and digestive organs"	1	134	16	150
"G50"	"C79"	"Disorders of trigeminal nerve"	"Secondary malignant neoplasm of other and unspecified sites"	1	104	38	142
"G50"	"E78"	"Disorders of trigeminal nerve"	"Disorders of lipoprotein metabolism and other lipidemias"	1	383	227	610
"G50"	"F03"	"Disorders of trigeminal nerve"	"Unspecified dementia"	1	195	12	207
"G50"	"F05"	"Disorders of trigeminal nerve"	"Delirium due to known physiological condition"	1	101	2	103
"G50"	"G53"	"Disorders of trigeminal nerve"	"Cranial nerve disorders in diseases classified elsewhere"	1	111	31	142
"G50"	"I50"	"Disorders of trigeminal nerve"	"Heart failure"	1	382	137	519
"G50"	"I63"	"Disorders of trigeminal nerve"	"Cerebral infarction"	1	277	160	437
"G50"	"I69"	"Disorders of trigeminal nerve"	"Sequelae of cerebrovascular disease"	1	349	185	534
"G50"	"K59"	"Disorders of trigeminal nerve"	"Other functional intestinal disorders"	1	498	252	750
"G50"	"N17"	"Disorders of trigeminal nerve"	"Acute kidney failure"	1	49	10	59
"G50"	"N18"	"Disorders of trigeminal nerve"	"Chronic kidney disease (CKD)"	1	119	21	140
"G50"	"N30"	"Disorders of trigeminal nerve"	"Cystitis"	1	539	299	838
"G50"	"N39"	"Disorders of trigeminal nerve"	"Other disorders of urinary system"	1	481	184	665
"G51"	"A49"	"Facial nerve disorders"	"Bacterial infection of unspecified site"	1	177	42	219
"G51"	"C15"	"Facial nerve disorders"	"Malignant neoplasm of esophagus"	1	30	1	31
"G51"	"C78"	"Facial nerve disorders"	"Secondary malignant neoplasm of resp and digestive organs"	1	174	28	202
"G51"	"D50"	"Facial nerve disorders"	"Iron deficiency anemia"	1	126	43	169
"G51"	"D63"	"Facial nerve disorders"	"Anemia in chronic diseases classified elsewhere"	1	87	21	108
"G51"	"D64"	"Facial nerve disorders"	"Other anemias"	1	370	105	475
"G51"	"F17"	"Facial nerve disorders"	"Nicotine dependence"	1	171	66	237
"G51"	"H02"	"Facial nerve disorders"	"Other disorders of eyelid"	1	829	504	1333
"G51"	"H57"	"Facial nerve disorders"	"Other disorders of eye and adnexa"	1	150	70	220
"G51"	"I26"	"Facial nerve disorders"	"Pulmonary embolism"	1	117	39	156
"G51"	"I44"	"Facial nerve disorders"	"Atrioventricular and left bundle-branch block"	1	87	23	110
"G51"	"I50"	"Facial nerve disorders"	"Heart failure"	1	441	149	590
"G51"	"J18"	"Facial nerve disorders"	"Pneumonia, unspecified organism"	1	858	396	1254
"G51"	"J44"	"Facial nerve disorders"	"Other chronic obstructive pulmonary disease"	1	369	192	561
"G51"	"J90"	"Facial nerve disorders"	"Pleural effusion, not elsewhere classified"	1	71	8	79
"G51"	"K56"	"Facial nerve disorders"	"Paralytic ileus and intestinal obstruction without hernia"	1	112	42	154
"G51"	"K57"	"Facial nerve disorders"	"Diverticular disease of intestine"	1	274	114	388
"G51"	"K59"	"Facial nerve disorders"	"Other functional intestinal disorders"	1	490	231	721
"G51"	"L89"	"Facial nerve disorders"	"Pressure ulcer"	1	77	9	86
"G51"	"M19"	"Facial nerve disorders"	"Other and unspecified osteoarthritis"	1	217	116	333
"G51"	"M80"	"Facial nerve disorders"	"Osteoporosis with current pathological fracture"	1	128	23	151
"G51"	"M85"	"Facial nerve disorders"	"Other disorders of bone density and structure"	1	140	43	183
"G51"	"N17"	"Facial nerve disorders"	"Acute kidney failure"	1	98	14	112
"G51"	"N18"	"Facial nerve disorders"	"Chronic kidney disease (CKD)"	1	207	39	246
"G54"	"C78"	"Nerve root and plexus disorders"	"Secondary malignant neoplasm of resp and digestive organs"	1	127	20	147
"G54"	"I48"	"Nerve root and plexus disorders"	"Atrial fibrillation and flutter"	1	252	127	379
"G54"	"M47"	"Nerve root and plexus disorders"	"Spondylosis"	1	649	453	1102
"G54"	"N18"	"Nerve root and plexus disorders"	"Chronic kidney disease (CKD)"	1	85	25	110
"G56"	"A04"	"Mononeuropathies of upper limb"	"Other bacterial intestinal infections"	1	401	82	483
"G56"	"A46"	"Mononeuropathies of upper limb"	"Erysipelas"	1	1333	621	1954
"G56"	"B02"	"Mononeuropathies of upper limb"	"Zoster [herpes zoster]"	1	199	88	287
"G56"	"B37"	"Mononeuropathies of upper limb"	"Candidiasis"	1	448	139	587
"G56"	"B44"	"Mononeuropathies of upper limb"	"Aspergillosis"	1	28	1	29
"G56"	"B96"	"Mononeuropathies of upper limb"	"Oth bacterial agents as the cause of diseases classd elswhr"	1	111	18	129
"G56"	"C04"	"Mononeuropathies of upper limb"	"Malignant neoplasm of floor of mouth"	1	31	2	33
"G56"	"C10"	"Mononeuropathies of upper limb"	"Malignant neoplasm of oropharynx"	1	72	4	76
"G56"	"C17"	"Mononeuropathies of upper limb"	"Malignant neoplasm of small intestine"	1	60	4	64
"G56"	"C18"	"Mononeuropathies of upper limb"	"Malignant neoplasm of colon"	1	647	191	838
"G56"	"C20"	"Mononeuropathies of upper limb"	"Malignant neoplasm of rectum"	1	281	93	374
"G56"	"C44"	"Mononeuropathies of upper limb"	"Other and unspecified malignant neoplasm of skin"	1	1189	338	1527
"G56"	"C48"	"Mononeuropathies of upper limb"	"Malignant neoplasm of retroperitoneum and peritoneum"	1	27	1	28
"G56"	"C64"	"Mononeuropathies of upper limb"	"Malignant neoplasm of kidney, except renal pelvis"	1	184	39	223
"G56"	"C67"	"Mononeuropathies of upper limb"	"Malignant neoplasm of bladder"	1	236	68	304
"G56"	"C71"	"Mononeuropathies of upper limb"	"Malignant neoplasm of brain"	1	180	8	188
"G56"	"C78"	"Mononeuropathies of upper limb"	"Secondary malignant neoplasm of resp and digestive organs"	1	1241	0	1241
"G56"	"C79"	"Mononeuropathies of upper limb"	"Secondary malignant neoplasm of other and unspecified sites"	1	913	0	913
"G56"	"C80"	"Mononeuropathies of upper limb"	"Malignant neoplasm without specification of site"	1	125	0	125
"G56"	"C85"	"Mononeuropathies of upper limb"	"Oth and unspecified types of non-Hodgkin lymphoma"	1	136	53	189
"G56"	"C92"	"Mononeuropathies of upper limb"	"Myeloid leukemia"	1	100	15	115
"G56"	"D03"	"Mononeuropathies of upper limb"	"Melanoma in situ"	1	97	26	123
"G56"	"D13"	"Mononeuropathies of upper limb"	"Benign neoplasm of and ill-defined parts of digestive system"	1	224	87	311
"G56"	"D32"	"Mononeuropathies of upper limb"	"Benign neoplasm of meninges"	1	177	51	228
"G56"	"D35"	"Mononeuropathies of upper limb"	"Benign neoplasm of other and unspecified endocrine glands"	1	289	80	369
"G56"	"D43"	"Mononeuropathies of upper limb"	"Neoplasm of uncertain behavior of brain and cnsl"	1	97	25	122
"G56"	"D46"	"Mononeuropathies of upper limb"	"Myelodysplastic syndromes"	1	130	5	135
"G56"	"D61"	"Mononeuropathies of upper limb"	"Oth aplastic anemias and other bone marrow failure syndromes"	1	87	16	103
"G56"	"D62"	"Mononeuropathies of upper limb"	"Acute posthemorrhagic anemia"	1	398	105	503
"G56"	"D63"	"Mononeuropathies of upper limb"	"Anemia in chronic diseases classified elsewhere"	1	561	25	586
"G56"	"D68"	"Mononeuropathies of upper limb"	"Other coagulation defects"	1	294	173	467
"G56"	"D69"	"Mononeuropathies of upper limb"	"Purpura and other hemorrhagic conditions"	1	295	130	425
"G56"	"D72"	"Mononeuropathies of upper limb"	"Other disorders of white blood cells"	1	117	42	159
"G56"	"E03"	"Mononeuropathies of upper limb"	"Other hypothyroidism"	1	1387	645	2032
"G56"	"E11"	"Mononeuropathies of upper limb"	"Type 2 diabetes mellitus"	1	3128	2437	5565
"G56"	"E13"	"Mononeuropathies of upper limb"	"Other specified diabetes mellitus"	1	194	71	265
"G56"	"E21"	"Mononeuropathies of upper limb"	"Hyperparathyroidism and other disorders of parathyroid gland"	1	344	128	472
"G56"	"E23"	"Mononeuropathies of upper limb"	"Hypofunction and other disorders of the pituitary gland"	1	155	59	214
"G56"	"E27"	"Mononeuropathies of upper limb"	"Other disorders of adrenal gland"	1	199	50	249
"G56"	"E46"	"Mononeuropathies of upper limb"	"Unspecified protein-calorie malnutrition"	1	26	0	26
"G56"	"E78"	"Mononeuropathies of upper limb"	"Disorders of lipoprotein metabolism and other lipidemias"	1	4187	2173	6360
"G56"	"E85"	"Mononeuropathies of upper limb"	"Amyloidosis"	1	99	7	106
"G56"	"E87"	"Mononeuropathies of upper limb"	"Other disorders of fluid, electrolyte and acid-base balance"	1	2152	0	2152
"G56"	"F01"	"Mononeuropathies of upper limb"	"Vascular dementia"	1	183	0	183
"G56"	"F05"	"Mononeuropathies of upper limb"	"Delirium due to known physiological condition"	1	478	0	478
"G56"	"F41"	"Mononeuropathies of upper limb"	"Other anxiety disorders"	1	775	218	993
"G56"	"F43"	"Mononeuropathies of upper limb"	"Reaction to severe stress, and adjustment disorders"	1	552	375	927
"G56"	"G20"	"Mononeuropathies of upper limb"	"Parkinson's disease"	1	323	98	421
"G56"	"G45"	"Mononeuropathies of upper limb"	"Transient cerebral ischemic attacks and related syndromes"	1	1285	798	2083
"G56"	"G95"	"Mononeuropathies of upper limb"	"Other and unspecified diseases of spinal cord"	1	399	70	469
"G56"	"H18"	"Mononeuropathies of upper limb"	"Other disorders of cornea"	1	265	127	392
"G56"	"H25"	"Mononeuropathies of upper limb"	"Age-related cataract"	1	5349	2666	8015
"G56"	"H26"	"Mononeuropathies of upper limb"	"Other cataract"	1	1560	770	2330
"G56"	"H54"	"Mononeuropathies of upper limb"	"Blindness and low vision"	1	246	87	333
"G56"	"H57"	"Mononeuropathies of upper limb"	"Other disorders of eye and adnexa"	1	521	206	727
"G56"	"I10"	"Mononeuropathies of upper limb"	"Essential (primary) hypertension"	1	9398	5474	14872
"G56"	"I15"	"Mononeuropathies of upper limb"	"Secondary hypertension"	1	387	218	605
"G56"	"I26"	"Mononeuropathies of upper limb"	"Pulmonary embolism"	1	855	239	1094
"G56"	"I27"	"Mononeuropathies of upper limb"	"Other pulmonary heart diseases"	1	311	62	373
"G56"	"I33"	"Mononeuropathies of upper limb"	"Acute and subacute endocarditis"	1	135	25	160
"G56"	"I34"	"Mononeuropathies of upper limb"	"Nonrheumatic mitral valve disorders"	1	494	121	615
"G56"	"I46"	"Mononeuropathies of upper limb"	"Cardiac arrest"	1	736	0	736
"G56"	"I51"	"Mononeuropathies of upper limb"	"Complications and ill-defined descriptions of heart disease"	1	465	92	557
"G56"	"I74"	"Mononeuropathies of upper limb"	"Arterial embolism and thrombosis"	1	240	120	360
"G56"	"I80"	"Mononeuropathies of upper limb"	"Phlebitis and thrombophlebitis"	1	1128	887	2015
"G56"	"I81"	"Mononeuropathies of upper limb"	"Portal vein thrombosis"	1	50	5	55
"G56"	"I82"	"Mononeuropathies of upper limb"	"Other venous embolism and thrombosis"	1	283	123	406
"G56"	"I87"	"Mononeuropathies of upper limb"	"Other disorders of veins"	1	233	95	328
"G56"	"J15"	"Mononeuropathies of upper limb"	"Bacterial pneumonia, not elsewhere classified"	1	2540	0	2540
"G56"	"J22"	"Mononeuropathies of upper limb"	"Unspecified acute lower respiratory infection"	1	359	25	384
"G56"	"J47"	"Mononeuropathies of upper limb"	"Bronchiectasis"	1	223	32	255
"G56"	"J81"	"Mononeuropathies of upper limb"	"Pulmonary edema"	1	343	39	382
"G56"	"J84"	"Mononeuropathies of upper limb"	"Other interstitial pulmonary diseases"	1	404	75	479
"G56"	"J85"	"Mononeuropathies of upper limb"	"Abscess of lung and mediastinum"	1	64	12	76
"G56"	"J91"	"Mononeuropathies of upper limb"	"Pleural effusion in conditions classified elsewhere"	1	232	31	263
"G56"	"J93"	"Mononeuropathies of upper limb"	"Pneumothorax and air leak"	1	214	116	330
"G56"	"J96"	"Mononeuropathies of upper limb"	"Respiratory failure, not elsewhere classified"	1	2320	0	2320
"G56"	"K05"	"Mononeuropathies of upper limb"	"Gingivitis and periodontal diseases"	1	369	173	542
"G56"	"K25"	"Mononeuropathies of upper limb"	"Gastric ulcer"	1	919	669	1588
"G56"	"K43"	"Mononeuropathies of upper limb"	"Ventral hernia"	1	721	536	1257
"G56"	"K52"	"Mononeuropathies of upper limb"	"Other and unsp noninfective gastroenteritis and colitis"	1	1190	560	1750
"G56"	"K63"	"Mononeuropathies of upper limb"	"Other diseases of intestine"	1	443	56	499
"G56"	"K65"	"Mononeuropathies of upper limb"	"Peritonitis"	1	282	160	442
"G56"	"K70"	"Mononeuropathies of upper limb"	"Alcoholic liver disease"	1	483	136	619
"G56"	"K72"	"Mononeuropathies of upper limb"	"Hepatic failure, not elsewhere classified"	1	216	17	233
"G56"	"K74"	"Mononeuropathies of upper limb"	"Fibrosis and cirrhosis of liver"	1	265	31	296
"G56"	"K76"	"Mononeuropathies of upper limb"	"Other diseases of liver"	1	525	235	760
"G56"	"K82"	"Mononeuropathies of upper limb"	"Other diseases of gallbladder"	1	70	21	91
"G56"	"K83"	"Mononeuropathies of upper limb"	"Other diseases of biliary tract"	1	370	126	496
"G56"	"K86"	"Mononeuropathies of upper limb"	"Other diseases of pancreas"	1	256	146	402
"G56"	"K92"	"Mononeuropathies of upper limb"	"Other diseases of digestive system"	1	1119	392	1511
"G56"	"L57"	"Mononeuropathies of upper limb"	"Skin changes due to chronic expsr to nonionizing radiation"	1	326	82	408
"G56"	"L82"	"Mononeuropathies of upper limb"	"Seborrheic keratosis"	1	228	54	282
"G56"	"L89"	"Mononeuropathies of upper limb"	"Pressure ulcer"	1	444	44	488
"G56"	"L97"	"Mononeuropathies of upper limb"	"Non-pressure chronic ulcer of lower limb, NEC"	1	810	163	973
"G56"	"L98"	"Mononeuropathies of upper limb"	"Oth disorders of skin, subcu, not elsewhere classified"	1	673	267	940
"G56"	"M05"	"Mononeuropathies of upper limb"	"Rheumatoid arthritis with rheumatoid factor"	1	893	467	1360
"G56"	"M10"	"Mononeuropathies of upper limb"	"Gout"	1	827	453	1280
"G56"	"M13"	"Mononeuropathies of upper limb"	"Other arthritis"	1	1037	592	1629
"G56"	"M15"	"Mononeuropathies of upper limb"	"Polyosteoarthritis"	1	991	568	1559
"G56"	"M18"	"Mononeuropathies of upper limb"	"Osteoarthritis of first carpometacarpal joint"	1	2046	1090	3136
"G56"	"M53"	"Mononeuropathies of upper limb"	"Other and unspecified dorsopathies, not elsewhere classified"	1	1155	837	1992
"G56"	"M65"	"Mononeuropathies of upper limb"	"Synovitis and tenosynovitis"	1	6522	5854	12376
"G56"	"M80"	"Mononeuropathies of upper limb"	"Osteoporosis with current pathological fracture"	1	1188	175	1363
"G56"	"N13"	"Mononeuropathies of upper limb"	"Obstructive and reflux uropathy"	1	428	197	625
"G56"	"Q61"	"Mononeuropathies of upper limb"	"Cystic kidney disease"	1	220	51	271
"G57"	"C77"	"Mononeuropathies of lower limb"	"Secondary and unspecified malignant neoplasm of lymph nodes"	1	87	24	111
"G57"	"C78"	"Mononeuropathies of lower limb"	"Secondary malignant neoplasm of resp and digestive organs"	1	214	22	236
"G57"	"D50"	"Mononeuropathies of lower limb"	"Iron deficiency anemia"	1	140	35	175
"G57"	"D63"	"Mononeuropathies of lower limb"	"Anemia in chronic diseases classified elsewhere"	1	88	6	94
"G57"	"E86"	"Mononeuropathies of lower limb"	"Volume depletion"	1	394	34	428
"G57"	"F41"	"Mononeuropathies of lower limb"	"Other anxiety disorders"	1	122	42	164
"G57"	"I48"	"Mononeuropathies of lower limb"	"Atrial fibrillation and flutter"	1	545	203	748
"G57"	"I50"	"Mononeuropathies of lower limb"	"Heart failure"	1	395	106	501
"G57"	"J18"	"Mononeuropathies of lower limb"	"Pneumonia, unspecified organism"	1	838	322	1160
"G57"	"J44"	"Mononeuropathies of lower limb"	"Other chronic obstructive pulmonary disease"	1	457	165	622
"G57"	"J96"	"Mononeuropathies of lower limb"	"Respiratory failure, not elsewhere classified"	1	355	51	406
"G57"	"K70"	"Mononeuropathies of lower limb"	"Alcoholic liver disease"	1	95	37	132
"G57"	"M48"	"Mononeuropathies of lower limb"	"Other spondylopathies"	1	649	329	978
"G57"	"N30"	"Mononeuropathies of lower limb"	"Cystitis"	1	542	321	863
"G60"	"C78"	"Hereditary and idiopathic neuropathy"	"Secondary malignant neoplasm of resp and digestive organs"	1	35	3	38
"G60"	"L89"	"Hereditary and idiopathic neuropathy"	"Pressure ulcer"	1	68	14	82
"G60"	"N39"	"Hereditary and idiopathic neuropathy"	"Other disorders of urinary system"	1	187	75	262
"G61"	"C34"	"Inflammatory polyneuropathy"	"Malignant neoplasm of bronchus and lung"	1	63	16	79
"G61"	"C78"	"Inflammatory polyneuropathy"	"Secondary malignant neoplasm of resp and digestive organs"	1	39	5	44
"G61"	"E86"	"Inflammatory polyneuropathy"	"Volume depletion"	1	162	43	205
"G61"	"M81"	"Inflammatory polyneuropathy"	"Osteoporosis without current pathological fracture"	1	132	44	176
"G62"	"A04"	"Other and unspecified polyneuropathies"	"Other bacterial intestinal infections"	1	429	169	598
"G62"	"C15"	"Other and unspecified polyneuropathies"	"Malignant neoplasm of esophagus"	1	124	17	141
"G62"	"C25"	"Other and unspecified polyneuropathies"	"Malignant neoplasm of pancreas"	1	157	16	173
"G62"	"C34"	"Other and unspecified polyneuropathies"	"Malignant neoplasm of bronchus and lung"	1	774	182	956
"G62"	"C78"	"Other and unspecified polyneuropathies"	"Secondary malignant neoplasm of resp and digestive organs"	1	508	128	636
"G62"	"C79"	"Other and unspecified polyneuropathies"	"Secondary malignant neoplasm of other and unspecified sites"	1	420	104	524
"G62"	"D50"	"Other and unspecified polyneuropathies"	"Iron deficiency anemia"	1	513	317	830
"G62"	"D62"	"Other and unspecified polyneuropathies"	"Acute posthemorrhagic anemia"	1	305	162	467
"G62"	"D63"	"Other and unspecified polyneuropathies"	"Anemia in chronic diseases classified elsewhere"	1	312	125	437
"G62"	"E41"	"Other and unspecified polyneuropathies"	"Nutritional marasmus"	1	114	28	142
"G62"	"E64"	"Other and unspecified polyneuropathies"	"Sequelae of malnutrition and other nutritional deficiencies"	1	247	121	368
"G62"	"F03"	"Other and unspecified polyneuropathies"	"Unspecified dementia"	1	891	269	1160
"G62"	"G23"	"Other and unspecified polyneuropathies"	"Other degenerative diseases of basal ganglia"	1	78	20	98
"G62"	"I69"	"Other and unspecified polyneuropathies"	"Sequelae of cerebrovascular disease"	1	1510	1202	2712
"G62"	"J15"	"Other and unspecified polyneuropathies"	"Bacterial pneumonia, not elsewhere classified"	1	1652	591	2243
"G62"	"K55"	"Other and unspecified polyneuropathies"	"Vascular disorders of intestine"	1	145	67	212
"G62"	"K72"	"Other and unspecified polyneuropathies"	"Hepatic failure, not elsewhere classified"	1	436	164	600
"G62"	"M80"	"Other and unspecified polyneuropathies"	"Osteoporosis with current pathological fracture"	1	702	382	1084
"G62"	"N30"	"Other and unspecified polyneuropathies"	"Cystitis"	1	2024	1461	3485
"G62"	"N39"	"Other and unspecified polyneuropathies"	"Other disorders of urinary system"	1	1970	1114	3084
"G63"	"A49"	"Polyneuropathy in diseases classified elsewhere"	"Bacterial infection of unspecified site"	1	200	78	278
"G63"	"J15"	"Polyneuropathy in diseases classified elsewhere"	"Bacterial pneumonia, not elsewhere classified"	1	263	148	411
"G63"	"L89"	"Polyneuropathy in diseases classified elsewhere"	"Pressure ulcer"	1	133	59	192
"G63"	"N39"	"Polyneuropathy in diseases classified elsewhere"	"Other disorders of urinary system"	1	375	230	605
"G70"	"M85"	"Myasthenia gravis and other myoneural disorders"	"Other disorders of bone density and structure"	1	96	31	127
"G71"	"A41"	"Primary disorders of muscles"	"Other sepsis"	1	73	13	86
"G71"	"A49"	"Primary disorders of muscles"	"Bacterial infection of unspecified site"	1	42	2	44
"G71"	"G47"	"Primary disorders of muscles"	"Sleep disorders"	1	152	38	190
"G71"	"I50"	"Primary disorders of muscles"	"Heart failure"	1	153	20	173
"G71"	"J95"	"Primary disorders of muscles"	"Intraop and postproc comp and disorders of resp sys, NEC"	1	25	0	25
"G71"	"J96"	"Primary disorders of muscles"	"Respiratory failure, not elsewhere classified"	1	545	96	641
"G71"	"L89"	"Primary disorders of muscles"	"Pressure ulcer"	1	36	2	38
"G71"	"M41"	"Primary disorders of muscles"	"Scoliosis"	1	142	22	164
"G71"	"M81"	"Primary disorders of muscles"	"Osteoporosis without current pathological fracture"	1	90	13	103
"G71"	"N31"	"Primary disorders of muscles"	"Neuromuscular dysfunction of bladder, NEC"	1	31	2	33
"G71"	"N39"	"Primary disorders of muscles"	"Other disorders of urinary system"	1	101	30	131
"G80"	"A41"	"Cerebral palsy"	"Other sepsis"	1	238	97	335
"G80"	"E22"	"Cerebral palsy"	"Hyperfunction of pituitary gland"	1	50	2	52
"G80"	"E30"	"Cerebral palsy"	"Disorders of puberty, not elsewhere classified"	1	52	8	60
"G80"	"F79"	"Cerebral palsy"	"Unspecified intellectual disabilities"	1	470	200	670
"G80"	"F84"	"Cerebral palsy"	"Pervasive developmental disorders"	1	152	53	205
"G80"	"G98"	"Cerebral palsy"	"Other disorders of nervous system not elsewhere classified"	1	83	15	98
"G80"	"H50"	"Cerebral palsy"	"Other strabismus"	1	563	303	866
"G80"	"H54"	"Cerebral palsy"	"Blindness and low vision"	1	277	138	415
"G80"	"J69"	"Cerebral palsy"	"Pneumonitis due to solids and liquids"	1	155	40	195
"G80"	"J95"	"Cerebral palsy"	"Intraop and postproc comp and disorders of resp sys, NEC"	1	38	1	39
"G80"	"K02"	"Cerebral palsy"	"Dental caries"	1	219	91	310
"G80"	"K08"	"Cerebral palsy"	"Other disorders of teeth and supporting structures"	1	59	8	67
"G80"	"K92"	"Cerebral palsy"	"Other diseases of digestive system"	1	160	45	205
"G80"	"L60"	"Cerebral palsy"	"Nail disorders"	1	75	8	83
"G80"	"L89"	"Cerebral palsy"	"Pressure ulcer"	1	89	29	118
"G80"	"L98"	"Cerebral palsy"	"Oth disorders of skin, subcu, not elsewhere classified"	1	58	13	71
"G80"	"M21"	"Cerebral palsy"	"Other acquired deformities of limbs"	1	278	99	377
"G80"	"M24"	"Cerebral palsy"	"Other specific joint derangements"	1	140	59	199
"G80"	"M89"	"Cerebral palsy"	"Other disorders of bone"	1	39	5	44
"G80"	"N39"	"Cerebral palsy"	"Other disorders of urinary system"	1	245	136	381
"G80"	"O70"	"Cerebral palsy"	"Perineal laceration during delivery"	1	27	1	28
"G80"	"O72"	"Cerebral palsy"	"Postpartum hemorrhage"	1	28	0	28
"G80"	"O99"	"Cerebral palsy"	"Oth maternal diseases classd elsw but compl preg/chldbrth"	1	55	2	57
"G82"	"A49"	"Paraplegia (paraparesis) and quadriplegia (quadriparesis)"	"Bacterial infection of unspecified site"	1	347	133	480
"G82"	"F79"	"Paraplegia (paraparesis) and quadriplegia (quadriparesis)"	"Unspecified intellectual disabilities"	1	217	123	340
"G82"	"G47"	"Paraplegia (paraparesis) and quadriplegia (quadriparesis)"	"Sleep disorders"	1	302	114	416
"G82"	"H47"	"Paraplegia (paraparesis) and quadriplegia (quadriparesis)"	"Other disorders of optic [2nd] nerve and visual pathways"	1	189	64	253
"G82"	"H52"	"Paraplegia (paraparesis) and quadriplegia (quadriparesis)"	"Disorders of refraction and accommodation"	1	254	128	382
"G82"	"J15"	"Paraplegia (paraparesis) and quadriplegia (quadriparesis)"	"Bacterial pneumonia, not elsewhere classified"	1	685	308	993
"G82"	"J22"	"Paraplegia (paraparesis) and quadriplegia (quadriparesis)"	"Unspecified acute lower respiratory infection"	1	110	35	145
"G82"	"J69"	"Paraplegia (paraparesis) and quadriplegia (quadriparesis)"	"Pneumonitis due to solids and liquids"	1	275	89	364
"G82"	"L89"	"Paraplegia (paraparesis) and quadriplegia (quadriparesis)"	"Pressure ulcer"	1	931	502	1433
"G82"	"M41"	"Paraplegia (paraparesis) and quadriplegia (quadriparesis)"	"Scoliosis"	1	300	164	464
"G82"	"N30"	"Paraplegia (paraparesis) and quadriplegia (quadriparesis)"	"Cystitis"	1	1156	917	2073
"G82"	"N31"	"Paraplegia (paraparesis) and quadriplegia (quadriparesis)"	"Neuromuscular dysfunction of bladder, NEC"	1	1762	695	2457
"G82"	"N46"	"Paraplegia (paraparesis) and quadriplegia (quadriparesis)"	"Male infertility"	1	61	13	74
"G90"	"C78"	"Disorders of autonomic nervous system"	"Secondary malignant neoplasm of resp and digestive organs"	1	87	16	103
"G90"	"D63"	"Disorders of autonomic nervous system"	"Anemia in chronic diseases classified elsewhere"	1	56	11	67
"G90"	"O72"	"Disorders of autonomic nervous system"	"Postpartum hemorrhage"	1	75	11	86
"G91"	"A41"	"Hydrocephalus"	"Other sepsis"	1	643	305	948
"G91"	"F01"	"Hydrocephalus"	"Vascular dementia"	1	190	81	271
"G91"	"F03"	"Hydrocephalus"	"Unspecified dementia"	1	562	348	910
"G91"	"F79"	"Hydrocephalus"	"Unspecified intellectual disabilities"	1	86	25	111
"G91"	"G47"	"Hydrocephalus"	"Sleep disorders"	1	202	95	297
"G91"	"G82"	"Hydrocephalus"	"Paraplegia (paraparesis) and quadriplegia (quadriparesis)"	1	216	119	335
"G91"	"H49"	"Hydrocephalus"	"Paralytic strabismus"	1	191	99	290
"G91"	"H53"	"Hydrocephalus"	"Visual disturbances"	1	407	209	616
"G91"	"H57"	"Hydrocephalus"	"Other disorders of eye and adnexa"	1	195	70	265
"G91"	"J15"	"Hydrocephalus"	"Bacterial pneumonia, not elsewhere classified"	1	464	308	772
"G91"	"J18"	"Hydrocephalus"	"Pneumonia, unspecified organism"	1	1148	916	2064
"G91"	"J69"	"Hydrocephalus"	"Pneumonitis due to solids and liquids"	1	249	87	336
"G93"	"H57"	"Other disorders of brain"	"Other disorders of eye and adnexa"	1	227	114	341
"G94"	"E86"	"Other disorders of brain in diseases classified elsewhere"	"Volume depletion"	1	158	56	214
"G94"	"H53"	"Other disorders of brain in diseases classified elsewhere"	"Visual disturbances"	1	132	58	190
"G94"	"H57"	"Other disorders of brain in diseases classified elsewhere"	"Other disorders of eye and adnexa"	1	79	19	98
"G95"	"A41"	"Other and unspecified diseases of spinal cord"	"Other sepsis"	1	1147	659	1806
"G95"	"A49"	"Other and unspecified diseases of spinal cord"	"Bacterial infection of unspecified site"	1	434	251	685
"G95"	"C80"	"Other and unspecified diseases of spinal cord"	"Malignant neoplasm without specification of site"	1	468	318	786
"G95"	"G47"	"Other and unspecified diseases of spinal cord"	"Sleep disorders"	1	837	244	1081
"G95"	"J15"	"Other and unspecified diseases of spinal cord"	"Bacterial pneumonia, not elsewhere classified"	1	733	409	1142
"G95"	"L89"	"Other and unspecified diseases of spinal cord"	"Pressure ulcer"	1	445	150	595
"G95"	"N31"	"Other and unspecified diseases of spinal cord"	"Neuromuscular dysfunction of bladder, NEC"	1	543	266	809
"G96"	"A04"	"Other disorders of central nervous system"	"Other bacterial intestinal infections"	1	426	253	679
"G96"	"A41"	"Other disorders of central nervous system"	"Other sepsis"	1	1564	922	2486
"G96"	"A49"	"Other disorders of central nervous system"	"Bacterial infection of unspecified site"	1	822	467	1289
"G96"	"C78"	"Other disorders of central nervous system"	"Secondary malignant neoplasm of resp and digestive organs"	1	226	117	343
"G96"	"F01"	"Other disorders of central nervous system"	"Vascular dementia"	1	324	125	449
"G96"	"F03"	"Other disorders of central nervous system"	"Unspecified dementia"	1	894	618	1512
"G96"	"J15"	"Other disorders of central nervous system"	"Bacterial pneumonia, not elsewhere classified"	1	1291	875	2166
"G96"	"K64"	"Other disorders of central nervous system"	"Hemorrhoids and perianal venous thrombosis"	1	401	142	543
"G96"	"L89"	"Other disorders of central nervous system"	"Pressure ulcer"	1	325	144	469
"G96"	"N17"	"Other disorders of central nervous system"	"Acute kidney failure"	1	349	208	557
"G97"	"O72"	"Intraop and postproc comp and disorders of nervous sys, NEC"	"Postpartum hemorrhage"	1	165	79	244
"G98"	"G30"	"Other disorders of nervous system not elsewhere classified"	"Alzheimer's disease"	1	99	13	112
"G98"	"J96"	"Other disorders of nervous system not elsewhere classified"	"Respiratory failure, not elsewhere classified"	1	365	215	580
"G99"	"E87"	"Oth disorders of nervous system in diseases classd elswhr"	"Other disorders of fluid, electrolyte and acid-base balance"	1	106	10	116
"G99"	"I69"	"Oth disorders of nervous system in diseases classd elswhr"	"Sequelae of cerebrovascular disease"	1	280	70	350
"G99"	"K59"	"Oth disorders of nervous system in diseases classd elswhr"	"Other functional intestinal disorders"	1	164	38	202
"G99"	"L89"	"Oth disorders of nervous system in diseases classd elswhr"	"Pressure ulcer"	1	61	11	72
"G99"	"N30"	"Oth disorders of nervous system in diseases classd elswhr"	"Cystitis"	1	196	85	281
"H00"	"C77"	"Hordeolum and chalazion"	"Secondary and unspecified malignant neoplasm of lymph nodes"	1	29	1	30
"H00"	"C79"	"Hordeolum and chalazion"	"Secondary malignant neoplasm of other and unspecified sites"	1	55	0	55
"H00"	"E11"	"Hordeolum and chalazion"	"Type 2 diabetes mellitus"	1	222	67	289
"H00"	"E86"	"Hordeolum and chalazion"	"Volume depletion"	1	193	40	233
"H00"	"E87"	"Hordeolum and chalazion"	"Other disorders of fluid, electrolyte and acid-base balance"	1	118	5	123
"H00"	"F32"	"Hordeolum and chalazion"	"Depressive episode"	1	81	15	96
"H00"	"F41"	"Hordeolum and chalazion"	"Other anxiety disorders"	1	44	5	49
"H00"	"I10"	"Hordeolum and chalazion"	"Essential (primary) hypertension"	1	592	155	747
"H00"	"J15"	"Hordeolum and chalazion"	"Bacterial pneumonia, not elsewhere classified"	1	174	21	195
"H00"	"J18"	"Hordeolum and chalazion"	"Pneumonia, unspecified organism"	1	443	234	677
"H00"	"J44"	"Hordeolum and chalazion"	"Other chronic obstructive pulmonary disease"	1	242	42	284
"H00"	"J96"	"Hordeolum and chalazion"	"Respiratory failure, not elsewhere classified"	1	144	1	145
"H00"	"K59"	"Hordeolum and chalazion"	"Other functional intestinal disorders"	1	344	127	471
"H00"	"L97"	"Hordeolum and chalazion"	"Non-pressure chronic ulcer of lower limb, NEC"	1	34	4	38
"H00"	"M17"	"Hordeolum and chalazion"	"Osteoarthritis of knee"	1	228	91	319
"H00"	"M67"	"Hordeolum and chalazion"	"Other disorders of synovium and tendon"	1	129	54	183
"H00"	"N30"	"Hordeolum and chalazion"	"Cystitis"	1	327	162	489
"H00"	"O72"	"Hordeolum and chalazion"	"Postpartum hemorrhage"	1	310	42	352
"H02"	"A41"	"Other disorders of eyelid"	"Other sepsis"	1	1586	344	1930
"H02"	"A49"	"Other disorders of eyelid"	"Bacterial infection of unspecified site"	1	652	162	814
"H02"	"C18"	"Other disorders of eyelid"	"Malignant neoplasm of colon"	1	406	252	658
"H02"	"C22"	"Other disorders of eyelid"	"Malignant neoplasm of liver and intrahepatic bile ducts"	1	97	10	107
"H02"	"C25"	"Other disorders of eyelid"	"Malignant neoplasm of pancreas"	1	204	16	220
"H02"	"C80"	"Other disorders of eyelid"	"Malignant neoplasm without specification of site"	1	77	16	93
"H02"	"D09"	"Other disorders of eyelid"	"Carcinoma in situ of other and unspecified sites"	1	76	21	97
"H02"	"D50"	"Other disorders of eyelid"	"Iron deficiency anemia"	1	508	216	724
"H02"	"D64"	"Other disorders of eyelid"	"Other anemias"	1	1623	590	2213
"H02"	"F03"	"Other disorders of eyelid"	"Unspecified dementia"	1	797	133	930
"H02"	"F41"	"Other disorders of eyelid"	"Other anxiety disorders"	1	304	129	433
"H02"	"I35"	"Other disorders of eyelid"	"Nonrheumatic aortic valve disorders"	1	1009	377	1386
"H02"	"I71"	"Other disorders of eyelid"	"Aortic aneurysm and dissection"	1	501	191	692
"H02"	"J18"	"Other disorders of eyelid"	"Pneumonia, unspecified organism"	1	3333	1669	5002
"H02"	"J44"	"Other disorders of eyelid"	"Other chronic obstructive pulmonary disease"	1	1626	1320	2946
"H02"	"J96"	"Other disorders of eyelid"	"Respiratory failure, not elsewhere classified"	1	1460	257	1717
"H02"	"K56"	"Other disorders of eyelid"	"Paralytic ileus and intestinal obstruction without hernia"	1	414	269	683
"H02"	"K59"	"Other disorders of eyelid"	"Other functional intestinal disorders"	1	1841	960	2801
"H02"	"K83"	"Other disorders of eyelid"	"Other diseases of biliary tract"	1	195	91	286
"H02"	"L89"	"Other disorders of eyelid"	"Pressure ulcer"	1	251	49	300
"H02"	"M80"	"Other disorders of eyelid"	"Osteoporosis with current pathological fracture"	1	821	221	1042
"H02"	"M81"	"Other disorders of eyelid"	"Osteoporosis without current pathological fracture"	1	1537	945	2482
"H02"	"N18"	"Other disorders of eyelid"	"Chronic kidney disease (CKD)"	1	854	231	1085
"H02"	"N30"	"Other disorders of eyelid"	"Cystitis"	1	2119	1274	3393
"H02"	"N39"	"Other disorders of eyelid"	"Other disorders of urinary system"	1	2085	1088	3173
"H04"	"A41"	"Disorders of lacrimal system"	"Other sepsis"	1	257	50	307
"H04"	"C34"	"Disorders of lacrimal system"	"Malignant neoplasm of bronchus and lung"	1	147	19	166
"H04"	"C78"	"Disorders of lacrimal system"	"Secondary malignant neoplasm of resp and digestive organs"	1	144	14	158
"H04"	"E86"	"Disorders of lacrimal system"	"Volume depletion"	1	440	46	486
"H04"	"F32"	"Disorders of lacrimal system"	"Depressive episode"	1	107	44	151
"H04"	"I46"	"Disorders of lacrimal system"	"Cardiac arrest"	1	62	0	62
"H04"	"I50"	"Disorders of lacrimal system"	"Heart failure"	1	334	121	455
"H04"	"K92"	"Disorders of lacrimal system"	"Other diseases of digestive system"	1	144	51	195
"H04"	"M80"	"Disorders of lacrimal system"	"Osteoporosis with current pathological fracture"	1	148	28	176
"H04"	"N19"	"Disorders of lacrimal system"	"Unspecified kidney failure"	1	78	19	97
"H04"	"N30"	"Disorders of lacrimal system"	"Cystitis"	1	445	208	653
"H04"	"N39"	"Disorders of lacrimal system"	"Other disorders of urinary system"	1	343	164	507
"H05"	"E03"	"Disorders of orbit"	"Other hypothyroidism"	1	295	140	435
"H05"	"E89"	"Disorders of orbit"	"Postproc endocrine and metabolic comp and disorders, NEC"	1	122	54	176
"H10"	"A41"	"Conjunctivitis"	"Other sepsis"	1	1221	81	1302
"H10"	"C32"	"Conjunctivitis"	"Malignant neoplasm of larynx"	1	37	1	38
"H10"	"C34"	"Conjunctivitis"	"Malignant neoplasm of bronchus and lung"	1	445	0	445
"H10"	"C49"	"Conjunctivitis"	"Malignant neoplasm of other connective and soft tissue"	1	34	1	35
"H10"	"C50"	"Conjunctivitis"	"Malignant neoplasm of breast"	1	389	149	538
"H10"	"C56"	"Conjunctivitis"	"Malignant neoplasm of ovary"	1	59	13	72
"H10"	"C61"	"Conjunctivitis"	"Malignant neoplasm of prostate"	1	336	0	336
"H10"	"C78"	"Conjunctivitis"	"Secondary malignant neoplasm of resp and digestive organs"	1	373	0	373
"H10"	"D12"	"Conjunctivitis"	"Benign neoplasm of colon, rectum, anus and anal canal"	1	937	0	937
"H10"	"D17"	"Conjunctivitis"	"Benign lipomatous neoplasm"	1	485	76	561
"H10"	"D50"	"Conjunctivitis"	"Iron deficiency anemia"	1	358	45	403
"H10"	"D62"	"Conjunctivitis"	"Acute posthemorrhagic anemia"	1	184	13	197
"H10"	"D63"	"Conjunctivitis"	"Anemia in chronic diseases classified elsewhere"	1	194	0	194
"H10"	"E11"	"Conjunctivitis"	"Type 2 diabetes mellitus"	1	1503	271	1774
"H10"	"E16"	"Conjunctivitis"	"Other disorders of pancreatic internal secretion"	1	212	112	324
"H10"	"E78"	"Conjunctivitis"	"Disorders of lipoprotein metabolism and other lipidemias"	1	1901	0	1901
"H10"	"E87"	"Conjunctivitis"	"Other disorders of fluid, electrolyte and acid-base balance"	1	795	34	829
"H10"	"F12"	"Conjunctivitis"	"Cannabis related disorders"	1	73	11	84
"H10"	"F20"	"Conjunctivitis"	"Schizophrenia"	1	140	23	163
"H10"	"F22"	"Conjunctivitis"	"Delusional disorders"	1	44	6	50
"H10"	"F31"	"Conjunctivitis"	"Bipolar disorder"	1	66	7	73
"H10"	"F41"	"Conjunctivitis"	"Other anxiety disorders"	1	412	29	441
"H10"	"F44"	"Conjunctivitis"	"Dissociative and conversion disorders"	1	51	11	62
"H10"	"G43"	"Conjunctivitis"	"Migraine"	1	569	263	832
"H10"	"G56"	"Conjunctivitis"	"Mononeuropathies of upper limb"	1	1077	189	1266
"H10"	"G93"	"Conjunctivitis"	"Other disorders of brain"	1	140	20	160
"H10"	"H25"	"Conjunctivitis"	"Age-related cataract"	1	1992	1177	3169
"H10"	"H26"	"Conjunctivitis"	"Other cataract"	1	900	447	1347
"H10"	"H35"	"Conjunctivitis"	"Other retinal disorders"	1	934	495	1429
"H10"	"H57"	"Conjunctivitis"	"Other disorders of eye and adnexa"	1	969	438	1407
"H10"	"I10"	"Conjunctivitis"	"Essential (primary) hypertension"	1	4521	0	4521
"H10"	"I25"	"Conjunctivitis"	"Chronic ischemic heart disease"	1	1610	406	2016
"H10"	"I26"	"Conjunctivitis"	"Pulmonary embolism"	1	376	39	415
"H10"	"I34"	"Conjunctivitis"	"Nonrheumatic mitral valve disorders"	1	190	29	219
"H10"	"I48"	"Conjunctivitis"	"Atrial fibrillation and flutter"	1	1677	255	1932
"H10"	"I71"	"Conjunctivitis"	"Aortic aneurysm and dissection"	1	226	0	226
"H10"	"I80"	"Conjunctivitis"	"Phlebitis and thrombophlebitis"	1	740	137	877
"H10"	"I85"	"Conjunctivitis"	"Esophageal varices"	1	86	1	87
"H10"	"J01"	"Conjunctivitis"	"Acute sinusitis"	1	433	235	668
"H10"	"J18"	"Conjunctivitis"	"Pneumonia, unspecified organism"	1	3766	1647	5413
"H10"	"J44"	"Conjunctivitis"	"Other chronic obstructive pulmonary disease"	1	1540	368	1908
"H10"	"J90"	"Conjunctivitis"	"Pleural effusion, not elsewhere classified"	1	201	3	204
"H10"	"J93"	"Conjunctivitis"	"Pneumothorax and air leak"	1	176	43	219
"H10"	"J95"	"Conjunctivitis"	"Intraop and postproc comp and disorders of resp sys, NEC"	1	38	0	38
"H10"	"J96"	"Conjunctivitis"	"Respiratory failure, not elsewhere classified"	1	1107	33	1140
"H10"	"K04"	"Conjunctivitis"	"Diseases of pulp and periapical tissues"	1	292	66	358
"H10"	"K05"	"Conjunctivitis"	"Gingivitis and periodontal diseases"	1	225	24	249
"H10"	"K08"	"Conjunctivitis"	"Other disorders of teeth and supporting structures"	1	262	73	335
"H10"	"K25"	"Conjunctivitis"	"Gastric ulcer"	1	425	160	585
"H10"	"K29"	"Conjunctivitis"	"Gastritis and duodenitis"	1	865	481	1346
"H10"	"K30"	"Conjunctivitis"	"Functional dyspepsia"	1	847	356	1203
"H10"	"K42"	"Conjunctivitis"	"Umbilical hernia"	1	398	86	484
"H10"	"K43"	"Conjunctivitis"	"Ventral hernia"	1	321	57	378
"H10"	"K44"	"Conjunctivitis"	"Diaphragmatic hernia"	1	523	166	689
"H10"	"K56"	"Conjunctivitis"	"Paralytic ileus and intestinal obstruction without hernia"	1	395	61	456
"H10"	"K63"	"Conjunctivitis"	"Other diseases of intestine"	1	164	0	164
"H10"	"K65"	"Conjunctivitis"	"Peritonitis"	1	164	29	193
"H10"	"K72"	"Conjunctivitis"	"Hepatic failure, not elsewhere classified"	1	101	0	101
"H10"	"K74"	"Conjunctivitis"	"Fibrosis and cirrhosis of liver"	1	88	0	88
"H10"	"K76"	"Conjunctivitis"	"Other diseases of liver"	1	242	18	260
"H10"	"K80"	"Conjunctivitis"	"Cholelithiasis"	1	1137	347	1484
"H10"	"K86"	"Conjunctivitis"	"Other diseases of pancreas"	1	131	34	165
"H10"	"K91"	"Conjunctivitis"	"Intraop and postproc comp and disorders of dgstv sys, NEC"	1	110	12	122
"H10"	"K92"	"Conjunctivitis"	"Other diseases of digestive system"	1	647	124	771
"H10"	"L30"	"Conjunctivitis"	"Other and unspecified dermatitis"	1	739	295	1034
"H10"	"L71"	"Conjunctivitis"	"Rosacea"	1	170	52	222
"H10"	"L89"	"Conjunctivitis"	"Pressure ulcer"	1	220	11	231
"H10"	"L90"	"Conjunctivitis"	"Atrophic disorders of skin"	1	317	109	426
"H10"	"M17"	"Conjunctivitis"	"Osteoarthritis of knee"	1	1568	264	1832
"H10"	"M43"	"Conjunctivitis"	"Other deforming dorsopathies"	1	204	101	305
"H10"	"M47"	"Conjunctivitis"	"Spondylosis"	1	659	110	769
"H10"	"M48"	"Conjunctivitis"	"Other spondylopathies"	1	686	59	745
"H10"	"M50"	"Conjunctivitis"	"Cervical disc disorders"	1	580	152	732
"H10"	"M51"	"Conjunctivitis"	"Thoracic, thoracolum, and lumbosacral intvrt disc disorders"	1	1542	532	2074
"H10"	"M67"	"Conjunctivitis"	"Other disorders of synovium and tendon"	1	845	189	1034
"H10"	"M75"	"Conjunctivitis"	"Shoulder lesions"	1	2570	0	2570
"H10"	"M76"	"Conjunctivitis"	"Enthesopathies, lower limb, excluding foot"	1	556	176	732
"H10"	"M80"	"Conjunctivitis"	"Osteoporosis with current pathological fracture"	1	383	30	413
"H10"	"M99"	"Conjunctivitis"	"Biomechanical lesions, not elsewhere classified"	1	155	20	175
"H10"	"N20"	"Conjunctivitis"	"Calculus of kidney and ureter"	1	766	242	1008
"H10"	"N39"	"Conjunctivitis"	"Other disorders of urinary system"	1	1738	374	2112
"H10"	"N43"	"Conjunctivitis"	"Hydrocele and spermatocele"	1	229	129	358
"H10"	"N49"	"Conjunctivitis"	"Inflammatory disorders of male genital organs, NEC"	1	67	15	82
"H10"	"N81"	"Conjunctivitis"	"Female genital prolapse"	1	398	156	554
"H10"	"O08"	"Conjunctivitis"	"Complications following ectopic and molar pregnancy"	1	196	90	286
"H10"	"O24"	"Conjunctivitis"	"Diabetes in pregnancy, childbirth, and the puerperium"	1	161	65	226
"H10"	"O68"	"Conjunctivitis"	"Labor and delivery comp by abnlt of fetal acid-base balance"	1	742	547	1289
"H10"	"O70"	"Conjunctivitis"	"Perineal laceration during delivery"	1	1234	695	1929
"H10"	"O72"	"Conjunctivitis"	"Postpartum hemorrhage"	1	1561	163	1724
"H11"	"A41"	"Other disorders of conjunctiva"	"Other sepsis"	1	440	65	505
"H11"	"A46"	"Other disorders of conjunctiva"	"Erysipelas"	1	188	89	277
"H11"	"C34"	"Other disorders of conjunctiva"	"Malignant neoplasm of bronchus and lung"	1	169	0	169
"H11"	"C61"	"Other disorders of conjunctiva"	"Malignant neoplasm of prostate"	1	192	44	236
"H11"	"C78"	"Other disorders of conjunctiva"	"Secondary malignant neoplasm of resp and digestive organs"	1	191	9	200
"H11"	"C79"	"Other disorders of conjunctiva"	"Secondary malignant neoplasm of other and unspecified sites"	1	113	14	127
"H11"	"D63"	"Other disorders of conjunctiva"	"Anemia in chronic diseases classified elsewhere"	1	88	8	96
"H11"	"F17"	"Other disorders of conjunctiva"	"Nicotine dependence"	1	129	34	163
"H11"	"F32"	"Other disorders of conjunctiva"	"Depressive episode"	1	184	71	255
"H11"	"I10"	"Other disorders of conjunctiva"	"Essential (primary) hypertension"	1	1237	838	2075
"H11"	"I48"	"Other disorders of conjunctiva"	"Atrial fibrillation and flutter"	1	549	366	915
"H11"	"I73"	"Other disorders of conjunctiva"	"Other peripheral vascular diseases"	1	177	60	237
"H11"	"J18"	"Other disorders of conjunctiva"	"Pneumonia, unspecified organism"	1	963	368	1331
"H11"	"K56"	"Other disorders of conjunctiva"	"Paralytic ileus and intestinal obstruction without hernia"	1	119	40	159
"H11"	"L89"	"Other disorders of conjunctiva"	"Pressure ulcer"	1	65	12	77
"H11"	"M19"	"Other disorders of conjunctiva"	"Other and unspecified osteoarthritis"	1	331	130	461
"H11"	"N18"	"Other disorders of conjunctiva"	"Chronic kidney disease (CKD)"	1	257	45	302
"H11"	"N39"	"Other disorders of conjunctiva"	"Other disorders of urinary system"	1	535	162	697
"H11"	"O72"	"Other disorders of conjunctiva"	"Postpartum hemorrhage"	1	184	79	263
"H16"	"C25"	"Keratitis"	"Malignant neoplasm of pancreas"	1	34	1	35
"H16"	"C34"	"Keratitis"	"Malignant neoplasm of bronchus and lung"	1	154	19	173
"H16"	"C78"	"Keratitis"	"Secondary malignant neoplasm of resp and digestive organs"	1	149	22	171
"H16"	"C79"	"Keratitis"	"Secondary malignant neoplasm of other and unspecified sites"	1	109	17	126
"H16"	"D12"	"Keratitis"	"Benign neoplasm of colon, rectum, anus and anal canal"	1	318	94	412
"H16"	"G47"	"Keratitis"	"Sleep disorders"	1	278	75	353
"H16"	"H17"	"Keratitis"	"Corneal scars and opacities"	1	619	284	903
"H16"	"I26"	"Keratitis"	"Pulmonary embolism"	1	125	53	178
"H16"	"I35"	"Keratitis"	"Nonrheumatic aortic valve disorders"	1	208	57	265
"H16"	"I48"	"Keratitis"	"Atrial fibrillation and flutter"	1	569	298	867
"H16"	"I50"	"Keratitis"	"Heart failure"	1	519	257	776
"H16"	"I73"	"Keratitis"	"Other peripheral vascular diseases"	1	171	72	243
"H16"	"J44"	"Keratitis"	"Other chronic obstructive pulmonary disease"	1	465	258	723
"H16"	"K59"	"Keratitis"	"Other functional intestinal disorders"	1	533	260	793
"H16"	"M19"	"Keratitis"	"Other and unspecified osteoarthritis"	1	249	118	367
"H16"	"M75"	"Keratitis"	"Shoulder lesions"	1	465	288	753
"H16"	"N30"	"Keratitis"	"Cystitis"	1	618	370	988
"H16"	"O72"	"Keratitis"	"Postpartum hemorrhage"	1	501	183	684
"H18"	"C78"	"Other disorders of cornea"	"Secondary malignant neoplasm of resp and digestive organs"	1	217	26	243
"H18"	"D63"	"Other disorders of cornea"	"Anemia in chronic diseases classified elsewhere"	1	107	24	131
"H18"	"D64"	"Other disorders of cornea"	"Other anemias"	1	598	258	856
"H18"	"E87"	"Other disorders of cornea"	"Other disorders of fluid, electrolyte and acid-base balance"	1	437	110	547
"H18"	"I61"	"Other disorders of cornea"	"Nontraumatic intracerebral hemorrhage"	1	100	34	134
"H18"	"I69"	"Other disorders of cornea"	"Sequelae of cerebrovascular disease"	1	428	183	611
"H18"	"J15"	"Other disorders of cornea"	"Bacterial pneumonia, not elsewhere classified"	1	411	145	556
"H18"	"J18"	"Other disorders of cornea"	"Pneumonia, unspecified organism"	1	1037	575	1612
"H18"	"J90"	"Other disorders of cornea"	"Pleural effusion, not elsewhere classified"	1	100	23	123
"H18"	"L89"	"Other disorders of cornea"	"Pressure ulcer"	1	113	24	137
"H18"	"M81"	"Other disorders of cornea"	"Osteoporosis without current pathological fracture"	1	460	304	764
"H18"	"N17"	"Other disorders of cornea"	"Acute kidney failure"	1	132	28	160
"H18"	"N18"	"Other disorders of cornea"	"Chronic kidney disease (CKD)"	1	317	123	440
"H18"	"N30"	"Other disorders of cornea"	"Cystitis"	1	816	414	1230
"H18"	"N39"	"Other disorders of cornea"	"Other disorders of urinary system"	1	592	301	893
"H20"	"C61"	"Iridocyclitis"	"Malignant neoplasm of prostate"	1	93	22	115
"H20"	"C78"	"Iridocyclitis"	"Secondary malignant neoplasm of resp and digestive organs"	1	129	3	132
"H20"	"G47"	"Iridocyclitis"	"Sleep disorders"	1	202	26	228
"H20"	"H54"	"Iridocyclitis"	"Blindness and low vision"	1	172	64	236
"H20"	"I10"	"Iridocyclitis"	"Essential (primary) hypertension"	1	1037	466	1503
"H20"	"I25"	"Iridocyclitis"	"Chronic ischemic heart disease"	1	388	248	636
"H20"	"I42"	"Iridocyclitis"	"Cardiomyopathy"	1	65	13	78
"H20"	"I48"	"Iridocyclitis"	"Atrial fibrillation and flutter"	1	480	149	629
"H20"	"I71"	"Iridocyclitis"	"Aortic aneurysm and dissection"	1	78	16	94
"H20"	"J44"	"Iridocyclitis"	"Other chronic obstructive pulmonary disease"	1	417	141	558
"H20"	"J96"	"Iridocyclitis"	"Respiratory failure, not elsewhere classified"	1	316	9	325
"H20"	"K57"	"Iridocyclitis"	"Diverticular disease of intestine"	1	249	71	320
"H20"	"K62"	"Iridocyclitis"	"Other diseases of anus and rectum"	1	203	94	297
"H20"	"K64"	"Iridocyclitis"	"Hemorrhoids and perianal venous thrombosis"	1	110	0	110
"H20"	"M17"	"Iridocyclitis"	"Osteoarthritis of knee"	1	298	181	479
"H20"	"M19"	"Iridocyclitis"	"Other and unspecified osteoarthritis"	1	203	63	266
"H20"	"M85"	"Iridocyclitis"	"Other disorders of bone density and structure"	1	247	47	294
"H20"	"N39"	"Iridocyclitis"	"Other disorders of urinary system"	1	458	129	587
"H25"	"A04"	"Age-related cataract"	"Other bacterial intestinal infections"	1	3334	0	3334
"H25"	"A08"	"Age-related cataract"	"Viral and other specified intestinal infections"	1	1215	763	1978
"H25"	"A40"	"Age-related cataract"	"Streptococcal sepsis"	1	692	266	958
"H25"	"A46"	"Age-related cataract"	"Erysipelas"	1	5113	2867	7980
"H25"	"A49"	"Age-related cataract"	"Bacterial infection of unspecified site"	1	7249	0	7249
"H25"	"C13"	"Age-related cataract"	"Malignant neoplasm of hypopharynx"	1	158	62	220
"H25"	"C16"	"Age-related cataract"	"Malignant neoplasm of stomach"	1	1028	228	1256
"H25"	"C22"	"Age-related cataract"	"Malignant neoplasm of liver and intrahepatic bile ducts"	1	840	75	915
"H25"	"C23"	"Age-related cataract"	"Malignant neoplasm of gallbladder"	1	131	9	140
"H25"	"C25"	"Age-related cataract"	"Malignant neoplasm of pancreas"	1	2070	0	2070
"H25"	"C34"	"Age-related cataract"	"Malignant neoplasm of bronchus and lung"	1	9445	0	9445
"H25"	"C41"	"Age-related cataract"	"Malignant neoplasm of bone/artic cartl of and unsp sites"	1	143	45	188
"H25"	"C48"	"Age-related cataract"	"Malignant neoplasm of retroperitoneum and peritoneum"	1	102	30	132
"H25"	"C61"	"Age-related cataract"	"Malignant neoplasm of prostate"	1	3508	2636	6144
"H25"	"C64"	"Age-related cataract"	"Malignant neoplasm of kidney, except renal pelvis"	1	787	426	1213
"H25"	"C67"	"Age-related cataract"	"Malignant neoplasm of bladder"	1	1404	1059	2463
"H25"	"C71"	"Age-related cataract"	"Malignant neoplasm of brain"	1	744	182	926
"H25"	"C76"	"Age-related cataract"	"Malignant neoplasm of other and ill-defined sites"	1	416	151	567
"H25"	"C79"	"Age-related cataract"	"Secondary malignant neoplasm of other and unspecified sites"	1	4787	0	4787
"H25"	"C80"	"Age-related cataract"	"Malignant neoplasm without specification of site"	1	793	102	895
"H25"	"C88"	"Age-related cataract"	"Malig immunoproliferative dis and certain oth B-cell lymph"	1	237	131	368
"H25"	"D04"	"Age-related cataract"	"Carcinoma in situ of skin"	1	341	181	522
"H25"	"D50"	"Age-related cataract"	"Iron deficiency anemia"	1	7789	0	7789
"H25"	"D61"	"Age-related cataract"	"Oth aplastic anemias and other bone marrow failure syndromes"	1	403	151	554
"H25"	"D62"	"Age-related cataract"	"Acute posthemorrhagic anemia"	1	2925	858	3783
"H25"	"D69"	"Age-related cataract"	"Purpura and other hemorrhagic conditions"	1	955	602	1557
"H25"	"E16"	"Age-related cataract"	"Other disorders of pancreatic internal secretion"	1	2459	1548	4007
"H25"	"E63"	"Age-related cataract"	"Other nutritional deficiencies"	1	310	58	368
"H25"	"E64"	"Age-related cataract"	"Sequelae of malnutrition and other nutritional deficiencies"	1	1181	305	1486
"H25"	"E83"	"Age-related cataract"	"Disorders of mineral metabolism"	1	1663	464	2127
"H25"	"E86"	"Age-related cataract"	"Volume depletion"	1	28437	0	28437
"H25"	"F03"	"Age-related cataract"	"Unspecified dementia"	1	12531	0	12531
"H25"	"F32"	"Age-related cataract"	"Depressive episode"	1	5915	2640	8555
"H25"	"G12"	"Age-related cataract"	"Spinal muscular atrophy and related syndromes"	1	203	89	292
"H25"	"G21"	"Age-related cataract"	"Secondary parkinsonism"	1	417	192	609
"H25"	"G25"	"Age-related cataract"	"Other extrapyramidal and movement disorders"	1	719	492	1211
"H25"	"G30"	"Age-related cataract"	"Alzheimer's disease"	1	3451	0	3451
"H25"	"H26"	"Age-related cataract"	"Other cataract"	1	66465	0	66465
"H25"	"H27"	"Age-related cataract"	"Other disorders of lens"	1	3930	2946	6876
"H25"	"I11"	"Age-related cataract"	"Hypertensive heart disease"	1	2552	1256	3808
"H25"	"I15"	"Age-related cataract"	"Secondary hypertension"	1	1428	1137	2565
"H25"	"I34"	"Age-related cataract"	"Nonrheumatic mitral valve disorders"	1	2648	1545	4193
"H25"	"I38"	"Age-related cataract"	"Endocarditis, valve unspecified"	1	330	111	441
"H25"	"I45"	"Age-related cataract"	"Other conduction disorders"	1	1473	1034	2507
"H25"	"I49"	"Age-related cataract"	"Other cardiac arrhythmias"	1	4490	3692	8182
"H25"	"I87"	"Age-related cataract"	"Other disorders of veins"	1	782	469	1251
"H25"	"I95"	"Age-related cataract"	"Hypotension"	1	5822	0	5822
"H25"	"J22"	"Age-related cataract"	"Unspecified acute lower respiratory infection"	1	1642	266	1908
"H25"	"J44"	"Age-related cataract"	"Other chronic obstructive pulmonary disease"	1	15316	13266	28582
"H25"	"J81"	"Age-related cataract"	"Pulmonary edema"	1	3798	0	3798
"H25"	"J84"	"Age-related cataract"	"Other interstitial pulmonary diseases"	1	1509	862	2371
"H25"	"J90"	"Age-related cataract"	"Pleural effusion, not elsewhere classified"	1	3742	0	3742
"H25"	"J93"	"Age-related cataract"	"Pneumothorax and air leak"	1	1164	643	1807
"H25"	"K27"	"Age-related cataract"	"Peptic ulcer, site unspecified"	1	1269	868	2137
"H25"	"K52"	"Age-related cataract"	"Other and unsp noninfective gastroenteritis and colitis"	1	4403	2469	6872
"H25"	"K57"	"Age-related cataract"	"Diverticular disease of intestine"	1	8455	7490	15945
"H25"	"K59"	"Age-related cataract"	"Other functional intestinal disorders"	1	20959	0	20959
"H25"	"K63"	"Age-related cataract"	"Other diseases of intestine"	1	1587	585	2172
"H25"	"K65"	"Age-related cataract"	"Peritonitis"	1	1214	753	1967
"H25"	"K74"	"Age-related cataract"	"Fibrosis and cirrhosis of liver"	1	767	487	1254
"H25"	"K82"	"Age-related cataract"	"Other diseases of gallbladder"	1	144	68	212
"H25"	"K83"	"Age-related cataract"	"Other diseases of biliary tract"	1	1508	657	2165
"H25"	"K92"	"Age-related cataract"	"Other diseases of digestive system"	1	9587	0	9587
"H25"	"L29"	"Age-related cataract"	"Pruritus"	1	447	246	693
"H25"	"L57"	"Age-related cataract"	"Skin changes due to chronic expsr to nonionizing radiation"	1	1473	641	2114
"H25"	"M10"	"Age-related cataract"	"Gout"	1	3008	1949	4957
"H25"	"M80"	"Age-related cataract"	"Osteoporosis with current pathological fracture"	1	11274	0	11274
"H25"	"M81"	"Age-related cataract"	"Osteoporosis without current pathological fracture"	1	12828	7624	20452
"H25"	"N08"	"Age-related cataract"	"Glomerular disorders in diseases classified elsewhere"	1	226	108	334
"H25"	"N10"	"Age-related cataract"	"Acute pyelonephritis"	1	1321	977	2298
"H25"	"N13"	"Age-related cataract"	"Obstructive and reflux uropathy"	1	2105	1255	3360
"H25"	"N18"	"Age-related cataract"	"Chronic kidney disease (CKD)"	1	11766	0	11766
"H25"	"N30"	"Age-related cataract"	"Cystitis"	1	32430	0	32430
"H25"	"N39"	"Age-related cataract"	"Other disorders of urinary system"	1	24995	0	24995
"H26"	"A04"	"Other cataract"	"Other bacterial intestinal infections"	1	638	163	801
"H26"	"A41"	"Other cataract"	"Other sepsis"	1	4268	0	4268
"H26"	"A46"	"Other cataract"	"Erysipelas"	1	1290	740	2030
"H26"	"C15"	"Other cataract"	"Malignant neoplasm of esophagus"	1	226	22	248
"H26"	"C16"	"Other cataract"	"Malignant neoplasm of stomach"	1	237	57	294
"H26"	"C18"	"Other cataract"	"Malignant neoplasm of colon"	1	967	599	1566
"H26"	"C24"	"Other cataract"	"Malignant neoplasm of other and unsp parts of biliary tract"	1	92	9	101
"H26"	"C44"	"Other cataract"	"Other and unspecified malignant neoplasm of skin"	1	1519	946	2465
"H26"	"C45"	"Other cataract"	"Mesothelioma"	1	35	4	39
"H26"	"C61"	"Other cataract"	"Malignant neoplasm of prostate"	1	768	532	1300
"H26"	"C64"	"Other cataract"	"Malignant neoplasm of kidney, except renal pelvis"	1	197	99	296
"H26"	"C71"	"Other cataract"	"Malignant neoplasm of brain"	1	174	48	222
"H26"	"C77"	"Other cataract"	"Secondary and unspecified malignant neoplasm of lymph nodes"	1	493	181	674
"H26"	"C79"	"Other cataract"	"Secondary malignant neoplasm of other and unspecified sites"	1	950	108	1058
"H26"	"D09"	"Other cataract"	"Carcinoma in situ of other and unspecified sites"	1	165	43	208
"H26"	"D47"	"Other cataract"	"Oth neoplm of uncrt behav of lymphoid, hematpoetc & rel tiss"	1	283	116	399
"H26"	"E64"	"Other cataract"	"Sequelae of malnutrition and other nutritional deficiencies"	1	281	64	345
"H26"	"E86"	"Other cataract"	"Volume depletion"	1	6703	0	6703
"H26"	"F03"	"Other cataract"	"Unspecified dementia"	1	2878	0	2878
"H26"	"F17"	"Other cataract"	"Nicotine dependence"	1	422	218	640
"H26"	"F32"	"Other cataract"	"Depressive episode"	1	1541	675	2216
"H26"	"F41"	"Other cataract"	"Other anxiety disorders"	1	551	175	726
"H26"	"G47"	"Other cataract"	"Sleep disorders"	1	895	506	1401
"H26"	"G95"	"Other cataract"	"Other and unspecified diseases of spinal cord"	1	197	69	266
"H26"	"G96"	"Other cataract"	"Other disorders of central nervous system"	1	522	145	667
"H26"	"G98"	"Other cataract"	"Other disorders of nervous system not elsewhere classified"	1	126	24	150
"H26"	"I26"	"Other cataract"	"Pulmonary embolism"	1	1023	471	1494
"H26"	"I69"	"Other cataract"	"Sequelae of cerebrovascular disease"	1	3214	1336	4550
"H26"	"I71"	"Other cataract"	"Aortic aneurysm and dissection"	1	816	387	1203
"H26"	"J84"	"Other cataract"	"Other interstitial pulmonary diseases"	1	339	215	554
"H26"	"K55"	"Other cataract"	"Vascular disorders of intestine"	1	314	87	401
"H26"	"K56"	"Other cataract"	"Paralytic ileus and intestinal obstruction without hernia"	1	1054	507	1561
"H26"	"L57"	"Other cataract"	"Skin changes due to chronic expsr to nonionizing radiation"	1	361	152	513
"H26"	"L89"	"Other cataract"	"Pressure ulcer"	1	787	103	890
"H26"	"N13"	"Other cataract"	"Obstructive and reflux uropathy"	1	480	280	760
"H27"	"A41"	"Other disorders of lens"	"Other sepsis"	1	256	0	256
"H27"	"C18"	"Other disorders of lens"	"Malignant neoplasm of colon"	1	114	17	131
"H27"	"C50"	"Other disorders of lens"	"Malignant neoplasm of breast"	1	100	36	136
"H27"	"C78"	"Other disorders of lens"	"Secondary malignant neoplasm of resp and digestive organs"	1	110	0	110
"H27"	"C79"	"Other disorders of lens"	"Secondary malignant neoplasm of other and unspecified sites"	1	84	0	84
"H27"	"G47"	"Other disorders of lens"	"Sleep disorders"	1	54	5	59
"H27"	"H57"	"Other disorders of lens"	"Other disorders of eye and adnexa"	1	147	51	198
"H27"	"I50"	"Other disorders of lens"	"Heart failure"	1	785	69	854
"H27"	"J44"	"Other disorders of lens"	"Other chronic obstructive pulmonary disease"	1	459	97	556
"H27"	"K25"	"Other disorders of lens"	"Gastric ulcer"	1	161	44	205
"H27"	"K57"	"Other disorders of lens"	"Diverticular disease of intestine"	1	237	44	281
"H27"	"K59"	"Other disorders of lens"	"Other functional intestinal disorders"	1	286	26	312
"H27"	"K80"	"Other disorders of lens"	"Cholelithiasis"	1	180	54	234
"H27"	"M54"	"Other disorders of lens"	"Dorsalgia"	1	259	74	333
"H27"	"M75"	"Other disorders of lens"	"Shoulder lesions"	1	111	43	154
"H27"	"N30"	"Other disorders of lens"	"Cystitis"	1	587	25	612
"H27"	"N39"	"Other disorders of lens"	"Other disorders of urinary system"	1	324	9	333
"H28"	"A49"	"Cataract in diseases classified elsewhere"	"Bacterial infection of unspecified site"	1	52	0	52
"H28"	"D64"	"Cataract in diseases classified elsewhere"	"Other anemias"	1	116	19	135
"H28"	"E87"	"Cataract in diseases classified elsewhere"	"Other disorders of fluid, electrolyte and acid-base balance"	1	84	3	87
"H28"	"G96"	"Cataract in diseases classified elsewhere"	"Other disorders of central nervous system"	1	38	0	38
"H28"	"I50"	"Cataract in diseases classified elsewhere"	"Heart failure"	1	148	69	217
"H28"	"I69"	"Cataract in diseases classified elsewhere"	"Sequelae of cerebrovascular disease"	1	114	21	135
"H28"	"J18"	"Cataract in diseases classified elsewhere"	"Pneumonia, unspecified organism"	1	232	63	295
"H28"	"N18"	"Cataract in diseases classified elsewhere"	"Chronic kidney disease (CKD)"	1	130	14	144
"H28"	"N19"	"Cataract in diseases classified elsewhere"	"Unspecified kidney failure"	1	75	17	92
"H28"	"N30"	"Cataract in diseases classified elsewhere"	"Cystitis"	1	140	46	186
"H33"	"A46"	"Retinal detachments and breaks"	"Erysipelas"	1	301	117	418
"H33"	"B37"	"Retinal detachments and breaks"	"Candidiasis"	1	110	19	129
"H33"	"C15"	"Retinal detachments and breaks"	"Malignant neoplasm of esophagus"	1	57	3	60
"H33"	"C22"	"Retinal detachments and breaks"	"Malignant neoplasm of liver and intrahepatic bile ducts"	1	46	1	47
"H33"	"C25"	"Retinal detachments and breaks"	"Malignant neoplasm of pancreas"	1	106	0	106
"H33"	"C34"	"Retinal detachments and breaks"	"Malignant neoplasm of bronchus and lung"	1	450	28	478
"H33"	"C61"	"Retinal detachments and breaks"	"Malignant neoplasm of prostate"	1	380	109	489
"H33"	"C80"	"Retinal detachments and breaks"	"Malignant neoplasm without specification of site"	1	57	5	62
"H33"	"D09"	"Retinal detachments and breaks"	"Carcinoma in situ of other and unspecified sites"	1	35	4	39
"H33"	"D46"	"Retinal detachments and breaks"	"Myelodysplastic syndromes"	1	51	2	53
"H33"	"D47"	"Retinal detachments and breaks"	"Oth neoplm of uncrt behav of lymphoid, hematpoetc & rel tiss"	1	80	6	86
"H33"	"D69"	"Retinal detachments and breaks"	"Purpura and other hemorrhagic conditions"	1	96	35	131
"H33"	"E03"	"Retinal detachments and breaks"	"Other hypothyroidism"	1	244	111	355
"H33"	"E55"	"Retinal detachments and breaks"	"Vitamin D deficiency"	1	100	0	100
"H33"	"E78"	"Retinal detachments and breaks"	"Disorders of lipoprotein metabolism and other lipidemias"	1	971	559	1530
"H33"	"E87"	"Retinal detachments and breaks"	"Other disorders of fluid, electrolyte and acid-base balance"	1	504	21	525
"H33"	"F01"	"Retinal detachments and breaks"	"Vascular dementia"	1	81	0	81
"H33"	"F03"	"Retinal detachments and breaks"	"Unspecified dementia"	1	345	0	345
"H33"	"F05"	"Retinal detachments and breaks"	"Delirium due to known physiological condition"	1	151	0	151
"H33"	"F32"	"Retinal detachments and breaks"	"Depressive episode"	1	254	69	323
"H33"	"G20"	"Retinal detachments and breaks"	"Parkinson's disease"	1	104	6	110
"H33"	"G45"	"Retinal detachments and breaks"	"Transient cerebral ischemic attacks and related syndromes"	1	532	277	809
"H33"	"G62"	"Retinal detachments and breaks"	"Other and unspecified polyneuropathies"	1	178	61	239
"H33"	"G95"	"Retinal detachments and breaks"	"Other and unspecified diseases of spinal cord"	1	107	1	108
"H33"	"G96"	"Retinal detachments and breaks"	"Other disorders of central nervous system"	1	202	29	231
"H33"	"G98"	"Retinal detachments and breaks"	"Other disorders of nervous system not elsewhere classified"	1	59	13	72
"H33"	"H25"	"Retinal detachments and breaks"	"Age-related cataract"	1	5246	4081	9327
"H33"	"H26"	"Retinal detachments and breaks"	"Other cataract"	1	3913	1927	5840
"H33"	"H40"	"Retinal detachments and breaks"	"Glaucoma"	1	1428	919	2347
"H33"	"H57"	"Retinal detachments and breaks"	"Other disorders of eye and adnexa"	1	1032	246	1278
"H33"	"H59"	"Retinal detachments and breaks"	"Intraop and postproc comp and disord of eye and adnexa, NEC"	1	159	67	226
"H33"	"I10"	"Retinal detachments and breaks"	"Essential (primary) hypertension"	1	2533	1466	3999
"H33"	"I25"	"Retinal detachments and breaks"	"Chronic ischemic heart disease"	1	918	581	1499
"H33"	"I26"	"Retinal detachments and breaks"	"Pulmonary embolism"	1	254	50	304
"H33"	"I34"	"Retinal detachments and breaks"	"Nonrheumatic mitral valve disorders"	1	165	43	208
"H33"	"I35"	"Retinal detachments and breaks"	"Nonrheumatic aortic valve disorders"	1	509	68	577
"H33"	"I46"	"Retinal detachments and breaks"	"Cardiac arrest"	1	224	0	224
"H33"	"I48"	"Retinal detachments and breaks"	"Atrial fibrillation and flutter"	1	1496	431	1927
"H33"	"I61"	"Retinal detachments and breaks"	"Nontraumatic intracerebral hemorrhage"	1	201	32	233
"H33"	"I69"	"Retinal detachments and breaks"	"Sequelae of cerebrovascular disease"	1	688	118	806
"H33"	"I70"	"Retinal detachments and breaks"	"Atherosclerosis"	1	347	200	547
"H33"	"I73"	"Retinal detachments and breaks"	"Other peripheral vascular diseases"	1	310	123	433
"H33"	"J15"	"Retinal detachments and breaks"	"Bacterial pneumonia, not elsewhere classified"	1	607	43	650
"H33"	"J22"	"Retinal detachments and breaks"	"Unspecified acute lower respiratory infection"	1	75	6	81
"H33"	"J81"	"Retinal detachments and breaks"	"Pulmonary edema"	1	132	7	139
"H33"	"J90"	"Retinal detachments and breaks"	"Pleural effusion, not elsewhere classified"	1	164	6	170
"H33"	"J91"	"Retinal detachments and breaks"	"Pleural effusion in conditions classified elsewhere"	1	66	11	77
"H33"	"J93"	"Retinal detachments and breaks"	"Pneumothorax and air leak"	1	75	21	96
"H33"	"J95"	"Retinal detachments and breaks"	"Intraop and postproc comp and disorders of resp sys, NEC"	1	31	0	31
"H33"	"J96"	"Retinal detachments and breaks"	"Respiratory failure, not elsewhere classified"	1	566	9	575
"H33"	"K25"	"Retinal detachments and breaks"	"Gastric ulcer"	1	255	134	389
"H33"	"K52"	"Retinal detachments and breaks"	"Other and unsp noninfective gastroenteritis and colitis"	1	292	90	382
"H33"	"K55"	"Retinal detachments and breaks"	"Vascular disorders of intestine"	1	68	5	73
"H33"	"K57"	"Retinal detachments and breaks"	"Diverticular disease of intestine"	1	695	253	948
"H33"	"K63"	"Retinal detachments and breaks"	"Other diseases of intestine"	1	107	25	132
"H33"	"K64"	"Retinal detachments and breaks"	"Hemorrhoids and perianal venous thrombosis"	1	262	5	267
"H33"	"K65"	"Retinal detachments and breaks"	"Peritonitis"	1	91	30	121
"H33"	"K72"	"Retinal detachments and breaks"	"Hepatic failure, not elsewhere classified"	1	45	8	53
"H33"	"K92"	"Retinal detachments and breaks"	"Other diseases of digestive system"	1	320	59	379
"H33"	"L57"	"Retinal detachments and breaks"	"Skin changes due to chronic expsr to nonionizing radiation"	1	97	14	111
"H33"	"L89"	"Retinal detachments and breaks"	"Pressure ulcer"	1	129	2	131
"H33"	"M48"	"Retinal detachments and breaks"	"Other spondylopathies"	1	453	153	606
"H33"	"M80"	"Retinal detachments and breaks"	"Osteoporosis with current pathological fracture"	1	354	11	365
"H33"	"M81"	"Retinal detachments and breaks"	"Osteoporosis without current pathological fracture"	1	710	182	892
"H33"	"M85"	"Retinal detachments and breaks"	"Other disorders of bone density and structure"	1	356	111	467
"H33"	"N13"	"Retinal detachments and breaks"	"Obstructive and reflux uropathy"	1	171	51	222
"H33"	"N30"	"Retinal detachments and breaks"	"Cystitis"	1	1082	271	1353
"H34"	"C34"	"Retinal vascular occlusions"	"Malignant neoplasm of bronchus and lung"	1	393	71	464
"H34"	"I50"	"Retinal vascular occlusions"	"Heart failure"	1	1188	532	1720
"H34"	"I61"	"Retinal vascular occlusions"	"Nontraumatic intracerebral hemorrhage"	1	265	74	339
"H34"	"I69"	"Retinal vascular occlusions"	"Sequelae of cerebrovascular disease"	1	1136	479	1615
"H34"	"K56"	"Retinal vascular occlusions"	"Paralytic ileus and intestinal obstruction without hernia"	1	169	87	256
"H34"	"K59"	"Retinal vascular occlusions"	"Other functional intestinal disorders"	1	739	285	1024
"H34"	"M80"	"Retinal vascular occlusions"	"Osteoporosis with current pathological fracture"	1	316	124	440
"H34"	"N39"	"Retinal vascular occlusions"	"Other disorders of urinary system"	1	867	281	1148
"H35"	"A46"	"Other retinal disorders"	"Erysipelas"	1	1591	914	2505
"H35"	"B37"	"Other retinal disorders"	"Candidiasis"	1	720	312	1032
"H35"	"C15"	"Other retinal disorders"	"Malignant neoplasm of esophagus"	1	282	32	314
"H35"	"C18"	"Other retinal disorders"	"Malignant neoplasm of colon"	1	1239	900	2139
"H35"	"C25"	"Other retinal disorders"	"Malignant neoplasm of pancreas"	1	561	40	601
"H35"	"C34"	"Other retinal disorders"	"Malignant neoplasm of bronchus and lung"	1	2404	528	2932
"H35"	"C44"	"Other retinal disorders"	"Other and unspecified malignant neoplasm of skin"	1	1903	1358	3261
"H35"	"C61"	"Other retinal disorders"	"Malignant neoplasm of prostate"	1	1136	905	2041
"H35"	"C71"	"Other retinal disorders"	"Malignant neoplasm of brain"	1	274	78	352
"H35"	"D46"	"Other retinal disorders"	"Myelodysplastic syndromes"	1	271	79	350
"H35"	"D47"	"Other retinal disorders"	"Oth neoplm of uncrt behav of lymphoid, hematpoetc & rel tiss"	1	381	146	527
"H35"	"E21"	"Other retinal disorders"	"Hyperparathyroidism and other disorders of parathyroid gland"	1	386	216	602
"H35"	"F01"	"Other retinal disorders"	"Vascular dementia"	1	750	72	822
"H35"	"F03"	"Other retinal disorders"	"Unspecified dementia"	1	3951	0	3951
"H35"	"G20"	"Other retinal disorders"	"Parkinson's disease"	1	683	310	993
"H35"	"G21"	"Other retinal disorders"	"Secondary parkinsonism"	1	105	40	145
"H35"	"G23"	"Other retinal disorders"	"Other degenerative diseases of basal ganglia"	1	64	15	79
"H35"	"G95"	"Other retinal disorders"	"Other and unspecified diseases of spinal cord"	1	321	97	418
"H35"	"H57"	"Other retinal disorders"	"Other disorders of eye and adnexa"	1	1166	844	2010
"H35"	"I26"	"Other retinal disorders"	"Pulmonary embolism"	1	1289	607	1896
"H35"	"I46"	"Other retinal disorders"	"Cardiac arrest"	1	1431	0	1431
"H35"	"I48"	"Other retinal disorders"	"Atrial fibrillation and flutter"	1	8076	5121	13197
"H35"	"I50"	"Other retinal disorders"	"Heart failure"	1	7021	3566	10587
"H35"	"I69"	"Other retinal disorders"	"Sequelae of cerebrovascular disease"	1	4805	1939	6744
"H35"	"I82"	"Other retinal disorders"	"Other venous embolism and thrombosis"	1	296	174	470
"H35"	"J15"	"Other retinal disorders"	"Bacterial pneumonia, not elsewhere classified"	1	5486	0	5486
"H35"	"J18"	"Other retinal disorders"	"Pneumonia, unspecified organism"	1	16347	0	16347
"H35"	"J44"	"Other retinal disorders"	"Other chronic obstructive pulmonary disease"	1	4662	4101	8763
"H35"	"J69"	"Other retinal disorders"	"Pneumonitis due to solids and liquids"	1	537	10	547
"H35"	"J90"	"Other retinal disorders"	"Pleural effusion, not elsewhere classified"	1	1018	209	1227
"H35"	"J98"	"Other retinal disorders"	"Other respiratory disorders"	1	512	326	838
"H35"	"K63"	"Other retinal disorders"	"Other diseases of intestine"	1	511	181	692
"H35"	"K64"	"Other retinal disorders"	"Hemorrhoids and perianal venous thrombosis"	1	736	145	881
"H35"	"K65"	"Other retinal disorders"	"Peritonitis"	1	449	244	693
"H35"	"K72"	"Other retinal disorders"	"Hepatic failure, not elsewhere classified"	1	222	58	280
"H35"	"K83"	"Other retinal disorders"	"Other diseases of biliary tract"	1	424	251	675
"H35"	"L89"	"Other retinal disorders"	"Pressure ulcer"	1	959	93	1052
"H35"	"L97"	"Other retinal disorders"	"Non-pressure chronic ulcer of lower limb, NEC"	1	1391	489	1880
"H35"	"M85"	"Other retinal disorders"	"Other disorders of bone density and structure"	1	1154	904	2058
"H35"	"N13"	"Other retinal disorders"	"Obstructive and reflux uropathy"	1	732	431	1163
"H35"	"N30"	"Other retinal disorders"	"Cystitis"	1	10866	0	10866
"H35"	"N39"	"Other retinal disorders"	"Other disorders of urinary system"	1	8209	0	8209
"H36"	"A04"	"Retinal disorders in diseases classified elsewhere"	"Other bacterial intestinal infections"	1	279	65	344
"H36"	"A26"	"Retinal disorders in diseases classified elsewhere"	"Erysipeloid"	1	33	0	33
"H36"	"A49"	"Retinal disorders in diseases classified elsewhere"	"Bacterial infection of unspecified site"	1	725	113	838
"H36"	"C16"	"Retinal disorders in diseases classified elsewhere"	"Malignant neoplasm of stomach"	1	82	15	97
"H36"	"C44"	"Retinal disorders in diseases classified elsewhere"	"Other and unspecified malignant neoplasm of skin"	1	325	126	451
"H36"	"C78"	"Retinal disorders in diseases classified elsewhere"	"Secondary malignant neoplasm of resp and digestive organs"	1	429	80	509
"H36"	"D47"	"Retinal disorders in diseases classified elsewhere"	"Oth neoplm of uncrt behav of lymphoid, hematpoetc & rel tiss"	1	77	12	89
"H36"	"D50"	"Retinal disorders in diseases classified elsewhere"	"Iron deficiency anemia"	1	600	190	790
"H36"	"D62"	"Retinal disorders in diseases classified elsewhere"	"Acute posthemorrhagic anemia"	1	268	86	354
"H36"	"D63"	"Retinal disorders in diseases classified elsewhere"	"Anemia in chronic diseases classified elsewhere"	1	456	73	529
"H36"	"E55"	"Retinal disorders in diseases classified elsewhere"	"Vitamin D deficiency"	1	222	78	300
"H36"	"E86"	"Retinal disorders in diseases classified elsewhere"	"Volume depletion"	1	1664	194	1858
"H36"	"G20"	"Retinal disorders in diseases classified elsewhere"	"Parkinson's disease"	1	130	45	175
"H36"	"G47"	"Retinal disorders in diseases classified elsewhere"	"Sleep disorders"	1	520	259	779
"H36"	"G62"	"Retinal disorders in diseases classified elsewhere"	"Other and unspecified polyneuropathies"	1	413	221	634
"H36"	"H02"	"Retinal disorders in diseases classified elsewhere"	"Other disorders of eyelid"	1	411	267	678
"H36"	"H18"	"Retinal disorders in diseases classified elsewhere"	"Other disorders of cornea"	1	281	93	374
"H36"	"H21"	"Retinal disorders in diseases classified elsewhere"	"Other disorders of iris and ciliary body"	1	131	61	192
"H36"	"H57"	"Retinal disorders in diseases classified elsewhere"	"Other disorders of eye and adnexa"	1	312	85	397
"H36"	"I11"	"Retinal disorders in diseases classified elsewhere"	"Hypertensive heart disease"	1	479	316	795
"H36"	"I26"	"Retinal disorders in diseases classified elsewhere"	"Pulmonary embolism"	1	268	86	354
"H36"	"I44"	"Retinal disorders in diseases classified elsewhere"	"Atrioventricular and left bundle-branch block"	1	478	118	596
"H36"	"I51"	"Retinal disorders in diseases classified elsewhere"	"Complications and ill-defined descriptions of heart disease"	1	228	48	276
"H36"	"I69"	"Retinal disorders in diseases classified elsewhere"	"Sequelae of cerebrovascular disease"	1	1564	684	2248
"H36"	"I70"	"Retinal disorders in diseases classified elsewhere"	"Atherosclerosis"	1	1815	1143	2958
"H36"	"J22"	"Retinal disorders in diseases classified elsewhere"	"Unspecified acute lower respiratory infection"	1	203	111	314
"H36"	"J84"	"Retinal disorders in diseases classified elsewhere"	"Other interstitial pulmonary diseases"	1	101	39	140
"H36"	"J90"	"Retinal disorders in diseases classified elsewhere"	"Pleural effusion, not elsewhere classified"	1	371	51	422
"H36"	"K63"	"Retinal disorders in diseases classified elsewhere"	"Other diseases of intestine"	1	127	23	150
"H36"	"K64"	"Retinal disorders in diseases classified elsewhere"	"Hemorrhoids and perianal venous thrombosis"	1	140	0	140
"H36"	"K65"	"Retinal disorders in diseases classified elsewhere"	"Peritonitis"	1	273	121	394
"H36"	"L89"	"Retinal disorders in diseases classified elsewhere"	"Pressure ulcer"	1	562	102	664
"H36"	"L97"	"Retinal disorders in diseases classified elsewhere"	"Non-pressure chronic ulcer of lower limb, NEC"	1	1582	443	2025
"H36"	"M80"	"Retinal disorders in diseases classified elsewhere"	"Osteoporosis with current pathological fracture"	1	301	77	378
"H36"	"M85"	"Retinal disorders in diseases classified elsewhere"	"Other disorders of bone density and structure"	1	340	115	455
"H36"	"N16"	"Retinal disorders in diseases classified elsewhere"	"Renal tubulo-interstitial disord in diseases classd elswhr"	1	73	5	78
"H36"	"N17"	"Retinal disorders in diseases classified elsewhere"	"Acute kidney failure"	1	708	88	796
"H36"	"N18"	"Retinal disorders in diseases classified elsewhere"	"Chronic kidney disease (CKD)"	1	2982	0	2982
"H36"	"N25"	"Retinal disorders in diseases classified elsewhere"	"Disorders resulting from impaired renal tubular function"	1	122	13	135
"H36"	"N39"	"Retinal disorders in diseases classified elsewhere"	"Other disorders of urinary system"	1	1569	505	2074
"H40"	"A04"	"Glaucoma"	"Other bacterial intestinal infections"	1	276	34	310
"H40"	"A09"	"Glaucoma"	"Infectious gastroenteritis and colitis, unspecified"	1	608	365	973
"H40"	"A46"	"Glaucoma"	"Erysipelas"	1	595	266	861
"H40"	"C15"	"Glaucoma"	"Malignant neoplasm of esophagus"	1	112	10	122
"H40"	"C16"	"Glaucoma"	"Malignant neoplasm of stomach"	1	134	22	156
"H40"	"C18"	"Glaucoma"	"Malignant neoplasm of colon"	1	523	236	759
"H40"	"C24"	"Glaucoma"	"Malignant neoplasm of other and unsp parts of biliary tract"	1	37	3	40
"H40"	"C61"	"Glaucoma"	"Malignant neoplasm of prostate"	1	500	222	722
"H40"	"C77"	"Glaucoma"	"Secondary and unspecified malignant neoplasm of lymph nodes"	1	218	57	275
"H40"	"C78"	"Glaucoma"	"Secondary malignant neoplasm of resp and digestive organs"	1	735	30	765
"H40"	"C79"	"Glaucoma"	"Secondary malignant neoplasm of other and unspecified sites"	1	475	37	512
"H40"	"C80"	"Glaucoma"	"Malignant neoplasm without specification of site"	1	89	4	93
"H40"	"C83"	"Glaucoma"	"Non-follicular lymphoma"	1	90	33	123
"H40"	"C92"	"Glaucoma"	"Myeloid leukemia"	1	67	15	82
"H40"	"D12"	"Glaucoma"	"Benign neoplasm of colon, rectum, anus and anal canal"	1	824	503	1327
"H40"	"D62"	"Glaucoma"	"Acute posthemorrhagic anemia"	1	320	68	388
"H40"	"D63"	"Glaucoma"	"Anemia in chronic diseases classified elsewhere"	1	428	47	475
"H40"	"E16"	"Glaucoma"	"Other disorders of pancreatic internal secretion"	1	376	206	582
"H40"	"E64"	"Glaucoma"	"Sequelae of malnutrition and other nutritional deficiencies"	1	127	31	158
"H40"	"E83"	"Glaucoma"	"Disorders of mineral metabolism"	1	199	32	231
"H40"	"E86"	"Glaucoma"	"Volume depletion"	1	3190	0	3190
"H40"	"F41"	"Glaucoma"	"Other anxiety disorders"	1	207	69	276
"H40"	"G47"	"Glaucoma"	"Sleep disorders"	1	382	136	518
"H40"	"G95"	"Glaucoma"	"Other and unspecified diseases of spinal cord"	1	105	29	134
"H40"	"H57"	"Glaucoma"	"Other disorders of eye and adnexa"	1	695	386	1081
"H40"	"I21"	"Glaucoma"	"Acute myocardial infarction"	1	1566	804	2370
"H40"	"I34"	"Glaucoma"	"Nonrheumatic mitral valve disorders"	1	323	126	449
"H40"	"I46"	"Glaucoma"	"Cardiac arrest"	1	474	0	474
"H40"	"I48"	"Glaucoma"	"Atrial fibrillation and flutter"	1	3219	1313	4532
"H40"	"I49"	"Glaucoma"	"Other cardiac arrhythmias"	1	600	337	937
"H40"	"I51"	"Glaucoma"	"Complications and ill-defined descriptions of heart disease"	1	201	50	251
"H40"	"I70"	"Glaucoma"	"Atherosclerosis"	1	1014	648	1662
"H40"	"I73"	"Glaucoma"	"Other peripheral vascular diseases"	1	563	232	795
"H40"	"I74"	"Glaucoma"	"Arterial embolism and thrombosis"	1	122	52	174
"H40"	"J15"	"Glaucoma"	"Bacterial pneumonia, not elsewhere classified"	1	1585	158	1743
"H40"	"J18"	"Glaucoma"	"Pneumonia, unspecified organism"	1	5685	0	5685
"H40"	"J93"	"Glaucoma"	"Pneumothorax and air leak"	1	139	50	189
"H40"	"J96"	"Glaucoma"	"Respiratory failure, not elsewhere classified"	1	1399	122	1521
"H40"	"K25"	"Glaucoma"	"Gastric ulcer"	1	656	429	1085
"H40"	"K52"	"Glaucoma"	"Other and unsp noninfective gastroenteritis and colitis"	1	561	201	762
"H40"	"K55"	"Glaucoma"	"Vascular disorders of intestine"	1	135	24	159
"H40"	"K59"	"Glaucoma"	"Other functional intestinal disorders"	1	1803	583	2386
"H40"	"K62"	"Glaucoma"	"Other diseases of anus and rectum"	1	725	442	1167
"H40"	"K63"	"Glaucoma"	"Other diseases of intestine"	1	191	35	226
"H40"	"K74"	"Glaucoma"	"Fibrosis and cirrhosis of liver"	1	75	23	98
"H40"	"L98"	"Glaucoma"	"Oth disorders of skin, subcu, not elsewhere classified"	1	295	118	413
"H40"	"M19"	"Glaucoma"	"Other and unspecified osteoarthritis"	1	647	468	1115
"H40"	"M48"	"Glaucoma"	"Other spondylopathies"	1	690	389	1079
"H40"	"M81"	"Glaucoma"	"Osteoporosis without current pathological fracture"	1	1619	723	2342
"H40"	"N18"	"Glaucoma"	"Chronic kidney disease (CKD)"	1	1075	150	1225
"H40"	"N39"	"Glaucoma"	"Other disorders of urinary system"	1	2215	562	2777
"H43"	"B37"	"Disorders of vitreous body"	"Candidiasis"	1	149	69	218
"H43"	"C16"	"Disorders of vitreous body"	"Malignant neoplasm of stomach"	1	45	7	52
"H43"	"C24"	"Disorders of vitreous body"	"Malignant neoplasm of other and unsp parts of biliary tract"	1	29	2	31
"H43"	"C25"	"Disorders of vitreous body"	"Malignant neoplasm of pancreas"	1	135	1	136
"H43"	"C34"	"Disorders of vitreous body"	"Malignant neoplasm of bronchus and lung"	1	423	67	490
"H43"	"C44"	"Disorders of vitreous body"	"Other and unspecified malignant neoplasm of skin"	1	500	213	713
"H43"	"C77"	"Disorders of vitreous body"	"Secondary and unspecified malignant neoplasm of lymph nodes"	1	143	54	197
"H43"	"C79"	"Disorders of vitreous body"	"Secondary malignant neoplasm of other and unspecified sites"	1	263	32	295
"H43"	"D12"	"Disorders of vitreous body"	"Benign neoplasm of colon, rectum, anus and anal canal"	1	766	444	1210
"H43"	"D63"	"Disorders of vitreous body"	"Anemia in chronic diseases classified elsewhere"	1	280	32	312
"H43"	"D64"	"Disorders of vitreous body"	"Other anemias"	1	1148	334	1482
"H43"	"E64"	"Disorders of vitreous body"	"Sequelae of malnutrition and other nutritional deficiencies"	1	84	18	102
"H43"	"E86"	"Disorders of vitreous body"	"Volume depletion"	1	1197	115	1312
"H43"	"F32"	"Disorders of vitreous body"	"Depressive episode"	1	331	174	505
"H43"	"G47"	"Disorders of vitreous body"	"Sleep disorders"	1	420	239	659
"H43"	"G95"	"Disorders of vitreous body"	"Other and unspecified diseases of spinal cord"	1	91	16	107
"H43"	"H54"	"Disorders of vitreous body"	"Blindness and low vision"	1	474	213	687
"H43"	"H57"	"Disorders of vitreous body"	"Other disorders of eye and adnexa"	1	712	398	1110
"H43"	"I26"	"Disorders of vitreous body"	"Pulmonary embolism"	1	262	124	386
"H43"	"I35"	"Disorders of vitreous body"	"Nonrheumatic aortic valve disorders"	1	640	202	842
"H43"	"I71"	"Disorders of vitreous body"	"Aortic aneurysm and dissection"	1	281	87	368
"H43"	"J18"	"Disorders of vitreous body"	"Pneumonia, unspecified organism"	1	2035	811	2846
"H43"	"J44"	"Disorders of vitreous body"	"Other chronic obstructive pulmonary disease"	1	853	553	1406
"H43"	"J90"	"Disorders of vitreous body"	"Pleural effusion, not elsewhere classified"	1	201	38	239
"H43"	"J96"	"Disorders of vitreous body"	"Respiratory failure, not elsewhere classified"	1	850	84	934
"H43"	"K52"	"Disorders of vitreous body"	"Other and unsp noninfective gastroenteritis and colitis"	1	313	188	501
"H43"	"K56"	"Disorders of vitreous body"	"Paralytic ileus and intestinal obstruction without hernia"	1	248	106	354
"H43"	"L97"	"Disorders of vitreous body"	"Non-pressure chronic ulcer of lower limb, NEC"	1	397	180	577
"H43"	"M80"	"Disorders of vitreous body"	"Osteoporosis with current pathological fracture"	1	434	81	515
"H43"	"N08"	"Disorders of vitreous body"	"Glomerular disorders in diseases classified elsewhere"	1	93	27	120
"H43"	"N13"	"Disorders of vitreous body"	"Obstructive and reflux uropathy"	1	191	85	276
"H43"	"N18"	"Disorders of vitreous body"	"Chronic kidney disease (CKD)"	1	1028	222	1250
"H43"	"N30"	"Disorders of vitreous body"	"Cystitis"	1	1417	627	2044
"H44"	"D64"	"Disorders of globe"	"Other anemias"	1	277	107	384
"H44"	"G47"	"Disorders of globe"	"Sleep disorders"	1	154	32	186
"H44"	"H57"	"Disorders of globe"	"Other disorders of eye and adnexa"	1	226	128	354
"H44"	"I35"	"Disorders of globe"	"Nonrheumatic aortic valve disorders"	1	137	37	174
"H44"	"I50"	"Disorders of globe"	"Heart failure"	1	360	170	530
"H44"	"J15"	"Disorders of globe"	"Bacterial pneumonia, not elsewhere classified"	1	227	49	276
"H44"	"K59"	"Disorders of globe"	"Other functional intestinal disorders"	1	306	131	437
"H44"	"N30"	"Disorders of globe"	"Cystitis"	1	379	170	549
"H44"	"N39"	"Disorders of globe"	"Other disorders of urinary system"	1	321	90	411
"H46"	"G35"	"Optic neuritis"	"Multiple sclerosis"	1	1210	443	1653
"H46"	"G37"	"Optic neuritis"	"Other demyelinating diseases of central nervous system"	1	203	112	315
"H46"	"H57"	"Optic neuritis"	"Other disorders of eye and adnexa"	1	173	87	260
"H47"	"A41"	"Other disorders of optic [2nd] nerve and visual pathways"	"Other sepsis"	1	304	107	411
"H47"	"I69"	"Other disorders of optic [2nd] nerve and visual pathways"	"Sequelae of cerebrovascular disease"	1	271	159	430
"H49"	"C78"	"Paralytic strabismus"	"Secondary malignant neoplasm of resp and digestive organs"	1	119	47	166
"H49"	"G35"	"Paralytic strabismus"	"Multiple sclerosis"	1	176	92	268
"H49"	"I69"	"Paralytic strabismus"	"Sequelae of cerebrovascular disease"	1	497	297	794
"H49"	"K59"	"Paralytic strabismus"	"Other functional intestinal disorders"	1	281	145	426
"H49"	"O72"	"Paralytic strabismus"	"Postpartum hemorrhage"	1	91	24	115
"H50"	"A04"	"Other strabismus"	"Other bacterial intestinal infections"	1	82	15	97
"H50"	"A41"	"Other strabismus"	"Other sepsis"	1	409	76	485
"H50"	"A46"	"Other strabismus"	"Erysipelas"	1	189	68	257
"H50"	"A49"	"Other strabismus"	"Bacterial infection of unspecified site"	1	213	43	256
"H50"	"C18"	"Other strabismus"	"Malignant neoplasm of colon"	1	101	15	116
"H50"	"C25"	"Other strabismus"	"Malignant neoplasm of pancreas"	1	37	0	37
"H50"	"C78"	"Other strabismus"	"Secondary malignant neoplasm of resp and digestive organs"	1	120	1	121
"H50"	"D22"	"Other strabismus"	"Melanocytic nevi"	1	123	22	145
"H50"	"D50"	"Other strabismus"	"Iron deficiency anemia"	1	150	39	189
"H50"	"E11"	"Other strabismus"	"Type 2 diabetes mellitus"	1	375	212	587
"H50"	"E78"	"Other strabismus"	"Disorders of lipoprotein metabolism and other lipidemias"	1	442	206	648
"H50"	"E86"	"Other strabismus"	"Volume depletion"	1	512	201	713
"H50"	"F84"	"Other strabismus"	"Pervasive developmental disorders"	1	148	44	192
"H50"	"G96"	"Other strabismus"	"Other disorders of central nervous system"	1	208	83	291
"H50"	"H57"	"Other strabismus"	"Other disorders of eye and adnexa"	1	360	230	590
"H50"	"I26"	"Other strabismus"	"Pulmonary embolism"	1	114	21	135
"H50"	"I50"	"Other strabismus"	"Heart failure"	1	377	137	514
"H50"	"I51"	"Other strabismus"	"Complications and ill-defined descriptions of heart disease"	1	54	6	60
"H50"	"I73"	"Other strabismus"	"Other peripheral vascular diseases"	1	134	45	179
"H50"	"J44"	"Other strabismus"	"Other chronic obstructive pulmonary disease"	1	408	199	607
"H50"	"J81"	"Other strabismus"	"Pulmonary edema"	1	48	5	53
"H50"	"J90"	"Other strabismus"	"Pleural effusion, not elsewhere classified"	1	66	7	73
"H50"	"J96"	"Other strabismus"	"Respiratory failure, not elsewhere classified"	1	382	103	485
"H50"	"K01"	"Other strabismus"	"Embedded and impacted teeth"	1	74	17	91
"H50"	"K22"	"Other strabismus"	"Other diseases of esophagus"	1	103	38	141
"H50"	"K35"	"Other strabismus"	"Acute appendicitis"	1	251	138	389
"H50"	"K52"	"Other strabismus"	"Other and unsp noninfective gastroenteritis and colitis"	1	227	113	340
"H50"	"K56"	"Other strabismus"	"Paralytic ileus and intestinal obstruction without hernia"	1	143	49	192
"H50"	"K57"	"Other strabismus"	"Diverticular disease of intestine"	1	295	103	398
"H50"	"K58"	"Other strabismus"	"Irritable bowel syndrome"	1	155	77	232
"H50"	"K63"	"Other strabismus"	"Other diseases of intestine"	1	56	8	64
"H50"	"L08"	"Other strabismus"	"Other local infections of skin and subcutaneous tissue"	1	195	68	263
"H50"	"L60"	"Other strabismus"	"Nail disorders"	1	103	27	130
"H50"	"L98"	"Other strabismus"	"Oth disorders of skin, subcu, not elsewhere classified"	1	92	28	120
"H50"	"M19"	"Other strabismus"	"Other and unspecified osteoarthritis"	1	271	70	341
"H50"	"M20"	"Other strabismus"	"Acquired deformities of fingers and toes"	1	204	105	309
"H50"	"M22"	"Other strabismus"	"Disorder of patella"	1	177	83	260
"H50"	"M25"	"Other strabismus"	"Other joint disorder, not elsewhere classified"	1	221	75	296
"H50"	"M54"	"Other strabismus"	"Dorsalgia"	1	611	381	992
"H50"	"M75"	"Other strabismus"	"Shoulder lesions"	1	427	199	626
"H50"	"M76"	"Other strabismus"	"Enthesopathies, lower limb, excluding foot"	1	122	43	165
"H50"	"N17"	"Other strabismus"	"Acute kidney failure"	1	86	2	88
"H50"	"N46"	"Other strabismus"	"Male infertility"	1	67	6	73
"H50"	"N63"	"Other strabismus"	"Unspecified lump in breast"	1	112	37	149
"H50"	"N64"	"Other strabismus"	"Other disorders of breast"	1	97	30	127
"H50"	"N93"	"Other strabismus"	"Other abnormal uterine and vaginal bleeding"	1	51	6	57
"H50"	"N94"	"Other strabismus"	"Pain and oth cond assoc w fem gntl org and menstrual cycle"	1	132	42	174
"H50"	"N97"	"Other strabismus"	"Female infertility"	1	113	45	158
"H50"	"O02"	"Other strabismus"	"Other abnormal products of conception"	1	111	38	149
"H50"	"O08"	"Other strabismus"	"Complications following ectopic and molar pregnancy"	1	58	10	68
"H50"	"O24"	"Other strabismus"	"Diabetes in pregnancy, childbirth, and the puerperium"	1	39	3	42
"H50"	"O34"	"Other strabismus"	"Maternal care for abnormality of pelvic organs"	1	69	14	83
"H50"	"O36"	"Other strabismus"	"Maternal care for other fetal problems"	1	109	23	132
"H50"	"O62"	"Other strabismus"	"Abnormalities of forces of labor"	1	296	155	451
"H50"	"O68"	"Other strabismus"	"Labor and delivery comp by abnlt of fetal acid-base balance"	1	223	55	278
"H50"	"O70"	"Other strabismus"	"Perineal laceration during delivery"	1	412	71	483
"H50"	"O72"	"Other strabismus"	"Postpartum hemorrhage"	1	427	0	427
"H50"	"O82"	"Other strabismus"	"Encounter for cesarean delivery without indication"	1	210	85	295
"H50"	"O91"	"Other strabismus"	"Infect of breast assoc w pregnancy, the puerp and lactation"	1	26	0	26
"H50"	"O99"	"Other strabismus"	"Oth maternal diseases classd elsw but compl preg/chldbrth"	1	380	35	415
"H51"	"O72"	"Other disorders of binocular movement"	"Postpartum hemorrhage"	1	54	3	57
"H52"	"A49"	"Disorders of refraction and accommodation"	"Bacterial infection of unspecified site"	1	349	106	455
"H52"	"C34"	"Disorders of refraction and accommodation"	"Malignant neoplasm of bronchus and lung"	1	263	24	287
"H52"	"C61"	"Disorders of refraction and accommodation"	"Malignant neoplasm of prostate"	1	212	44	256
"H52"	"D50"	"Disorders of refraction and accommodation"	"Iron deficiency anemia"	1	232	98	330
"H52"	"E78"	"Disorders of refraction and accommodation"	"Disorders of lipoprotein metabolism and other lipidemias"	1	887	430	1317
"H52"	"F41"	"Disorders of refraction and accommodation"	"Other anxiety disorders"	1	245	85	330
"H52"	"G62"	"Disorders of refraction and accommodation"	"Other and unspecified polyneuropathies"	1	172	76	248
"H52"	"I25"	"Disorders of refraction and accommodation"	"Chronic ischemic heart disease"	1	759	410	1169
"H52"	"I35"	"Disorders of refraction and accommodation"	"Nonrheumatic aortic valve disorders"	1	356	62	418
"H52"	"I46"	"Disorders of refraction and accommodation"	"Cardiac arrest"	1	170	6	176
"H52"	"I49"	"Disorders of refraction and accommodation"	"Other cardiac arrhythmias"	1	332	163	495
"H52"	"I70"	"Disorders of refraction and accommodation"	"Atherosclerosis"	1	255	128	383
"H52"	"J15"	"Disorders of refraction and accommodation"	"Bacterial pneumonia, not elsewhere classified"	1	586	209	795
"H52"	"K55"	"Disorders of refraction and accommodation"	"Vascular disorders of intestine"	1	42	5	47
"H52"	"K56"	"Disorders of refraction and accommodation"	"Paralytic ileus and intestinal obstruction without hernia"	1	247	118	365
"H52"	"K57"	"Disorders of refraction and accommodation"	"Diverticular disease of intestine"	1	637	187	824
"H52"	"K62"	"Disorders of refraction and accommodation"	"Other diseases of anus and rectum"	1	515	273	788
"H52"	"K64"	"Disorders of refraction and accommodation"	"Hemorrhoids and perianal venous thrombosis"	1	543	25	568
"H52"	"K83"	"Disorders of refraction and accommodation"	"Other diseases of biliary tract"	1	83	30	113
"H52"	"M16"	"Disorders of refraction and accommodation"	"Osteoarthritis of hip"	1	503	272	775
"H52"	"M17"	"Disorders of refraction and accommodation"	"Osteoarthritis of knee"	1	866	568	1434
"H52"	"M18"	"Disorders of refraction and accommodation"	"Osteoarthritis of first carpometacarpal joint"	1	122	51	173
"H52"	"M19"	"Disorders of refraction and accommodation"	"Other and unspecified osteoarthritis"	1	595	263	858
"H52"	"M47"	"Disorders of refraction and accommodation"	"Spondylosis"	1	434	270	704
"H52"	"M48"	"Disorders of refraction and accommodation"	"Other spondylopathies"	1	446	139	585
"H52"	"M80"	"Disorders of refraction and accommodation"	"Osteoporosis with current pathological fracture"	1	272	29	301
"H52"	"N30"	"Disorders of refraction and accommodation"	"Cystitis"	1	1086	582	1668
"H52"	"O72"	"Disorders of refraction and accommodation"	"Postpartum hemorrhage"	1	1801	831	2632
"H53"	"C25"	"Visual disturbances"	"Malignant neoplasm of pancreas"	1	95	10	105
"H53"	"C34"	"Visual disturbances"	"Malignant neoplasm of bronchus and lung"	1	426	131	557
"H53"	"C78"	"Visual disturbances"	"Secondary malignant neoplasm of resp and digestive organs"	1	365	87	452
"H53"	"D12"	"Visual disturbances"	"Benign neoplasm of colon, rectum, anus and anal canal"	1	582	398	980
"H53"	"D64"	"Visual disturbances"	"Other anemias"	1	924	438	1362
"H53"	"I50"	"Visual disturbances"	"Heart failure"	1	1095	601	1696
"H53"	"I69"	"Visual disturbances"	"Sequelae of cerebrovascular disease"	1	2207	1418	3625
"H53"	"J90"	"Visual disturbances"	"Pleural effusion, not elsewhere classified"	1	170	63	233
"H53"	"J96"	"Visual disturbances"	"Respiratory failure, not elsewhere classified"	1	906	280	1186
"H53"	"N18"	"Visual disturbances"	"Chronic kidney disease (CKD)"	1	509	180	689
"H54"	"A49"	"Blindness and low vision"	"Bacterial infection of unspecified site"	1	301	174	475
"H54"	"C34"	"Blindness and low vision"	"Malignant neoplasm of bronchus and lung"	1	156	70	226
"H54"	"J15"	"Blindness and low vision"	"Bacterial pneumonia, not elsewhere classified"	1	613	403	1016
"H57"	"C78"	"Other disorders of eye and adnexa"	"Secondary malignant neoplasm of resp and digestive organs"	1	135	50	185
"H57"	"K64"	"Other disorders of eye and adnexa"	"Hemorrhoids and perianal venous thrombosis"	1	277	75	352
"H57"	"M85"	"Other disorders of eye and adnexa"	"Other disorders of bone density and structure"	1	246	98	344
"H59"	"H26"	"Intraop and postproc comp and disord of eye and adnexa, NEC"	"Other cataract"	1	573	198	771
"H60"	"C61"	"Otitis externa"	"Malignant neoplasm of prostate"	1	87	29	116
"H60"	"C78"	"Otitis externa"	"Secondary malignant neoplasm of resp and digestive organs"	1	135	0	135
"H60"	"C79"	"Otitis externa"	"Secondary malignant neoplasm of other and unspecified sites"	1	116	7	123
"H60"	"H02"	"Otitis externa"	"Other disorders of eyelid"	1	168	83	251
"H60"	"I48"	"Otitis externa"	"Atrial fibrillation and flutter"	1	562	198	760
"H60"	"I50"	"Otitis externa"	"Heart failure"	1	515	168	683
"H60"	"J44"	"Otitis externa"	"Other chronic obstructive pulmonary disease"	1	486	192	678
"H60"	"K56"	"Otitis externa"	"Paralytic ileus and intestinal obstruction without hernia"	1	132	44	176
"H60"	"K92"	"Otitis externa"	"Other diseases of digestive system"	1	196	71	267
"H60"	"M48"	"Otitis externa"	"Other spondylopathies"	1	172	59	231
"H61"	"C78"	"Other disorders of external ear"	"Secondary malignant neoplasm of resp and digestive organs"	1	169	9	178
"H61"	"C79"	"Other disorders of external ear"	"Secondary malignant neoplasm of other and unspecified sites"	1	114	12	126
"H61"	"D12"	"Other disorders of external ear"	"Benign neoplasm of colon, rectum, anus and anal canal"	1	220	105	325
"H61"	"D63"	"Other disorders of external ear"	"Anemia in chronic diseases classified elsewhere"	1	98	18	116
"H61"	"D64"	"Other disorders of external ear"	"Other anemias"	1	406	142	548
"H61"	"E78"	"Other disorders of external ear"	"Disorders of lipoprotein metabolism and other lipidemias"	1	344	208	552
"H61"	"I26"	"Other disorders of external ear"	"Pulmonary embolism"	1	100	36	136
"H61"	"I48"	"Other disorders of external ear"	"Atrial fibrillation and flutter"	1	575	316	891
"H61"	"J18"	"Other disorders of external ear"	"Pneumonia, unspecified organism"	1	965	463	1428
"H61"	"J44"	"Other disorders of external ear"	"Other chronic obstructive pulmonary disease"	1	398	229	627
"H61"	"J96"	"Other disorders of external ear"	"Respiratory failure, not elsewhere classified"	1	364	34	398
"H61"	"K57"	"Other disorders of external ear"	"Diverticular disease of intestine"	1	230	127	357
"H61"	"K59"	"Other disorders of external ear"	"Other functional intestinal disorders"	1	442	221	663
"H61"	"N30"	"Other disorders of external ear"	"Cystitis"	1	551	331	882
"H65"	"B02"	"Nonsuppurative otitis media"	"Zoster [herpes zoster]"	1	95	22	117
"H65"	"B18"	"Nonsuppurative otitis media"	"Chronic viral hepatitis"	1	52	12	64
"H65"	"B27"	"Nonsuppurative otitis media"	"Infectious mononucleosis"	1	226	45	271
"H65"	"C22"	"Nonsuppurative otitis media"	"Malignant neoplasm of liver and intrahepatic bile ducts"	1	27	1	28
"H65"	"C34"	"Nonsuppurative otitis media"	"Malignant neoplasm of bronchus and lung"	1	297	3	300
"H65"	"C44"	"Nonsuppurative otitis media"	"Other and unspecified malignant neoplasm of skin"	1	208	31	239
"H65"	"C64"	"Nonsuppurative otitis media"	"Malignant neoplasm of kidney, except renal pelvis"	1	35	4	39
"H65"	"C77"	"Nonsuppurative otitis media"	"Secondary and unspecified malignant neoplasm of lymph nodes"	1	88	30	118
"H65"	"D16"	"Nonsuppurative otitis media"	"Benign neoplasm of bone and articular cartilage"	1	97	9	106
"H65"	"D21"	"Nonsuppurative otitis media"	"Other benign neoplasms of connective and other soft tissue"	1	72	16	88
"H65"	"D22"	"Nonsuppurative otitis media"	"Melanocytic nevi"	1	186	0	186
"H65"	"D23"	"Nonsuppurative otitis media"	"Other benign neoplasms of skin"	1	300	82	382
"H65"	"D63"	"Nonsuppurative otitis media"	"Anemia in chronic diseases classified elsewhere"	1	134	10	144
"H65"	"D64"	"Nonsuppurative otitis media"	"Other anemias"	1	639	74	713
"H65"	"E04"	"Nonsuppurative otitis media"	"Other nontoxic goiter"	1	178	70	248
"H65"	"E64"	"Nonsuppurative otitis media"	"Sequelae of malnutrition and other nutritional deficiencies"	1	114	41	155
"H65"	"E78"	"Nonsuppurative otitis media"	"Disorders of lipoprotein metabolism and other lipidemias"	1	719	137	856
"H65"	"E83"	"Nonsuppurative otitis media"	"Disorders of mineral metabolism"	1	73	3	76
"H65"	"E87"	"Nonsuppurative otitis media"	"Other disorders of fluid, electrolyte and acid-base balance"	1	329	44	373
"H65"	"E89"	"Nonsuppurative otitis media"	"Postproc endocrine and metabolic comp and disorders, NEC"	1	58	4	62
"H65"	"F10"	"Nonsuppurative otitis media"	"Alcohol related disorders"	1	514	28	542
"H65"	"F20"	"Nonsuppurative otitis media"	"Schizophrenia"	1	43	0	43
"H65"	"F43"	"Nonsuppurative otitis media"	"Reaction to severe stress, and adjustment disorders"	1	282	30	312
"H65"	"F45"	"Nonsuppurative otitis media"	"Somatoform disorders"	1	58	2	60
"H65"	"F70"	"Nonsuppurative otitis media"	"Mild intellectual disabilities"	1	201	4	205
"H65"	"F79"	"Nonsuppurative otitis media"	"Unspecified intellectual disabilities"	1	402	89	491
"H65"	"F80"	"Nonsuppurative otitis media"	"Specific developmental disorders of speech and language"	1	237	64	301
"H65"	"F84"	"Nonsuppurative otitis media"	"Pervasive developmental disorders"	1	357	2	359
"H65"	"G20"	"Nonsuppurative otitis media"	"Parkinson's disease"	1	57	9	66
"H65"	"G44"	"Nonsuppurative otitis media"	"Other headache syndromes"	1	309	5	314
"H65"	"H00"	"Nonsuppurative otitis media"	"Hordeolum and chalazion"	1	177	50	227
"H65"	"H26"	"Nonsuppurative otitis media"	"Other cataract"	1	369	103	472
"H65"	"H36"	"Nonsuppurative otitis media"	"Retinal disorders in diseases classified elsewhere"	1	93	32	125
"H65"	"H43"	"Nonsuppurative otitis media"	"Disorders of vitreous body"	1	95	31	126
"H65"	"H61"	"Nonsuppurative otitis media"	"Other disorders of external ear"	1	495	329	824
"H65"	"I10"	"Nonsuppurative otitis media"	"Essential (primary) hypertension"	1	1654	424	2078
"H65"	"I21"	"Nonsuppurative otitis media"	"Acute myocardial infarction"	1	452	155	607
"H65"	"I25"	"Nonsuppurative otitis media"	"Chronic ischemic heart disease"	1	803	292	1095
"H65"	"I26"	"Nonsuppurative otitis media"	"Pulmonary embolism"	1	158	12	170
"H65"	"I42"	"Nonsuppurative otitis media"	"Cardiomyopathy"	1	84	24	108
"H65"	"I63"	"Nonsuppurative otitis media"	"Cerebral infarction"	1	419	55	474
"H65"	"I69"	"Nonsuppurative otitis media"	"Sequelae of cerebrovascular disease"	1	496	57	553
"H65"	"I70"	"Nonsuppurative otitis media"	"Atherosclerosis"	1	282	104	386
"H65"	"I71"	"Nonsuppurative otitis media"	"Aortic aneurysm and dissection"	1	140	5	145
"H65"	"I73"	"Nonsuppurative otitis media"	"Other peripheral vascular diseases"	1	234	38	272
"H65"	"I80"	"Nonsuppurative otitis media"	"Phlebitis and thrombophlebitis"	1	286	52	338
"H65"	"I83"	"Nonsuppurative otitis media"	"Varicose veins of lower extremities"	1	226	122	348
"H65"	"I89"	"Nonsuppurative otitis media"	"Oth noninfective disorders of lymphatic vessels and nodes"	1	70	7	77
"H65"	"J01"	"Nonsuppurative otitis media"	"Acute sinusitis"	1	277	134	411
"H65"	"J03"	"Nonsuppurative otitis media"	"Acute tonsillitis"	1	2419	1855	4274
"H65"	"J34"	"Nonsuppurative otitis media"	"Other and unspecified disorders of nose and nasal sinuses"	1	362	200	562
"H65"	"J84"	"Nonsuppurative otitis media"	"Other interstitial pulmonary diseases"	1	84	14	98
"H65"	"J93"	"Nonsuppurative otitis media"	"Pneumothorax and air leak"	1	63	4	67
"H65"	"K35"	"Nonsuppurative otitis media"	"Acute appendicitis"	1	658	10	668
"H65"	"K52"	"Nonsuppurative otitis media"	"Other and unsp noninfective gastroenteritis and colitis"	1	632	259	891
"H65"	"K57"	"Nonsuppurative otitis media"	"Diverticular disease of intestine"	1	400	60	460
"H65"	"K58"	"Nonsuppurative otitis media"	"Irritable bowel syndrome"	1	212	19	231
"H65"	"K60"	"Nonsuppurative otitis media"	"Fissure and fistula of anal and rectal regions"	1	192	56	248
"H65"	"K61"	"Nonsuppurative otitis media"	"Abscess of anal and rectal regions"	1	115	34	149
"H65"	"K65"	"Nonsuppurative otitis media"	"Peritonitis"	1	97	34	131
"H65"	"K70"	"Nonsuppurative otitis media"	"Alcoholic liver disease"	1	52	12	64
"H65"	"K72"	"Nonsuppurative otitis media"	"Hepatic failure, not elsewhere classified"	1	59	7	66
"H65"	"K80"	"Nonsuppurative otitis media"	"Cholelithiasis"	1	446	124	570
"H65"	"K91"	"Nonsuppurative otitis media"	"Intraop and postproc comp and disorders of dgstv sys, NEC"	1	59	12	71
"H65"	"L02"	"Nonsuppurative otitis media"	"Cutaneous abscess, furuncle and carbuncle"	1	620	200	820
"H65"	"L05"	"Nonsuppurative otitis media"	"Pilonidal cyst and sinus"	1	96	0	96
"H65"	"L20"	"Nonsuppurative otitis media"	"Atopic dermatitis"	1	569	397	966
"H65"	"L40"	"Nonsuppurative otitis media"	"Psoriasis"	1	103	26	129
"H65"	"L60"	"Nonsuppurative otitis media"	"Nail disorders"	1	194	0	194
"H65"	"L98"	"Nonsuppurative otitis media"	"Oth disorders of skin, subcu, not elsewhere classified"	1	168	29	197
"H65"	"M02"	"Nonsuppurative otitis media"	"Postinfective and reactive arthropathies"	1	339	166	505
"H65"	"M06"	"Nonsuppurative otitis media"	"Other rheumatoid arthritis"	1	104	31	135
"H65"	"M07"	"Nonsuppurative otitis media"	"Enteropathic arthropathies"	1	39	3	42
"H65"	"M17"	"Nonsuppurative otitis media"	"Osteoarthritis of knee"	1	518	181	699
"H65"	"M21"	"Nonsuppurative otitis media"	"Other acquired deformities of limbs"	1	466	28	494
"H65"	"M22"	"Nonsuppurative otitis media"	"Disorder of patella"	1	248	0	248
"H65"	"M23"	"Nonsuppurative otitis media"	"Internal derangement of knee"	1	876	2	878
"H65"	"M24"	"Nonsuppurative otitis media"	"Other specific joint derangements"	1	316	39	355
"H65"	"M25"	"Nonsuppurative otitis media"	"Other joint disorder, not elsewhere classified"	1	462	31	493
"H65"	"M41"	"Nonsuppurative otitis media"	"Scoliosis"	1	301	0	301
"H65"	"M48"	"Nonsuppurative otitis media"	"Other spondylopathies"	1	276	40	316
"H65"	"M53"	"Nonsuppurative otitis media"	"Other and unspecified dorsopathies, not elsewhere classified"	1	103	17	120
"H65"	"M54"	"Nonsuppurative otitis media"	"Dorsalgia"	1	1020	182	1202
"H65"	"M65"	"Nonsuppurative otitis media"	"Synovitis and tenosynovitis"	1	401	73	474
"H65"	"M76"	"Nonsuppurative otitis media"	"Enthesopathies, lower limb, excluding foot"	1	215	0	215
"H65"	"M77"	"Nonsuppurative otitis media"	"Other enthesopathies"	1	213	36	249
"H65"	"M79"	"Nonsuppurative otitis media"	"Oth and unsp soft tissue disorders, not elsewhere classified"	1	2114	0	2114
"H65"	"M84"	"Nonsuppurative otitis media"	"Disorder of continuity of bone"	1	47	5	52
"H65"	"M85"	"Nonsuppurative otitis media"	"Other disorders of bone density and structure"	1	188	0	188
"H65"	"M89"	"Nonsuppurative otitis media"	"Other disorders of bone"	1	101	17	118
"H65"	"N19"	"Nonsuppurative otitis media"	"Unspecified kidney failure"	1	133	35	168
"H65"	"N20"	"Nonsuppurative otitis media"	"Calculus of kidney and ureter"	1	243	80	323
"H65"	"N31"	"Nonsuppurative otitis media"	"Neuromuscular dysfunction of bladder, NEC"	1	85	25	110
"H65"	"N39"	"Nonsuppurative otitis media"	"Other disorders of urinary system"	1	1095	197	1292
"H65"	"N44"	"Nonsuppurative otitis media"	"Noninflammatory disorders of testis"	1	113	0	113
"H65"	"N48"	"Nonsuppurative otitis media"	"Other disorders of penis"	1	279	105	384
"H65"	"N50"	"Nonsuppurative otitis media"	"Other and unspecified disorders of male genital organs"	1	188	4	192
"H65"	"N62"	"Nonsuppurative otitis media"	"Hypertrophy of breast"	1	150	0	150
"H65"	"N83"	"Nonsuppurative otitis media"	"Noninflammatory disord of ovary, fallop and broad ligament"	1	191	22	213
"H65"	"N87"	"Nonsuppurative otitis media"	"Dysplasia of cervix uteri"	1	101	26	127
"H65"	"N92"	"Nonsuppurative otitis media"	"Excessive, frequent and irregular menstruation"	1	331	96	427
"H65"	"N93"	"Nonsuppurative otitis media"	"Other abnormal uterine and vaginal bleeding"	1	73	0	73
"H65"	"N97"	"Nonsuppurative otitis media"	"Female infertility"	1	153	23	176
"H65"	"O02"	"Nonsuppurative otitis media"	"Other abnormal products of conception"	1	153	35	188
"H65"	"O03"	"Nonsuppurative otitis media"	"Spontaneous abortion"	1	133	62	195
"H65"	"O08"	"Nonsuppurative otitis media"	"Complications following ectopic and molar pregnancy"	1	71	0	71
"H65"	"O13"	"Nonsuppurative otitis media"	"Gestational hypertension without significant proteinuria"	1	27	1	28
"H65"	"O14"	"Nonsuppurative otitis media"	"Pre-eclampsia"	1	58	6	64
"H65"	"O24"	"Nonsuppurative otitis media"	"Diabetes in pregnancy, childbirth, and the puerperium"	1	70	7	77
"H65"	"O36"	"Nonsuppurative otitis media"	"Maternal care for other fetal problems"	1	151	15	166
"H65"	"O42"	"Nonsuppurative otitis media"	"Premature rupture of membranes"	1	130	7	137
"H65"	"O62"	"Nonsuppurative otitis media"	"Abnormalities of forces of labor"	1	320	132	452
"H65"	"O63"	"Nonsuppurative otitis media"	"Long labor"	1	60	3	63
"H65"	"O82"	"Nonsuppurative otitis media"	"Encounter for cesarean delivery without indication"	1	246	51	297
"H65"	"O92"	"Nonsuppurative otitis media"	"Oth disord of brst/lactatn assoc w pregnancy and the puerp"	1	49	0	49
"H65"	"Q53"	"Nonsuppurative otitis media"	"Undescended and ectopic testicle"	1	574	382	956
"H65"	"Q93"	"Nonsuppurative otitis media"	"Monosomies and deletions from the autosomes, NEC"	1	121	25	146
"H66"	"A41"	"Suppurative and unspecified otitis media"	"Other sepsis"	1	587	180	767
"H66"	"C18"	"Suppurative and unspecified otitis media"	"Malignant neoplasm of colon"	1	107	1	108
"H66"	"C34"	"Suppurative and unspecified otitis media"	"Malignant neoplasm of bronchus and lung"	1	226	0	226
"H66"	"C77"	"Suppurative and unspecified otitis media"	"Secondary and unspecified malignant neoplasm of lymph nodes"	1	53	1	54
"H66"	"C79"	"Suppurative and unspecified otitis media"	"Secondary malignant neoplasm of other and unspecified sites"	1	126	0	126
"H66"	"D12"	"Suppurative and unspecified otitis media"	"Benign neoplasm of colon, rectum, anus and anal canal"	1	280	1	281
"H66"	"D23"	"Suppurative and unspecified otitis media"	"Other benign neoplasms of skin"	1	270	65	335
"H66"	"D63"	"Suppurative and unspecified otitis media"	"Anemia in chronic diseases classified elsewhere"	1	100	8	108
"H66"	"D64"	"Suppurative and unspecified otitis media"	"Other anemias"	1	495	44	539
"H66"	"D80"	"Suppurative and unspecified otitis media"	"Immunodeficiency with predominantly antibody defects"	1	113	34	147
"H66"	"D83"	"Suppurative and unspecified otitis media"	"Common variable immunodeficiency"	1	121	33	154
"H66"	"D84"	"Suppurative and unspecified otitis media"	"Other immunodeficiencies"	1	334	110	444
"H66"	"E03"	"Suppurative and unspecified otitis media"	"Other hypothyroidism"	1	208	18	226
"H66"	"E05"	"Suppurative and unspecified otitis media"	"Thyrotoxicosis [hyperthyroidism]"	1	134	31	165
"H66"	"E11"	"Suppurative and unspecified otitis media"	"Type 2 diabetes mellitus"	1	589	139	728
"H66"	"E87"	"Suppurative and unspecified otitis media"	"Other disorders of fluid, electrolyte and acid-base balance"	1	278	22	300
"H66"	"E89"	"Suppurative and unspecified otitis media"	"Postproc endocrine and metabolic comp and disorders, NEC"	1	50	8	58
"H66"	"F10"	"Suppurative and unspecified otitis media"	"Alcohol related disorders"	1	478	29	507
"H66"	"F43"	"Suppurative and unspecified otitis media"	"Reaction to severe stress, and adjustment disorders"	1	251	15	266
"H66"	"F72"	"Suppurative and unspecified otitis media"	"Severe intellectual disabilities"	1	89	17	106
"H66"	"G20"	"Suppurative and unspecified otitis media"	"Parkinson's disease"	1	47	0	47
"H66"	"G56"	"Suppurative and unspecified otitis media"	"Mononeuropathies of upper limb"	1	295	34	329
"H66"	"H25"	"Suppurative and unspecified otitis media"	"Age-related cataract"	1	851	64	915
"H66"	"H26"	"Suppurative and unspecified otitis media"	"Other cataract"	1	303	31	334
"H66"	"H33"	"Suppurative and unspecified otitis media"	"Retinal detachments and breaks"	1	79	12	91
"H66"	"H65"	"Suppurative and unspecified otitis media"	"Nonsuppurative otitis media"	1	6252	5568	11820
"H66"	"H72"	"Suppurative and unspecified otitis media"	"Perforation of tympanic membrane"	1	2804	2075	4879
"H66"	"H90"	"Suppurative and unspecified otitis media"	"Conductive and sensorineural hearing loss"	1	3032	1445	4477
"H66"	"H92"	"Suppurative and unspecified otitis media"	"Otalgia and effusion of ear"	1	812	337	1149
"H66"	"H93"	"Suppurative and unspecified otitis media"	"Other disorders of ear, not elsewhere classified"	1	623	381	1004
"H66"	"H95"	"Suppurative and unspecified otitis media"	"Intraop and postproc comp and disorders of ear/mastd, NEC"	1	180	12	192
"H66"	"I10"	"Suppurative and unspecified otitis media"	"Essential (primary) hypertension"	1	1417	123	1540
"H66"	"I47"	"Suppurative and unspecified otitis media"	"Paroxysmal tachycardia"	1	224	36	260
"H66"	"I48"	"Suppurative and unspecified otitis media"	"Atrial fibrillation and flutter"	1	704	29	733
"H66"	"I49"	"Suppurative and unspecified otitis media"	"Other cardiac arrhythmias"	1	208	15	223
"H66"	"I71"	"Suppurative and unspecified otitis media"	"Aortic aneurysm and dissection"	1	98	0	98
"H66"	"J30"	"Suppurative and unspecified otitis media"	"Vasomotor and allergic rhinitis"	1	569	43	612
"H66"	"J96"	"Suppurative and unspecified otitis media"	"Respiratory failure, not elsewhere classified"	1	564	250	814
"H66"	"K21"	"Suppurative and unspecified otitis media"	"Gastro-esophageal reflux disease"	1	417	247	664
"H66"	"K43"	"Suppurative and unspecified otitis media"	"Ventral hernia"	1	136	24	160
"H66"	"K44"	"Suppurative and unspecified otitis media"	"Diaphragmatic hernia"	1	202	40	242
"H66"	"K50"	"Suppurative and unspecified otitis media"	"Crohn's disease [regional enteritis]"	1	88	10	98
"H66"	"K51"	"Suppurative and unspecified otitis media"	"Ulcerative colitis"	1	93	15	108
"H66"	"K61"	"Suppurative and unspecified otitis media"	"Abscess of anal and rectal regions"	1	125	46	171
"H66"	"K62"	"Suppurative and unspecified otitis media"	"Other diseases of anus and rectum"	1	429	75	504
"H66"	"K70"	"Suppurative and unspecified otitis media"	"Alcoholic liver disease"	1	64	15	79
"H66"	"K83"	"Suppurative and unspecified otitis media"	"Other diseases of biliary tract"	1	43	5	48
"H66"	"K92"	"Suppurative and unspecified otitis media"	"Other diseases of digestive system"	1	324	33	357
"H66"	"L01"	"Suppurative and unspecified otitis media"	"Impetigo"	1	533	289	822
"H66"	"L90"	"Suppurative and unspecified otitis media"	"Atrophic disorders of skin"	1	155	0	155
"H66"	"M07"	"Suppurative and unspecified otitis media"	"Enteropathic arthropathies"	1	33	0	33
"H66"	"M19"	"Suppurative and unspecified otitis media"	"Other and unspecified osteoarthritis"	1	274	11	285
"H66"	"M20"	"Suppurative and unspecified otitis media"	"Acquired deformities of fingers and toes"	1	233	27	260
"H66"	"M21"	"Suppurative and unspecified otitis media"	"Other acquired deformities of limbs"	1	407	16	423
"H66"	"M22"	"Suppurative and unspecified otitis media"	"Disorder of patella"	1	203	0	203
"H66"	"M23"	"Suppurative and unspecified otitis media"	"Internal derangement of knee"	1	730	11	741
"H66"	"M25"	"Suppurative and unspecified otitis media"	"Other joint disorder, not elsewhere classified"	1	459	29	488
"H66"	"M41"	"Suppurative and unspecified otitis media"	"Scoliosis"	1	243	0	243
"H66"	"M48"	"Suppurative and unspecified otitis media"	"Other spondylopathies"	1	210	2	212
"H66"	"M53"	"Suppurative and unspecified otitis media"	"Other and unspecified dorsopathies, not elsewhere classified"	1	100	7	107
"H66"	"M65"	"Suppurative and unspecified otitis media"	"Synovitis and tenosynovitis"	1	334	60	394
"H66"	"M67"	"Suppurative and unspecified otitis media"	"Other disorders of synovium and tendon"	1	387	12	399
"H66"	"M70"	"Suppurative and unspecified otitis media"	"Soft tissue disorders related to use, overuse and pressure"	1	222	30	252
"H66"	"M72"	"Suppurative and unspecified otitis media"	"Fibroblastic disorders"	1	126	19	145
"H66"	"M76"	"Suppurative and unspecified otitis media"	"Enthesopathies, lower limb, excluding foot"	1	184	1	185
"H66"	"M77"	"Suppurative and unspecified otitis media"	"Other enthesopathies"	1	174	23	197
"H66"	"M81"	"Suppurative and unspecified otitis media"	"Osteoporosis without current pathological fracture"	1	315	0	315
"H66"	"M85"	"Suppurative and unspecified otitis media"	"Other disorders of bone density and structure"	1	107	0	107
"H66"	"M92"	"Suppurative and unspecified otitis media"	"Other juvenile osteochondrosis"	1	68	0	68
"H66"	"N13"	"Suppurative and unspecified otitis media"	"Obstructive and reflux uropathy"	1	131	62	193
"H66"	"N19"	"Suppurative and unspecified otitis media"	"Unspecified kidney failure"	1	123	26	149
"H66"	"N40"	"Suppurative and unspecified otitis media"	"Benign prostatic hyperplasia"	1	291	97	388
"H66"	"N60"	"Suppurative and unspecified otitis media"	"Benign mammary dysplasia"	1	84	26	110
"H66"	"N62"	"Suppurative and unspecified otitis media"	"Hypertrophy of breast"	1	124	8	132
"H66"	"N81"	"Suppurative and unspecified otitis media"	"Female genital prolapse"	1	173	36	209
"H66"	"N83"	"Suppurative and unspecified otitis media"	"Noninflammatory disord of ovary, fallop and broad ligament"	1	138	26	164
"H66"	"N87"	"Suppurative and unspecified otitis media"	"Dysplasia of cervix uteri"	1	76	21	97
"H66"	"N92"	"Suppurative and unspecified otitis media"	"Excessive, frequent and irregular menstruation"	1	283	115	398
"H66"	"N94"	"Suppurative and unspecified otitis media"	"Pain and oth cond assoc w fem gntl org and menstrual cycle"	1	128	16	144
"H66"	"O02"	"Suppurative and unspecified otitis media"	"Other abnormal products of conception"	1	143	49	192
"H66"	"O14"	"Suppurative and unspecified otitis media"	"Pre-eclampsia"	1	48	9	57
"H66"	"O47"	"Suppurative and unspecified otitis media"	"False labor"	1	94	32	126
"H66"	"O92"	"Suppurative and unspecified otitis media"	"Oth disord of brst/lactatn assoc w pregnancy and the puerp"	1	37	3	40
"H66"	"O99"	"Suppurative and unspecified otitis media"	"Oth maternal diseases classd elsw but compl preg/chldbrth"	1	352	49	401
"H66"	"Q16"	"Suppurative and unspecified otitis media"	"Congenital malform of ear causing impairment of hearing"	1	109	46	155
"H66"	"Q55"	"Suppurative and unspecified otitis media"	"Other congenital malformations of male genital organs"	1	126	32	158
"H66"	"Q66"	"Suppurative and unspecified otitis media"	"Congenital deformities of feet"	1	379	183	562
"H68"	"I10"	"Eustachian salpingitis and obstruction"	"Essential (primary) hypertension"	1	200	66	266
"H68"	"O72"	"Eustachian salpingitis and obstruction"	"Postpartum hemorrhage"	1	69	13	82
"H71"	"A46"	"Cholesteatoma of middle ear"	"Erysipelas"	1	72	11	83
"H71"	"A49"	"Cholesteatoma of middle ear"	"Bacterial infection of unspecified site"	1	79	2	81
"H71"	"C18"	"Cholesteatoma of middle ear"	"Malignant neoplasm of colon"	1	52	7	59
"H71"	"C34"	"Cholesteatoma of middle ear"	"Malignant neoplasm of bronchus and lung"	1	94	0	94
"H71"	"C61"	"Cholesteatoma of middle ear"	"Malignant neoplasm of prostate"	1	69	3	72
"H71"	"C78"	"Cholesteatoma of middle ear"	"Secondary malignant neoplasm of resp and digestive organs"	1	69	0	69
"H71"	"C79"	"Cholesteatoma of middle ear"	"Secondary malignant neoplasm of other and unspecified sites"	1	48	0	48
"H71"	"D12"	"Cholesteatoma of middle ear"	"Benign neoplasm of colon, rectum, anus and anal canal"	1	158	8	166
"H71"	"E03"	"Cholesteatoma of middle ear"	"Other hypothyroidism"	1	71	3	74
"H71"	"E66"	"Cholesteatoma of middle ear"	"Overweight and obesity"	1	182	23	205
"H71"	"E78"	"Cholesteatoma of middle ear"	"Disorders of lipoprotein metabolism and other lipidemias"	1	233	35	268
"H71"	"F32"	"Cholesteatoma of middle ear"	"Depressive episode"	1	75	8	83
"H71"	"F33"	"Cholesteatoma of middle ear"	"Major depressive disorder, recurrent"	1	39	1	40
"H71"	"G44"	"Cholesteatoma of middle ear"	"Other headache syndromes"	1	53	11	64
"H71"	"G45"	"Cholesteatoma of middle ear"	"Transient cerebral ischemic attacks and related syndromes"	1	82	23	105
"H71"	"G56"	"Cholesteatoma of middle ear"	"Mononeuropathies of upper limb"	1	89	31	120
"H71"	"H25"	"Cholesteatoma of middle ear"	"Age-related cataract"	1	331	71	402
"H71"	"H26"	"Cholesteatoma of middle ear"	"Other cataract"	1	91	15	106
"H71"	"H60"	"Cholesteatoma of middle ear"	"Otitis externa"	1	443	220	663
"H71"	"H61"	"Cholesteatoma of middle ear"	"Other disorders of external ear"	1	139	64	203
"H71"	"H90"	"Cholesteatoma of middle ear"	"Conductive and sensorineural hearing loss"	1	1839	976	2815
"H71"	"I10"	"Cholesteatoma of middle ear"	"Essential (primary) hypertension"	1	557	116	673
"H71"	"I20"	"Cholesteatoma of middle ear"	"Angina pectoris"	1	193	97	290
"H71"	"I25"	"Cholesteatoma of middle ear"	"Chronic ischemic heart disease"	1	247	74	321
"H71"	"I35"	"Cholesteatoma of middle ear"	"Nonrheumatic aortic valve disorders"	1	98	5	103
"H71"	"I46"	"Cholesteatoma of middle ear"	"Cardiac arrest"	1	35	0	35
"H71"	"I63"	"Cholesteatoma of middle ear"	"Cerebral infarction"	1	120	9	129
"H71"	"I80"	"Cholesteatoma of middle ear"	"Phlebitis and thrombophlebitis"	1	85	12	97
"H71"	"J15"	"Cholesteatoma of middle ear"	"Bacterial pneumonia, not elsewhere classified"	1	123	0	123
"H71"	"J44"	"Cholesteatoma of middle ear"	"Other chronic obstructive pulmonary disease"	1	250	32	282
"H71"	"J90"	"Cholesteatoma of middle ear"	"Pleural effusion, not elsewhere classified"	1	34	0	34
"H71"	"K57"	"Cholesteatoma of middle ear"	"Diverticular disease of intestine"	1	155	14	169
"H71"	"K59"	"Cholesteatoma of middle ear"	"Other functional intestinal disorders"	1	199	35	234
"H71"	"K64"	"Cholesteatoma of middle ear"	"Hemorrhoids and perianal venous thrombosis"	1	58	0	58
"H71"	"K92"	"Cholesteatoma of middle ear"	"Other diseases of digestive system"	1	87	10	97
"H71"	"M17"	"Cholesteatoma of middle ear"	"Osteoarthritis of knee"	1	160	37	197
"H71"	"M25"	"Cholesteatoma of middle ear"	"Other joint disorder, not elsewhere classified"	1	74	15	89
"H71"	"M79"	"Cholesteatoma of middle ear"	"Oth and unsp soft tissue disorders, not elsewhere classified"	1	238	86	324
"H71"	"M81"	"Cholesteatoma of middle ear"	"Osteoporosis without current pathological fracture"	1	112	4	116
"H71"	"N17"	"Cholesteatoma of middle ear"	"Acute kidney failure"	1	43	1	44
"H71"	"N30"	"Cholesteatoma of middle ear"	"Cystitis"	1	204	27	231
"H71"	"N39"	"Cholesteatoma of middle ear"	"Other disorders of urinary system"	1	163	15	178
"H71"	"O70"	"Cholesteatoma of middle ear"	"Perineal laceration during delivery"	1	118	46	164
"H72"	"A04"	"Perforation of tympanic membrane"	"Other bacterial intestinal infections"	1	38	6	44
"H72"	"A49"	"Perforation of tympanic membrane"	"Bacterial infection of unspecified site"	1	137	29	166
"H72"	"C18"	"Perforation of tympanic membrane"	"Malignant neoplasm of colon"	1	62	10	72
"H72"	"C34"	"Perforation of tympanic membrane"	"Malignant neoplasm of bronchus and lung"	1	136	0	136
"H72"	"C61"	"Perforation of tympanic membrane"	"Malignant neoplasm of prostate"	1	74	17	91
"H72"	"C78"	"Perforation of tympanic membrane"	"Secondary malignant neoplasm of resp and digestive organs"	1	100	0	100
"H72"	"C79"	"Perforation of tympanic membrane"	"Secondary malignant neoplasm of other and unspecified sites"	1	67	0	67
"H72"	"D12"	"Perforation of tympanic membrane"	"Benign neoplasm of colon, rectum, anus and anal canal"	1	196	35	231
"H72"	"D22"	"Perforation of tympanic membrane"	"Melanocytic nevi"	1	71	17	88
"H72"	"D50"	"Perforation of tympanic membrane"	"Iron deficiency anemia"	1	97	26	123
"H72"	"D64"	"Perforation of tympanic membrane"	"Other anemias"	1	225	41	266
"H72"	"E03"	"Perforation of tympanic membrane"	"Other hypothyroidism"	1	132	27	159
"H72"	"E28"	"Perforation of tympanic membrane"	"Ovarian dysfunction"	1	32	3	35
"H72"	"E78"	"Perforation of tympanic membrane"	"Disorders of lipoprotein metabolism and other lipidemias"	1	325	108	433
"H72"	"E83"	"Perforation of tympanic membrane"	"Disorders of mineral metabolism"	1	35	2	37
"H72"	"E86"	"Perforation of tympanic membrane"	"Volume depletion"	1	256	79	335
"H72"	"F17"	"Perforation of tympanic membrane"	"Nicotine dependence"	1	178	16	194
"H72"	"F32"	"Perforation of tympanic membrane"	"Depressive episode"	1	110	34	144
"H72"	"G44"	"Perforation of tympanic membrane"	"Other headache syndromes"	1	118	32	150
"H72"	"G95"	"Perforation of tympanic membrane"	"Other and unspecified diseases of spinal cord"	1	29	0	29
"H72"	"H57"	"Perforation of tympanic membrane"	"Other disorders of eye and adnexa"	1	78	22	100
"H72"	"I10"	"Perforation of tympanic membrane"	"Essential (primary) hypertension"	1	745	327	1072
"H72"	"I26"	"Perforation of tympanic membrane"	"Pulmonary embolism"	1	93	8	101
"H72"	"I35"	"Perforation of tympanic membrane"	"Nonrheumatic aortic valve disorders"	1	111	15	126
"H72"	"I46"	"Perforation of tympanic membrane"	"Cardiac arrest"	1	58	0	58
"H72"	"I49"	"Perforation of tympanic membrane"	"Other cardiac arrhythmias"	1	104	32	136
"H72"	"I63"	"Perforation of tympanic membrane"	"Cerebral infarction"	1	157	42	199
"H72"	"J90"	"Perforation of tympanic membrane"	"Pleural effusion, not elsewhere classified"	1	48	6	54
"H72"	"J96"	"Perforation of tympanic membrane"	"Respiratory failure, not elsewhere classified"	1	213	15	228
"H72"	"K59"	"Perforation of tympanic membrane"	"Other functional intestinal disorders"	1	374	170	544
"H72"	"L89"	"Perforation of tympanic membrane"	"Pressure ulcer"	1	33	2	35
"H72"	"L90"	"Perforation of tympanic membrane"	"Atrophic disorders of skin"	1	67	19	86
"H72"	"M23"	"Perforation of tympanic membrane"	"Internal derangement of knee"	1	440	176	616
"H72"	"M25"	"Perforation of tympanic membrane"	"Other joint disorder, not elsewhere classified"	1	143	66	209
"H72"	"M48"	"Perforation of tympanic membrane"	"Other spondylopathies"	1	145	34	179
"H72"	"M77"	"Perforation of tympanic membrane"	"Other enthesopathies"	1	103	34	137
"H72"	"M79"	"Perforation of tympanic membrane"	"Oth and unsp soft tissue disorders, not elsewhere classified"	1	476	277	753
"H72"	"M85"	"Perforation of tympanic membrane"	"Other disorders of bone density and structure"	1	96	14	110
"H72"	"N17"	"Perforation of tympanic membrane"	"Acute kidney failure"	1	49	0	49
"H72"	"N18"	"Perforation of tympanic membrane"	"Chronic kidney disease (CKD)"	1	120	11	131
"H72"	"O68"	"Perforation of tympanic membrane"	"Labor and delivery comp by abnlt of fetal acid-base balance"	1	144	65	209
"H72"	"O70"	"Perforation of tympanic membrane"	"Perineal laceration during delivery"	1	280	77	357
"H74"	"E11"	"Other disorders of middle ear mastoid"	"Type 2 diabetes mellitus"	1	104	14	118
"H74"	"E66"	"Other disorders of middle ear mastoid"	"Overweight and obesity"	1	84	2	86
"H74"	"I20"	"Other disorders of middle ear mastoid"	"Angina pectoris"	1	108	33	141
"H74"	"J18"	"Other disorders of middle ear mastoid"	"Pneumonia, unspecified organism"	1	202	7	209
"H74"	"J44"	"Other disorders of middle ear mastoid"	"Other chronic obstructive pulmonary disease"	1	128	3	131
"H74"	"K59"	"Other disorders of middle ear mastoid"	"Other functional intestinal disorders"	1	93	3	96
"H74"	"M16"	"Other disorders of middle ear mastoid"	"Osteoarthritis of hip"	1	57	14	71
"H74"	"M19"	"Other disorders of middle ear mastoid"	"Other and unspecified osteoarthritis"	1	37	0	37
"H74"	"M23"	"Other disorders of middle ear mastoid"	"Internal derangement of knee"	1	94	23	117
"H74"	"M54"	"Other disorders of middle ear mastoid"	"Dorsalgia"	1	124	35	159
"H80"	"A04"	"Otosclerosis"	"Other bacterial intestinal infections"	1	45	0	45
"H80"	"B37"	"Otosclerosis"	"Candidiasis"	1	60	0	60
"H80"	"C18"	"Otosclerosis"	"Malignant neoplasm of colon"	1	133	1	134
"H80"	"C43"	"Otosclerosis"	"Malignant melanoma of skin"	1	50	5	55
"H80"	"C56"	"Otosclerosis"	"Malignant neoplasm of ovary"	1	53	4	57
"H80"	"C61"	"Otosclerosis"	"Malignant neoplasm of prostate"	1	144	0	144
"H80"	"C71"	"Otosclerosis"	"Malignant neoplasm of brain"	1	26	0	26
"H80"	"C77"	"Otosclerosis"	"Secondary and unspecified malignant neoplasm of lymph nodes"	1	76	0	76
"H80"	"C78"	"Otosclerosis"	"Secondary malignant neoplasm of resp and digestive organs"	1	158	0	158
"H80"	"C79"	"Otosclerosis"	"Secondary malignant neoplasm of other and unspecified sites"	1	123	0	123
"H80"	"C83"	"Otosclerosis"	"Non-follicular lymphoma"	1	36	1	37
"H80"	"C85"	"Otosclerosis"	"Oth and unspecified types of non-Hodgkin lymphoma"	1	33	2	35
"H80"	"D14"	"Otosclerosis"	"Benign neoplasm of middle ear and respiratory system"	1	40	5	45
"H80"	"D23"	"Otosclerosis"	"Other benign neoplasms of skin"	1	97	29	126
"H80"	"D62"	"Otosclerosis"	"Acute posthemorrhagic anemia"	1	57	0	57
"H80"	"D63"	"Otosclerosis"	"Anemia in chronic diseases classified elsewhere"	1	79	0	79
"H80"	"D64"	"Otosclerosis"	"Other anemias"	1	372	0	372
"H80"	"D68"	"Otosclerosis"	"Other coagulation defects"	1	31	0	31
"H80"	"E03"	"Otosclerosis"	"Other hypothyroidism"	1	175	0	175
"H80"	"E10"	"Otosclerosis"	"Type 1 diabetes mellitus"	1	173	30	203
"H80"	"E11"	"Otosclerosis"	"Type 2 diabetes mellitus"	1	468	36	504
"H80"	"E78"	"Otosclerosis"	"Disorders of lipoprotein metabolism and other lipidemias"	1	470	0	470
"H80"	"F32"	"Otosclerosis"	"Depressive episode"	1	190	3	193
"H80"	"F33"	"Otosclerosis"	"Major depressive disorder, recurrent"	1	86	0	86
"H80"	"F41"	"Otosclerosis"	"Other anxiety disorders"	1	64	0	64
"H80"	"H25"	"Otosclerosis"	"Age-related cataract"	1	1164	75	1239
"H80"	"H35"	"Otosclerosis"	"Other retinal disorders"	1	374	5	379
"H80"	"H36"	"Otosclerosis"	"Retinal disorders in diseases classified elsewhere"	1	69	7	76
"H80"	"H43"	"Otosclerosis"	"Disorders of vitreous body"	1	97	3	100
"H80"	"I10"	"Otosclerosis"	"Essential (primary) hypertension"	1	1537	0	1537
"H80"	"I20"	"Otosclerosis"	"Angina pectoris"	1	625	142	767
"H80"	"I26"	"Otosclerosis"	"Pulmonary embolism"	1	108	0	108
"H80"	"I34"	"Otosclerosis"	"Nonrheumatic mitral valve disorders"	1	82	0	82
"H80"	"I35"	"Otosclerosis"	"Nonrheumatic aortic valve disorders"	1	210	0	210
"H80"	"I46"	"Otosclerosis"	"Cardiac arrest"	1	92	0	92
"H80"	"I49"	"Otosclerosis"	"Other cardiac arrhythmias"	1	183	9	192
"H80"	"I51"	"Otosclerosis"	"Complications and ill-defined descriptions of heart disease"	1	44	0	44
"H80"	"I69"	"Otosclerosis"	"Sequelae of cerebrovascular disease"	1	383	0	383
"H80"	"I70"	"Otosclerosis"	"Atherosclerosis"	1	258	46	304
"H80"	"I71"	"Otosclerosis"	"Aortic aneurysm and dissection"	1	96	0	96
"H80"	"I74"	"Otosclerosis"	"Arterial embolism and thrombosis"	1	42	0	42
"H80"	"I80"	"Otosclerosis"	"Phlebitis and thrombophlebitis"	1	198	14	212
"H80"	"I83"	"Otosclerosis"	"Varicose veins of lower extremities"	1	239	72	311
"H80"	"I87"	"Otosclerosis"	"Other disorders of veins"	1	26	0	26
"H80"	"I95"	"Otosclerosis"	"Hypotension"	1	57	0	57
"H80"	"J42"	"Otosclerosis"	"Unspecified chronic bronchitis"	1	109	38	147
"H80"	"J43"	"Otosclerosis"	"Emphysema"	1	54	3	57
"H80"	"J45"	"Otosclerosis"	"Asthma"	1	217	77	294
"H80"	"J96"	"Otosclerosis"	"Respiratory failure, not elsewhere classified"	1	233	0	233
"H80"	"K04"	"Otosclerosis"	"Diseases of pulp and periapical tissues"	1	48	1	49
"H80"	"K05"	"Otosclerosis"	"Gingivitis and periodontal diseases"	1	35	0	35
"H80"	"K30"	"Otosclerosis"	"Functional dyspepsia"	1	230	70	300
"H80"	"K40"	"Otosclerosis"	"Inguinal hernia"	1	279	98	377
"H80"	"K42"	"Otosclerosis"	"Umbilical hernia"	1	53	9	62
"H80"	"K44"	"Otosclerosis"	"Diaphragmatic hernia"	1	188	34	222
"H80"	"K52"	"Otosclerosis"	"Other and unsp noninfective gastroenteritis and colitis"	1	150	1	151
"H80"	"K55"	"Otosclerosis"	"Vascular disorders of intestine"	1	29	0	29
"H80"	"K56"	"Otosclerosis"	"Paralytic ileus and intestinal obstruction without hernia"	1	156	2	158
"H80"	"K58"	"Otosclerosis"	"Irritable bowel syndrome"	1	90	27	117
"H80"	"K59"	"Otosclerosis"	"Other functional intestinal disorders"	1	417	0	417
"H80"	"K62"	"Otosclerosis"	"Other diseases of anus and rectum"	1	263	23	286
"H80"	"K63"	"Otosclerosis"	"Other diseases of intestine"	1	38	0	38
"H80"	"K65"	"Otosclerosis"	"Peritonitis"	1	57	2	59
"H80"	"K85"	"Otosclerosis"	"Acute pancreatitis"	1	65	6	71
"H80"	"K92"	"Otosclerosis"	"Other diseases of digestive system"	1	200	0	200
"H80"	"L30"	"Otosclerosis"	"Other and unspecified dermatitis"	1	66	10	76
"H80"	"L89"	"Otosclerosis"	"Pressure ulcer"	1	49	0	49
"H80"	"L98"	"Otosclerosis"	"Oth disorders of skin, subcu, not elsewhere classified"	1	69	4	73
"H80"	"M06"	"Otosclerosis"	"Other rheumatoid arthritis"	1	81	20	101
"H80"	"M10"	"Otosclerosis"	"Gout"	1	82	2	84
"H80"	"M13"	"Otosclerosis"	"Other arthritis"	1	68	6	74
"H80"	"M15"	"Otosclerosis"	"Polyosteoarthritis"	1	64	5	69
"H80"	"M16"	"Otosclerosis"	"Osteoarthritis of hip"	1	329	36	365
"H80"	"M17"	"Otosclerosis"	"Osteoarthritis of knee"	1	554	60	614
"H80"	"M20"	"Otosclerosis"	"Acquired deformities of fingers and toes"	1	152	38	190
"H80"	"M23"	"Otosclerosis"	"Internal derangement of knee"	1	349	102	451
"H80"	"M35"	"Otosclerosis"	"Other systemic involvement of connective tissue"	1	133	25	158
"H80"	"M47"	"Otosclerosis"	"Spondylosis"	1	209	37	246
"H80"	"M48"	"Otosclerosis"	"Other spondylopathies"	1	205	0	205
"H80"	"M65"	"Otosclerosis"	"Synovitis and tenosynovitis"	1	161	31	192
"H80"	"M72"	"Otosclerosis"	"Fibroblastic disorders"	1	95	13	108
"H80"	"M75"	"Otosclerosis"	"Shoulder lesions"	1	396	54	450
"H80"	"M77"	"Otosclerosis"	"Other enthesopathies"	1	109	45	154
"H80"	"M79"	"Otosclerosis"	"Oth and unsp soft tissue disorders, not elsewhere classified"	1	448	77	525
"H80"	"M81"	"Otosclerosis"	"Osteoporosis without current pathological fracture"	1	393	0	393
"H80"	"M85"	"Otosclerosis"	"Other disorders of bone density and structure"	1	113	0	113
"H80"	"N10"	"Otosclerosis"	"Acute pyelonephritis"	1	63	16	79
"H80"	"N13"	"Otosclerosis"	"Obstructive and reflux uropathy"	1	85	2	87
"H80"	"N19"	"Otosclerosis"	"Unspecified kidney failure"	1	107	0	107
"H80"	"N30"	"Otosclerosis"	"Cystitis"	1	690	0	690
"H80"	"N39"	"Otosclerosis"	"Other disorders of urinary system"	1	437	0	437
"H80"	"N40"	"Otosclerosis"	"Benign prostatic hyperplasia"	1	295	72	367
"H81"	"A41"	"Disorders of vestibular function"	"Other sepsis"	1	2098	0	2098
"H81"	"A49"	"Disorders of vestibular function"	"Bacterial infection of unspecified site"	1	736	82	818
"H81"	"B37"	"Disorders of vestibular function"	"Candidiasis"	1	350	96	446
"H81"	"C20"	"Disorders of vestibular function"	"Malignant neoplasm of rectum"	1	161	83	244
"H81"	"C22"	"Disorders of vestibular function"	"Malignant neoplasm of liver and intrahepatic bile ducts"	1	69	0	69
"H81"	"C24"	"Disorders of vestibular function"	"Malignant neoplasm of other and unsp parts of biliary tract"	1	43	4	47
"H81"	"C25"	"Disorders of vestibular function"	"Malignant neoplasm of pancreas"	1	217	0	217
"H81"	"C61"	"Disorders of vestibular function"	"Malignant neoplasm of prostate"	1	501	166	667
"H81"	"C64"	"Disorders of vestibular function"	"Malignant neoplasm of kidney, except renal pelvis"	1	128	33	161
"H81"	"C67"	"Disorders of vestibular function"	"Malignant neoplasm of bladder"	1	169	77	246
"H81"	"C78"	"Disorders of vestibular function"	"Secondary malignant neoplasm of resp and digestive organs"	1	705	18	723
"H81"	"C79"	"Disorders of vestibular function"	"Secondary malignant neoplasm of other and unspecified sites"	1	556	59	615
"H81"	"C83"	"Disorders of vestibular function"	"Non-follicular lymphoma"	1	127	49	176
"H81"	"C92"	"Disorders of vestibular function"	"Myeloid leukemia"	1	62	14	76
"H81"	"D46"	"Disorders of vestibular function"	"Myelodysplastic syndromes"	1	80	17	97
"H81"	"D63"	"Disorders of vestibular function"	"Anemia in chronic diseases classified elsewhere"	1	420	50	470
"H81"	"D69"	"Disorders of vestibular function"	"Purpura and other hemorrhagic conditions"	1	195	100	295
"H81"	"F01"	"Disorders of vestibular function"	"Vascular dementia"	1	424	45	469
"H81"	"F03"	"Disorders of vestibular function"	"Unspecified dementia"	1	2427	0	2427
"H81"	"G11"	"Disorders of vestibular function"	"Hereditary ataxia"	1	67	14	81
"H81"	"G25"	"Disorders of vestibular function"	"Other extrapyramidal and movement disorders"	1	215	103	318
"H81"	"G93"	"Disorders of vestibular function"	"Other disorders of brain"	1	197	102	299
"H81"	"G98"	"Disorders of vestibular function"	"Other disorders of nervous system not elsewhere classified"	1	213	45	258
"H81"	"H53"	"Disorders of vestibular function"	"Visual disturbances"	1	492	326	818
"H81"	"H54"	"Disorders of vestibular function"	"Blindness and low vision"	1	317	135	452
"H81"	"I21"	"Disorders of vestibular function"	"Acute myocardial infarction"	1	1475	1162	2637
"H81"	"I26"	"Disorders of vestibular function"	"Pulmonary embolism"	1	600	222	822
"H81"	"I27"	"Disorders of vestibular function"	"Other pulmonary heart diseases"	1	227	63	290
"H81"	"I34"	"Disorders of vestibular function"	"Nonrheumatic mitral valve disorders"	1	325	199	524
"H81"	"I49"	"Disorders of vestibular function"	"Other cardiac arrhythmias"	1	1006	703	1709
"H81"	"I50"	"Disorders of vestibular function"	"Heart failure"	1	2958	1184	4142
"H81"	"I69"	"Disorders of vestibular function"	"Sequelae of cerebrovascular disease"	1	3074	1656	4730
"H81"	"I70"	"Disorders of vestibular function"	"Atherosclerosis"	1	1007	675	1682
"H81"	"I71"	"Disorders of vestibular function"	"Aortic aneurysm and dissection"	1	513	122	635
"H81"	"I73"	"Disorders of vestibular function"	"Other peripheral vascular diseases"	1	677	259	936
"H81"	"I95"	"Disorders of vestibular function"	"Hypotension"	1	1126	840	1966
"H81"	"J44"	"Disorders of vestibular function"	"Other chronic obstructive pulmonary disease"	1	2005	1087	3092
"H81"	"J81"	"Disorders of vestibular function"	"Pulmonary edema"	1	396	53	449
"H81"	"J93"	"Disorders of vestibular function"	"Pneumothorax and air leak"	1	160	60	220
"H81"	"J98"	"Disorders of vestibular function"	"Other respiratory disorders"	1	244	71	315
"H81"	"K22"	"Disorders of vestibular function"	"Other diseases of esophagus"	1	319	155	474
"H81"	"K31"	"Disorders of vestibular function"	"Other diseases of stomach and duodenum"	1	131	43	174
"H81"	"K55"	"Disorders of vestibular function"	"Vascular disorders of intestine"	1	154	32	186
"H81"	"K59"	"Disorders of vestibular function"	"Other functional intestinal disorders"	1	2639	952	3591
"H81"	"K63"	"Disorders of vestibular function"	"Other diseases of intestine"	1	206	52	258
"H81"	"K65"	"Disorders of vestibular function"	"Peritonitis"	1	172	81	253
"H81"	"K72"	"Disorders of vestibular function"	"Hepatic failure, not elsewhere classified"	1	120	19	139
"H81"	"K74"	"Disorders of vestibular function"	"Fibrosis and cirrhosis of liver"	1	141	52	193
"H81"	"K76"	"Disorders of vestibular function"	"Other diseases of liver"	1	243	126	369
"H81"	"K83"	"Disorders of vestibular function"	"Other diseases of biliary tract"	1	211	60	271
"H81"	"N13"	"Disorders of vestibular function"	"Obstructive and reflux uropathy"	1	274	99	373
"H81"	"N18"	"Disorders of vestibular function"	"Chronic kidney disease (CKD)"	1	889	135	1024
"H81"	"O72"	"Disorders of vestibular function"	"Postpartum hemorrhage"	1	449	282	731
"H83"	"A09"	"Other diseases of inner ear"	"Infectious gastroenteritis and colitis, unspecified"	1	535	99	634
"H83"	"A46"	"Other diseases of inner ear"	"Erysipelas"	1	669	48	717
"H83"	"B37"	"Other diseases of inner ear"	"Candidiasis"	1	305	0	305
"H83"	"C15"	"Other diseases of inner ear"	"Malignant neoplasm of esophagus"	1	199	0	199
"H83"	"C16"	"Other diseases of inner ear"	"Malignant neoplasm of stomach"	1	278	0	278
"H83"	"C17"	"Other diseases of inner ear"	"Malignant neoplasm of small intestine"	1	28	0	28
"H83"	"C20"	"Other diseases of inner ear"	"Malignant neoplasm of rectum"	1	398	47	445
"H83"	"C34"	"Other diseases of inner ear"	"Malignant neoplasm of bronchus and lung"	1	1348	0	1348
"H83"	"C41"	"Other diseases of inner ear"	"Malignant neoplasm of bone/artic cartl of and unsp sites"	1	34	4	38
"H83"	"C43"	"Other diseases of inner ear"	"Malignant melanoma of skin"	1	256	44	300
"H83"	"C44"	"Other diseases of inner ear"	"Other and unspecified malignant neoplasm of skin"	1	986	27	1013
"H83"	"C61"	"Other diseases of inner ear"	"Malignant neoplasm of prostate"	1	1862	0	1862
"H83"	"C64"	"Other diseases of inner ear"	"Malignant neoplasm of kidney, except renal pelvis"	1	237	4	241
"H83"	"C76"	"Other diseases of inner ear"	"Malignant neoplasm of other and ill-defined sites"	1	48	4	52
"H83"	"C78"	"Other diseases of inner ear"	"Secondary malignant neoplasm of resp and digestive organs"	1	920	0	920
"H83"	"C79"	"Other diseases of inner ear"	"Secondary malignant neoplasm of other and unspecified sites"	1	748	0	748
"H83"	"C83"	"Other diseases of inner ear"	"Non-follicular lymphoma"	1	157	7	164
"H83"	"C90"	"Other diseases of inner ear"	"Multiple myeloma and malignant plasma cell neoplasms"	1	118	0	118
"H83"	"C91"	"Other diseases of inner ear"	"Lymphoid leukemia"	1	158	8	166
"H83"	"C92"	"Other diseases of inner ear"	"Myeloid leukemia"	1	113	0	113
"H83"	"D09"	"Other diseases of inner ear"	"Carcinoma in situ of other and unspecified sites"	1	116	0	116
"H83"	"D12"	"Other diseases of inner ear"	"Benign neoplasm of colon, rectum, anus and anal canal"	1	2103	0	2103
"H83"	"D13"	"Other diseases of inner ear"	"Benign neoplasm of and ill-defined parts of digestive system"	1	133	8	141
"H83"	"D14"	"Other diseases of inner ear"	"Benign neoplasm of middle ear and respiratory system"	1	177	54	231
"H83"	"D23"	"Other diseases of inner ear"	"Other benign neoplasms of skin"	1	337	177	514
"H83"	"D30"	"Other diseases of inner ear"	"Benign neoplasm of urinary organs"	1	438	152	590
"H83"	"D46"	"Other diseases of inner ear"	"Myelodysplastic syndromes"	1	97	0	97
"H83"	"D47"	"Other diseases of inner ear"	"Oth neoplm of uncrt behav of lymphoid, hematpoetc & rel tiss"	1	160	0	160
"H83"	"D50"	"Other diseases of inner ear"	"Iron deficiency anemia"	1	485	0	485
"H83"	"D61"	"Other diseases of inner ear"	"Oth aplastic anemias and other bone marrow failure syndromes"	1	76	0	76
"H83"	"D62"	"Other diseases of inner ear"	"Acute posthemorrhagic anemia"	1	244	0	244
"H83"	"D64"	"Other diseases of inner ear"	"Other anemias"	1	1764	0	1764
"H83"	"D72"	"Other diseases of inner ear"	"Other disorders of white blood cells"	1	43	1	44
"H83"	"E05"	"Other diseases of inner ear"	"Thyrotoxicosis [hyperthyroidism]"	1	327	99	426
"H83"	"E27"	"Other diseases of inner ear"	"Other disorders of adrenal gland"	1	71	5	76
"H83"	"E34"	"Other diseases of inner ear"	"Other endocrine disorders"	1	44	0	44
"H83"	"E66"	"Other diseases of inner ear"	"Overweight and obesity"	1	822	192	1014
"H83"	"E83"	"Other diseases of inner ear"	"Disorders of mineral metabolism"	1	147	0	147
"H83"	"F01"	"Other diseases of inner ear"	"Vascular dementia"	1	198	0	198
"H83"	"F32"	"Other diseases of inner ear"	"Depressive episode"	1	607	0	607
"H83"	"G20"	"Other diseases of inner ear"	"Parkinson's disease"	1	373	0	373
"H83"	"G24"	"Other diseases of inner ear"	"Dystonia"	1	39	5	44
"H83"	"G30"	"Other diseases of inner ear"	"Alzheimer's disease"	1	164	0	164
"H83"	"G31"	"Other diseases of inner ear"	"Oth degenerative diseases of nervous system, NEC"	1	123	0	123
"H83"	"G40"	"Other diseases of inner ear"	"Epilepsy and recurrent seizures"	1	532	132	664
"H83"	"G62"	"Other diseases of inner ear"	"Other and unspecified polyneuropathies"	1	430	53	483
"H83"	"G82"	"Other diseases of inner ear"	"Paraplegia (paraparesis) and quadriplegia (quadriparesis)"	1	65	3	68
"H83"	"H18"	"Other diseases of inner ear"	"Other disorders of cornea"	1	136	8	144
"H83"	"H25"	"Other diseases of inner ear"	"Age-related cataract"	1	5111	0	5111
"H83"	"H34"	"Other diseases of inner ear"	"Retinal vascular occlusions"	1	252	26	278
"H83"	"H36"	"Other diseases of inner ear"	"Retinal disorders in diseases classified elsewhere"	1	317	70	387
"H83"	"H43"	"Other diseases of inner ear"	"Disorders of vitreous body"	1	338	48	386
"H83"	"I12"	"Other diseases of inner ear"	"Hypertensive chronic kidney disease"	1	89	5	94
"H83"	"I15"	"Other diseases of inner ear"	"Secondary hypertension"	1	186	12	198
"H83"	"I20"	"Other diseases of inner ear"	"Angina pectoris"	1	2784	1639	4423
"H83"	"I21"	"Other diseases of inner ear"	"Acute myocardial infarction"	1	2329	651	2980
"H83"	"I24"	"Other diseases of inner ear"	"Other acute ischemic heart diseases"	1	146	24	170
"H83"	"I27"	"Other diseases of inner ear"	"Other pulmonary heart diseases"	1	191	3	194
"H83"	"I42"	"Other diseases of inner ear"	"Cardiomyopathy"	1	330	18	348
"H83"	"I45"	"Other diseases of inner ear"	"Other conduction disorders"	1	254	38	292
"H83"	"I48"	"Other diseases of inner ear"	"Atrial fibrillation and flutter"	1	4273	0	4273
"H83"	"I69"	"Other diseases of inner ear"	"Sequelae of cerebrovascular disease"	1	1987	0	1987
"H83"	"I82"	"Other diseases of inner ear"	"Other venous embolism and thrombosis"	1	134	8	142
"H83"	"I85"	"Other diseases of inner ear"	"Esophageal varices"	1	98	7	105
"H83"	"I87"	"Other diseases of inner ear"	"Other disorders of veins"	1	115	16	131
"H83"	"I97"	"Other diseases of inner ear"	"Intraop and postproc comp and disorders of circ sys, NEC"	1	33	2	35
"H83"	"J13"	"Other diseases of inner ear"	"Pneumonia due to Streptococcus pneumoniae"	1	101	5	106
"H83"	"J14"	"Other diseases of inner ear"	"Pneumonia due to Hemophilus influenzae"	1	66	1	67
"H83"	"J15"	"Other diseases of inner ear"	"Bacterial pneumonia, not elsewhere classified"	1	1080	0	1080
"H83"	"J18"	"Other diseases of inner ear"	"Pneumonia, unspecified organism"	1	4594	0	4594
"H83"	"J20"	"Other diseases of inner ear"	"Acute bronchitis"	1	228	103	331
"H83"	"J22"	"Other diseases of inner ear"	"Unspecified acute lower respiratory infection"	1	88	0	88
"H83"	"J45"	"Other diseases of inner ear"	"Asthma"	1	638	332	970
"H83"	"J81"	"Other diseases of inner ear"	"Pulmonary edema"	1	328	0	328
"H83"	"J84"	"Other diseases of inner ear"	"Other interstitial pulmonary diseases"	1	289	11	300
"H83"	"J90"	"Other diseases of inner ear"	"Pleural effusion, not elsewhere classified"	1	374	0	374
"H83"	"J91"	"Other diseases of inner ear"	"Pleural effusion in conditions classified elsewhere"	1	149	0	149
"H83"	"J95"	"Other diseases of inner ear"	"Intraop and postproc comp and disorders of resp sys, NEC"	1	77	0	77
"H83"	"K08"	"Other diseases of inner ear"	"Other disorders of teeth and supporting structures"	1	233	42	275
"H83"	"K13"	"Other diseases of inner ear"	"Other diseases of lip and oral mucosa"	1	101	31	132
"H83"	"K21"	"Other diseases of inner ear"	"Gastro-esophageal reflux disease"	1	898	444	1342
"H83"	"K26"	"Other diseases of inner ear"	"Duodenal ulcer"	1	586	229	815
"H83"	"K40"	"Other diseases of inner ear"	"Inguinal hernia"	1	1818	1355	3173
"H83"	"K43"	"Other diseases of inner ear"	"Ventral hernia"	1	384	133	517
"H83"	"K56"	"Other diseases of inner ear"	"Paralytic ileus and intestinal obstruction without hernia"	1	576	20	596
"H83"	"K57"	"Other diseases of inner ear"	"Diverticular disease of intestine"	1	1957	0	1957
"H83"	"K59"	"Other diseases of inner ear"	"Other functional intestinal disorders"	1	1899	0	1899
"H83"	"K63"	"Other diseases of inner ear"	"Other diseases of intestine"	1	214	0	214
"H83"	"K76"	"Other diseases of inner ear"	"Other diseases of liver"	1	184	24	208
"H83"	"K80"	"Other diseases of inner ear"	"Cholelithiasis"	1	1024	341	1365
"H83"	"K83"	"Other diseases of inner ear"	"Other diseases of biliary tract"	1	243	1	244
"H83"	"K86"	"Other diseases of inner ear"	"Other diseases of pancreas"	1	135	38	173
"H83"	"L02"	"Other diseases of inner ear"	"Cutaneous abscess, furuncle and carbuncle"	1	464	219	683
"H83"	"L30"	"Other diseases of inner ear"	"Other and unspecified dermatitis"	1	205	43	248
"H83"	"L40"	"Other diseases of inner ear"	"Psoriasis"	1	133	56	189
"H83"	"L97"	"Other diseases of inner ear"	"Non-pressure chronic ulcer of lower limb, NEC"	1	314	0	314
"H83"	"L98"	"Other diseases of inner ear"	"Oth disorders of skin, subcu, not elsewhere classified"	1	283	29	312
"H83"	"M06"	"Other diseases of inner ear"	"Other rheumatoid arthritis"	1	235	70	305
"H83"	"M10"	"Other diseases of inner ear"	"Gout"	1	602	44	646
"H83"	"M13"	"Other diseases of inner ear"	"Other arthritis"	1	310	40	350
"H83"	"M25"	"Other diseases of inner ear"	"Other joint disorder, not elsewhere classified"	1	433	162	595
"H83"	"M31"	"Other diseases of inner ear"	"Other necrotizing vasculopathies"	1	162	31	193
"H83"	"M48"	"Other diseases of inner ear"	"Other spondylopathies"	1	1049	101	1150
"H83"	"M65"	"Other diseases of inner ear"	"Synovitis and tenosynovitis"	1	486	314	800
"H83"	"M72"	"Other diseases of inner ear"	"Fibroblastic disorders"	1	580	305	885
"H83"	"M75"	"Other diseases of inner ear"	"Shoulder lesions"	1	1782	763	2545
"H83"	"M76"	"Other diseases of inner ear"	"Enthesopathies, lower limb, excluding foot"	1	173	88	261
"H83"	"M79"	"Other diseases of inner ear"	"Oth and unsp soft tissue disorders, not elsewhere classified"	1	1449	460	1909
"H83"	"M99"	"Other diseases of inner ear"	"Biomechanical lesions, not elsewhere classified"	1	211	51	262
"H83"	"N10"	"Other diseases of inner ear"	"Acute pyelonephritis"	1	213	15	228
"H83"	"N12"	"Other diseases of inner ear"	"Tubulo-interstitial nephritis, not spcf as acute or chronic"	1	37	0	37
"H83"	"N19"	"Other diseases of inner ear"	"Unspecified kidney failure"	1	525	0	525
"H83"	"N30"	"Other diseases of inner ear"	"Cystitis"	1	2166	0	2166
"H83"	"N35"	"Other diseases of inner ear"	"Urethral stricture"	1	276	92	368
"H83"	"N48"	"Other diseases of inner ear"	"Other disorders of penis"	1	306	158	464
"H83"	"N99"	"Other diseases of inner ear"	"Intraop and postproc comp and disorders of GU sys, NEC"	1	193	91	284
"H83"	"Q61"	"Other diseases of inner ear"	"Cystic kidney disease"	1	118	7	125
"H90"	"A41"	"Conductive and sensorineural hearing loss"	"Other sepsis"	1	2369	0	2369
"H90"	"A46"	"Conductive and sensorineural hearing loss"	"Erysipelas"	1	930	300	1230
"H90"	"C16"	"Conductive and sensorineural hearing loss"	"Malignant neoplasm of stomach"	1	211	31	242
"H90"	"C17"	"Conductive and sensorineural hearing loss"	"Malignant neoplasm of small intestine"	1	35	4	39
"H90"	"C24"	"Conductive and sensorineural hearing loss"	"Malignant neoplasm of other and unsp parts of biliary tract"	1	68	0	68
"H90"	"C44"	"Conductive and sensorineural hearing loss"	"Other and unspecified malignant neoplasm of skin"	1	1040	349	1389
"H90"	"C61"	"Conductive and sensorineural hearing loss"	"Malignant neoplasm of prostate"	1	913	333	1246
"H90"	"C64"	"Conductive and sensorineural hearing loss"	"Malignant neoplasm of kidney, except renal pelvis"	1	135	41	176
"H90"	"C67"	"Conductive and sensorineural hearing loss"	"Malignant neoplasm of bladder"	1	272	144	416
"H90"	"C77"	"Conductive and sensorineural hearing loss"	"Secondary and unspecified malignant neoplasm of lymph nodes"	1	338	116	454
"H90"	"C80"	"Conductive and sensorineural hearing loss"	"Malignant neoplasm without specification of site"	1	121	6	127
"H90"	"C83"	"Conductive and sensorineural hearing loss"	"Non-follicular lymphoma"	1	145	67	212
"H90"	"C90"	"Conductive and sensorineural hearing loss"	"Multiple myeloma and malignant plasma cell neoplasms"	1	108	39	147
"H90"	"C92"	"Conductive and sensorineural hearing loss"	"Myeloid leukemia"	1	97	16	113
"H90"	"D46"	"Conductive and sensorineural hearing loss"	"Myelodysplastic syndromes"	1	95	18	113
"H90"	"D63"	"Conductive and sensorineural hearing loss"	"Anemia in chronic diseases classified elsewhere"	1	564	51	615
"H90"	"D64"	"Conductive and sensorineural hearing loss"	"Other anemias"	1	2977	0	2977
"H90"	"D68"	"Conductive and sensorineural hearing loss"	"Other coagulation defects"	1	195	70	265
"H90"	"D69"	"Conductive and sensorineural hearing loss"	"Purpura and other hemorrhagic conditions"	1	261	126	387
"H90"	"E03"	"Conductive and sensorineural hearing loss"	"Other hypothyroidism"	1	836	312	1148
"H90"	"E11"	"Conductive and sensorineural hearing loss"	"Type 2 diabetes mellitus"	1	2163	1337	3500
"H90"	"F32"	"Conductive and sensorineural hearing loss"	"Depressive episode"	1	948	277	1225
"H90"	"F33"	"Conductive and sensorineural hearing loss"	"Major depressive disorder, recurrent"	1	471	67	538
"H90"	"F84"	"Conductive and sensorineural hearing loss"	"Pervasive developmental disorders"	1	121	28	149
"H90"	"G47"	"Conductive and sensorineural hearing loss"	"Sleep disorders"	1	1022	467	1489
"H90"	"G95"	"Conductive and sensorineural hearing loss"	"Other and unspecified diseases of spinal cord"	1	171	31	202
"H90"	"H25"	"Conductive and sensorineural hearing loss"	"Age-related cataract"	1	5609	2805	8414
"H90"	"H34"	"Conductive and sensorineural hearing loss"	"Retinal vascular occlusions"	1	243	111	354
"H90"	"I10"	"Conductive and sensorineural hearing loss"	"Essential (primary) hypertension"	1	6225	3246	9471
"H90"	"I11"	"Conductive and sensorineural hearing loss"	"Hypertensive heart disease"	1	402	92	494
"H90"	"I12"	"Conductive and sensorineural hearing loss"	"Hypertensive chronic kidney disease"	1	113	39	152
"H90"	"I15"	"Conductive and sensorineural hearing loss"	"Secondary hypertension"	1	268	135	403
"H90"	"I24"	"Conductive and sensorineural hearing loss"	"Other acute ischemic heart diseases"	1	138	59	197
"H90"	"I27"	"Conductive and sensorineural hearing loss"	"Other pulmonary heart diseases"	1	237	65	302
"H90"	"I33"	"Conductive and sensorineural hearing loss"	"Acute and subacute endocarditis"	1	84	28	112
"H90"	"I34"	"Conductive and sensorineural hearing loss"	"Nonrheumatic mitral valve disorders"	1	463	163	626
"H90"	"I35"	"Conductive and sensorineural hearing loss"	"Nonrheumatic aortic valve disorders"	1	1401	248	1649
"H90"	"I42"	"Conductive and sensorineural hearing loss"	"Cardiomyopathy"	1	302	140	442
"H90"	"I44"	"Conductive and sensorineural hearing loss"	"Atrioventricular and left bundle-branch block"	1	689	168	857
"H90"	"I46"	"Conductive and sensorineural hearing loss"	"Cardiac arrest"	1	611	0	611
"H90"	"I49"	"Conductive and sensorineural hearing loss"	"Other cardiac arrhythmias"	1	877	427	1304
"H90"	"I50"	"Conductive and sensorineural hearing loss"	"Heart failure"	1	4763	0	4763
"H90"	"I51"	"Conductive and sensorineural hearing loss"	"Complications and ill-defined descriptions of heart disease"	1	287	71	358
"H90"	"I69"	"Conductive and sensorineural hearing loss"	"Sequelae of cerebrovascular disease"	1	2336	536	2872
"H90"	"I71"	"Conductive and sensorineural hearing loss"	"Aortic aneurysm and dissection"	1	734	128	862
"H90"	"I80"	"Conductive and sensorineural hearing loss"	"Phlebitis and thrombophlebitis"	1	895	492	1387
"H90"	"I82"	"Conductive and sensorineural hearing loss"	"Other venous embolism and thrombosis"	1	174	45	219
"H90"	"I85"	"Conductive and sensorineural hearing loss"	"Esophageal varices"	1	77	24	101
"H90"	"I95"	"Conductive and sensorineural hearing loss"	"Hypotension"	1	577	42	619
"H90"	"I97"	"Conductive and sensorineural hearing loss"	"Intraop and postproc comp and disorders of circ sys, NEC"	1	69	19	88
"H90"	"J06"	"Conductive and sensorineural hearing loss"	"Acute upper resp infections of multiple and unsp sites"	1	266	156	422
"H90"	"J15"	"Conductive and sensorineural hearing loss"	"Bacterial pneumonia, not elsewhere classified"	1	2131	0	2131
"H90"	"J22"	"Conductive and sensorineural hearing loss"	"Unspecified acute lower respiratory infection"	1	230	8	238
"H90"	"J81"	"Conductive and sensorineural hearing loss"	"Pulmonary edema"	1	495	38	533
"H90"	"J85"	"Conductive and sensorineural hearing loss"	"Abscess of lung and mediastinum"	1	55	11	66
"H90"	"J90"	"Conductive and sensorineural hearing loss"	"Pleural effusion, not elsewhere classified"	1	448	45	493
"H90"	"J95"	"Conductive and sensorineural hearing loss"	"Intraop and postproc comp and disorders of resp sys, NEC"	1	126	16	142
"H90"	"J96"	"Conductive and sensorineural hearing loss"	"Respiratory failure, not elsewhere classified"	1	1995	0	1995
"H90"	"J98"	"Conductive and sensorineural hearing loss"	"Other respiratory disorders"	1	295	151	446
"H90"	"K56"	"Conductive and sensorineural hearing loss"	"Paralytic ileus and intestinal obstruction without hernia"	1	742	240	982
"H90"	"K59"	"Conductive and sensorineural hearing loss"	"Other functional intestinal disorders"	1	2802	800	3602
"H90"	"K62"	"Conductive and sensorineural hearing loss"	"Other diseases of anus and rectum"	1	1172	642	1814
"H90"	"K63"	"Conductive and sensorineural hearing loss"	"Other diseases of intestine"	1	274	65	339
"H90"	"K64"	"Conductive and sensorineural hearing loss"	"Hemorrhoids and perianal venous thrombosis"	1	557	55	612
"H90"	"L89"	"Conductive and sensorineural hearing loss"	"Pressure ulcer"	1	389	8	397
"H90"	"L97"	"Conductive and sensorineural hearing loss"	"Non-pressure chronic ulcer of lower limb, NEC"	1	474	94	568
"H90"	"L98"	"Conductive and sensorineural hearing loss"	"Oth disorders of skin, subcu, not elsewhere classified"	1	370	174	544
"H90"	"M10"	"Conductive and sensorineural hearing loss"	"Gout"	1	491	182	673
"H90"	"M19"	"Conductive and sensorineural hearing loss"	"Other and unspecified osteoarthritis"	1	991	646	1637
"H90"	"M48"	"Conductive and sensorineural hearing loss"	"Other spondylopathies"	1	1109	504	1613
"H90"	"M85"	"Conductive and sensorineural hearing loss"	"Other disorders of bone density and structure"	1	714	203	917
"H90"	"N13"	"Conductive and sensorineural hearing loss"	"Obstructive and reflux uropathy"	1	415	152	567
"H90"	"N19"	"Conductive and sensorineural hearing loss"	"Unspecified kidney failure"	1	619	92	711
"H90"	"N39"	"Conductive and sensorineural hearing loss"	"Other disorders of urinary system"	1	3570	0	3570
"H90"	"O72"	"Conductive and sensorineural hearing loss"	"Postpartum hemorrhage"	1	500	100	600
"H91"	"A40"	"Other and unspecified hearing loss"	"Streptococcal sepsis"	1	532	118	650
"H91"	"A41"	"Other and unspecified hearing loss"	"Other sepsis"	1	10539	0	10539
"H91"	"A46"	"Other and unspecified hearing loss"	"Erysipelas"	1	5171	0	5171
"H91"	"A48"	"Other and unspecified hearing loss"	"Other bacterial diseases, not elsewhere classified"	1	123	38	161
"H91"	"B36"	"Other and unspecified hearing loss"	"Other superficial mycoses"	1	163	41	204
"H91"	"B59"	"Other and unspecified hearing loss"	"Pneumocystosis"	1	42	7	49
"H91"	"B95"	"Other and unspecified hearing loss"	"Strep as the cause of diseases classified elsewhere"	1	203	17	220
"H91"	"B96"	"Other and unspecified hearing loss"	"Oth bacterial agents as the cause of diseases classd elswhr"	1	437	27	464
"H91"	"C15"	"Other and unspecified hearing loss"	"Malignant neoplasm of esophagus"	1	784	44	828
"H91"	"C20"	"Other and unspecified hearing loss"	"Malignant neoplasm of rectum"	1	1557	719	2276
"H91"	"C23"	"Other and unspecified hearing loss"	"Malignant neoplasm of gallbladder"	1	93	3	96
"H91"	"C25"	"Other and unspecified hearing loss"	"Malignant neoplasm of pancreas"	1	1445	0	1445
"H91"	"C26"	"Other and unspecified hearing loss"	"Malignant neoplasm of other and ill-defined digestive organs"	1	49	0	49
"H91"	"C43"	"Other and unspecified hearing loss"	"Malignant melanoma of skin"	1	923	619	1542
"H91"	"C44"	"Other and unspecified hearing loss"	"Other and unspecified malignant neoplasm of skin"	1	6614	0	6614
"H91"	"C49"	"Other and unspecified hearing loss"	"Malignant neoplasm of other connective and soft tissue"	1	206	81	287
"H91"	"C56"	"Other and unspecified hearing loss"	"Malignant neoplasm of ovary"	1	425	288	713
"H91"	"C64"	"Other and unspecified hearing loss"	"Malignant neoplasm of kidney, except renal pelvis"	1	733	183	916
"H91"	"C67"	"Other and unspecified hearing loss"	"Malignant neoplasm of bladder"	1	1418	687	2105
"H91"	"C77"	"Other and unspecified hearing loss"	"Secondary and unspecified malignant neoplasm of lymph nodes"	1	1335	462	1797
"H91"	"C80"	"Other and unspecified hearing loss"	"Malignant neoplasm without specification of site"	1	543	28	571
"H91"	"C83"	"Other and unspecified hearing loss"	"Non-follicular lymphoma"	1	653	210	863
"H91"	"C85"	"Other and unspecified hearing loss"	"Oth and unspecified types of non-Hodgkin lymphoma"	1	610	292	902
"H91"	"C88"	"Other and unspecified hearing loss"	"Malig immunoproliferative dis and certain oth B-cell lymph"	1	205	43	248
"H91"	"C94"	"Other and unspecified hearing loss"	"Other leukemias of specified cell type"	1	74	17	91
"H91"	"C95"	"Other and unspecified hearing loss"	"Leukemia of unspecified cell type"	1	206	30	236
"H91"	"D12"	"Other and unspecified hearing loss"	"Benign neoplasm of colon, rectum, anus and anal canal"	1	6065	3239	9304
"H91"	"D13"	"Other and unspecified hearing loss"	"Benign neoplasm of and ill-defined parts of digestive system"	1	491	255	746
"H91"	"D35"	"Other and unspecified hearing loss"	"Benign neoplasm of other and unspecified endocrine glands"	1	365	196	561
"H91"	"D43"	"Other and unspecified hearing loss"	"Neoplasm of uncertain behavior of brain and cnsl"	1	313	105	418
"H91"	"D46"	"Other and unspecified hearing loss"	"Myelodysplastic syndromes"	1	582	40	622
"H91"	"D53"	"Other and unspecified hearing loss"	"Other nutritional anemias"	1	216	50	266
"H91"	"D63"	"Other and unspecified hearing loss"	"Anemia in chronic diseases classified elsewhere"	1	2966	0	2966
"H91"	"D68"	"Other and unspecified hearing loss"	"Other coagulation defects"	1	631	212	843
"H91"	"D70"	"Other and unspecified hearing loss"	"Neutropenia"	1	126	53	179
"H91"	"E03"	"Other and unspecified hearing loss"	"Other hypothyroidism"	1	3435	1316	4751
"H91"	"E16"	"Other and unspecified hearing loss"	"Other disorders of pancreatic internal secretion"	1	1418	435	1853
"H91"	"E21"	"Other and unspecified hearing loss"	"Hyperparathyroidism and other disorders of parathyroid gland"	1	901	275	1176
"H91"	"E25"	"Other and unspecified hearing loss"	"Adrenogenital disorders"	1	156	7	163
"H91"	"E34"	"Other and unspecified hearing loss"	"Other endocrine disorders"	1	316	120	436
"H91"	"E41"	"Other and unspecified hearing loss"	"Nutritional marasmus"	1	289	0	289
"H91"	"E61"	"Other and unspecified hearing loss"	"Deficiency of other nutrient elements"	1	146	18	164
"H91"	"E63"	"Other and unspecified hearing loss"	"Other nutritional deficiencies"	1	220	3	223
"H91"	"E64"	"Other and unspecified hearing loss"	"Sequelae of malnutrition and other nutritional deficiencies"	1	1076	122	1198
"H91"	"E83"	"Other and unspecified hearing loss"	"Disorders of mineral metabolism"	1	1064	123	1187
"H91"	"E85"	"Other and unspecified hearing loss"	"Amyloidosis"	1	64	10	74
"H91"	"E86"	"Other and unspecified hearing loss"	"Volume depletion"	1	17809	0	17809
"H91"	"F03"	"Other and unspecified hearing loss"	"Unspecified dementia"	1	10260	0	10260
"H91"	"F05"	"Other and unspecified hearing loss"	"Delirium due to known physiological condition"	1	2158	0	2158
"H91"	"F32"	"Other and unspecified hearing loss"	"Depressive episode"	1	6397	0	6397
"H91"	"F33"	"Other and unspecified hearing loss"	"Major depressive disorder, recurrent"	1	2426	0	2426
"H91"	"G12"	"Other and unspecified hearing loss"	"Spinal muscular atrophy and related syndromes"	1	202	36	238
"H91"	"G20"	"Other and unspecified hearing loss"	"Parkinson's disease"	1	2080	367	2447
"H91"	"G21"	"Other and unspecified hearing loss"	"Secondary parkinsonism"	1	320	33	353
"H91"	"G23"	"Other and unspecified hearing loss"	"Other degenerative diseases of basal ganglia"	1	147	0	147
"H91"	"G24"	"Other and unspecified hearing loss"	"Dystonia"	1	249	132	381
"H91"	"G40"	"Other and unspecified hearing loss"	"Epilepsy and recurrent seizures"	1	2409	1759	4168
"H91"	"G95"	"Other and unspecified hearing loss"	"Other and unspecified diseases of spinal cord"	1	852	96	948
"H91"	"H25"	"Other and unspecified hearing loss"	"Age-related cataract"	1	44091	0	44091
"H91"	"H26"	"Other and unspecified hearing loss"	"Other cataract"	1	7629	4041	11670
"H91"	"H34"	"Other and unspecified hearing loss"	"Retinal vascular occlusions"	1	1206	605	1811
"H91"	"H35"	"Other and unspecified hearing loss"	"Other retinal disorders"	1	14282	0	14282
"H91"	"H40"	"Other and unspecified hearing loss"	"Glaucoma"	1	2598	2175	4773
"H91"	"H53"	"Other and unspecified hearing loss"	"Visual disturbances"	1	1830	1307	3137
"H91"	"H54"	"Other and unspecified hearing loss"	"Blindness and low vision"	1	1792	943	2735
"H91"	"H61"	"Other and unspecified hearing loss"	"Other disorders of external ear"	1	2544	2080	4624
"H91"	"I10"	"Other and unspecified hearing loss"	"Essential (primary) hypertension"	1	43764	0	43764
"H91"	"I11"	"Other and unspecified hearing loss"	"Hypertensive heart disease"	1	1969	392	2361
"H91"	"I13"	"Other and unspecified hearing loss"	"Hypertensive heart and chronic kidney disease"	1	183	44	227
"H91"	"I21"	"Other and unspecified hearing loss"	"Acute myocardial infarction"	1	16057	0	16057
"H91"	"I24"	"Other and unspecified hearing loss"	"Other acute ischemic heart diseases"	1	680	319	999
"H91"	"I27"	"Other and unspecified hearing loss"	"Other pulmonary heart diseases"	1	1132	200	1332
"H91"	"I31"	"Other and unspecified hearing loss"	"Other diseases of pericardium"	1	315	111	426
"H91"	"I34"	"Other and unspecified hearing loss"	"Nonrheumatic mitral valve disorders"	1	2240	766	3006
"H91"	"I38"	"Other and unspecified hearing loss"	"Endocarditis, valve unspecified"	1	229	33	262
"H91"	"I42"	"Other and unspecified hearing loss"	"Cardiomyopathy"	1	1231	425	1656
"H91"	"I44"	"Other and unspecified hearing loss"	"Atrioventricular and left bundle-branch block"	1	4339	0	4339
"H91"	"I45"	"Other and unspecified hearing loss"	"Other conduction disorders"	1	1272	529	1801
"H91"	"I46"	"Other and unspecified hearing loss"	"Cardiac arrest"	1	2858	0	2858
"H91"	"I51"	"Other and unspecified hearing loss"	"Complications and ill-defined descriptions of heart disease"	1	1137	257	1394
"H91"	"I63"	"Other and unspecified hearing loss"	"Cerebral infarction"	1	13288	0	13288
"H91"	"I70"	"Other and unspecified hearing loss"	"Atherosclerosis"	1	6081	3555	9636
"H91"	"I71"	"Other and unspecified hearing loss"	"Aortic aneurysm and dissection"	1	3948	0	3948
"H91"	"I74"	"Other and unspecified hearing loss"	"Arterial embolism and thrombosis"	1	980	293	1273
"H91"	"I89"	"Other and unspecified hearing loss"	"Oth noninfective disorders of lymphatic vessels and nodes"	1	459	160	619
"H91"	"J09"	"Other and unspecified hearing loss"	"Influenza due to certain identified influenza viruses"	1	252	0	252
"H91"	"J10"	"Other and unspecified hearing loss"	"Influenza due to other identified influenza virus"	1	237	0	237
"H91"	"J15"	"Other and unspecified hearing loss"	"Bacterial pneumonia, not elsewhere classified"	1	9582	0	9582
"H91"	"J16"	"Other and unspecified hearing loss"	"Pneumonia due to oth infectious organisms, NEC"	1	253	81	334
"H91"	"J18"	"Other and unspecified hearing loss"	"Pneumonia, unspecified organism"	1	36113	0	36113
"H91"	"J22"	"Other and unspecified hearing loss"	"Unspecified acute lower respiratory infection"	1	863	0	863
"H91"	"J47"	"Other and unspecified hearing loss"	"Bronchiectasis"	1	469	136	605
"H91"	"J81"	"Other and unspecified hearing loss"	"Pulmonary edema"	1	2873	0	2873
"H91"	"J86"	"Other and unspecified hearing loss"	"Pyothorax"	1	412	127	539
"H91"	"J90"	"Other and unspecified hearing loss"	"Pleural effusion, not elsewhere classified"	1	2326	0	2326
"H91"	"J93"	"Other and unspecified hearing loss"	"Pneumothorax and air leak"	1	846	245	1091
"H91"	"J96"	"Other and unspecified hearing loss"	"Respiratory failure, not elsewhere classified"	1	8106	0	8106
"H91"	"J98"	"Other and unspecified hearing loss"	"Other respiratory disorders"	1	1181	502	1683
"H91"	"K25"	"Other and unspecified hearing loss"	"Gastric ulcer"	1	4675	2566	7241
"H91"	"K26"	"Other and unspecified hearing loss"	"Duodenal ulcer"	1	2924	1917	4841
"H91"	"K52"	"Other and unspecified hearing loss"	"Other and unsp noninfective gastroenteritis and colitis"	1	3509	1051	4560
"H91"	"K57"	"Other and unspecified hearing loss"	"Diverticular disease of intestine"	1	11831	0	11831
"H91"	"K59"	"Other and unspecified hearing loss"	"Other functional intestinal disorders"	1	14906	0	14906
"H91"	"K64"	"Other and unspecified hearing loss"	"Hemorrhoids and perianal venous thrombosis"	1	1840	0	1840
"H91"	"K65"	"Other and unspecified hearing loss"	"Peritonitis"	1	933	297	1230
"H91"	"K72"	"Other and unspecified hearing loss"	"Hepatic failure, not elsewhere classified"	1	493	65	558
"H91"	"K81"	"Other and unspecified hearing loss"	"Cholecystitis"	1	1384	700	2084
"H91"	"K86"	"Other and unspecified hearing loss"	"Other diseases of pancreas"	1	524	353	877
"H91"	"K92"	"Other and unspecified hearing loss"	"Other diseases of digestive system"	1	7137	0	7137
"H91"	"L08"	"Other and unspecified hearing loss"	"Other local infections of skin and subcutaneous tissue"	1	1407	712	2119
"H91"	"L12"	"Other and unspecified hearing loss"	"Pemphigoid"	1	266	39	305
"H91"	"L28"	"Other and unspecified hearing loss"	"Lichen simplex chronicus and prurigo"	1	299	142	441
"H91"	"L30"	"Other and unspecified hearing loss"	"Other and unspecified dermatitis"	1	1140	625	1765
"H91"	"L82"	"Other and unspecified hearing loss"	"Seborrheic keratosis"	1	522	238	760
"H91"	"M48"	"Other and unspecified hearing loss"	"Other spondylopathies"	1	4351	2205	6556
"H91"	"M81"	"Other and unspecified hearing loss"	"Osteoporosis without current pathological fracture"	1	11331	0	11331
"H91"	"M85"	"Other and unspecified hearing loss"	"Other disorders of bone density and structure"	1	2346	766	3112
"H91"	"N00"	"Other and unspecified hearing loss"	"Acute nephritic syndrome"	1	172	84	256
"H91"	"N10"	"Other and unspecified hearing loss"	"Acute pyelonephritis"	1	1204	536	1740
"H91"	"N12"	"Other and unspecified hearing loss"	"Tubulo-interstitial nephritis, not spcf as acute or chronic"	1	322	85	407
"H91"	"N17"	"Other and unspecified hearing loss"	"Acute kidney failure"	1	2182	0	2182
"H91"	"N25"	"Other and unspecified hearing loss"	"Disorders resulting from impaired renal tubular function"	1	140	34	174
"H91"	"N28"	"Other and unspecified hearing loss"	"Oth disorders of kidney and ureter, not elsewhere classified"	1	1010	87	1097
"H91"	"N30"	"Other and unspecified hearing loss"	"Cystitis"	1	23020	0	23020
"H91"	"N32"	"Other and unspecified hearing loss"	"Other disorders of bladder"	1	659	446	1105
"H91"	"N47"	"Other and unspecified hearing loss"	"Disorders of prepuce"	1	1044	651	1695
"H91"	"Q61"	"Other and unspecified hearing loss"	"Cystic kidney disease"	1	434	132	566
"H93"	"A04"	"Other disorders of ear, not elsewhere classified"	"Other bacterial intestinal infections"	1	309	9	318
"H93"	"A40"	"Other disorders of ear, not elsewhere classified"	"Streptococcal sepsis"	1	120	12	132
"H93"	"A46"	"Other disorders of ear, not elsewhere classified"	"Erysipelas"	1	784	166	950
"H93"	"B37"	"Other disorders of ear, not elsewhere classified"	"Candidiasis"	1	364	62	426
"H93"	"C15"	"Other disorders of ear, not elsewhere classified"	"Malignant neoplasm of esophagus"	1	167	1	168
"H93"	"C16"	"Other disorders of ear, not elsewhere classified"	"Malignant neoplasm of stomach"	1	225	6	231
"H93"	"C18"	"Other disorders of ear, not elsewhere classified"	"Malignant neoplasm of colon"	1	752	105	857
"H93"	"C24"	"Other disorders of ear, not elsewhere classified"	"Malignant neoplasm of other and unsp parts of biliary tract"	1	59	0	59
"H93"	"C25"	"Other disorders of ear, not elsewhere classified"	"Malignant neoplasm of pancreas"	1	260	0	260
"H93"	"C43"	"Other disorders of ear, not elsewhere classified"	"Malignant melanoma of skin"	1	269	118	387
"H93"	"C61"	"Other disorders of ear, not elsewhere classified"	"Malignant neoplasm of prostate"	1	1228	130	1358
"H93"	"C64"	"Other disorders of ear, not elsewhere classified"	"Malignant neoplasm of kidney, except renal pelvis"	1	185	27	212
"H93"	"C76"	"Other disorders of ear, not elsewhere classified"	"Malignant neoplasm of other and ill-defined sites"	1	63	10	73
"H93"	"C78"	"Other disorders of ear, not elsewhere classified"	"Secondary malignant neoplasm of resp and digestive organs"	1	1000	0	1000
"H93"	"C83"	"Other disorders of ear, not elsewhere classified"	"Non-follicular lymphoma"	1	169	33	202
"H93"	"C91"	"Other disorders of ear, not elsewhere classified"	"Lymphoid leukemia"	1	156	42	198
"H93"	"D12"	"Other disorders of ear, not elsewhere classified"	"Benign neoplasm of colon, rectum, anus and anal canal"	1	2254	517	2771
"H93"	"D13"	"Other disorders of ear, not elsewhere classified"	"Benign neoplasm of and ill-defined parts of digestive system"	1	164	51	215
"H93"	"D22"	"Other disorders of ear, not elsewhere classified"	"Melanocytic nevi"	1	261	116	377
"H93"	"D38"	"Other disorders of ear, not elsewhere classified"	"Neoplm of uncrt behav of mid ear & resp and intrathorac org"	1	57	11	68
"H93"	"D61"	"Other disorders of ear, not elsewhere classified"	"Oth aplastic anemias and other bone marrow failure syndromes"	1	77	4	81
"H93"	"D68"	"Other disorders of ear, not elsewhere classified"	"Other coagulation defects"	1	167	67	234
"H93"	"D75"	"Other disorders of ear, not elsewhere classified"	"Other and unsp diseases of blood and blood-forming organs"	1	93	24	117
"H93"	"E03"	"Other disorders of ear, not elsewhere classified"	"Other hypothyroidism"	1	805	258	1063
"H93"	"E10"	"Other disorders of ear, not elsewhere classified"	"Type 1 diabetes mellitus"	1	835	501	1336
"H93"	"E13"	"Other disorders of ear, not elsewhere classified"	"Other specified diabetes mellitus"	1	88	13	101
"H93"	"E27"	"Other disorders of ear, not elsewhere classified"	"Other disorders of adrenal gland"	1	90	16	106
"H93"	"E46"	"Other disorders of ear, not elsewhere classified"	"Unspecified protein-calorie malnutrition"	1	30	0	30
"H93"	"E55"	"Other disorders of ear, not elsewhere classified"	"Vitamin D deficiency"	1	220	0	220
"H93"	"E64"	"Other disorders of ear, not elsewhere classified"	"Sequelae of malnutrition and other nutritional deficiencies"	1	305	40	345
"H93"	"E89"	"Other disorders of ear, not elsewhere classified"	"Postproc endocrine and metabolic comp and disorders, NEC"	1	129	42	171
"H93"	"F02"	"Other disorders of ear, not elsewhere classified"	"Dementia in other diseases classified elsewhere"	1	55	0	55
"H93"	"F03"	"Other disorders of ear, not elsewhere classified"	"Unspecified dementia"	1	1058	0	1058
"H93"	"F05"	"Other disorders of ear, not elsewhere classified"	"Delirium due to known physiological condition"	1	310	0	310
"H93"	"F17"	"Other disorders of ear, not elsewhere classified"	"Nicotine dependence"	1	480	118	598
"H93"	"F33"	"Other disorders of ear, not elsewhere classified"	"Major depressive disorder, recurrent"	1	520	39	559
"H93"	"G12"	"Other disorders of ear, not elsewhere classified"	"Spinal muscular atrophy and related syndromes"	1	60	2	62
"H93"	"G23"	"Other disorders of ear, not elsewhere classified"	"Other degenerative diseases of basal ganglia"	1	35	0	35
"H93"	"G30"	"Other disorders of ear, not elsewhere classified"	"Alzheimer's disease"	1	290	0	290
"H93"	"G31"	"Other disorders of ear, not elsewhere classified"	"Oth degenerative diseases of nervous system, NEC"	1	159	1	160
"H93"	"G45"	"Other disorders of ear, not elsewhere classified"	"Transient cerebral ischemic attacks and related syndromes"	1	1321	537	1858
"H93"	"G47"	"Other disorders of ear, not elsewhere classified"	"Sleep disorders"	1	1360	375	1735
"H93"	"G95"	"Other disorders of ear, not elsewhere classified"	"Other and unspecified diseases of spinal cord"	1	213	10	223
"H93"	"H25"	"Other disorders of ear, not elsewhere classified"	"Age-related cataract"	1	7220	0	7220
"H93"	"H26"	"Other disorders of ear, not elsewhere classified"	"Other cataract"	1	1384	451	1835
"H93"	"H36"	"Other disorders of ear, not elsewhere classified"	"Retinal disorders in diseases classified elsewhere"	1	302	173	475
"H93"	"H40"	"Other disorders of ear, not elsewhere classified"	"Glaucoma"	1	496	257	753
"H93"	"H43"	"Other disorders of ear, not elsewhere classified"	"Disorders of vitreous body"	1	463	211	674
"H93"	"I10"	"Other disorders of ear, not elsewhere classified"	"Essential (primary) hypertension"	1	10074	0	10074
"H93"	"I11"	"Other disorders of ear, not elsewhere classified"	"Hypertensive heart disease"	1	363	35	398
"H93"	"I21"	"Other disorders of ear, not elsewhere classified"	"Acute myocardial infarction"	1	1890	881	2771
"H93"	"I26"	"Other disorders of ear, not elsewhere classified"	"Pulmonary embolism"	1	687	70	757
"H93"	"I27"	"Other disorders of ear, not elsewhere classified"	"Other pulmonary heart diseases"	1	232	16	248
"H93"	"I31"	"Other disorders of ear, not elsewhere classified"	"Other diseases of pericardium"	1	74	19	93
"H93"	"I35"	"Other disorders of ear, not elsewhere classified"	"Nonrheumatic aortic valve disorders"	1	1555	0	1555
"H93"	"I38"	"Other disorders of ear, not elsewhere classified"	"Endocarditis, valve unspecified"	1	47	3	50
"H93"	"I44"	"Other disorders of ear, not elsewhere classified"	"Atrioventricular and left bundle-branch block"	1	586	60	646
"H93"	"I45"	"Other disorders of ear, not elsewhere classified"	"Other conduction disorders"	1	232	89	321
"H93"	"I46"	"Other disorders of ear, not elsewhere classified"	"Cardiac arrest"	1	510	0	510
"H93"	"I48"	"Other disorders of ear, not elsewhere classified"	"Atrial fibrillation and flutter"	1	4705	0	4705
"H93"	"I49"	"Other disorders of ear, not elsewhere classified"	"Other cardiac arrhythmias"	1	1049	311	1360
"H93"	"I50"	"Other disorders of ear, not elsewhere classified"	"Heart failure"	1	3394	0	3394
"H93"	"I61"	"Other disorders of ear, not elsewhere classified"	"Nontraumatic intracerebral hemorrhage"	1	473	59	532
"H93"	"I70"	"Other disorders of ear, not elsewhere classified"	"Atherosclerosis"	1	1139	444	1583
"H93"	"I80"	"Other disorders of ear, not elsewhere classified"	"Phlebitis and thrombophlebitis"	1	905	329	1234
"H93"	"I82"	"Other disorders of ear, not elsewhere classified"	"Other venous embolism and thrombosis"	1	182	38	220
"H93"	"I87"	"Other disorders of ear, not elsewhere classified"	"Other disorders of veins"	1	151	32	183
"H93"	"I89"	"Other disorders of ear, not elsewhere classified"	"Oth noninfective disorders of lymphatic vessels and nodes"	1	158	27	185
"H93"	"I95"	"Other disorders of ear, not elsewhere classified"	"Hypotension"	1	478	3	481
"H93"	"J15"	"Other disorders of ear, not elsewhere classified"	"Bacterial pneumonia, not elsewhere classified"	1	1653	0	1653
"H93"	"J18"	"Other disorders of ear, not elsewhere classified"	"Pneumonia, unspecified organism"	1	5530	0	5530
"H93"	"J44"	"Other disorders of ear, not elsewhere classified"	"Other chronic obstructive pulmonary disease"	1	3596	0	3596
"H93"	"J69"	"Other disorders of ear, not elsewhere classified"	"Pneumonitis due to solids and liquids"	1	174	0	174
"H93"	"J81"	"Other disorders of ear, not elsewhere classified"	"Pulmonary edema"	1	335	1	336
"H93"	"J84"	"Other disorders of ear, not elsewhere classified"	"Other interstitial pulmonary diseases"	1	309	43	352
"H93"	"J85"	"Other disorders of ear, not elsewhere classified"	"Abscess of lung and mediastinum"	1	40	4	44
"H93"	"J86"	"Other disorders of ear, not elsewhere classified"	"Pyothorax"	1	94	19	113
"H93"	"J90"	"Other disorders of ear, not elsewhere classified"	"Pleural effusion, not elsewhere classified"	1	430	0	430
"H93"	"J94"	"Other disorders of ear, not elsewhere classified"	"Other pleural conditions"	1	132	5	137
"H93"	"J96"	"Other disorders of ear, not elsewhere classified"	"Respiratory failure, not elsewhere classified"	1	1363	0	1363
"H93"	"K05"	"Other disorders of ear, not elsewhere classified"	"Gingivitis and periodontal diseases"	1	253	146	399
"H93"	"K08"	"Other disorders of ear, not elsewhere classified"	"Other disorders of teeth and supporting structures"	1	260	129	389
"H93"	"K27"	"Other disorders of ear, not elsewhere classified"	"Peptic ulcer, site unspecified"	1	167	72	239
"H93"	"K52"	"Other disorders of ear, not elsewhere classified"	"Other and unsp noninfective gastroenteritis and colitis"	1	860	245	1105
"H93"	"K55"	"Other disorders of ear, not elsewhere classified"	"Vascular disorders of intestine"	1	175	1	176
"H93"	"K57"	"Other disorders of ear, not elsewhere classified"	"Diverticular disease of intestine"	1	2344	494	2838
"H93"	"K62"	"Other disorders of ear, not elsewhere classified"	"Other diseases of anus and rectum"	1	1291	488	1779
"H93"	"K63"	"Other disorders of ear, not elsewhere classified"	"Other diseases of intestine"	1	278	17	295
"H93"	"K65"	"Other disorders of ear, not elsewhere classified"	"Peritonitis"	1	248	47	295
"H93"	"K70"	"Other disorders of ear, not elsewhere classified"	"Alcoholic liver disease"	1	204	85	289
"H93"	"K74"	"Other disorders of ear, not elsewhere classified"	"Fibrosis and cirrhosis of liver"	1	155	28	183
"H93"	"K76"	"Other disorders of ear, not elsewhere classified"	"Other diseases of liver"	1	312	121	433
"H93"	"K81"	"Other disorders of ear, not elsewhere classified"	"Cholecystitis"	1	285	126	411
"H93"	"K83"	"Other disorders of ear, not elsewhere classified"	"Other diseases of biliary tract"	1	273	31	304
"H93"	"K85"	"Other disorders of ear, not elsewhere classified"	"Acute pancreatitis"	1	294	133	427
"H93"	"K86"	"Other disorders of ear, not elsewhere classified"	"Other diseases of pancreas"	1	168	66	234
"H93"	"K91"	"Other disorders of ear, not elsewhere classified"	"Intraop and postproc comp and disorders of dgstv sys, NEC"	1	123	38	161
"H93"	"K92"	"Other disorders of ear, not elsewhere classified"	"Other diseases of digestive system"	1	1064	152	1216
"H93"	"L97"	"Other disorders of ear, not elsewhere classified"	"Non-pressure chronic ulcer of lower limb, NEC"	1	450	16	466
"H93"	"M10"	"Other disorders of ear, not elsewhere classified"	"Gout"	1	510	126	636
"H93"	"M13"	"Other disorders of ear, not elsewhere classified"	"Other arthritis"	1	338	138	476
"H93"	"M15"	"Other disorders of ear, not elsewhere classified"	"Polyosteoarthritis"	1	281	152	433
"H93"	"M17"	"Other disorders of ear, not elsewhere classified"	"Osteoarthritis of knee"	1	2285	1523	3808
"H93"	"M31"	"Other disorders of ear, not elsewhere classified"	"Other necrotizing vasculopathies"	1	235	90	325
"H93"	"M35"	"Other disorders of ear, not elsewhere classified"	"Other systemic involvement of connective tissue"	1	516	298	814
"H93"	"M48"	"Other disorders of ear, not elsewhere classified"	"Other spondylopathies"	1	1391	358	1749
"H93"	"M80"	"Other disorders of ear, not elsewhere classified"	"Osteoporosis with current pathological fracture"	1	917	5	922
"H93"	"M85"	"Other disorders of ear, not elsewhere classified"	"Other disorders of bone density and structure"	1	871	119	990
"H93"	"M99"	"Other disorders of ear, not elsewhere classified"	"Biomechanical lesions, not elsewhere classified"	1	262	124	386
"H93"	"N10"	"Other disorders of ear, not elsewhere classified"	"Acute pyelonephritis"	1	265	117	382
"H93"	"N18"	"Other disorders of ear, not elsewhere classified"	"Chronic kidney disease (CKD)"	1	1019	0	1019
"H93"	"N30"	"Other disorders of ear, not elsewhere classified"	"Cystitis"	1	3667	0	3667
"H93"	"N39"	"Other disorders of ear, not elsewhere classified"	"Other disorders of urinary system"	1	2849	0	2849
"H94"	"C18"	"Other disorders of ear in diseases classified elsewhere"	"Malignant neoplasm of colon"	1	44	0	44
"H94"	"C34"	"Other disorders of ear in diseases classified elsewhere"	"Malignant neoplasm of bronchus and lung"	1	72	0	72
"H94"	"C78"	"Other disorders of ear in diseases classified elsewhere"	"Secondary malignant neoplasm of resp and digestive organs"	1	66	0	66
"H94"	"C79"	"Other disorders of ear in diseases classified elsewhere"	"Secondary malignant neoplasm of other and unspecified sites"	1	37	0	37
"H94"	"I10"	"Other disorders of ear in diseases classified elsewhere"	"Essential (primary) hypertension"	1	414	42	456
"H94"	"I20"	"Other disorders of ear in diseases classified elsewhere"	"Angina pectoris"	1	159	78	237
"H94"	"I48"	"Other disorders of ear in diseases classified elsewhere"	"Atrial fibrillation and flutter"	1	249	22	271
"H94"	"I70"	"Other disorders of ear in diseases classified elsewhere"	"Atherosclerosis"	1	87	21	108
"H94"	"I73"	"Other disorders of ear in diseases classified elsewhere"	"Other peripheral vascular diseases"	1	33	0	33
"H94"	"M48"	"Other disorders of ear in diseases classified elsewhere"	"Other spondylopathies"	1	57	3	60
"I05"	"C34"	"Rheumatic mitral valve diseases"	"Malignant neoplasm of bronchus and lung"	1	53	6	59
"I05"	"D68"	"Rheumatic mitral valve diseases"	"Other coagulation defects"	1	77	17	94
"I05"	"J96"	"Rheumatic mitral valve diseases"	"Respiratory failure, not elsewhere classified"	1	178	55	233
"I05"	"N17"	"Rheumatic mitral valve diseases"	"Acute kidney failure"	1	93	27	120
"I06"	"I46"	"Rheumatic aortic valve diseases"	"Cardiac arrest"	1	80	20	100
"I06"	"N18"	"Rheumatic aortic valve diseases"	"Chronic kidney disease (CKD)"	1	118	52	170
"I10"	"A04"	"Essential (primary) hypertension"	"Other bacterial intestinal infections"	1	6781	0	6781
"I10"	"A09"	"Essential (primary) hypertension"	"Infectious gastroenteritis and colitis, unspecified"	1	8951	7382	16333
"I10"	"A46"	"Essential (primary) hypertension"	"Erysipelas"	1	9691	6225	15916
"I10"	"B59"	"Essential (primary) hypertension"	"Pneumocystosis"	1	179	29	208
"I10"	"C14"	"Essential (primary) hypertension"	"Malig neoplasm of sites in the lip, oral cavity and pharynx"	1	206	51	257
"I10"	"C15"	"Essential (primary) hypertension"	"Malignant neoplasm of esophagus"	1	1498	538	2036
"I10"	"C16"	"Essential (primary) hypertension"	"Malignant neoplasm of stomach"	1	1847	693	2540
"I10"	"C25"	"Essential (primary) hypertension"	"Malignant neoplasm of pancreas"	1	4183	0	4183
"I10"	"C38"	"Essential (primary) hypertension"	"Malignant neoplasm of heart, mediastinum and pleura"	1	246	82	328
"I10"	"C45"	"Essential (primary) hypertension"	"Mesothelioma"	1	350	66	416
"I10"	"C61"	"Essential (primary) hypertension"	"Malignant neoplasm of prostate"	1	5834	3474	9308
"I10"	"C65"	"Essential (primary) hypertension"	"Malignant neoplasm of renal pelvis"	1	416	229	645
"I10"	"C67"	"Essential (primary) hypertension"	"Malignant neoplasm of bladder"	1	1959	1637	3596
"I10"	"C71"	"Essential (primary) hypertension"	"Malignant neoplasm of brain"	1	1443	758	2201
"I10"	"C78"	"Essential (primary) hypertension"	"Secondary malignant neoplasm of resp and digestive organs"	1	14525	0	14525
"I10"	"C80"	"Essential (primary) hypertension"	"Malignant neoplasm without specification of site"	1	1624	223	1847
"I10"	"C83"	"Essential (primary) hypertension"	"Non-follicular lymphoma"	1	1393	565	1958
"I10"	"C86"	"Essential (primary) hypertension"	"Other specified types of T/NK-cell lymphoma"	1	46	3	49
"I10"	"C88"	"Essential (primary) hypertension"	"Malig immunoproliferative dis and certain oth B-cell lymph"	1	389	135	524
"I10"	"C90"	"Essential (primary) hypertension"	"Multiple myeloma and malignant plasma cell neoplasms"	1	1118	451	1569
"I10"	"C93"	"Essential (primary) hypertension"	"Monocytic leukemia"	1	169	19	188
"I10"	"C95"	"Essential (primary) hypertension"	"Leukemia of unspecified cell type"	1	301	136	437
"I10"	"D09"	"Essential (primary) hypertension"	"Carcinoma in situ of other and unspecified sites"	1	1087	167	1254
"I10"	"D35"	"Essential (primary) hypertension"	"Benign neoplasm of other and unspecified endocrine glands"	1	1902	893	2795
"I10"	"D38"	"Essential (primary) hypertension"	"Neoplm of uncrt behav of mid ear & resp and intrathorac org"	1	535	307	842
"I10"	"D44"	"Essential (primary) hypertension"	"Neoplasm of uncertain behavior of endocrine glands"	1	295	136	431
"I10"	"D50"	"Essential (primary) hypertension"	"Iron deficiency anemia"	1	14316	0	14316
"I10"	"D59"	"Essential (primary) hypertension"	"Acquired hemolytic anemia"	1	497	302	799
"I10"	"D62"	"Essential (primary) hypertension"	"Acute posthemorrhagic anemia"	1	5496	2325	7821
"I10"	"D64"	"Essential (primary) hypertension"	"Other anemias"	1	46015	0	46015
"I10"	"D68"	"Essential (primary) hypertension"	"Other coagulation defects"	1	2816	1329	4145
"I10"	"D69"	"Essential (primary) hypertension"	"Purpura and other hemorrhagic conditions"	1	2373	1289	3662
"I10"	"D70"	"Essential (primary) hypertension"	"Neutropenia"	1	321	163	484
"I10"	"D72"	"Essential (primary) hypertension"	"Other disorders of white blood cells"	1	775	387	1162
"I10"	"E13"	"Essential (primary) hypertension"	"Other specified diabetes mellitus"	1	2165	974	3139
"I10"	"E16"	"Essential (primary) hypertension"	"Other disorders of pancreatic internal secretion"	1	4423	2930	7353
"I10"	"E25"	"Essential (primary) hypertension"	"Adrenogenital disorders"	1	750	135	885
"I10"	"E35"	"Essential (primary) hypertension"	"Disorders of endocrine glands in diseases classd elswhr"	1	302	85	387
"I10"	"E41"	"Essential (primary) hypertension"	"Nutritional marasmus"	1	1045	85	1130
"I10"	"E55"	"Essential (primary) hypertension"	"Vitamin D deficiency"	1	4924	2478	7402
"I10"	"E68"	"Essential (primary) hypertension"	"Sequelae of hyperalimentation"	1	862	408	1270
"I10"	"E86"	"Essential (primary) hypertension"	"Volume depletion"	1	50884	0	50884
"I10"	"F03"	"Essential (primary) hypertension"	"Unspecified dementia"	1	21618	0	21618
"I10"	"F04"	"Essential (primary) hypertension"	"Amnestic disorder due to known physiological condition"	1	189	101	290
"I10"	"F05"	"Essential (primary) hypertension"	"Delirium due to known physiological condition"	1	9367	0	9367
"I10"	"F32"	"Essential (primary) hypertension"	"Depressive episode"	1	12920	10212	23132
"I10"	"F33"	"Essential (primary) hypertension"	"Major depressive disorder, recurrent"	1	7633	4534	12167
"I10"	"G23"	"Essential (primary) hypertension"	"Other degenerative diseases of basal ganglia"	1	422	59	481
"I10"	"G25"	"Essential (primary) hypertension"	"Other extrapyramidal and movement disorders"	1	1511	941	2452
"I10"	"G47"	"Essential (primary) hypertension"	"Sleep disorders"	1	17442	0	17442
"I10"	"G62"	"Essential (primary) hypertension"	"Other and unspecified polyneuropathies"	1	4876	3078	7954
"I10"	"G63"	"Essential (primary) hypertension"	"Polyneuropathy in diseases classified elsewhere"	1	1328	509	1837
"I10"	"G81"	"Essential (primary) hypertension"	"Hemiplegia and hemiparesis"	1	924	555	1479
"I10"	"G95"	"Essential (primary) hypertension"	"Other and unspecified diseases of spinal cord"	1	2130	680	2810
"I10"	"G98"	"Essential (primary) hypertension"	"Other disorders of nervous system not elsewhere classified"	1	1956	601	2557
"I10"	"H36"	"Essential (primary) hypertension"	"Retinal disorders in diseases classified elsewhere"	1	5572	4586	10158
"I10"	"H53"	"Essential (primary) hypertension"	"Visual disturbances"	1	3669	2974	6643
"I10"	"H54"	"Essential (primary) hypertension"	"Blindness and low vision"	1	2543	1788	4331
"I10"	"H82"	"Essential (primary) hypertension"	"Vertiginous syndromes in diseases classified elsewhere"	1	465	305	770
"I10"	"I24"	"Essential (primary) hypertension"	"Other acute ischemic heart diseases"	1	2549	2102	4651
"I10"	"I27"	"Essential (primary) hypertension"	"Other pulmonary heart diseases"	1	3975	1708	5683
"I10"	"I34"	"Essential (primary) hypertension"	"Nonrheumatic mitral valve disorders"	1	5969	4960	10929
"I10"	"I35"	"Essential (primary) hypertension"	"Nonrheumatic aortic valve disorders"	1	20477	13902	34379
"I10"	"I38"	"Essential (primary) hypertension"	"Endocarditis, valve unspecified"	1	919	277	1196
"I10"	"I44"	"Essential (primary) hypertension"	"Atrioventricular and left bundle-branch block"	1	8974	5570	14544
"I10"	"I50"	"Essential (primary) hypertension"	"Heart failure"	1	70876	0	70876
"I10"	"I51"	"Essential (primary) hypertension"	"Complications and ill-defined descriptions of heart disease"	1	5011	2078	7089
"I10"	"I67"	"Essential (primary) hypertension"	"Other cerebrovascular diseases"	1	3276	2670	5946
"I10"	"I71"	"Essential (primary) hypertension"	"Aortic aneurysm and dissection"	1	8808	6002	14810
"I10"	"I72"	"Essential (primary) hypertension"	"Other aneurysm"	1	2055	1119	3174
"I10"	"I74"	"Essential (primary) hypertension"	"Arterial embolism and thrombosis"	1	2323	1505	3828
"I10"	"I79"	"Essential (primary) hypertension"	"Disord of art, arterioles and capilare in dis classd elswhr"	1	168	78	246
"I10"	"I95"	"Essential (primary) hypertension"	"Hypotension"	1	12931	0	12931
"I10"	"J13"	"Essential (primary) hypertension"	"Pneumonia due to Streptococcus pneumoniae"	1	1214	917	2131
"I10"	"J14"	"Essential (primary) hypertension"	"Pneumonia due to Hemophilus influenzae"	1	717	374	1091
"I10"	"J16"	"Essential (primary) hypertension"	"Pneumonia due to oth infectious organisms, NEC"	1	445	278	723
"I10"	"J18"	"Essential (primary) hypertension"	"Pneumonia, unspecified organism"	1	86772	0	86772
"I10"	"J47"	"Essential (primary) hypertension"	"Bronchiectasis"	1	993	409	1402
"I10"	"J85"	"Essential (primary) hypertension"	"Abscess of lung and mediastinum"	1	422	245	667
"I10"	"J90"	"Essential (primary) hypertension"	"Pleural effusion, not elsewhere classified"	1	7933	0	7933
"I10"	"J94"	"Essential (primary) hypertension"	"Other pleural conditions"	1	1831	688	2519
"I10"	"J98"	"Essential (primary) hypertension"	"Other respiratory disorders"	1	3147	1989	5136
"I10"	"K22"	"Essential (primary) hypertension"	"Other diseases of esophagus"	1	3746	2665	6411
"I10"	"K55"	"Essential (primary) hypertension"	"Vascular disorders of intestine"	1	2813	770	3583
"I10"	"K57"	"Essential (primary) hypertension"	"Diverticular disease of intestine"	1	17477	13392	30869
"I10"	"K63"	"Essential (primary) hypertension"	"Other diseases of intestine"	1	3741	1254	4995
"I10"	"K64"	"Essential (primary) hypertension"	"Hemorrhoids and perianal venous thrombosis"	1	6529	0	6529
"I10"	"K65"	"Essential (primary) hypertension"	"Peritonitis"	1	3613	1959	5572
"I10"	"K72"	"Essential (primary) hypertension"	"Hepatic failure, not elsewhere classified"	1	1721	473	2194
"I10"	"K74"	"Essential (primary) hypertension"	"Fibrosis and cirrhosis of liver"	1	1820	834	2654
"I10"	"L97"	"Essential (primary) hypertension"	"Non-pressure chronic ulcer of lower limb, NEC"	1	9594	0	9594
"I10"	"M10"	"Essential (primary) hypertension"	"Gout"	1	8524	4992	13516
"I10"	"N08"	"Essential (primary) hypertension"	"Glomerular disorders in diseases classified elsewhere"	1	604	132	736
"I10"	"N10"	"Essential (primary) hypertension"	"Acute pyelonephritis"	1	2952	2368	5320
"I10"	"N13"	"Essential (primary) hypertension"	"Obstructive and reflux uropathy"	1	4622	2959	7581
"I10"	"N15"	"Essential (primary) hypertension"	"Other renal tubulo-interstitial diseases"	1	626	362	988
"I10"	"N16"	"Essential (primary) hypertension"	"Renal tubulo-interstitial disord in diseases classd elswhr"	1	339	106	445
"I10"	"N17"	"Essential (primary) hypertension"	"Acute kidney failure"	1	12726	0	12726
"I10"	"N19"	"Essential (primary) hypertension"	"Unspecified kidney failure"	1	14709	0	14709
"I10"	"N25"	"Essential (primary) hypertension"	"Disorders resulting from impaired renal tubular function"	1	699	256	955
"I10"	"N30"	"Essential (primary) hypertension"	"Cystitis"	1	60966	0	60966
"I10"	"N39"	"Essential (primary) hypertension"	"Other disorders of urinary system"	1	50767	0	50767
"I10"	"Q61"	"Essential (primary) hypertension"	"Cystic kidney disease"	1	1511	897	2408
"I11"	"A41"	"Hypertensive heart disease"	"Other sepsis"	1	1717	997	2714
"I11"	"C78"	"Hypertensive heart disease"	"Secondary malignant neoplasm of resp and digestive organs"	1	421	164	585
"I11"	"C79"	"Hypertensive heart disease"	"Secondary malignant neoplasm of other and unspecified sites"	1	252	98	350
"I11"	"E86"	"Hypertensive heart disease"	"Volume depletion"	1	2174	1220	3394
"I11"	"E87"	"Hypertensive heart disease"	"Other disorders of fluid, electrolyte and acid-base balance"	1	1216	939	2155
"I11"	"J15"	"Hypertensive heart disease"	"Bacterial pneumonia, not elsewhere classified"	1	1338	1079	2417
"I11"	"L89"	"Hypertensive heart disease"	"Pressure ulcer"	1	318	160	478
"I11"	"L97"	"Hypertensive heart disease"	"Non-pressure chronic ulcer of lower limb, NEC"	1	508	345	853
"I11"	"N18"	"Hypertensive heart disease"	"Chronic kidney disease (CKD)"	1	1587	860	2447
"I11"	"N28"	"Hypertensive heart disease"	"Oth disorders of kidney and ureter, not elsewhere classified"	1	341	186	527
"I12"	"A04"	"Hypertensive chronic kidney disease"	"Other bacterial intestinal infections"	1	160	39	199
"I12"	"A09"	"Hypertensive chronic kidney disease"	"Infectious gastroenteritis and colitis, unspecified"	1	297	153	450
"I12"	"C44"	"Hypertensive chronic kidney disease"	"Other and unspecified malignant neoplasm of skin"	1	140	52	192
"I12"	"C78"	"Hypertensive chronic kidney disease"	"Secondary malignant neoplasm of resp and digestive organs"	1	75	14	89
"I12"	"C79"	"Hypertensive chronic kidney disease"	"Secondary malignant neoplasm of other and unspecified sites"	1	59	7	66
"I12"	"E13"	"Hypertensive chronic kidney disease"	"Other specified diabetes mellitus"	1	53	13	66
"I12"	"E86"	"Hypertensive chronic kidney disease"	"Volume depletion"	1	507	338	845
"I12"	"I46"	"Hypertensive chronic kidney disease"	"Cardiac arrest"	1	210	23	233
"I12"	"I95"	"Hypertensive chronic kidney disease"	"Hypotension"	1	184	78	262
"I12"	"J18"	"Hypertensive chronic kidney disease"	"Pneumonia, unspecified organism"	1	987	666	1653
"I12"	"J90"	"Hypertensive chronic kidney disease"	"Pleural effusion, not elsewhere classified"	1	120	49	169
"I12"	"J96"	"Hypertensive chronic kidney disease"	"Respiratory failure, not elsewhere classified"	1	378	141	519
"I12"	"K03"	"Hypertensive chronic kidney disease"	"Other diseases of hard tissues of teeth"	1	44	8	52
"I12"	"K52"	"Hypertensive chronic kidney disease"	"Other and unsp noninfective gastroenteritis and colitis"	1	195	100	295
"I12"	"K92"	"Hypertensive chronic kidney disease"	"Other diseases of digestive system"	1	274	118	392
"I12"	"L82"	"Hypertensive chronic kidney disease"	"Seborrheic keratosis"	1	44	0	44
"I12"	"L89"	"Hypertensive chronic kidney disease"	"Pressure ulcer"	1	96	22	118
"I12"	"L97"	"Hypertensive chronic kidney disease"	"Non-pressure chronic ulcer of lower limb, NEC"	1	193	64	257
"I12"	"L98"	"Hypertensive chronic kidney disease"	"Oth disorders of skin, subcu, not elsewhere classified"	1	106	30	136
"I15"	"A04"	"Secondary hypertension"	"Other bacterial intestinal infections"	1	338	112	450
"I15"	"A41"	"Secondary hypertension"	"Other sepsis"	1	1656	679	2335
"I15"	"B07"	"Secondary hypertension"	"Viral warts"	1	105	26	131
"I15"	"C22"	"Secondary hypertension"	"Malignant neoplasm of liver and intrahepatic bile ducts"	1	46	7	53
"I15"	"C34"	"Secondary hypertension"	"Malignant neoplasm of bronchus and lung"	1	403	111	514
"I15"	"C77"	"Secondary hypertension"	"Secondary and unspecified malignant neoplasm of lymph nodes"	1	166	61	227
"I15"	"C79"	"Secondary hypertension"	"Secondary malignant neoplasm of other and unspecified sites"	1	228	54	282
"I15"	"E83"	"Secondary hypertension"	"Disorders of mineral metabolism"	1	221	113	334
"I15"	"E86"	"Secondary hypertension"	"Volume depletion"	1	1419	761	2180
"I15"	"E87"	"Secondary hypertension"	"Other disorders of fluid, electrolyte and acid-base balance"	1	1086	839	1925
"I15"	"I46"	"Secondary hypertension"	"Cardiac arrest"	1	471	73	544
"I15"	"J10"	"Secondary hypertension"	"Influenza due to other identified influenza virus"	1	53	6	59
"I15"	"J15"	"Secondary hypertension"	"Bacterial pneumonia, not elsewhere classified"	1	1120	572	1692
"I15"	"J90"	"Secondary hypertension"	"Pleural effusion, not elsewhere classified"	1	315	120	435
"I15"	"K59"	"Secondary hypertension"	"Other functional intestinal disorders"	1	1073	668	1741
"I15"	"L57"	"Secondary hypertension"	"Skin changes due to chronic expsr to nonionizing radiation"	1	165	13	178
"I15"	"L89"	"Secondary hypertension"	"Pressure ulcer"	1	253	93	346
"I20"	"A04"	"Angina pectoris"	"Other bacterial intestinal infections"	1	1627	0	1627
"I20"	"A40"	"Angina pectoris"	"Streptococcal sepsis"	1	519	51	570
"I20"	"A48"	"Angina pectoris"	"Other bacterial diseases, not elsewhere classified"	1	174	53	227
"I20"	"A49"	"Angina pectoris"	"Bacterial infection of unspecified site"	1	3616	0	3616
"I20"	"B95"	"Angina pectoris"	"Strep as the cause of diseases classified elsewhere"	1	201	6	207
"I20"	"C02"	"Angina pectoris"	"Malignant neoplasm of other and unspecified parts of tongue"	1	83	19	102
"I20"	"C04"	"Angina pectoris"	"Malignant neoplasm of floor of mouth"	1	60	8	68
"I20"	"C09"	"Angina pectoris"	"Malignant neoplasm of tonsil"	1	113	24	137
"I20"	"C14"	"Angina pectoris"	"Malig neoplasm of sites in the lip, oral cavity and pharynx"	1	55	0	55
"I20"	"C16"	"Angina pectoris"	"Malignant neoplasm of stomach"	1	877	60	937
"I20"	"C20"	"Angina pectoris"	"Malignant neoplasm of rectum"	1	1097	378	1475
"I20"	"C21"	"Angina pectoris"	"Malignant neoplasm of anus and anal canal"	1	101	30	131
"I20"	"C22"	"Angina pectoris"	"Malignant neoplasm of liver and intrahepatic bile ducts"	1	503	0	503
"I20"	"C23"	"Angina pectoris"	"Malignant neoplasm of gallbladder"	1	71	0	71
"I20"	"C25"	"Angina pectoris"	"Malignant neoplasm of pancreas"	1	1053	0	1053
"I20"	"C32"	"Angina pectoris"	"Malignant neoplasm of larynx"	1	204	105	309
"I20"	"C34"	"Angina pectoris"	"Malignant neoplasm of bronchus and lung"	1	5475	0	5475
"I20"	"C38"	"Angina pectoris"	"Malignant neoplasm of heart, mediastinum and pleura"	1	128	13	141
"I20"	"C41"	"Angina pectoris"	"Malignant neoplasm of bone/artic cartl of and unsp sites"	1	101	15	116
"I20"	"C44"	"Angina pectoris"	"Other and unspecified malignant neoplasm of skin"	1	3972	0	3972
"I20"	"C45"	"Angina pectoris"	"Mesothelioma"	1	149	0	149
"I20"	"C48"	"Angina pectoris"	"Malignant neoplasm of retroperitoneum and peritoneum"	1	74	3	77
"I20"	"C49"	"Angina pectoris"	"Malignant neoplasm of other connective and soft tissue"	1	180	34	214
"I20"	"C50"	"Angina pectoris"	"Malignant neoplasm of breast"	1	1548	1253	2801
"I20"	"C56"	"Angina pectoris"	"Malignant neoplasm of ovary"	1	302	125	427
"I20"	"C60"	"Angina pectoris"	"Malignant neoplasm of penis"	1	58	10	68
"I20"	"C64"	"Angina pectoris"	"Malignant neoplasm of kidney, except renal pelvis"	1	788	113	901
"I20"	"C65"	"Angina pectoris"	"Malignant neoplasm of renal pelvis"	1	174	55	229
"I20"	"C71"	"Angina pectoris"	"Malignant neoplasm of brain"	1	514	14	528
"I20"	"C78"	"Angina pectoris"	"Secondary malignant neoplasm of resp and digestive organs"	1	3704	0	3704
"I20"	"C80"	"Angina pectoris"	"Malignant neoplasm without specification of site"	1	412	0	412
"I20"	"C82"	"Angina pectoris"	"Follicular lymphoma"	1	149	55	204
"I20"	"D04"	"Angina pectoris"	"Carcinoma in situ of skin"	1	195	19	214
"I20"	"D09"	"Angina pectoris"	"Carcinoma in situ of other and unspecified sites"	1	444	0	444
"I20"	"D10"	"Angina pectoris"	"Benign neoplasm of mouth and pharynx"	1	441	221	662
"I20"	"D14"	"Angina pectoris"	"Benign neoplasm of middle ear and respiratory system"	1	577	365	942
"I20"	"D18"	"Angina pectoris"	"Hemangioma and lymphangioma, any site"	1	264	115	379
"I20"	"D22"	"Angina pectoris"	"Melanocytic nevi"	1	478	156	634
"I20"	"D30"	"Angina pectoris"	"Benign neoplasm of urinary organs"	1	1071	711	1782
"I20"	"D32"	"Angina pectoris"	"Benign neoplasm of meninges"	1	321	65	386
"I20"	"D38"	"Angina pectoris"	"Neoplm of uncrt behav of mid ear & resp and intrathorac org"	1	315	78	393
"I20"	"D45"	"Angina pectoris"	"Polycythemia vera"	1	205	105	310
"I20"	"D46"	"Angina pectoris"	"Myelodysplastic syndromes"	1	520	42	562
"I20"	"D47"	"Angina pectoris"	"Oth neoplm of uncrt behav of lymphoid, hematpoetc & rel tiss"	1	792	65	857
"I20"	"D50"	"Angina pectoris"	"Iron deficiency anemia"	1	5470	0	5470
"I20"	"D53"	"Angina pectoris"	"Other nutritional anemias"	1	184	26	210
"I20"	"D64"	"Angina pectoris"	"Other anemias"	1	16222	0	16222
"I20"	"D65"	"Angina pectoris"	"Disseminated intravascular coagulation"	1	97	11	108
"I20"	"D68"	"Angina pectoris"	"Other coagulation defects"	1	1196	267	1463
"I20"	"D70"	"Angina pectoris"	"Neutropenia"	1	141	24	165
"I20"	"E03"	"Angina pectoris"	"Other hypothyroidism"	1	3581	1673	5254
"I20"	"E10"	"Angina pectoris"	"Type 1 diabetes mellitus"	1	6168	4658	10826
"I20"	"E15"	"Angina pectoris"	"Nondiabetic hypoglycemic coma"	1	188	77	265
"I20"	"E16"	"Angina pectoris"	"Other disorders of pancreatic internal secretion"	1	1787	448	2235
"I20"	"E25"	"Angina pectoris"	"Adrenogenital disorders"	1	664	0	664
"I20"	"E46"	"Angina pectoris"	"Unspecified protein-calorie malnutrition"	1	137	2	139
"I20"	"E50"	"Angina pectoris"	"Vitamin A deficiency"	1	383	32	415
"I20"	"E53"	"Angina pectoris"	"Deficiency of other B group vitamins"	1	476	36	512
"I20"	"E63"	"Angina pectoris"	"Other nutritional deficiencies"	1	152	2	154
"I20"	"E64"	"Angina pectoris"	"Sequelae of malnutrition and other nutritional deficiencies"	1	765	26	791
"I20"	"E66"	"Angina pectoris"	"Overweight and obesity"	1	8295	5837	14132
"I20"	"E78"	"Angina pectoris"	"Disorders of lipoprotein metabolism and other lipidemias"	1	81987	0	81987
"I20"	"E79"	"Angina pectoris"	"Disorders of purine and pyrimidine metabolism"	1	84	22	106
"I20"	"E83"	"Angina pectoris"	"Disorders of mineral metabolism"	1	951	22	973
"I20"	"E85"	"Angina pectoris"	"Amyloidosis"	1	112	22	134
"I20"	"E86"	"Angina pectoris"	"Volume depletion"	1	11712	0	11712
"I20"	"E87"	"Angina pectoris"	"Other disorders of fluid, electrolyte and acid-base balance"	1	7067	0	7067
"I20"	"F02"	"Angina pectoris"	"Dementia in other diseases classified elsewhere"	1	284	3	287
"I20"	"F03"	"Angina pectoris"	"Unspecified dementia"	1	4453	0	4453
"I20"	"F06"	"Angina pectoris"	"Other mental disorders due to known physiological condition"	1	640	0	640
"I20"	"F22"	"Angina pectoris"	"Delusional disorders"	1	143	49	192
"I20"	"F31"	"Angina pectoris"	"Bipolar disorder"	1	293	174	467
"I20"	"F43"	"Angina pectoris"	"Reaction to severe stress, and adjustment disorders"	1	857	455	1312
"I20"	"G00"	"Angina pectoris"	"Bacterial meningitis, not elsewhere classified"	1	119	49	168
"I20"	"G21"	"Angina pectoris"	"Secondary parkinsonism"	1	235	28	263
"I20"	"G25"	"Angina pectoris"	"Other extrapyramidal and movement disorders"	1	613	100	713
"I20"	"G31"	"Angina pectoris"	"Oth degenerative diseases of nervous system, NEC"	1	466	6	472
"I20"	"G40"	"Angina pectoris"	"Epilepsy and recurrent seizures"	1	2119	1216	3335
"I20"	"G47"	"Angina pectoris"	"Sleep disorders"	1	5604	0	5604
"I20"	"G62"	"Angina pectoris"	"Other and unspecified polyneuropathies"	1	2119	517	2636
"I20"	"G91"	"Angina pectoris"	"Hydrocephalus"	1	363	25	388
"I20"	"G94"	"Angina pectoris"	"Other disorders of brain in diseases classified elsewhere"	1	68	13	81
"I20"	"G98"	"Angina pectoris"	"Other disorders of nervous system not elsewhere classified"	1	497	6	503
"I20"	"H34"	"Angina pectoris"	"Retinal vascular occlusions"	1	1009	363	1372
"I20"	"H35"	"Angina pectoris"	"Other retinal disorders"	1	7973	0	7973
"I20"	"H81"	"Angina pectoris"	"Disorders of vestibular function"	1	2688	1971	4659
"I20"	"I08"	"Angina pectoris"	"Multiple valve diseases"	1	288	76	364
"I20"	"I11"	"Angina pectoris"	"Hypertensive heart disease"	1	5345	0	5345
"I20"	"I12"	"Angina pectoris"	"Hypertensive chronic kidney disease"	1	606	405	1011
"I20"	"I15"	"Angina pectoris"	"Secondary hypertension"	1	2020	999	3019
"I20"	"I24"	"Angina pectoris"	"Other acute ischemic heart diseases"	1	4218	1919	6137
"I20"	"I28"	"Angina pectoris"	"Other diseases of pulmonary vessels"	1	130	25	155
"I20"	"I31"	"Angina pectoris"	"Other diseases of pericardium"	1	1199	361	1560
"I20"	"I35"	"Angina pectoris"	"Nonrheumatic aortic valve disorders"	1	9514	5798	15312
"I20"	"I36"	"Angina pectoris"	"Nonrheumatic tricuspid valve disorders"	1	388	134	522
"I20"	"I46"	"Angina pectoris"	"Cardiac arrest"	1	4924	0	4924
"I20"	"I48"	"Angina pectoris"	"Atrial fibrillation and flutter"	1	38031	0	38031
"I20"	"I51"	"Angina pectoris"	"Complications and ill-defined descriptions of heart disease"	1	4237	0	4237
"I20"	"I60"	"Angina pectoris"	"Nontraumatic subarachnoid hemorrhage"	1	476	225	701
"I20"	"I61"	"Angina pectoris"	"Nontraumatic intracerebral hemorrhage"	1	2265	0	2265
"I20"	"I66"	"Angina pectoris"	"Occls and stenosis of cereb art, not rslt in cerebral infrc"	1	202	89	291
"I20"	"I71"	"Angina pectoris"	"Aortic aneurysm and dissection"	1	5484	0	5484
"I20"	"I74"	"Angina pectoris"	"Arterial embolism and thrombosis"	1	1297	443	1740
"I20"	"I79"	"Angina pectoris"	"Disord of art, arterioles and capilare in dis classd elswhr"	1	99	16	115
"I20"	"I80"	"Angina pectoris"	"Phlebitis and thrombophlebitis"	1	3564	1738	5302
"I20"	"I85"	"Angina pectoris"	"Esophageal varices"	1	432	81	513
"I20"	"I87"	"Angina pectoris"	"Other disorders of veins"	1	618	130	748
"I20"	"I89"	"Angina pectoris"	"Oth noninfective disorders of lymphatic vessels and nodes"	1	444	100	544
"I20"	"I95"	"Angina pectoris"	"Hypotension"	1	4472	0	4472
"I20"	"I99"	"Angina pectoris"	"Other and unspecified disorders of circulatory system"	1	1173	513	1686
"I20"	"J18"	"Angina pectoris"	"Pneumonia, unspecified organism"	1	33219	0	33219
"I20"	"J22"	"Angina pectoris"	"Unspecified acute lower respiratory infection"	1	1504	0	1504
"I20"	"J40"	"Angina pectoris"	"Bronchitis, not specified as acute or chronic"	1	407	248	655
"I20"	"J43"	"Angina pectoris"	"Emphysema"	1	1393	728	2121
"I20"	"J44"	"Angina pectoris"	"Other chronic obstructive pulmonary disease"	1	23126	0	23126
"I20"	"J47"	"Angina pectoris"	"Bronchiectasis"	1	532	103	635
"I20"	"J69"	"Angina pectoris"	"Pneumonitis due to solids and liquids"	1	714	0	714
"I20"	"J85"	"Angina pectoris"	"Abscess of lung and mediastinum"	1	217	44	261
"I20"	"J86"	"Angina pectoris"	"Pyothorax"	1	449	118	567
"I20"	"J90"	"Angina pectoris"	"Pleural effusion, not elsewhere classified"	1	3949	0	3949
"I20"	"J91"	"Angina pectoris"	"Pleural effusion in conditions classified elsewhere"	1	1375	122	1497
"I20"	"J92"	"Angina pectoris"	"Pleural plaque"	1	413	149	562
"I20"	"J93"	"Angina pectoris"	"Pneumothorax and air leak"	1	1055	313	1368
"I20"	"J95"	"Angina pectoris"	"Intraop and postproc comp and disorders of resp sys, NEC"	1	539	43	582
"I20"	"J96"	"Angina pectoris"	"Respiratory failure, not elsewhere classified"	1	9473	0	9473
"I20"	"J98"	"Angina pectoris"	"Other respiratory disorders"	1	1814	552	2366
"I20"	"K02"	"Angina pectoris"	"Dental caries"	1	1001	352	1353
"I20"	"K12"	"Angina pectoris"	"Stomatitis and related lesions"	1	330	173	503
"I20"	"K25"	"Angina pectoris"	"Gastric ulcer"	1	5968	2658	8626
"I20"	"K27"	"Angina pectoris"	"Peptic ulcer, site unspecified"	1	1387	630	2017
"I20"	"K42"	"Angina pectoris"	"Umbilical hernia"	1	1107	807	1914
"I20"	"K43"	"Angina pectoris"	"Ventral hernia"	1	2069	1101	3170
"I20"	"K55"	"Angina pectoris"	"Vascular disorders of intestine"	1	1216	69	1285
"I20"	"K56"	"Angina pectoris"	"Paralytic ileus and intestinal obstruction without hernia"	1	3583	0	3583
"I20"	"K57"	"Angina pectoris"	"Diverticular disease of intestine"	1	10836	0	10836
"I20"	"K62"	"Angina pectoris"	"Other diseases of anus and rectum"	1	7983	0	7983
"I20"	"K70"	"Angina pectoris"	"Alcoholic liver disease"	1	901	306	1207
"I20"	"K72"	"Angina pectoris"	"Hepatic failure, not elsewhere classified"	1	515	21	536
"I20"	"K74"	"Angina pectoris"	"Fibrosis and cirrhosis of liver"	1	533	112	645
"I20"	"K91"	"Angina pectoris"	"Intraop and postproc comp and disorders of dgstv sys, NEC"	1	501	161	662
"I20"	"K92"	"Angina pectoris"	"Other diseases of digestive system"	1	7409	0	7409
"I20"	"L08"	"Angina pectoris"	"Other local infections of skin and subcutaneous tissue"	1	1737	726	2463
"I20"	"L12"	"Angina pectoris"	"Pemphigoid"	1	123	22	145
"I20"	"L30"	"Angina pectoris"	"Other and unspecified dermatitis"	1	1199	478	1677
"I20"	"L90"	"Angina pectoris"	"Atrophic disorders of skin"	1	610	345	955
"I20"	"L98"	"Angina pectoris"	"Oth disorders of skin, subcu, not elsewhere classified"	1	1761	394	2155
"I20"	"M16"	"Angina pectoris"	"Osteoarthritis of hip"	1	4674	3144	7818
"I20"	"M17"	"Angina pectoris"	"Osteoarthritis of knee"	1	6085	4900	10985
"I20"	"M31"	"Angina pectoris"	"Other necrotizing vasculopathies"	1	756	470	1226
"I20"	"M35"	"Angina pectoris"	"Other systemic involvement of connective tissue"	1	1830	1282	3112
"I20"	"M60"	"Angina pectoris"	"Myositis"	1	424	232	656
"I20"	"M81"	"Angina pectoris"	"Osteoporosis without current pathological fracture"	1	7995	0	7995
"I20"	"M84"	"Angina pectoris"	"Disorder of continuity of bone"	1	360	139	499
"I20"	"M85"	"Angina pectoris"	"Other disorders of bone density and structure"	1	2824	0	2824
"I20"	"M87"	"Angina pectoris"	"Osteonecrosis"	1	185	59	244
"I20"	"M90"	"Angina pectoris"	"Osteopathies in diseases classified elsewhere"	1	93	4	97
"I20"	"N13"	"Angina pectoris"	"Obstructive and reflux uropathy"	1	1575	460	2035
"I20"	"N19"	"Angina pectoris"	"Unspecified kidney failure"	1	4928	0	4928
"I20"	"N30"	"Angina pectoris"	"Cystitis"	1	17533	0	17533
"I20"	"N35"	"Angina pectoris"	"Urethral stricture"	1	563	403	966
"I20"	"N45"	"Angina pectoris"	"Orchitis and epididymitis"	1	882	601	1483
"I20"	"N62"	"Angina pectoris"	"Hypertrophy of breast"	1	906	563	1469
"I20"	"N99"	"Angina pectoris"	"Intraop and postproc comp and disorders of GU sys, NEC"	1	704	496	1200
"I20"	"Q23"	"Angina pectoris"	"Congenital malformations of aortic and mitral valves"	1	205	91	296
"I21"	"A46"	"Acute myocardial infarction"	"Erysipelas"	1	2315	1246	3561
"I21"	"B96"	"Acute myocardial infarction"	"Oth bacterial agents as the cause of diseases classd elswhr"	1	283	65	348
"I21"	"C14"	"Acute myocardial infarction"	"Malig neoplasm of sites in the lip, oral cavity and pharynx"	1	41	6	47
"I21"	"C17"	"Acute myocardial infarction"	"Malignant neoplasm of small intestine"	1	75	21	96
"I21"	"C18"	"Acute myocardial infarction"	"Malignant neoplasm of colon"	1	1557	896	2453
"I21"	"C24"	"Acute myocardial infarction"	"Malignant neoplasm of other and unsp parts of biliary tract"	1	142	14	156
"I21"	"C25"	"Acute myocardial infarction"	"Malignant neoplasm of pancreas"	1	652	42	694
"I21"	"C26"	"Acute myocardial infarction"	"Malignant neoplasm of other and ill-defined digestive organs"	1	31	2	33
"I21"	"C34"	"Acute myocardial infarction"	"Malignant neoplasm of bronchus and lung"	1	4074	0	4074
"I21"	"C64"	"Acute myocardial infarction"	"Malignant neoplasm of kidney, except renal pelvis"	1	418	184	602
"I21"	"C71"	"Acute myocardial infarction"	"Malignant neoplasm of brain"	1	288	48	336
"I21"	"C76"	"Acute myocardial infarction"	"Malignant neoplasm of other and ill-defined sites"	1	174	87	261
"I21"	"C77"	"Acute myocardial infarction"	"Secondary and unspecified malignant neoplasm of lymph nodes"	1	679	146	825
"I21"	"C78"	"Acute myocardial infarction"	"Secondary malignant neoplasm of resp and digestive organs"	1	2511	0	2511
"I21"	"C79"	"Acute myocardial infarction"	"Secondary malignant neoplasm of other and unspecified sites"	1	1692	177	1869
"I21"	"C92"	"Acute myocardial infarction"	"Myeloid leukemia"	1	214	88	302
"I21"	"D12"	"Acute myocardial infarction"	"Benign neoplasm of colon, rectum, anus and anal canal"	1	2984	1620	4604
"I21"	"D13"	"Acute myocardial infarction"	"Benign neoplasm of and ill-defined parts of digestive system"	1	292	158	450
"I21"	"D38"	"Acute myocardial infarction"	"Neoplm of uncrt behav of mid ear & resp and intrathorac org"	1	173	89	262
"I21"	"D47"	"Acute myocardial infarction"	"Oth neoplm of uncrt behav of lymphoid, hematpoetc & rel tiss"	1	483	131	614
"I21"	"D61"	"Acute myocardial infarction"	"Oth aplastic anemias and other bone marrow failure syndromes"	1	203	82	285
"I21"	"D62"	"Acute myocardial infarction"	"Acute posthemorrhagic anemia"	1	1975	981	2956
"I21"	"D63"	"Acute myocardial infarction"	"Anemia in chronic diseases classified elsewhere"	1	1938	396	2334
"I21"	"D69"	"Acute myocardial infarction"	"Purpura and other hemorrhagic conditions"	1	611	292	903
"I21"	"E16"	"Acute myocardial infarction"	"Other disorders of pancreatic internal secretion"	1	1198	742	1940
"I21"	"E20"	"Acute myocardial infarction"	"Hypoparathyroidism"	1	349	156	505
"I21"	"E25"	"Acute myocardial infarction"	"Adrenogenital disorders"	1	613	46	659
"I21"	"E27"	"Acute myocardial infarction"	"Other disorders of adrenal gland"	1	213	93	306
"I21"	"E34"	"Acute myocardial infarction"	"Other endocrine disorders"	1	212	61	273
"I21"	"E41"	"Acute myocardial infarction"	"Nutritional marasmus"	1	203	10	213
"I21"	"E46"	"Acute myocardial infarction"	"Unspecified protein-calorie malnutrition"	1	116	29	145
"I21"	"E53"	"Acute myocardial infarction"	"Deficiency of other B group vitamins"	1	310	112	422
"I21"	"F03"	"Acute myocardial infarction"	"Unspecified dementia"	1	3695	1324	5019
"I21"	"F05"	"Acute myocardial infarction"	"Delirium due to known physiological condition"	1	1644	212	1856
"I21"	"G20"	"Acute myocardial infarction"	"Parkinson's disease"	1	587	406	993
"I21"	"G30"	"Acute myocardial infarction"	"Alzheimer's disease"	1	713	44	757
"I21"	"G95"	"Acute myocardial infarction"	"Other and unspecified diseases of spinal cord"	1	387	108	495
"I21"	"G96"	"Acute myocardial infarction"	"Other disorders of central nervous system"	1	1147	231	1378
"I21"	"G98"	"Acute myocardial infarction"	"Other disorders of nervous system not elsewhere classified"	1	304	71	375
"I21"	"H54"	"Acute myocardial infarction"	"Blindness and low vision"	1	406	218	624
"I21"	"I13"	"Acute myocardial infarction"	"Hypertensive heart and chronic kidney disease"	1	344	183	527
"I21"	"I24"	"Acute myocardial infarction"	"Other acute ischemic heart diseases"	1	3769	2672	6441
"I21"	"I27"	"Acute myocardial infarction"	"Other pulmonary heart diseases"	1	912	599	1511
"I21"	"I28"	"Acute myocardial infarction"	"Other diseases of pulmonary vessels"	1	94	32	126
"I21"	"I31"	"Acute myocardial infarction"	"Other diseases of pericardium"	1	618	424	1042
"I21"	"I34"	"Acute myocardial infarction"	"Nonrheumatic mitral valve disorders"	1	2859	2210	5069
"I21"	"I42"	"Acute myocardial infarction"	"Cardiomyopathy"	1	3163	1824	4987
"I21"	"I44"	"Acute myocardial infarction"	"Atrioventricular and left bundle-branch block"	1	3736	3242	6978
"I21"	"I45"	"Acute myocardial infarction"	"Other conduction disorders"	1	1619	1120	2739
"I21"	"I48"	"Acute myocardial infarction"	"Atrial fibrillation and flutter"	1	17549	16243	33792
"I21"	"I49"	"Acute myocardial infarction"	"Other cardiac arrhythmias"	1	6276	4501	10777
"I21"	"I61"	"Acute myocardial infarction"	"Nontraumatic intracerebral hemorrhage"	1	1401	649	2050
"I21"	"I69"	"Acute myocardial infarction"	"Sequelae of cerebrovascular disease"	1	6847	4701	11548
"I21"	"I71"	"Acute myocardial infarction"	"Aortic aneurysm and dissection"	1	3107	1258	4365
"I21"	"I72"	"Acute myocardial infarction"	"Other aneurysm"	1	930	418	1348
"I21"	"I74"	"Acute myocardial infarction"	"Arterial embolism and thrombosis"	1	1008	719	1727
"I21"	"I82"	"Acute myocardial infarction"	"Other venous embolism and thrombosis"	1	378	186	564
"I21"	"I85"	"Acute myocardial infarction"	"Esophageal varices"	1	239	99	338
"I21"	"I87"	"Acute myocardial infarction"	"Other disorders of veins"	1	282	163	445
"I21"	"I97"	"Acute myocardial infarction"	"Intraop and postproc comp and disorders of circ sys, NEC"	1	430	263	693
"I21"	"J10"	"Acute myocardial infarction"	"Influenza due to other identified influenza virus"	1	190	9	199
"I21"	"J13"	"Acute myocardial infarction"	"Pneumonia due to Streptococcus pneumoniae"	1	443	302	745
"I21"	"J14"	"Acute myocardial infarction"	"Pneumonia due to Hemophilus influenzae"	1	229	105	334
"I21"	"J47"	"Acute myocardial infarction"	"Bronchiectasis"	1	206	90	296
"I21"	"J69"	"Acute myocardial infarction"	"Pneumonitis due to solids and liquids"	1	810	208	1018
"I21"	"J93"	"Acute myocardial infarction"	"Pneumothorax and air leak"	1	601	422	1023
"I21"	"J94"	"Acute myocardial infarction"	"Other pleural conditions"	1	705	269	974
"I21"	"J95"	"Acute myocardial infarction"	"Intraop and postproc comp and disorders of resp sys, NEC"	1	355	143	498
"I21"	"K02"	"Acute myocardial infarction"	"Dental caries"	1	465	276	741
"I21"	"K05"	"Acute myocardial infarction"	"Gingivitis and periodontal diseases"	1	821	515	1336
"I21"	"K22"	"Acute myocardial infarction"	"Other diseases of esophagus"	1	912	604	1516
"I21"	"K59"	"Acute myocardial infarction"	"Other functional intestinal disorders"	1	8567	0	8567
"I21"	"K62"	"Acute myocardial infarction"	"Other diseases of anus and rectum"	1	3146	2039	5185
"I21"	"K64"	"Acute myocardial infarction"	"Hemorrhoids and perianal venous thrombosis"	1	923	2	925
"I21"	"K65"	"Acute myocardial infarction"	"Peritonitis"	1	727	455	1182
"I21"	"K74"	"Acute myocardial infarction"	"Fibrosis and cirrhosis of liver"	1	279	162	441
"I21"	"K83"	"Acute myocardial infarction"	"Other diseases of biliary tract"	1	621	285	906
"I21"	"K92"	"Acute myocardial infarction"	"Other diseases of digestive system"	1	4831	2352	7183
"I21"	"L08"	"Acute myocardial infarction"	"Other local infections of skin and subcutaneous tissue"	1	950	650	1600
"I21"	"L29"	"Acute myocardial infarction"	"Pruritus"	1	208	87	295
"I21"	"L97"	"Acute myocardial infarction"	"Non-pressure chronic ulcer of lower limb, NEC"	1	1910	865	2775
"I21"	"L98"	"Acute myocardial infarction"	"Oth disorders of skin, subcu, not elsewhere classified"	1	1005	571	1576
"I21"	"M80"	"Acute myocardial infarction"	"Osteoporosis with current pathological fracture"	1	1786	1005	2791
"I21"	"M81"	"Acute myocardial infarction"	"Osteoporosis without current pathological fracture"	1	2927	2069	4996
"I21"	"N18"	"Acute myocardial infarction"	"Chronic kidney disease (CKD)"	1	9042	0	9042
"I21"	"N28"	"Acute myocardial infarction"	"Oth disorders of kidney and ureter, not elsewhere classified"	1	1201	350	1551
"I21"	"N30"	"Acute myocardial infarction"	"Cystitis"	1	8972	5733	14705
"I22"	"C78"	"Subsequent STEMI & NSTEMI mocard infrc"	"Secondary malignant neoplasm of resp and digestive organs"	1	43	2	45
"I22"	"D12"	"Subsequent STEMI & NSTEMI mocard infrc"	"Benign neoplasm of colon, rectum, anus and anal canal"	1	34	3	37
"I22"	"F03"	"Subsequent STEMI & NSTEMI mocard infrc"	"Unspecified dementia"	1	65	8	73
"I24"	"C34"	"Other acute ischemic heart diseases"	"Malignant neoplasm of bronchus and lung"	1	220	70	290
"I24"	"C78"	"Other acute ischemic heart diseases"	"Secondary malignant neoplasm of resp and digestive organs"	1	163	23	186
"I24"	"C79"	"Other acute ischemic heart diseases"	"Secondary malignant neoplasm of other and unspecified sites"	1	89	13	102
"I24"	"E25"	"Other acute ischemic heart diseases"	"Adrenogenital disorders"	1	86	21	107
"I24"	"I95"	"Other acute ischemic heart diseases"	"Hypotension"	1	270	142	412
"I25"	"A04"	"Chronic ischemic heart disease"	"Other bacterial intestinal infections"	1	2353	598	2951
"I25"	"A09"	"Chronic ischemic heart disease"	"Infectious gastroenteritis and colitis, unspecified"	1	4706	3421	8127
"I25"	"A41"	"Chronic ischemic heart disease"	"Other sepsis"	1	17916	0	17916
"I25"	"B34"	"Chronic ischemic heart disease"	"Viral infection of unspecified site"	1	671	496	1167
"I25"	"B44"	"Chronic ischemic heart disease"	"Aspergillosis"	1	67	20	87
"I25"	"C06"	"Chronic ischemic heart disease"	"Malignant neoplasm of other and unspecified parts of mouth"	1	187	68	255
"I25"	"C10"	"Chronic ischemic heart disease"	"Malignant neoplasm of oropharynx"	1	134	32	166
"I25"	"C13"	"Chronic ischemic heart disease"	"Malignant neoplasm of hypopharynx"	1	117	34	151
"I25"	"C14"	"Chronic ischemic heart disease"	"Malig neoplasm of sites in the lip, oral cavity and pharynx"	1	81	13	94
"I25"	"C15"	"Chronic ischemic heart disease"	"Malignant neoplasm of esophagus"	1	695	143	838
"I25"	"C16"	"Chronic ischemic heart disease"	"Malignant neoplasm of stomach"	1	881	237	1118
"I25"	"C17"	"Chronic ischemic heart disease"	"Malignant neoplasm of small intestine"	1	153	52	205
"I25"	"C22"	"Chronic ischemic heart disease"	"Malignant neoplasm of liver and intrahepatic bile ducts"	1	592	52	644
"I25"	"C23"	"Chronic ischemic heart disease"	"Malignant neoplasm of gallbladder"	1	84	12	96
"I25"	"C25"	"Chronic ischemic heart disease"	"Malignant neoplasm of pancreas"	1	1286	178	1464
"I25"	"C26"	"Chronic ischemic heart disease"	"Malignant neoplasm of other and ill-defined digestive organs"	1	67	4	71
"I25"	"C38"	"Chronic ischemic heart disease"	"Malignant neoplasm of heart, mediastinum and pleura"	1	160	54	214
"I25"	"C44"	"Chronic ischemic heart disease"	"Other and unspecified malignant neoplasm of skin"	1	3295	1751	5046
"I25"	"C49"	"Chronic ischemic heart disease"	"Malignant neoplasm of other connective and soft tissue"	1	178	75	253
"I25"	"C64"	"Chronic ischemic heart disease"	"Malignant neoplasm of kidney, except renal pelvis"	1	732	335	1067
"I25"	"C67"	"Chronic ischemic heart disease"	"Malignant neoplasm of bladder"	1	1151	849	2000
"I25"	"C71"	"Chronic ischemic heart disease"	"Malignant neoplasm of brain"	1	504	101	605
"I25"	"C78"	"Chronic ischemic heart disease"	"Secondary malignant neoplasm of resp and digestive organs"	1	5032	0	5032
"I25"	"C79"	"Chronic ischemic heart disease"	"Secondary malignant neoplasm of other and unspecified sites"	1	3478	0	3478
"I25"	"C92"	"Chronic ischemic heart disease"	"Myeloid leukemia"	1	445	102	547
"I25"	"C93"	"Chronic ischemic heart disease"	"Monocytic leukemia"	1	93	12	105
"I25"	"D46"	"Chronic ischemic heart disease"	"Myelodysplastic syndromes"	1	647	169	816
"I25"	"D47"	"Chronic ischemic heart disease"	"Oth neoplm of uncrt behav of lymphoid, hematpoetc & rel tiss"	1	823	256	1079
"I25"	"D50"	"Chronic ischemic heart disease"	"Iron deficiency anemia"	1	5561	2718	8279
"I25"	"D61"	"Chronic ischemic heart disease"	"Oth aplastic anemias and other bone marrow failure syndromes"	1	381	131	512
"I25"	"D63"	"Chronic ischemic heart disease"	"Anemia in chronic diseases classified elsewhere"	1	4361	0	4361
"I25"	"D64"	"Chronic ischemic heart disease"	"Other anemias"	1	25607	0	25607
"I25"	"D70"	"Chronic ischemic heart disease"	"Neutropenia"	1	149	71	220
"I25"	"E25"	"Chronic ischemic heart disease"	"Adrenogenital disorders"	1	946	56	1002
"I25"	"E27"	"Chronic ischemic heart disease"	"Other disorders of adrenal gland"	1	412	175	587
"I25"	"E29"	"Chronic ischemic heart disease"	"Testicular dysfunction"	1	105	40	145
"I25"	"E35"	"Chronic ischemic heart disease"	"Disorders of endocrine glands in diseases classd elswhr"	1	169	82	251
"I25"	"E53"	"Chronic ischemic heart disease"	"Deficiency of other B group vitamins"	1	699	335	1034
"I25"	"E64"	"Chronic ischemic heart disease"	"Sequelae of malnutrition and other nutritional deficiencies"	1	1206	330	1536
"I25"	"E83"	"Chronic ischemic heart disease"	"Disorders of mineral metabolism"	1	1185	287	1472
"I25"	"F02"	"Chronic ischemic heart disease"	"Dementia in other diseases classified elsewhere"	1	380	144	524
"I25"	"G12"	"Chronic ischemic heart disease"	"Spinal muscular atrophy and related syndromes"	1	157	53	210
"I25"	"G20"	"Chronic ischemic heart disease"	"Parkinson's disease"	1	1365	990	2355
"I25"	"G21"	"Chronic ischemic heart disease"	"Secondary parkinsonism"	1	285	138	423
"I25"	"G23"	"Chronic ischemic heart disease"	"Other degenerative diseases of basal ganglia"	1	109	6	115
"I25"	"G31"	"Chronic ischemic heart disease"	"Oth degenerative diseases of nervous system, NEC"	1	612	260	872
"I25"	"G62"	"Chronic ischemic heart disease"	"Other and unspecified polyneuropathies"	1	1768	1120	2888
"I25"	"G63"	"Chronic ischemic heart disease"	"Polyneuropathy in diseases classified elsewhere"	1	534	270	804
"I25"	"G91"	"Chronic ischemic heart disease"	"Hydrocephalus"	1	405	183	588
"I25"	"G96"	"Chronic ischemic heart disease"	"Other disorders of central nervous system"	1	2190	530	2720
"I25"	"H02"	"Chronic ischemic heart disease"	"Other disorders of eyelid"	1	1659	1236	2895
"I25"	"H18"	"Chronic ischemic heart disease"	"Other disorders of cornea"	1	606	416	1022
"I25"	"H26"	"Chronic ischemic heart disease"	"Other cataract"	1	3926	3233	7159
"I25"	"H54"	"Chronic ischemic heart disease"	"Blindness and low vision"	1	1026	601	1627
"I25"	"H82"	"Chronic ischemic heart disease"	"Vertiginous syndromes in diseases classified elsewhere"	1	202	102	304
"I25"	"I08"	"Chronic ischemic heart disease"	"Multiple valve diseases"	1	452	172	624
"I25"	"I11"	"Chronic ischemic heart disease"	"Hypertensive heart disease"	1	4361	2978	7339
"I25"	"I13"	"Chronic ischemic heart disease"	"Hypertensive heart and chronic kidney disease"	1	578	327	905
"I25"	"I42"	"Chronic ischemic heart disease"	"Cardiomyopathy"	1	4353	3526	7879
"I25"	"I44"	"Chronic ischemic heart disease"	"Atrioventricular and left bundle-branch block"	1	5473	4748	10221
"I25"	"I46"	"Chronic ischemic heart disease"	"Cardiac arrest"	1	9774	0	9774
"I25"	"I49"	"Chronic ischemic heart disease"	"Other cardiac arrhythmias"	1	8750	7718	16468
"I25"	"I52"	"Chronic ischemic heart disease"	"Other heart disorders in diseases classified elsewhere"	1	130	41	171
"I25"	"I69"	"Chronic ischemic heart disease"	"Sequelae of cerebrovascular disease"	1	14069	9949	24018
"I25"	"I74"	"Chronic ischemic heart disease"	"Arterial embolism and thrombosis"	1	1579	1298	2877
"I25"	"I85"	"Chronic ischemic heart disease"	"Esophageal varices"	1	392	206	598
"I25"	"I95"	"Chronic ischemic heart disease"	"Hypotension"	1	6745	0	6745
"I25"	"J06"	"Chronic ischemic heart disease"	"Acute upper resp infections of multiple and unsp sites"	1	617	133	750
"I25"	"J22"	"Chronic ischemic heart disease"	"Unspecified acute lower respiratory infection"	1	1757	384	2141
"I25"	"J47"	"Chronic ischemic heart disease"	"Bronchiectasis"	1	411	170	581
"I25"	"J81"	"Chronic ischemic heart disease"	"Pulmonary edema"	1	4533	3391	7924
"I25"	"J84"	"Chronic ischemic heart disease"	"Other interstitial pulmonary diseases"	1	1649	977	2626
"I25"	"J85"	"Chronic ischemic heart disease"	"Abscess of lung and mediastinum"	1	271	133	404
"I25"	"J86"	"Chronic ischemic heart disease"	"Pyothorax"	1	531	332	863
"I25"	"J98"	"Chronic ischemic heart disease"	"Other respiratory disorders"	1	1917	1227	3144
"I25"	"K05"	"Chronic ischemic heart disease"	"Gingivitis and periodontal diseases"	1	1760	1267	3027
"I25"	"K55"	"Chronic ischemic heart disease"	"Vascular disorders of intestine"	1	1645	492	2137
"I25"	"K59"	"Chronic ischemic heart disease"	"Other functional intestinal disorders"	1	17557	0	17557
"I25"	"K76"	"Chronic ischemic heart disease"	"Other diseases of liver"	1	984	701	1685
"I25"	"K83"	"Chronic ischemic heart disease"	"Other diseases of biliary tract"	1	1340	609	1949
"I25"	"K91"	"Chronic ischemic heart disease"	"Intraop and postproc comp and disorders of dgstv sys, NEC"	1	564	396	960
"I25"	"K92"	"Chronic ischemic heart disease"	"Other diseases of digestive system"	1	11857	0	11857
"I25"	"L29"	"Chronic ischemic heart disease"	"Pruritus"	1	395	182	577
"I25"	"L82"	"Chronic ischemic heart disease"	"Seborrheic keratosis"	1	467	177	644
"I25"	"L98"	"Chronic ischemic heart disease"	"Oth disorders of skin, subcu, not elsewhere classified"	1	2182	1057	3239
"I25"	"M80"	"Chronic ischemic heart disease"	"Osteoporosis with current pathological fracture"	1	4698	2418	7116
"I25"	"M90"	"Chronic ischemic heart disease"	"Osteopathies in diseases classified elsewhere"	1	113	17	130
"I25"	"N08"	"Chronic ischemic heart disease"	"Glomerular disorders in diseases classified elsewhere"	1	273	128	401
"I25"	"N13"	"Chronic ischemic heart disease"	"Obstructive and reflux uropathy"	1	1739	1028	2767
"I25"	"N17"	"Chronic ischemic heart disease"	"Acute kidney failure"	1	6757	0	6757
"I25"	"N18"	"Chronic ischemic heart disease"	"Chronic kidney disease (CKD)"	1	15348	0	15348
"I25"	"N25"	"Chronic ischemic heart disease"	"Disorders resulting from impaired renal tubular function"	1	321	191	512
"I26"	"E72"	"Pulmonary embolism"	"Other disorders of amino-acid metabolism"	1	84	26	110
"I26"	"F41"	"Pulmonary embolism"	"Other anxiety disorders"	1	913	373	1286
"I26"	"G30"	"Pulmonary embolism"	"Alzheimer's disease"	1	219	105	324
"I26"	"G47"	"Pulmonary embolism"	"Sleep disorders"	1	1023	566	1589
"I26"	"I27"	"Pulmonary embolism"	"Other pulmonary heart diseases"	1	1432	827	2259
"I26"	"I87"	"Pulmonary embolism"	"Other disorders of veins"	1	404	237	641
"I27"	"A41"	"Other pulmonary heart diseases"	"Other sepsis"	1	982	689	1671
"I27"	"A49"	"Other pulmonary heart diseases"	"Bacterial infection of unspecified site"	1	358	232	590
"I27"	"C25"	"Other pulmonary heart diseases"	"Malignant neoplasm of pancreas"	1	45	9	54
"I27"	"C78"	"Other pulmonary heart diseases"	"Secondary malignant neoplasm of resp and digestive organs"	1	212	63	275
"I27"	"C79"	"Other pulmonary heart diseases"	"Secondary malignant neoplasm of other and unspecified sites"	1	137	51	188
"I30"	"C61"	"Acute pericarditis"	"Malignant neoplasm of prostate"	1	91	24	115
"I30"	"C79"	"Acute pericarditis"	"Secondary malignant neoplasm of other and unspecified sites"	1	107	25	132
"I30"	"E86"	"Acute pericarditis"	"Volume depletion"	1	287	53	340
"I30"	"E87"	"Acute pericarditis"	"Other disorders of fluid, electrolyte and acid-base balance"	1	207	61	268
"I30"	"F03"	"Acute pericarditis"	"Unspecified dementia"	1	66	12	78
"I30"	"F33"	"Acute pericarditis"	"Major depressive disorder, recurrent"	1	65	17	82
"I30"	"G47"	"Acute pericarditis"	"Sleep disorders"	1	215	24	239
"I30"	"I69"	"Acute pericarditis"	"Sequelae of cerebrovascular disease"	1	223	82	305
"I30"	"J15"	"Acute pericarditis"	"Bacterial pneumonia, not elsewhere classified"	1	398	252	650
"I30"	"K92"	"Acute pericarditis"	"Other diseases of digestive system"	1	156	56	212
"I30"	"N30"	"Acute pericarditis"	"Cystitis"	1	338	214	552
"I31"	"F03"	"Other diseases of pericardium"	"Unspecified dementia"	1	54	10	64
"I31"	"F41"	"Other diseases of pericardium"	"Other anxiety disorders"	1	129	46	175
"I33"	"C78"	"Acute and subacute endocarditis"	"Secondary malignant neoplasm of resp and digestive organs"	1	99	32	131
"I34"	"C15"	"Nonrheumatic mitral valve disorders"	"Malignant neoplasm of esophagus"	1	68	18	86
"I34"	"C22"	"Nonrheumatic mitral valve disorders"	"Malignant neoplasm of liver and intrahepatic bile ducts"	1	55	12	67
"I34"	"C79"	"Nonrheumatic mitral valve disorders"	"Secondary malignant neoplasm of other and unspecified sites"	1	256	55	311
"I34"	"D50"	"Nonrheumatic mitral valve disorders"	"Iron deficiency anemia"	1	681	501	1182
"I34"	"D62"	"Nonrheumatic mitral valve disorders"	"Acute posthemorrhagic anemia"	1	434	253	687
"I34"	"D63"	"Nonrheumatic mitral valve disorders"	"Anemia in chronic diseases classified elsewhere"	1	368	147	515
"I34"	"E25"	"Nonrheumatic mitral valve disorders"	"Adrenogenital disorders"	1	66	16	82
"I34"	"E87"	"Nonrheumatic mitral valve disorders"	"Other disorders of fluid, electrolyte and acid-base balance"	1	1129	595	1724
"I34"	"F03"	"Nonrheumatic mitral valve disorders"	"Unspecified dementia"	1	705	188	893
"I34"	"J15"	"Nonrheumatic mitral valve disorders"	"Bacterial pneumonia, not elsewhere classified"	1	1364	677	2041
"I34"	"K05"	"Nonrheumatic mitral valve disorders"	"Gingivitis and periodontal diseases"	1	926	567	1493
"I34"	"K59"	"Nonrheumatic mitral valve disorders"	"Other functional intestinal disorders"	1	1084	691	1775
"I34"	"K92"	"Nonrheumatic mitral valve disorders"	"Other diseases of digestive system"	1	868	519	1387
"I34"	"N39"	"Nonrheumatic mitral valve disorders"	"Other disorders of urinary system"	1	1367	838	2205
"I35"	"A49"	"Nonrheumatic aortic valve disorders"	"Bacterial infection of unspecified site"	1	2004	864	2868
"I35"	"C25"	"Nonrheumatic aortic valve disorders"	"Malignant neoplasm of pancreas"	1	274	83	357
"I35"	"C79"	"Nonrheumatic aortic valve disorders"	"Secondary malignant neoplasm of other and unspecified sites"	1	695	249	944
"I35"	"C80"	"Nonrheumatic aortic valve disorders"	"Malignant neoplasm without specification of site"	1	124	40	164
"I35"	"D64"	"Nonrheumatic aortic valve disorders"	"Other anemias"	1	5868	4713	10581
"I35"	"D68"	"Nonrheumatic aortic valve disorders"	"Other coagulation defects"	1	661	298	959
"I35"	"E25"	"Nonrheumatic aortic valve disorders"	"Adrenogenital disorders"	1	137	65	202
"I35"	"F03"	"Nonrheumatic aortic valve disorders"	"Unspecified dementia"	1	2032	754	2786
"I35"	"F41"	"Nonrheumatic aortic valve disorders"	"Other anxiety disorders"	1	500	301	801
"I35"	"I06"	"Nonrheumatic aortic valve disorders"	"Rheumatic aortic valve diseases"	1	1088	695	1783
"I35"	"I95"	"Nonrheumatic aortic valve disorders"	"Hypotension"	1	1421	896	2317
"I35"	"J15"	"Nonrheumatic aortic valve disorders"	"Bacterial pneumonia, not elsewhere classified"	1	3911	2316	6227
"I35"	"J22"	"Nonrheumatic aortic valve disorders"	"Unspecified acute lower respiratory infection"	1	562	375	937
"I35"	"J69"	"Nonrheumatic aortic valve disorders"	"Pneumonitis due to solids and liquids"	1	397	111	508
"I35"	"J81"	"Nonrheumatic aortic valve disorders"	"Pulmonary edema"	1	1526	1186	2712
"I35"	"J96"	"Nonrheumatic aortic valve disorders"	"Respiratory failure, not elsewhere classified"	1	4169	1903	6072
"I35"	"K01"	"Nonrheumatic aortic valve disorders"	"Embedded and impacted teeth"	1	598	305	903
"I35"	"K03"	"Nonrheumatic aortic valve disorders"	"Other diseases of hard tissues of teeth"	1	358	180	538
"I35"	"K08"	"Nonrheumatic aortic valve disorders"	"Other disorders of teeth and supporting structures"	1	2531	971	3502
"I35"	"K55"	"Nonrheumatic aortic valve disorders"	"Vascular disorders of intestine"	1	522	249	771
"I35"	"K92"	"Nonrheumatic aortic valve disorders"	"Other diseases of digestive system"	1	2414	1593	4007
"I35"	"L89"	"Nonrheumatic aortic valve disorders"	"Pressure ulcer"	1	769	316	1085
"I35"	"N17"	"Nonrheumatic aortic valve disorders"	"Acute kidney failure"	1	1766	843	2609
"I35"	"N18"	"Nonrheumatic aortic valve disorders"	"Chronic kidney disease (CKD)"	1	3205	2144	5349
"I36"	"I46"	"Nonrheumatic tricuspid valve disorders"	"Cardiac arrest"	1	73	16	89
"I42"	"C25"	"Cardiomyopathy"	"Malignant neoplasm of pancreas"	1	87	7	94
"I42"	"C34"	"Cardiomyopathy"	"Malignant neoplasm of bronchus and lung"	1	488	155	643
"I42"	"C79"	"Cardiomyopathy"	"Secondary malignant neoplasm of other and unspecified sites"	1	250	78	328
"I42"	"D50"	"Cardiomyopathy"	"Iron deficiency anemia"	1	466	304	770
"I42"	"D62"	"Cardiomyopathy"	"Acute posthemorrhagic anemia"	1	240	137	377
"I42"	"D63"	"Cardiomyopathy"	"Anemia in chronic diseases classified elsewhere"	1	276	118	394
"I42"	"D64"	"Cardiomyopathy"	"Other anemias"	1	1382	889	2271
"I42"	"E42"	"Cardiomyopathy"	"Marasmic kwashiorkor"	1	55	9	64
"I42"	"F03"	"Cardiomyopathy"	"Unspecified dementia"	1	401	155	556
"I42"	"G30"	"Cardiomyopathy"	"Alzheimer's disease"	1	79	14	93
"I42"	"J06"	"Cardiomyopathy"	"Acute upper resp infections of multiple and unsp sites"	1	107	42	149
"I42"	"J15"	"Cardiomyopathy"	"Bacterial pneumonia, not elsewhere classified"	1	1183	657	1840
"I42"	"J96"	"Cardiomyopathy"	"Respiratory failure, not elsewhere classified"	1	1441	895	2336
"I42"	"K52"	"Cardiomyopathy"	"Other and unsp noninfective gastroenteritis and colitis"	1	432	291	723
"I42"	"K59"	"Cardiomyopathy"	"Other functional intestinal disorders"	1	1016	613	1629
"I42"	"N19"	"Cardiomyopathy"	"Unspecified kidney failure"	1	721	381	1102
"I42"	"N28"	"Cardiomyopathy"	"Oth disorders of kidney and ureter, not elsewhere classified"	1	299	160	459
"I42"	"N30"	"Cardiomyopathy"	"Cystitis"	1	1108	864	1972
"I44"	"A04"	"Atrioventricular and left bundle-branch block"	"Other bacterial intestinal infections"	1	386	163	549
"I44"	"C71"	"Atrioventricular and left bundle-branch block"	"Malignant neoplasm of brain"	1	84	23	107
"I44"	"C78"	"Atrioventricular and left bundle-branch block"	"Secondary malignant neoplasm of resp and digestive organs"	1	511	111	622
"I44"	"C79"	"Atrioventricular and left bundle-branch block"	"Secondary malignant neoplasm of other and unspecified sites"	1	340	85	425
"I44"	"D46"	"Atrioventricular and left bundle-branch block"	"Myelodysplastic syndromes"	1	94	35	129
"I44"	"D64"	"Atrioventricular and left bundle-branch block"	"Other anemias"	1	2264	1692	3956
"I44"	"E55"	"Atrioventricular and left bundle-branch block"	"Vitamin D deficiency"	1	351	148	499
"I44"	"E83"	"Atrioventricular and left bundle-branch block"	"Disorders of mineral metabolism"	1	192	98	290
"I44"	"F03"	"Atrioventricular and left bundle-branch block"	"Unspecified dementia"	1	1360	657	2017
"I44"	"I95"	"Atrioventricular and left bundle-branch block"	"Hypotension"	1	801	545	1346
"I44"	"J15"	"Atrioventricular and left bundle-branch block"	"Bacterial pneumonia, not elsewhere classified"	1	1866	1058	2924
"I44"	"J69"	"Atrioventricular and left bundle-branch block"	"Pneumonitis due to solids and liquids"	1	245	71	316
"I44"	"J96"	"Atrioventricular and left bundle-branch block"	"Respiratory failure, not elsewhere classified"	1	1920	950	2870
"I44"	"K92"	"Atrioventricular and left bundle-branch block"	"Other diseases of digestive system"	1	962	709	1671
"I44"	"N18"	"Atrioventricular and left bundle-branch block"	"Chronic kidney disease (CKD)"	1	1723	994	2717
"I45"	"C34"	"Other conduction disorders"	"Malignant neoplasm of bronchus and lung"	1	325	61	386
"I45"	"C78"	"Other conduction disorders"	"Secondary malignant neoplasm of resp and digestive organs"	1	254	36	290
"I45"	"D63"	"Other conduction disorders"	"Anemia in chronic diseases classified elsewhere"	1	199	63	262
"I45"	"I46"	"Other conduction disorders"	"Cardiac arrest"	1	426	263	689
"I47"	"A41"	"Paroxysmal tachycardia"	"Other sepsis"	1	4021	0	4021
"I47"	"A46"	"Paroxysmal tachycardia"	"Erysipelas"	1	1141	453	1594
"I47"	"B95"	"Paroxysmal tachycardia"	"Strep as the cause of diseases classified elsewhere"	1	70	18	88
"I47"	"C04"	"Paroxysmal tachycardia"	"Malignant neoplasm of floor of mouth"	1	34	4	38
"I47"	"C06"	"Paroxysmal tachycardia"	"Malignant neoplasm of other and unspecified parts of mouth"	1	79	15	94
"I47"	"C15"	"Paroxysmal tachycardia"	"Malignant neoplasm of esophagus"	1	180	39	219
"I47"	"C16"	"Paroxysmal tachycardia"	"Malignant neoplasm of stomach"	1	174	40	214
"I47"	"C25"	"Paroxysmal tachycardia"	"Malignant neoplasm of pancreas"	1	297	8	305
"I47"	"C34"	"Paroxysmal tachycardia"	"Malignant neoplasm of bronchus and lung"	1	1288	327	1615
"I47"	"C44"	"Paroxysmal tachycardia"	"Other and unspecified malignant neoplasm of skin"	1	990	246	1236
"I47"	"C61"	"Paroxysmal tachycardia"	"Malignant neoplasm of prostate"	1	766	287	1053
"I47"	"C64"	"Paroxysmal tachycardia"	"Malignant neoplasm of kidney, except renal pelvis"	1	173	66	239
"I47"	"C71"	"Paroxysmal tachycardia"	"Malignant neoplasm of brain"	1	136	22	158
"I47"	"C77"	"Paroxysmal tachycardia"	"Secondary and unspecified malignant neoplasm of lymph nodes"	1	337	109	446
"I47"	"C90"	"Paroxysmal tachycardia"	"Multiple myeloma and malignant plasma cell neoplasms"	1	132	46	178
"I47"	"D09"	"Paroxysmal tachycardia"	"Carcinoma in situ of other and unspecified sites"	1	124	6	130
"I47"	"E06"	"Paroxysmal tachycardia"	"Thyroiditis"	1	189	82	271
"I47"	"E13"	"Paroxysmal tachycardia"	"Other specified diabetes mellitus"	1	152	37	189
"I47"	"E25"	"Paroxysmal tachycardia"	"Adrenogenital disorders"	1	115	36	151
"I47"	"E50"	"Paroxysmal tachycardia"	"Vitamin A deficiency"	1	126	43	169
"I47"	"E64"	"Paroxysmal tachycardia"	"Sequelae of malnutrition and other nutritional deficiencies"	1	262	40	302
"I47"	"E83"	"Paroxysmal tachycardia"	"Disorders of mineral metabolism"	1	345	114	459
"I47"	"F02"	"Paroxysmal tachycardia"	"Dementia in other diseases classified elsewhere"	1	70	3	73
"I47"	"F32"	"Paroxysmal tachycardia"	"Depressive episode"	1	1368	604	1972
"I47"	"F33"	"Paroxysmal tachycardia"	"Major depressive disorder, recurrent"	1	665	179	844
"I47"	"G23"	"Paroxysmal tachycardia"	"Other degenerative diseases of basal ganglia"	1	25	0	25
"I47"	"G30"	"Paroxysmal tachycardia"	"Alzheimer's disease"	1	315	0	315
"I47"	"G47"	"Paroxysmal tachycardia"	"Sleep disorders"	1	1223	307	1530
"I47"	"G63"	"Paroxysmal tachycardia"	"Polyneuropathy in diseases classified elsewhere"	1	87	26	113
"I47"	"G95"	"Paroxysmal tachycardia"	"Other and unspecified diseases of spinal cord"	1	204	48	252
"I47"	"H26"	"Paroxysmal tachycardia"	"Other cataract"	1	1153	571	1724
"I47"	"I35"	"Paroxysmal tachycardia"	"Nonrheumatic aortic valve disorders"	1	1944	1555	3499
"I47"	"I45"	"Paroxysmal tachycardia"	"Other conduction disorders"	1	2465	1975	4440
"I47"	"I49"	"Paroxysmal tachycardia"	"Other cardiac arrhythmias"	1	7507	6400	13907
"I47"	"I51"	"Paroxysmal tachycardia"	"Complications and ill-defined descriptions of heart disease"	1	1095	409	1504
"I47"	"I61"	"Paroxysmal tachycardia"	"Nontraumatic intracerebral hemorrhage"	1	697	138	835
"I47"	"I70"	"Paroxysmal tachycardia"	"Atherosclerosis"	1	1582	1223	2805
"I47"	"I82"	"Paroxysmal tachycardia"	"Other venous embolism and thrombosis"	1	237	87	324
"I47"	"I85"	"Paroxysmal tachycardia"	"Esophageal varices"	1	108	42	150
"I47"	"I89"	"Paroxysmal tachycardia"	"Oth noninfective disorders of lymphatic vessels and nodes"	1	140	54	194
"I47"	"I95"	"Paroxysmal tachycardia"	"Hypotension"	1	1352	490	1842
"I47"	"J15"	"Paroxysmal tachycardia"	"Bacterial pneumonia, not elsewhere classified"	1	2963	803	3766
"I47"	"J69"	"Paroxysmal tachycardia"	"Pneumonitis due to solids and liquids"	1	309	60	369
"I47"	"J81"	"Paroxysmal tachycardia"	"Pulmonary edema"	1	744	469	1213
"I47"	"J93"	"Paroxysmal tachycardia"	"Pneumothorax and air leak"	1	316	179	495
"I47"	"J96"	"Paroxysmal tachycardia"	"Respiratory failure, not elsewhere classified"	1	3143	905	4048
"I47"	"K52"	"Paroxysmal tachycardia"	"Other and unsp noninfective gastroenteritis and colitis"	1	1099	461	1560
"I47"	"K57"	"Paroxysmal tachycardia"	"Diverticular disease of intestine"	1	1898	832	2730
"I47"	"K59"	"Paroxysmal tachycardia"	"Other functional intestinal disorders"	1	3209	973	4182
"I47"	"K62"	"Paroxysmal tachycardia"	"Other diseases of anus and rectum"	1	1539	723	2262
"I47"	"K65"	"Paroxysmal tachycardia"	"Peritonitis"	1	313	183	496
"I47"	"K72"	"Paroxysmal tachycardia"	"Hepatic failure, not elsewhere classified"	1	205	47	252
"I47"	"K74"	"Paroxysmal tachycardia"	"Fibrosis and cirrhosis of liver"	1	161	75	236
"I47"	"K91"	"Paroxysmal tachycardia"	"Intraop and postproc comp and disorders of dgstv sys, NEC"	1	178	87	265
"I47"	"K92"	"Paroxysmal tachycardia"	"Other diseases of digestive system"	1	1553	584	2137
"I47"	"L08"	"Paroxysmal tachycardia"	"Other local infections of skin and subcutaneous tissue"	1	498	312	810
"I47"	"L97"	"Paroxysmal tachycardia"	"Non-pressure chronic ulcer of lower limb, NEC"	1	739	148	887
"I47"	"L98"	"Paroxysmal tachycardia"	"Oth disorders of skin, subcu, not elsewhere classified"	1	543	181	724
"I47"	"M10"	"Paroxysmal tachycardia"	"Gout"	1	1001	374	1375
"I47"	"N12"	"Paroxysmal tachycardia"	"Tubulo-interstitial nephritis, not spcf as acute or chronic"	1	98	27	125
"I47"	"N30"	"Paroxysmal tachycardia"	"Cystitis"	1	4213	1962	6175
"I47"	"N50"	"Paroxysmal tachycardia"	"Other and unspecified disorders of male genital organs"	1	195	99	294
"I48"	"C22"	"Atrial fibrillation and flutter"	"Malignant neoplasm of liver and intrahepatic bile ducts"	1	647	148	795
"I48"	"C24"	"Atrial fibrillation and flutter"	"Malignant neoplasm of other and unsp parts of biliary tract"	1	285	104	389
"I48"	"C26"	"Atrial fibrillation and flutter"	"Malignant neoplasm of other and ill-defined digestive organs"	1	79	19	98
"I48"	"C34"	"Atrial fibrillation and flutter"	"Malignant neoplasm of bronchus and lung"	1	4843	3439	8282
"I48"	"C71"	"Atrial fibrillation and flutter"	"Malignant neoplasm of brain"	1	491	250	741
"I48"	"C77"	"Atrial fibrillation and flutter"	"Secondary and unspecified malignant neoplasm of lymph nodes"	1	1228	843	2071
"I48"	"D46"	"Atrial fibrillation and flutter"	"Myelodysplastic syndromes"	1	593	318	911
"I48"	"D47"	"Atrial fibrillation and flutter"	"Oth neoplm of uncrt behav of lymphoid, hematpoetc & rel tiss"	1	838	494	1332
"I48"	"D63"	"Atrial fibrillation and flutter"	"Anemia in chronic diseases classified elsewhere"	1	3146	1343	4489
"I48"	"D64"	"Atrial fibrillation and flutter"	"Other anemias"	1	17135	11144	28279
"I48"	"E25"	"Atrial fibrillation and flutter"	"Adrenogenital disorders"	1	384	143	527
"I48"	"E27"	"Atrial fibrillation and flutter"	"Other disorders of adrenal gland"	1	464	268	732
"I48"	"E50"	"Atrial fibrillation and flutter"	"Vitamin A deficiency"	1	580	267	847
"I48"	"E55"	"Atrial fibrillation and flutter"	"Vitamin D deficiency"	1	1999	1209	3208
"I48"	"E87"	"Atrial fibrillation and flutter"	"Other disorders of fluid, electrolyte and acid-base balance"	1	10870	7365	18235
"I48"	"G23"	"Atrial fibrillation and flutter"	"Other degenerative diseases of basal ganglia"	1	111	28	139
"I48"	"G31"	"Atrial fibrillation and flutter"	"Oth degenerative diseases of nervous system, NEC"	1	775	369	1144
"I48"	"G95"	"Atrial fibrillation and flutter"	"Other and unspecified diseases of spinal cord"	1	686	443	1129
"I48"	"I08"	"Atrial fibrillation and flutter"	"Multiple valve diseases"	1	381	210	591
"I48"	"I11"	"Atrial fibrillation and flutter"	"Hypertensive heart disease"	1	4565	3639	8204
"I48"	"I36"	"Atrial fibrillation and flutter"	"Nonrheumatic tricuspid valve disorders"	1	960	515	1475
"I48"	"I46"	"Atrial fibrillation and flutter"	"Cardiac arrest"	1	8128	0	8128
"I48"	"I61"	"Atrial fibrillation and flutter"	"Nontraumatic intracerebral hemorrhage"	1	4129	2021	6150
"I48"	"I62"	"Atrial fibrillation and flutter"	"Other and unspecified nontraumatic intracranial hemorrhage"	1	592	188	780
"I48"	"J15"	"Atrial fibrillation and flutter"	"Bacterial pneumonia, not elsewhere classified"	1	15597	10242	25839
"I48"	"J69"	"Atrial fibrillation and flutter"	"Pneumonitis due to solids and liquids"	1	2011	897	2908
"I48"	"J90"	"Atrial fibrillation and flutter"	"Pleural effusion, not elsewhere classified"	1	5132	2903	8035
"I48"	"J94"	"Atrial fibrillation and flutter"	"Other pleural conditions"	1	1427	922	2349
"I48"	"K52"	"Atrial fibrillation and flutter"	"Other and unsp noninfective gastroenteritis and colitis"	1	3488	3000	6488
"I48"	"K55"	"Atrial fibrillation and flutter"	"Vascular disorders of intestine"	1	1481	757	2238
"I48"	"K72"	"Atrial fibrillation and flutter"	"Hepatic failure, not elsewhere classified"	1	914	443	1357
"I48"	"L97"	"Atrial fibrillation and flutter"	"Non-pressure chronic ulcer of lower limb, NEC"	1	4190	2053	6243
"I48"	"M10"	"Atrial fibrillation and flutter"	"Gout"	1	4931	3205	8136
"I48"	"N28"	"Atrial fibrillation and flutter"	"Oth disorders of kidney and ureter, not elsewhere classified"	1	2039	1033	3072
"I48"	"N30"	"Atrial fibrillation and flutter"	"Cystitis"	1	19985	17329	37314
"I48"	"N39"	"Atrial fibrillation and flutter"	"Other disorders of urinary system"	1	15967	11263	27230
"I49"	"C16"	"Other cardiac arrhythmias"	"Malignant neoplasm of stomach"	1	186	51	237
"I49"	"C22"	"Other cardiac arrhythmias"	"Malignant neoplasm of liver and intrahepatic bile ducts"	1	126	20	146
"I49"	"C44"	"Other cardiac arrhythmias"	"Other and unspecified malignant neoplasm of skin"	1	921	612	1533
"I49"	"C61"	"Other cardiac arrhythmias"	"Malignant neoplasm of prostate"	1	700	491	1191
"I49"	"C71"	"Other cardiac arrhythmias"	"Malignant neoplasm of brain"	1	135	34	169
"I49"	"C77"	"Other cardiac arrhythmias"	"Secondary and unspecified malignant neoplasm of lymph nodes"	1	303	109	412
"I49"	"C78"	"Other cardiac arrhythmias"	"Secondary malignant neoplasm of resp and digestive organs"	1	907	109	1016
"I49"	"C79"	"Other cardiac arrhythmias"	"Secondary malignant neoplasm of other and unspecified sites"	1	655	95	750
"I49"	"C80"	"Other cardiac arrhythmias"	"Malignant neoplasm without specification of site"	1	126	40	166
"I49"	"D09"	"Other cardiac arrhythmias"	"Carcinoma in situ of other and unspecified sites"	1	132	36	168
"I49"	"D46"	"Other cardiac arrhythmias"	"Myelodysplastic syndromes"	1	117	43	160
"I49"	"D63"	"Other cardiac arrhythmias"	"Anemia in chronic diseases classified elsewhere"	1	617	160	777
"I49"	"D64"	"Other cardiac arrhythmias"	"Other anemias"	1	3156	1594	4750
"I49"	"D68"	"Other cardiac arrhythmias"	"Other coagulation defects"	1	412	208	620
"I49"	"E50"	"Other cardiac arrhythmias"	"Vitamin A deficiency"	1	100	36	136
"I49"	"F41"	"Other cardiac arrhythmias"	"Other anxiety disorders"	1	599	371	970
"I49"	"G47"	"Other cardiac arrhythmias"	"Sleep disorders"	1	1011	525	1536
"I49"	"I33"	"Other cardiac arrhythmias"	"Acute and subacute endocarditis"	1	334	190	524
"I49"	"J15"	"Other cardiac arrhythmias"	"Bacterial pneumonia, not elsewhere classified"	1	2669	1177	3846
"I49"	"J91"	"Other cardiac arrhythmias"	"Pleural effusion in conditions classified elsewhere"	1	290	104	394
"I49"	"K59"	"Other cardiac arrhythmias"	"Other functional intestinal disorders"	1	2853	1544	4397
"I49"	"K92"	"Other cardiac arrhythmias"	"Other diseases of digestive system"	1	1307	845	2152
"I49"	"L89"	"Other cardiac arrhythmias"	"Pressure ulcer"	1	554	202	756
"I49"	"L97"	"Other cardiac arrhythmias"	"Non-pressure chronic ulcer of lower limb, NEC"	1	655	264	919
"I49"	"M10"	"Other cardiac arrhythmias"	"Gout"	1	817	611	1428
"I49"	"M81"	"Other cardiac arrhythmias"	"Osteoporosis without current pathological fracture"	1	1693	1138	2831
"I49"	"N17"	"Other cardiac arrhythmias"	"Acute kidney failure"	1	962	702	1664
"I50"	"A04"	"Heart failure"	"Other bacterial intestinal infections"	1	2302	1048	3350
"I50"	"A49"	"Heart failure"	"Bacterial infection of unspecified site"	1	4422	2075	6497
"I50"	"C15"	"Heart failure"	"Malignant neoplasm of esophagus"	1	437	192	629
"I50"	"C22"	"Heart failure"	"Malignant neoplasm of liver and intrahepatic bile ducts"	1	445	138	583
"I50"	"C24"	"Heart failure"	"Malignant neoplasm of other and unsp parts of biliary tract"	1	188	75	263
"I50"	"C34"	"Heart failure"	"Malignant neoplasm of bronchus and lung"	1	4159	2101	6260
"I50"	"C71"	"Heart failure"	"Malignant neoplasm of brain"	1	266	126	392
"I50"	"D09"	"Heart failure"	"Carcinoma in situ of other and unspecified sites"	1	248	138	386
"I50"	"D68"	"Heart failure"	"Other coagulation defects"	1	1339	760	2099
"I50"	"E16"	"Heart failure"	"Other disorders of pancreatic internal secretion"	1	2040	1530	3570
"I50"	"E25"	"Heart failure"	"Adrenogenital disorders"	1	489	156	645
"I50"	"E55"	"Heart failure"	"Vitamin D deficiency"	1	1386	979	2365
"I50"	"E86"	"Heart failure"	"Volume depletion"	1	29209	0	29209
"I50"	"E87"	"Heart failure"	"Other disorders of fluid, electrolyte and acid-base balance"	1	9051	6631	15682
"I50"	"F01"	"Heart failure"	"Vascular dementia"	1	1348	760	2108
"I50"	"F03"	"Heart failure"	"Unspecified dementia"	1	6987	4780	11767
"I50"	"F05"	"Heart failure"	"Delirium due to known physiological condition"	1	2867	1325	4192
"I50"	"F41"	"Heart failure"	"Other anxiety disorders"	1	1356	752	2108
"I50"	"G30"	"Heart failure"	"Alzheimer's disease"	1	1073	356	1429
"I50"	"G47"	"Heart failure"	"Sleep disorders"	1	2427	1597	4024
"I50"	"I11"	"Heart failure"	"Hypertensive heart disease"	1	4977	4315	9292
"I50"	"I13"	"Heart failure"	"Hypertensive heart and chronic kidney disease"	1	752	475	1227
"I50"	"I51"	"Heart failure"	"Complications and ill-defined descriptions of heart disease"	1	3251	2302	5553
"I50"	"J06"	"Heart failure"	"Acute upper resp infections of multiple and unsp sites"	1	521	274	795
"I50"	"J69"	"Heart failure"	"Pneumonitis due to solids and liquids"	1	1399	713	2112
"I50"	"J96"	"Heart failure"	"Respiratory failure, not elsewhere classified"	1	16251	12280	28531
"I50"	"K55"	"Heart failure"	"Vascular disorders of intestine"	1	1240	664	1904
"I50"	"K59"	"Heart failure"	"Other functional intestinal disorders"	1	8367	7128	15495
"I50"	"K64"	"Heart failure"	"Hemorrhoids and perianal venous thrombosis"	1	825	225	1050
"I50"	"M10"	"Heart failure"	"Gout"	1	5238	3418	8656
"I50"	"N08"	"Heart failure"	"Glomerular disorders in diseases classified elsewhere"	1	285	150	435
"I50"	"N18"	"Heart failure"	"Chronic kidney disease (CKD)"	1	19443	0	19443
"I51"	"O72"	"Complications and ill-defined descriptions of heart disease"	"Postpartum hemorrhage"	1	425	272	697
"I60"	"A41"	"Nontraumatic subarachnoid hemorrhage"	"Other sepsis"	1	500	197	697
"I60"	"C25"	"Nontraumatic subarachnoid hemorrhage"	"Malignant neoplasm of pancreas"	1	25	0	25
"I60"	"C34"	"Nontraumatic subarachnoid hemorrhage"	"Malignant neoplasm of bronchus and lung"	1	169	5	174
"I60"	"C79"	"Nontraumatic subarachnoid hemorrhage"	"Secondary malignant neoplasm of other and unspecified sites"	1	105	18	123
"I60"	"E86"	"Nontraumatic subarachnoid hemorrhage"	"Volume depletion"	1	468	176	644
"I60"	"G47"	"Nontraumatic subarachnoid hemorrhage"	"Sleep disorders"	1	162	52	214
"I60"	"G81"	"Nontraumatic subarachnoid hemorrhage"	"Hemiplegia and hemiparesis"	1	154	64	218
"I60"	"G97"	"Nontraumatic subarachnoid hemorrhage"	"Intraop and postproc comp and disorders of nervous sys, NEC"	1	115	27	142
"I60"	"H53"	"Nontraumatic subarachnoid hemorrhage"	"Visual disturbances"	1	409	149	558
"I61"	"A49"	"Nontraumatic intracerebral hemorrhage"	"Bacterial infection of unspecified site"	1	468	320	788
"I61"	"C78"	"Nontraumatic intracerebral hemorrhage"	"Secondary malignant neoplasm of resp and digestive organs"	1	237	120	357
"I61"	"F01"	"Nontraumatic intracerebral hemorrhage"	"Vascular dementia"	1	393	229	622
"I61"	"G40"	"Nontraumatic intracerebral hemorrhage"	"Epilepsy and recurrent seizures"	1	2928	2273	5201
"I61"	"G80"	"Nontraumatic intracerebral hemorrhage"	"Cerebral palsy"	1	139	56	195
"I61"	"I69"	"Nontraumatic intracerebral hemorrhage"	"Sequelae of cerebrovascular disease"	1	9445	5859	15304
"I61"	"J15"	"Nontraumatic intracerebral hemorrhage"	"Bacterial pneumonia, not elsewhere classified"	1	1291	1002	2293
"I61"	"J69"	"Nontraumatic intracerebral hemorrhage"	"Pneumonitis due to solids and liquids"	1	675	294	969
"I63"	"A41"	"Cerebral infarction"	"Other sepsis"	1	10650	0	10650
"I63"	"B37"	"Cerebral infarction"	"Candidiasis"	1	1026	712	1738
"I63"	"B96"	"Cerebral infarction"	"Oth bacterial agents as the cause of diseases classd elswhr"	1	325	117	442
"I63"	"C22"	"Cerebral infarction"	"Malignant neoplasm of liver and intrahepatic bile ducts"	1	226	47	273
"I63"	"C25"	"Cerebral infarction"	"Malignant neoplasm of pancreas"	1	458	166	624
"I63"	"C77"	"Cerebral infarction"	"Secondary and unspecified malignant neoplasm of lymph nodes"	1	515	307	822
"I63"	"C78"	"Cerebral infarction"	"Secondary malignant neoplasm of resp and digestive organs"	1	1770	464	2234
"I63"	"C80"	"Cerebral infarction"	"Malignant neoplasm without specification of site"	1	235	89	324
"I63"	"D09"	"Cerebral infarction"	"Carcinoma in situ of other and unspecified sites"	1	197	66	263
"I63"	"D46"	"Cerebral infarction"	"Myelodysplastic syndromes"	1	209	78	287
"I63"	"D47"	"Cerebral infarction"	"Oth neoplm of uncrt behav of lymphoid, hematpoetc & rel tiss"	1	433	232	665
"I63"	"D63"	"Cerebral infarction"	"Anemia in chronic diseases classified elsewhere"	1	1232	400	1632
"I63"	"E55"	"Cerebral infarction"	"Vitamin D deficiency"	1	1029	755	1784
"I63"	"E64"	"Cerebral infarction"	"Sequelae of malnutrition and other nutritional deficiencies"	1	976	416	1392
"I63"	"F03"	"Cerebral infarction"	"Unspecified dementia"	1	4821	2578	7399
"I63"	"F41"	"Cerebral infarction"	"Other anxiety disorders"	1	872	574	1446
"I63"	"G80"	"Cerebral infarction"	"Cerebral palsy"	1	366	159	525
"I63"	"I69"	"Cerebral infarction"	"Sequelae of cerebrovascular disease"	1	79822	0	79822
"I63"	"J69"	"Cerebral infarction"	"Pneumonitis due to solids and liquids"	1	2167	775	2942
"I63"	"J95"	"Cerebral infarction"	"Intraop and postproc comp and disorders of resp sys, NEC"	1	254	125	379
"I63"	"K56"	"Cerebral infarction"	"Paralytic ileus and intestinal obstruction without hernia"	1	1412	1069	2481
"I63"	"K63"	"Cerebral infarction"	"Other diseases of intestine"	1	573	323	896
"I63"	"K64"	"Cerebral infarction"	"Hemorrhoids and perianal venous thrombosis"	1	778	128	906
"I63"	"L89"	"Cerebral infarction"	"Pressure ulcer"	1	1996	596	2592
"I63"	"L97"	"Cerebral infarction"	"Non-pressure chronic ulcer of lower limb, NEC"	1	1516	863	2379
"I63"	"N18"	"Cerebral infarction"	"Chronic kidney disease (CKD)"	1	3624	1584	5208
"I63"	"N19"	"Cerebral infarction"	"Unspecified kidney failure"	1	1795	956	2751
"I63"	"N28"	"Cerebral infarction"	"Oth disorders of kidney and ureter, not elsewhere classified"	1	627	378	1005
"I63"	"N39"	"Cerebral infarction"	"Other disorders of urinary system"	1	8989	6113	15102
"I63"	"Q21"	"Cerebral infarction"	"Congenital malformations of cardiac septa"	1	670	337	1007
"I65"	"A41"	"Occls and stenosis of precerb art, not rslt in cereb infrc"	"Other sepsis"	1	930	35	965
"I65"	"C15"	"Occls and stenosis of precerb art, not rslt in cereb infrc"	"Malignant neoplasm of esophagus"	1	62	4	66
"I65"	"C16"	"Occls and stenosis of precerb art, not rslt in cereb infrc"	"Malignant neoplasm of stomach"	1	64	5	69
"I65"	"C25"	"Occls and stenosis of precerb art, not rslt in cereb infrc"	"Malignant neoplasm of pancreas"	1	81	2	83
"I65"	"C61"	"Occls and stenosis of precerb art, not rslt in cereb infrc"	"Malignant neoplasm of prostate"	1	242	84	326
"I65"	"C78"	"Occls and stenosis of precerb art, not rslt in cereb infrc"	"Secondary malignant neoplasm of resp and digestive organs"	1	257	1	258
"I65"	"D50"	"Occls and stenosis of precerb art, not rslt in cereb infrc"	"Iron deficiency anemia"	1	365	81	446
"I65"	"D63"	"Occls and stenosis of precerb art, not rslt in cereb infrc"	"Anemia in chronic diseases classified elsewhere"	1	179	7	186
"I65"	"F01"	"Occls and stenosis of precerb art, not rslt in cereb infrc"	"Vascular dementia"	1	228	1	229
"I65"	"F32"	"Occls and stenosis of precerb art, not rslt in cereb infrc"	"Depressive episode"	1	438	148	586
"I65"	"G40"	"Occls and stenosis of precerb art, not rslt in cereb infrc"	"Epilepsy and recurrent seizures"	1	595	305	900
"I65"	"G96"	"Occls and stenosis of precerb art, not rslt in cereb infrc"	"Other disorders of central nervous system"	1	354	170	524
"I65"	"H35"	"Occls and stenosis of precerb art, not rslt in cereb infrc"	"Other retinal disorders"	1	503	268	771
"I65"	"I26"	"Occls and stenosis of precerb art, not rslt in cereb infrc"	"Pulmonary embolism"	1	190	56	246
"I65"	"I49"	"Occls and stenosis of precerb art, not rslt in cereb infrc"	"Other cardiac arrhythmias"	1	365	215	580
"I65"	"I61"	"Occls and stenosis of precerb art, not rslt in cereb infrc"	"Nontraumatic intracerebral hemorrhage"	1	302	110	412
"I65"	"I71"	"Occls and stenosis of precerb art, not rslt in cereb infrc"	"Aortic aneurysm and dissection"	1	393	155	548
"I65"	"I95"	"Occls and stenosis of precerb art, not rslt in cereb infrc"	"Hypotension"	1	386	122	508
"I65"	"J96"	"Occls and stenosis of precerb art, not rslt in cereb infrc"	"Respiratory failure, not elsewhere classified"	1	785	28	813
"I65"	"K55"	"Occls and stenosis of precerb art, not rslt in cereb infrc"	"Vascular disorders of intestine"	1	168	15	183
"I65"	"K56"	"Occls and stenosis of precerb art, not rslt in cereb infrc"	"Paralytic ileus and intestinal obstruction without hernia"	1	199	58	257
"I65"	"K83"	"Occls and stenosis of precerb art, not rslt in cereb infrc"	"Other diseases of biliary tract"	1	67	21	88
"I65"	"M81"	"Occls and stenosis of precerb art, not rslt in cereb infrc"	"Osteoporosis without current pathological fracture"	1	507	182	689
"I65"	"N13"	"Occls and stenosis of precerb art, not rslt in cereb infrc"	"Obstructive and reflux uropathy"	1	146	52	198
"I67"	"C16"	"Other cerebrovascular diseases"	"Malignant neoplasm of stomach"	1	35	3	38
"I67"	"C78"	"Other cerebrovascular diseases"	"Secondary malignant neoplasm of resp and digestive organs"	1	147	19	166
"I67"	"C79"	"Other cerebrovascular diseases"	"Secondary malignant neoplasm of other and unspecified sites"	1	133	41	174
"I67"	"D63"	"Other cerebrovascular diseases"	"Anemia in chronic diseases classified elsewhere"	1	131	34	165
"I69"	"A04"	"Sequelae of cerebrovascular disease"	"Other bacterial intestinal infections"	1	1788	918	2706
"I69"	"A41"	"Sequelae of cerebrovascular disease"	"Other sepsis"	1	9335	5001	14336
"I69"	"A49"	"Sequelae of cerebrovascular disease"	"Bacterial infection of unspecified site"	1	3437	1704	5141
"I69"	"B96"	"Sequelae of cerebrovascular disease"	"Oth bacterial agents as the cause of diseases classd elswhr"	1	395	220	615
"I69"	"C24"	"Sequelae of cerebrovascular disease"	"Malignant neoplasm of other and unsp parts of biliary tract"	1	125	48	173
"I69"	"C34"	"Sequelae of cerebrovascular disease"	"Malignant neoplasm of bronchus and lung"	1	2352	938	3290
"I69"	"C78"	"Sequelae of cerebrovascular disease"	"Secondary malignant neoplasm of resp and digestive organs"	1	1637	494	2131
"I69"	"D63"	"Sequelae of cerebrovascular disease"	"Anemia in chronic diseases classified elsewhere"	1	1397	742	2139
"I69"	"E41"	"Sequelae of cerebrovascular disease"	"Nutritional marasmus"	1	394	163	557
"I69"	"E64"	"Sequelae of cerebrovascular disease"	"Sequelae of malnutrition and other nutritional deficiencies"	1	1098	798	1896
"I69"	"G30"	"Sequelae of cerebrovascular disease"	"Alzheimer's disease"	1	1242	790	2032
"I69"	"I46"	"Sequelae of cerebrovascular disease"	"Cardiac arrest"	1	2205	626	2831
"I69"	"J15"	"Sequelae of cerebrovascular disease"	"Bacterial pneumonia, not elsewhere classified"	1	7569	4758	12327
"I69"	"J69"	"Sequelae of cerebrovascular disease"	"Pneumonitis due to solids and liquids"	1	2509	1125	3634
"I69"	"J81"	"Sequelae of cerebrovascular disease"	"Pulmonary edema"	1	2053	1059	3112
"I69"	"J96"	"Sequelae of cerebrovascular disease"	"Respiratory failure, not elsewhere classified"	1	6571	3247	9818
"I69"	"K64"	"Sequelae of cerebrovascular disease"	"Hemorrhoids and perianal venous thrombosis"	1	815	179	994
"I69"	"K92"	"Sequelae of cerebrovascular disease"	"Other diseases of digestive system"	1	4144	3599	7743
"I69"	"L12"	"Sequelae of cerebrovascular disease"	"Pemphigoid"	1	217	106	323
"I69"	"L89"	"Sequelae of cerebrovascular disease"	"Pressure ulcer"	1	2425	1152	3577
"I69"	"N17"	"Sequelae of cerebrovascular disease"	"Acute kidney failure"	1	1689	1146	2835
"I69"	"N18"	"Sequelae of cerebrovascular disease"	"Chronic kidney disease (CKD)"	1	3874	2657	6531
"I69"	"N28"	"Sequelae of cerebrovascular disease"	"Oth disorders of kidney and ureter, not elsewhere classified"	1	790	554	1344
"I70"	"A04"	"Atherosclerosis"	"Other bacterial intestinal infections"	1	1089	331	1420
"I70"	"A09"	"Atherosclerosis"	"Infectious gastroenteritis and colitis, unspecified"	1	1662	1330	2992
"I70"	"A40"	"Atherosclerosis"	"Streptococcal sepsis"	1	330	179	509
"I70"	"A41"	"Atherosclerosis"	"Other sepsis"	1	8971	0	8971
"I70"	"A49"	"Atherosclerosis"	"Bacterial infection of unspecified site"	1	2523	750	3273
"I70"	"B96"	"Atherosclerosis"	"Oth bacterial agents as the cause of diseases classd elswhr"	1	277	67	344
"I70"	"C15"	"Atherosclerosis"	"Malignant neoplasm of esophagus"	1	386	45	431
"I70"	"C16"	"Atherosclerosis"	"Malignant neoplasm of stomach"	1	340	76	416
"I70"	"C18"	"Atherosclerosis"	"Malignant neoplasm of colon"	1	960	643	1603
"I70"	"C24"	"Atherosclerosis"	"Malignant neoplasm of other and unsp parts of biliary tract"	1	110	21	131
"I70"	"C45"	"Atherosclerosis"	"Mesothelioma"	1	60	12	72
"I70"	"C67"	"Atherosclerosis"	"Malignant neoplasm of bladder"	1	534	377	911
"I70"	"C92"	"Atherosclerosis"	"Myeloid leukemia"	1	140	43	183
"I70"	"D12"	"Atherosclerosis"	"Benign neoplasm of colon, rectum, anus and anal canal"	1	1759	1415	3174
"I70"	"D63"	"Atherosclerosis"	"Anemia in chronic diseases classified elsewhere"	1	1182	345	1527
"I70"	"E25"	"Atherosclerosis"	"Adrenogenital disorders"	1	190	49	239
"I70"	"E50"	"Atherosclerosis"	"Vitamin A deficiency"	1	163	68	231
"I70"	"E64"	"Atherosclerosis"	"Sequelae of malnutrition and other nutritional deficiencies"	1	510	191	701
"I70"	"E87"	"Atherosclerosis"	"Other disorders of fluid, electrolyte and acid-base balance"	1	3756	1413	5169
"I70"	"G47"	"Atherosclerosis"	"Sleep disorders"	1	891	341	1232
"I70"	"I11"	"Atherosclerosis"	"Hypertensive heart disease"	1	1213	949	2162
"I70"	"I33"	"Atherosclerosis"	"Acute and subacute endocarditis"	1	323	197	520
"I70"	"I46"	"Atherosclerosis"	"Cardiac arrest"	1	2685	0	2685
"I70"	"I50"	"Atherosclerosis"	"Heart failure"	1	9275	7923	17198
"I70"	"I61"	"Atherosclerosis"	"Nontraumatic intracerebral hemorrhage"	1	998	430	1428
"I70"	"I69"	"Atherosclerosis"	"Sequelae of cerebrovascular disease"	1	5608	4255	9863
"I70"	"I72"	"Atherosclerosis"	"Other aneurysm"	1	1163	779	1942
"I70"	"I77"	"Atherosclerosis"	"Other disorders of arteries and arterioles"	1	428	279	707
"I70"	"J15"	"Atherosclerosis"	"Bacterial pneumonia, not elsewhere classified"	1	6219	0	6219
"I70"	"J69"	"Atherosclerosis"	"Pneumonitis due to solids and liquids"	1	639	85	724
"I70"	"J80"	"Atherosclerosis"	"Acute respiratory distress syndrome"	1	86	29	115
"I70"	"J90"	"Atherosclerosis"	"Pleural effusion, not elsewhere classified"	1	1200	413	1613
"I70"	"J93"	"Atherosclerosis"	"Pneumothorax and air leak"	1	436	203	639
"I70"	"J96"	"Atherosclerosis"	"Respiratory failure, not elsewhere classified"	1	6658	0	6658
"I70"	"K22"	"Atherosclerosis"	"Other diseases of esophagus"	1	670	463	1133
"I70"	"K55"	"Atherosclerosis"	"Vascular disorders of intestine"	1	1385	617	2002
"I70"	"K63"	"Atherosclerosis"	"Other diseases of intestine"	1	684	270	954
"I70"	"K83"	"Atherosclerosis"	"Other diseases of biliary tract"	1	467	245	712
"I70"	"K92"	"Atherosclerosis"	"Other diseases of digestive system"	1	3139	1562	4701
"I70"	"M81"	"Atherosclerosis"	"Osteoporosis without current pathological fracture"	1	2490	1849	4339
"I70"	"M86"	"Atherosclerosis"	"Osteomyelitis"	1	907	686	1593
"I70"	"N19"	"Atherosclerosis"	"Unspecified kidney failure"	1	2403	1421	3824
"I70"	"N30"	"Atherosclerosis"	"Cystitis"	1	6594	3986	10580
"I71"	"C79"	"Aortic aneurysm and dissection"	"Secondary malignant neoplasm of other and unspecified sites"	1	528	157	685
"I71"	"E86"	"Aortic aneurysm and dissection"	"Volume depletion"	1	2300	1077	3377
"I71"	"F41"	"Aortic aneurysm and dissection"	"Other anxiety disorders"	1	288	139	427
"I71"	"J96"	"Aortic aneurysm and dissection"	"Respiratory failure, not elsewhere classified"	1	2578	1262	3840
"I71"	"K55"	"Aortic aneurysm and dissection"	"Vascular disorders of intestine"	1	517	327	844
"I71"	"N18"	"Aortic aneurysm and dissection"	"Chronic kidney disease (CKD)"	1	2083	996	3079
"I71"	"N19"	"Aortic aneurysm and dissection"	"Unspecified kidney failure"	1	1013	565	1578
"I72"	"C79"	"Other aneurysm"	"Secondary malignant neoplasm of other and unspecified sites"	1	115	17	132
"I72"	"D63"	"Other aneurysm"	"Anemia in chronic diseases classified elsewhere"	1	96	35	131
"I73"	"A04"	"Other peripheral vascular diseases"	"Other bacterial intestinal infections"	1	767	199	966
"I73"	"C15"	"Other peripheral vascular diseases"	"Malignant neoplasm of esophagus"	1	296	44	340
"I73"	"C16"	"Other peripheral vascular diseases"	"Malignant neoplasm of stomach"	1	239	53	292
"I73"	"C18"	"Other peripheral vascular diseases"	"Malignant neoplasm of colon"	1	621	430	1051
"I73"	"C78"	"Other peripheral vascular diseases"	"Secondary malignant neoplasm of resp and digestive organs"	1	1385	121	1506
"I73"	"D46"	"Other peripheral vascular diseases"	"Myelodysplastic syndromes"	1	151	41	192
"I73"	"D47"	"Other peripheral vascular diseases"	"Oth neoplm of uncrt behav of lymphoid, hematpoetc & rel tiss"	1	380	145	525
"I73"	"D50"	"Other peripheral vascular diseases"	"Iron deficiency anemia"	1	1488	607	2095
"I73"	"D64"	"Other peripheral vascular diseases"	"Other anemias"	1	4157	1803	5960
"I73"	"E25"	"Other peripheral vascular diseases"	"Adrenogenital disorders"	1	115	37	152
"I73"	"E87"	"Other peripheral vascular diseases"	"Other disorders of fluid, electrolyte and acid-base balance"	1	2885	939	3824
"I73"	"F32"	"Other peripheral vascular diseases"	"Depressive episode"	1	906	682	1588
"I73"	"G20"	"Other peripheral vascular diseases"	"Parkinson's disease"	1	286	92	378
"I73"	"G47"	"Other peripheral vascular diseases"	"Sleep disorders"	1	1016	477	1493
"I73"	"G96"	"Other peripheral vascular diseases"	"Other disorders of central nervous system"	1	670	265	935
"I73"	"I27"	"Other peripheral vascular diseases"	"Other pulmonary heart diseases"	1	425	221	646
"I73"	"I51"	"Other peripheral vascular diseases"	"Complications and ill-defined descriptions of heart disease"	1	549	296	845
"I73"	"I61"	"Other peripheral vascular diseases"	"Nontraumatic intracerebral hemorrhage"	1	491	207	698
"I73"	"I95"	"Other peripheral vascular diseases"	"Hypotension"	1	1029	416	1445
"I73"	"I97"	"Other peripheral vascular diseases"	"Intraop and postproc comp and disorders of circ sys, NEC"	1	243	116	359
"I73"	"J18"	"Other peripheral vascular diseases"	"Pneumonia, unspecified organism"	1	6754	3956	10710
"I73"	"J69"	"Other peripheral vascular diseases"	"Pneumonitis due to solids and liquids"	1	411	27	438
"I73"	"J96"	"Other peripheral vascular diseases"	"Respiratory failure, not elsewhere classified"	1	4787	0	4787
"I73"	"K52"	"Other peripheral vascular diseases"	"Other and unsp noninfective gastroenteritis and colitis"	1	1022	723	1745
"I73"	"K55"	"Other peripheral vascular diseases"	"Vascular disorders of intestine"	1	810	237	1047
"I73"	"K56"	"Other peripheral vascular diseases"	"Paralytic ileus and intestinal obstruction without hernia"	1	901	548	1449
"I73"	"L89"	"Other peripheral vascular diseases"	"Pressure ulcer"	1	1215	302	1517
"I73"	"L97"	"Other peripheral vascular diseases"	"Non-pressure chronic ulcer of lower limb, NEC"	1	3033	1541	4574
"I73"	"M85"	"Other peripheral vascular diseases"	"Other disorders of bone density and structure"	1	685	444	1129
"I73"	"N18"	"Other peripheral vascular diseases"	"Chronic kidney disease (CKD)"	1	3098	1177	4275
"I73"	"N19"	"Other peripheral vascular diseases"	"Unspecified kidney failure"	1	1199	695	1894
"I73"	"N28"	"Other peripheral vascular diseases"	"Oth disorders of kidney and ureter, not elsewhere classified"	1	584	227	811
"I73"	"O72"	"Other peripheral vascular diseases"	"Postpartum hemorrhage"	1	148	55	203
"I74"	"A41"	"Arterial embolism and thrombosis"	"Other sepsis"	1	941	541	1482
"I74"	"D68"	"Arterial embolism and thrombosis"	"Other coagulation defects"	1	401	151	552
"I74"	"E86"	"Arterial embolism and thrombosis"	"Volume depletion"	1	809	459	1268
"I74"	"I46"	"Arterial embolism and thrombosis"	"Cardiac arrest"	1	311	102	413
"I74"	"L89"	"Arterial embolism and thrombosis"	"Pressure ulcer"	1	295	120	415
"I74"	"N39"	"Arterial embolism and thrombosis"	"Other disorders of urinary system"	1	583	409	992
"I77"	"A41"	"Other disorders of arteries and arterioles"	"Other sepsis"	1	242	137	379
"I77"	"C78"	"Other disorders of arteries and arterioles"	"Secondary malignant neoplasm of resp and digestive organs"	1	52	8	60
"I78"	"E87"	"Diseases of capillaries"	"Other disorders of fluid, electrolyte and acid-base balance"	1	238	52	290
"I78"	"K59"	"Diseases of capillaries"	"Other functional intestinal disorders"	1	378	193	571
"I78"	"N39"	"Diseases of capillaries"	"Other disorders of urinary system"	1	378	171	549
"I80"	"A26"	"Phlebitis and thrombophlebitis"	"Erysipeloid"	1	193	45	238
"I80"	"A40"	"Phlebitis and thrombophlebitis"	"Streptococcal sepsis"	1	280	141	421
"I80"	"C10"	"Phlebitis and thrombophlebitis"	"Malignant neoplasm of oropharynx"	1	59	10	69
"I80"	"C34"	"Phlebitis and thrombophlebitis"	"Malignant neoplasm of bronchus and lung"	1	1359	762	2121
"I80"	"D09"	"Phlebitis and thrombophlebitis"	"Carcinoma in situ of other and unspecified sites"	1	92	31	123
"I80"	"D12"	"Phlebitis and thrombophlebitis"	"Benign neoplasm of colon, rectum, anus and anal canal"	1	1648	922	2570
"I80"	"E64"	"Phlebitis and thrombophlebitis"	"Sequelae of malnutrition and other nutritional deficiencies"	1	292	95	387
"I80"	"E72"	"Phlebitis and thrombophlebitis"	"Other disorders of amino-acid metabolism"	1	149	41	190
"I80"	"F33"	"Phlebitis and thrombophlebitis"	"Major depressive disorder, recurrent"	1	731	297	1028
"I80"	"F41"	"Phlebitis and thrombophlebitis"	"Other anxiety disorders"	1	897	291	1188
"I80"	"G47"	"Phlebitis and thrombophlebitis"	"Sleep disorders"	1	1475	518	1993
"I80"	"I27"	"Phlebitis and thrombophlebitis"	"Other pulmonary heart diseases"	1	601	214	815
"I80"	"I33"	"Phlebitis and thrombophlebitis"	"Acute and subacute endocarditis"	1	236	100	336
"I80"	"I44"	"Phlebitis and thrombophlebitis"	"Atrioventricular and left bundle-branch block"	1	613	331	944
"I80"	"I63"	"Phlebitis and thrombophlebitis"	"Cerebral infarction"	1	2310	1411	3721
"I80"	"I69"	"Phlebitis and thrombophlebitis"	"Sequelae of cerebrovascular disease"	1	2695	1585	4280
"I80"	"I72"	"Phlebitis and thrombophlebitis"	"Other aneurysm"	1	360	231	591
"I80"	"I73"	"Phlebitis and thrombophlebitis"	"Other peripheral vascular diseases"	1	1485	941	2426
"I80"	"I87"	"Phlebitis and thrombophlebitis"	"Other disorders of veins"	1	3072	0	3072
"I80"	"J47"	"Phlebitis and thrombophlebitis"	"Bronchiectasis"	1	122	48	170
"I80"	"J95"	"Phlebitis and thrombophlebitis"	"Intraop and postproc comp and disorders of resp sys, NEC"	1	153	45	198
"I80"	"J96"	"Phlebitis and thrombophlebitis"	"Respiratory failure, not elsewhere classified"	1	4232	0	4232
"I80"	"K52"	"Phlebitis and thrombophlebitis"	"Other and unsp noninfective gastroenteritis and colitis"	1	1051	723	1774
"I80"	"K57"	"Phlebitis and thrombophlebitis"	"Diverticular disease of intestine"	1	1738	1236	2974
"I80"	"K64"	"Phlebitis and thrombophlebitis"	"Hemorrhoids and perianal venous thrombosis"	1	675	33	708
"I80"	"K83"	"Phlebitis and thrombophlebitis"	"Other diseases of biliary tract"	1	346	201	547
"I80"	"L30"	"Phlebitis and thrombophlebitis"	"Other and unspecified dermatitis"	1	539	382	921
"I80"	"L97"	"Phlebitis and thrombophlebitis"	"Non-pressure chronic ulcer of lower limb, NEC"	1	1654	410	2064
"I80"	"L98"	"Phlebitis and thrombophlebitis"	"Oth disorders of skin, subcu, not elsewhere classified"	1	1013	382	1395
"I80"	"M66"	"Phlebitis and thrombophlebitis"	"Spontaneous rupture of synovium and tendon"	1	772	395	1167
"I80"	"M71"	"Phlebitis and thrombophlebitis"	"Other bursopathies"	1	1156	880	2036
"I80"	"M79"	"Phlebitis and thrombophlebitis"	"Oth and unsp soft tissue disorders, not elsewhere classified"	1	4940	4413	9353
"I80"	"M81"	"Phlebitis and thrombophlebitis"	"Osteoporosis without current pathological fracture"	1	2209	1119	3328
"I80"	"O72"	"Phlebitis and thrombophlebitis"	"Postpartum hemorrhage"	1	735	446	1181
"I81"	"D68"	"Portal vein thrombosis"	"Other coagulation defects"	1	139	59	198
"I82"	"D68"	"Other venous embolism and thrombosis"	"Other coagulation defects"	1	939	365	1304
"I82"	"I87"	"Other venous embolism and thrombosis"	"Other disorders of veins"	1	438	246	684
"I83"	"A04"	"Varicose veins of lower extremities"	"Other bacterial intestinal infections"	1	482	90	572
"I83"	"A26"	"Varicose veins of lower extremities"	"Erysipeloid"	1	141	32	173
"I83"	"B02"	"Varicose veins of lower extremities"	"Zoster [herpes zoster]"	1	230	95	325
"I83"	"B44"	"Varicose veins of lower extremities"	"Aspergillosis"	1	29	0	29
"I83"	"C13"	"Varicose veins of lower extremities"	"Malignant neoplasm of hypopharynx"	1	34	3	37
"I83"	"C14"	"Varicose veins of lower extremities"	"Malig neoplasm of sites in the lip, oral cavity and pharynx"	1	28	0	28
"I83"	"C16"	"Varicose veins of lower extremities"	"Malignant neoplasm of stomach"	1	231	0	231
"I83"	"C18"	"Varicose veins of lower extremities"	"Malignant neoplasm of colon"	1	956	82	1038
"I83"	"C22"	"Varicose veins of lower extremities"	"Malignant neoplasm of liver and intrahepatic bile ducts"	1	170	0	170
"I83"	"C24"	"Varicose veins of lower extremities"	"Malignant neoplasm of other and unsp parts of biliary tract"	1	92	0	92
"I83"	"C34"	"Varicose veins of lower extremities"	"Malignant neoplasm of bronchus and lung"	1	1315	0	1315
"I83"	"C38"	"Varicose veins of lower extremities"	"Malignant neoplasm of heart, mediastinum and pleura"	1	33	0	33
"I83"	"C44"	"Varicose veins of lower extremities"	"Other and unspecified malignant neoplasm of skin"	1	1604	312	1916
"I83"	"C45"	"Varicose veins of lower extremities"	"Mesothelioma"	1	42	0	42
"I83"	"C48"	"Varicose veins of lower extremities"	"Malignant neoplasm of retroperitoneum and peritoneum"	1	26	0	26
"I83"	"C50"	"Varicose veins of lower extremities"	"Malignant neoplasm of breast"	1	1431	615	2046
"I83"	"C56"	"Varicose veins of lower extremities"	"Malignant neoplasm of ovary"	1	254	58	312
"I83"	"C61"	"Varicose veins of lower extremities"	"Malignant neoplasm of prostate"	1	1022	41	1063
"I83"	"C80"	"Varicose veins of lower extremities"	"Malignant neoplasm without specification of site"	1	146	0	146
"I83"	"C82"	"Varicose veins of lower extremities"	"Follicular lymphoma"	1	73	24	97
"I83"	"C85"	"Varicose veins of lower extremities"	"Oth and unspecified types of non-Hodgkin lymphoma"	1	198	50	248
"I83"	"C88"	"Varicose veins of lower extremities"	"Malig immunoproliferative dis and certain oth B-cell lymph"	1	62	5	67
"I83"	"C90"	"Varicose veins of lower extremities"	"Multiple myeloma and malignant plasma cell neoplasms"	1	165	0	165
"I83"	"C91"	"Varicose veins of lower extremities"	"Lymphoid leukemia"	1	177	33	210
"I83"	"D05"	"Varicose veins of lower extremities"	"Carcinoma in situ of breast"	1	155	37	192
"I83"	"D10"	"Varicose veins of lower extremities"	"Benign neoplasm of mouth and pharynx"	1	221	89	310
"I83"	"D13"	"Varicose veins of lower extremities"	"Benign neoplasm of and ill-defined parts of digestive system"	1	238	57	295
"I83"	"D21"	"Varicose veins of lower extremities"	"Other benign neoplasms of connective and other soft tissue"	1	228	110	338
"I83"	"D22"	"Varicose veins of lower extremities"	"Melanocytic nevi"	1	478	190	668
"I83"	"D35"	"Varicose veins of lower extremities"	"Benign neoplasm of other and unspecified endocrine glands"	1	198	39	237
"I83"	"D50"	"Varicose veins of lower extremities"	"Iron deficiency anemia"	1	1272	292	1564
"I83"	"D62"	"Varicose veins of lower extremities"	"Acute posthemorrhagic anemia"	1	592	197	789
"I83"	"D63"	"Varicose veins of lower extremities"	"Anemia in chronic diseases classified elsewhere"	1	627	28	655
"I83"	"D64"	"Varicose veins of lower extremities"	"Other anemias"	1	4346	0	4346
"I83"	"D69"	"Varicose veins of lower extremities"	"Purpura and other hemorrhagic conditions"	1	377	185	562
"I83"	"D75"	"Varicose veins of lower extremities"	"Other and unsp diseases of blood and blood-forming organs"	1	156	75	231
"I83"	"D84"	"Varicose veins of lower extremities"	"Other immunodeficiencies"	1	53	5	58
"I83"	"E03"	"Varicose veins of lower extremities"	"Other hypothyroidism"	1	1348	533	1881
"I83"	"E05"	"Varicose veins of lower extremities"	"Thyrotoxicosis [hyperthyroidism]"	1	1028	710	1738
"I83"	"E11"	"Varicose veins of lower extremities"	"Type 2 diabetes mellitus"	1	2788	1948	4736
"I83"	"E16"	"Varicose veins of lower extremities"	"Other disorders of pancreatic internal secretion"	1	372	198	570
"I83"	"E23"	"Varicose veins of lower extremities"	"Hypofunction and other disorders of the pituitary gland"	1	114	42	156
"I83"	"E34"	"Varicose veins of lower extremities"	"Other endocrine disorders"	1	125	11	136
"I83"	"E55"	"Varicose veins of lower extremities"	"Vitamin D deficiency"	1	456	64	520
"I83"	"E61"	"Varicose veins of lower extremities"	"Deficiency of other nutrient elements"	1	57	9	66
"I83"	"E64"	"Varicose veins of lower extremities"	"Sequelae of malnutrition and other nutritional deficiencies"	1	269	33	302
"I83"	"E87"	"Varicose veins of lower extremities"	"Other disorders of fluid, electrolyte and acid-base balance"	1	2244	0	2244
"I83"	"E89"	"Varicose veins of lower extremities"	"Postproc endocrine and metabolic comp and disorders, NEC"	1	179	74	253
"I83"	"F02"	"Varicose veins of lower extremities"	"Dementia in other diseases classified elsewhere"	1	88	6	94
"I83"	"F03"	"Varicose veins of lower extremities"	"Unspecified dementia"	1	1749	0	1749
"I83"	"F05"	"Varicose veins of lower extremities"	"Delirium due to known physiological condition"	1	604	0	604
"I83"	"F06"	"Varicose veins of lower extremities"	"Other mental disorders due to known physiological condition"	1	195	5	200
"I83"	"F17"	"Varicose veins of lower extremities"	"Nicotine dependence"	1	941	537	1478
"I83"	"F31"	"Varicose veins of lower extremities"	"Bipolar disorder"	1	96	31	127
"I83"	"F33"	"Varicose veins of lower extremities"	"Major depressive disorder, recurrent"	1	620	39	659
"I83"	"F34"	"Varicose veins of lower extremities"	"Persistent mood [affective] disorders"	1	95	21	116
"I83"	"G12"	"Varicose veins of lower extremities"	"Spinal muscular atrophy and related syndromes"	1	78	0	78
"I83"	"G24"	"Varicose veins of lower extremities"	"Dystonia"	1	93	27	120
"I83"	"G25"	"Varicose veins of lower extremities"	"Other extrapyramidal and movement disorders"	1	217	40	257
"I83"	"G30"	"Varicose veins of lower extremities"	"Alzheimer's disease"	1	286	0	286
"I83"	"G31"	"Varicose veins of lower extremities"	"Oth degenerative diseases of nervous system, NEC"	1	170	18	188
"I83"	"G45"	"Varicose veins of lower extremities"	"Transient cerebral ischemic attacks and related syndromes"	1	1482	579	2061
"I83"	"G47"	"Varicose veins of lower extremities"	"Sleep disorders"	1	1491	239	1730
"I83"	"G56"	"Varicose veins of lower extremities"	"Mononeuropathies of upper limb"	1	1936	1117	3053
"I83"	"G62"	"Varicose veins of lower extremities"	"Other and unspecified polyneuropathies"	1	830	251	1081
"I83"	"G63"	"Varicose veins of lower extremities"	"Polyneuropathy in diseases classified elsewhere"	1	122	44	166
"I83"	"G91"	"Varicose veins of lower extremities"	"Hydrocephalus"	1	145	9	154
"I83"	"G96"	"Varicose veins of lower extremities"	"Other disorders of central nervous system"	1	548	33	581
"I83"	"G98"	"Varicose veins of lower extremities"	"Other disorders of nervous system not elsewhere classified"	1	132	0	132
"I83"	"H01"	"Varicose veins of lower extremities"	"Other inflammation of eyelid"	1	166	27	193
"I83"	"H04"	"Varicose veins of lower extremities"	"Disorders of lacrimal system"	1	212	74	286
"I83"	"H26"	"Varicose veins of lower extremities"	"Other cataract"	1	1612	546	2158
"I83"	"H33"	"Varicose veins of lower extremities"	"Retinal detachments and breaks"	1	449	186	635
"I83"	"H43"	"Varicose veins of lower extremities"	"Disorders of vitreous body"	1	560	166	726
"I83"	"H54"	"Varicose veins of lower extremities"	"Blindness and low vision"	1	222	63	285
"I83"	"H57"	"Varicose veins of lower extremities"	"Other disorders of eye and adnexa"	1	335	100	435
"I83"	"H91"	"Varicose veins of lower extremities"	"Other and unspecified hearing loss"	1	3842	2212	6054
"I83"	"I10"	"Varicose veins of lower extremities"	"Essential (primary) hypertension"	1	14273	0	14273
"I83"	"I15"	"Varicose veins of lower extremities"	"Secondary hypertension"	1	352	142	494
"I83"	"I33"	"Varicose veins of lower extremities"	"Acute and subacute endocarditis"	1	176	46	222
"I83"	"I34"	"Varicose veins of lower extremities"	"Nonrheumatic mitral valve disorders"	1	695	215	910
"I83"	"I42"	"Varicose veins of lower extremities"	"Cardiomyopathy"	1	502	151	653
"I83"	"I44"	"Varicose veins of lower extremities"	"Atrioventricular and left bundle-branch block"	1	740	184	924
"I83"	"I45"	"Varicose veins of lower extremities"	"Other conduction disorders"	1	276	135	411
"I83"	"I47"	"Varicose veins of lower extremities"	"Paroxysmal tachycardia"	1	967	734	1701
"I83"	"I49"	"Varicose veins of lower extremities"	"Other cardiac arrhythmias"	1	1382	493	1875
"I83"	"I50"	"Varicose veins of lower extremities"	"Heart failure"	1	4184	1945	6129
"I83"	"I60"	"Varicose veins of lower extremities"	"Nontraumatic subarachnoid hemorrhage"	1	217	61	278
"I83"	"I61"	"Varicose veins of lower extremities"	"Nontraumatic intracerebral hemorrhage"	1	702	49	751
"I83"	"I65"	"Varicose veins of lower extremities"	"Occls and stenosis of precerb art, not rslt in cereb infrc"	1	217	111	328
"I83"	"I67"	"Varicose veins of lower extremities"	"Other cerebrovascular diseases"	1	275	61	336
"I83"	"I69"	"Varicose veins of lower extremities"	"Sequelae of cerebrovascular disease"	1	2893	0	2893
"I83"	"I71"	"Varicose veins of lower extremities"	"Aortic aneurysm and dissection"	1	833	69	902
"I83"	"I73"	"Varicose veins of lower extremities"	"Other peripheral vascular diseases"	1	1786	932	2718
"I83"	"I82"	"Varicose veins of lower extremities"	"Other venous embolism and thrombosis"	1	475	297	772
"I83"	"I85"	"Varicose veins of lower extremities"	"Esophageal varices"	1	217	122	339
"I83"	"I87"	"Varicose veins of lower extremities"	"Other disorders of veins"	1	1996	1390	3386
"I83"	"I89"	"Varicose veins of lower extremities"	"Oth noninfective disorders of lymphatic vessels and nodes"	1	821	392	1213
"I83"	"I97"	"Varicose veins of lower extremities"	"Intraop and postproc comp and disorders of circ sys, NEC"	1	264	91	355
"I83"	"J06"	"Varicose veins of lower extremities"	"Acute upper resp infections of multiple and unsp sites"	1	224	15	239
"I83"	"J09"	"Varicose veins of lower extremities"	"Influenza due to certain identified influenza viruses"	1	68	0	68
"I83"	"J13"	"Varicose veins of lower extremities"	"Pneumonia due to Streptococcus pneumoniae"	1	180	77	257
"I83"	"J22"	"Varicose veins of lower extremities"	"Unspecified acute lower respiratory infection"	1	371	16	387
"I83"	"J69"	"Varicose veins of lower extremities"	"Pneumonitis due to solids and liquids"	1	217	0	217
"I83"	"J84"	"Varicose veins of lower extremities"	"Other interstitial pulmonary diseases"	1	373	54	427
"I83"	"J86"	"Varicose veins of lower extremities"	"Pyothorax"	1	135	62	197
"I83"	"J91"	"Varicose veins of lower extremities"	"Pleural effusion in conditions classified elsewhere"	1	260	25	285
"I83"	"J94"	"Varicose veins of lower extremities"	"Other pleural conditions"	1	205	31	236
"I83"	"J96"	"Varicose veins of lower extremities"	"Respiratory failure, not elsewhere classified"	1	2524	0	2524
"I83"	"K08"	"Varicose veins of lower extremities"	"Other disorders of teeth and supporting structures"	1	284	141	425
"I83"	"K12"	"Varicose veins of lower extremities"	"Stomatitis and related lesions"	1	144	64	208
"I83"	"K20"	"Varicose veins of lower extremities"	"Esophagitis"	1	498	290	788
"I83"	"K28"	"Varicose veins of lower extremities"	"Gastrojejunal ulcer"	1	76	21	97
"I83"	"K29"	"Varicose veins of lower extremities"	"Gastritis and duodenitis"	1	1486	1079	2565
"I83"	"K31"	"Varicose veins of lower extremities"	"Other diseases of stomach and duodenum"	1	204	33	237
"I83"	"K43"	"Varicose veins of lower extremities"	"Ventral hernia"	1	770	456	1226
"I83"	"K44"	"Varicose veins of lower extremities"	"Diaphragmatic hernia"	1	1462	742	2204
"I83"	"K52"	"Varicose veins of lower extremities"	"Other and unsp noninfective gastroenteritis and colitis"	1	1192	302	1494
"I83"	"K55"	"Varicose veins of lower extremities"	"Vascular disorders of intestine"	1	264	17	281
"I83"	"K56"	"Varicose veins of lower extremities"	"Paralytic ileus and intestinal obstruction without hernia"	1	1046	211	1257
"I83"	"K62"	"Varicose veins of lower extremities"	"Other diseases of anus and rectum"	1	2050	748	2798
"I83"	"K63"	"Varicose veins of lower extremities"	"Other diseases of intestine"	1	450	38	488
"I83"	"K64"	"Varicose veins of lower extremities"	"Hemorrhoids and perianal venous thrombosis"	1	1131	0	1131
"I83"	"K74"	"Varicose veins of lower extremities"	"Fibrosis and cirrhosis of liver"	1	374	143	517
"I83"	"K76"	"Varicose veins of lower extremities"	"Other diseases of liver"	1	463	200	663
"I83"	"K80"	"Varicose veins of lower extremities"	"Cholelithiasis"	1	1900	1593	3493
"I83"	"K81"	"Varicose veins of lower extremities"	"Cholecystitis"	1	410	172	582
"I83"	"K85"	"Varicose veins of lower extremities"	"Acute pancreatitis"	1	385	195	580
"I83"	"K86"	"Varicose veins of lower extremities"	"Other diseases of pancreas"	1	203	97	300
"I83"	"K92"	"Varicose veins of lower extremities"	"Other diseases of digestive system"	1	1538	391	1929
"I83"	"L90"	"Varicose veins of lower extremities"	"Atrophic disorders of skin"	1	742	308	1050
"I83"	"L98"	"Varicose veins of lower extremities"	"Oth disorders of skin, subcu, not elsewhere classified"	1	1986	1192	3178
"I83"	"M05"	"Varicose veins of lower extremities"	"Rheumatoid arthritis with rheumatoid factor"	1	485	324	809
"I83"	"M07"	"Varicose veins of lower extremities"	"Enteropathic arthropathies"	1	223	91	314
"I83"	"M18"	"Varicose veins of lower extremities"	"Osteoarthritis of first carpometacarpal joint"	1	627	152	779
"I83"	"M23"	"Varicose veins of lower extremities"	"Internal derangement of knee"	1	3203	2585	5788
"I83"	"M25"	"Varicose veins of lower extremities"	"Other joint disorder, not elsewhere classified"	1	1334	650	1984
"I83"	"M43"	"Varicose veins of lower extremities"	"Other deforming dorsopathies"	1	403	231	634
"I83"	"M47"	"Varicose veins of lower extremities"	"Spondylosis"	1	1482	656	2138
"I83"	"M54"	"Varicose veins of lower extremities"	"Dorsalgia"	1	3313	2745	6058
"I83"	"M65"	"Varicose veins of lower extremities"	"Synovitis and tenosynovitis"	1	1442	1018	2460
"I83"	"M67"	"Varicose veins of lower extremities"	"Other disorders of synovium and tendon"	1	1098	807	1905
"I83"	"M76"	"Varicose veins of lower extremities"	"Enthesopathies, lower limb, excluding foot"	1	761	456	1217
"I83"	"M79"	"Varicose veins of lower extremities"	"Oth and unsp soft tissue disorders, not elsewhere classified"	1	4143	2386	6529
"I83"	"M80"	"Varicose veins of lower extremities"	"Osteoporosis with current pathological fracture"	1	1466	196	1662
"I83"	"M81"	"Varicose veins of lower extremities"	"Osteoporosis without current pathological fracture"	1	4042	0	4042
"I83"	"M90"	"Varicose veins of lower extremities"	"Osteopathies in diseases classified elsewhere"	1	39	5	44
"I83"	"N10"	"Varicose veins of lower extremities"	"Acute pyelonephritis"	1	390	216	606
"I83"	"N12"	"Varicose veins of lower extremities"	"Tubulo-interstitial nephritis, not spcf as acute or chronic"	1	107	30	137
"I83"	"N17"	"Varicose veins of lower extremities"	"Acute kidney failure"	1	783	71	854
"I83"	"N28"	"Varicose veins of lower extremities"	"Oth disorders of kidney and ureter, not elsewhere classified"	1	356	76	432
"I83"	"N30"	"Varicose veins of lower extremities"	"Cystitis"	1	6020	0	6020
"I83"	"N39"	"Varicose veins of lower extremities"	"Other disorders of urinary system"	1	5252	0	5252
"I83"	"N40"	"Varicose veins of lower extremities"	"Benign prostatic hyperplasia"	1	1376	985	2361
"I83"	"N50"	"Varicose veins of lower extremities"	"Other and unspecified disorders of male genital organs"	1	244	118	362
"I83"	"N64"	"Varicose veins of lower extremities"	"Other disorders of breast"	1	537	324	861
"I83"	"N84"	"Varicose veins of lower extremities"	"Polyp of female genital tract"	1	977	429	1406
"I85"	"A41"	"Esophageal varices"	"Other sepsis"	1	851	452	1303
"I85"	"C22"	"Esophageal varices"	"Malignant neoplasm of liver and intrahepatic bile ducts"	1	487	201	688
"I85"	"C34"	"Esophageal varices"	"Malignant neoplasm of bronchus and lung"	1	140	40	180
"I85"	"G31"	"Esophageal varices"	"Oth degenerative diseases of nervous system, NEC"	1	185	91	276
"I85"	"G93"	"Esophageal varices"	"Other disorders of brain"	1	223	81	304
"I85"	"I46"	"Esophageal varices"	"Cardiac arrest"	1	232	59	291
"I85"	"K72"	"Esophageal varices"	"Hepatic failure, not elsewhere classified"	1	1705	1295	3000
"I85"	"N17"	"Esophageal varices"	"Acute kidney failure"	1	304	186	490
"I86"	"C61"	"Varicose veins of other sites"	"Malignant neoplasm of prostate"	1	78	4	82
"I86"	"C78"	"Varicose veins of other sites"	"Secondary malignant neoplasm of resp and digestive organs"	1	61	17	78
"I86"	"E78"	"Varicose veins of other sites"	"Disorders of lipoprotein metabolism and other lipidemias"	1	148	70	218
"I86"	"J15"	"Varicose veins of other sites"	"Bacterial pneumonia, not elsewhere classified"	1	101	41	142
"I86"	"K59"	"Varicose veins of other sites"	"Other functional intestinal disorders"	1	177	78	255
"I87"	"A41"	"Other disorders of veins"	"Other sepsis"	1	599	287	886
"I87"	"L89"	"Other disorders of veins"	"Pressure ulcer"	1	199	102	301
"I88"	"C81"	"Nonspecific lymphadenitis"	"Hodgkin lymphoma"	1	190	71	261
"I88"	"C83"	"Nonspecific lymphadenitis"	"Non-follicular lymphoma"	1	350	77	427
"I88"	"C85"	"Nonspecific lymphadenitis"	"Oth and unspecified types of non-Hodgkin lymphoma"	1	351	145	496
"I88"	"I10"	"Nonspecific lymphadenitis"	"Essential (primary) hypertension"	1	409	239	648
"I88"	"I50"	"Nonspecific lymphadenitis"	"Heart failure"	1	160	59	219
"I88"	"I69"	"Nonspecific lymphadenitis"	"Sequelae of cerebrovascular disease"	1	106	28	134
"I88"	"M75"	"Nonspecific lymphadenitis"	"Shoulder lesions"	1	260	108	368
"I88"	"N18"	"Nonspecific lymphadenitis"	"Chronic kidney disease (CKD)"	1	78	9	87
"I89"	"A41"	"Oth noninfective disorders of lymphatic vessels and nodes"	"Other sepsis"	1	483	330	813
"I89"	"G47"	"Oth noninfective disorders of lymphatic vessels and nodes"	"Sleep disorders"	1	332	158	490
"I99"	"F33"	"Other and unspecified disorders of circulatory system"	"Major depressive disorder, recurrent"	1	256	62	318
"I99"	"F41"	"Other and unspecified disorders of circulatory system"	"Other anxiety disorders"	1	284	65	349
"I99"	"G96"	"Other and unspecified disorders of circulatory system"	"Other disorders of central nervous system"	1	231	11	242
"I99"	"J15"	"Other and unspecified disorders of circulatory system"	"Bacterial pneumonia, not elsewhere classified"	1	463	274	737
"I99"	"K59"	"Other and unspecified disorders of circulatory system"	"Other functional intestinal disorders"	1	517	239	756
"I99"	"N28"	"Other and unspecified disorders of circulatory system"	"Oth disorders of kidney and ureter, not elsewhere classified"	1	136	18	154
"J00"	"B34"	"Acute nasopharyngitis [common cold]"	"Viral infection of unspecified site"	1	4426	3294	7720
"J00"	"D80"	"Acute nasopharyngitis [common cold]"	"Immunodeficiency with predominantly antibody defects"	1	82	23	105
"J00"	"D83"	"Acute nasopharyngitis [common cold]"	"Common variable immunodeficiency"	1	97	21	118
"J00"	"F10"	"Acute nasopharyngitis [common cold]"	"Alcohol related disorders"	1	121	0	121
"J00"	"F72"	"Acute nasopharyngitis [common cold]"	"Severe intellectual disabilities"	1	72	12	84
"J00"	"G47"	"Acute nasopharyngitis [common cold]"	"Sleep disorders"	1	557	62	619
"J00"	"H60"	"Acute nasopharyngitis [common cold]"	"Otitis externa"	1	263	34	297
"J00"	"H65"	"Acute nasopharyngitis [common cold]"	"Nonsuppurative otitis media"	1	3280	2292	5572
"J00"	"H66"	"Acute nasopharyngitis [common cold]"	"Suppurative and unspecified otitis media"	1	3467	3004	6471
"J00"	"J01"	"Acute nasopharyngitis [common cold]"	"Acute sinusitis"	1	210	119	329
"J00"	"J02"	"Acute nasopharyngitis [common cold]"	"Acute pharyngitis"	1	599	341	940
"J00"	"J03"	"Acute nasopharyngitis [common cold]"	"Acute tonsillitis"	1	3525	1187	4712
"J00"	"J06"	"Acute nasopharyngitis [common cold]"	"Acute upper resp infections of multiple and unsp sites"	1	2722	1250	3972
"J00"	"J18"	"Acute nasopharyngitis [common cold]"	"Pneumonia, unspecified organism"	1	3754	2599	6353
"J00"	"J30"	"Acute nasopharyngitis [common cold]"	"Vasomotor and allergic rhinitis"	1	559	7	566
"J00"	"J32"	"Acute nasopharyngitis [common cold]"	"Chronic sinusitis"	1	104	32	136
"J00"	"J34"	"Acute nasopharyngitis [common cold]"	"Other and unspecified disorders of nose and nasal sinuses"	1	155	29	184
"J00"	"J35"	"Acute nasopharyngitis [common cold]"	"Chronic diseases of tonsils and adenoids"	1	4101	0	4101
"J00"	"J45"	"Acute nasopharyngitis [common cold]"	"Asthma"	1	4500	3151	7651
"J00"	"K12"	"Acute nasopharyngitis [common cold]"	"Stomatitis and related lesions"	1	324	104	428
"J00"	"L08"	"Acute nasopharyngitis [common cold]"	"Other local infections of skin and subcutaneous tissue"	1	564	41	605
"J00"	"M23"	"Acute nasopharyngitis [common cold]"	"Internal derangement of knee"	1	248	0	248
"J00"	"O72"	"Acute nasopharyngitis [common cold]"	"Postpartum hemorrhage"	1	247	0	247
"J00"	"Q85"	"Acute nasopharyngitis [common cold]"	"Phakomatoses, not elsewhere classified"	1	126	23	149
"J01"	"C78"	"Acute sinusitis"	"Secondary malignant neoplasm of resp and digestive organs"	1	105	8	113
"J01"	"C79"	"Acute sinusitis"	"Secondary malignant neoplasm of other and unspecified sites"	1	80	16	96
"J01"	"H02"	"Acute sinusitis"	"Other disorders of eyelid"	1	162	77	239
"J01"	"I48"	"Acute sinusitis"	"Atrial fibrillation and flutter"	1	302	178	480
"J01"	"I50"	"Acute sinusitis"	"Heart failure"	1	265	133	398
"J02"	"C34"	"Acute pharyngitis"	"Malignant neoplasm of bronchus and lung"	1	42	2	44
"J02"	"E66"	"Acute pharyngitis"	"Overweight and obesity"	1	283	135	418
"J02"	"O72"	"Acute pharyngitis"	"Postpartum hemorrhage"	1	305	115	420
"J03"	"C43"	"Acute tonsillitis"	"Malignant melanoma of skin"	1	79	27	106
"J03"	"C79"	"Acute tonsillitis"	"Secondary malignant neoplasm of other and unspecified sites"	1	71	7	78
"J03"	"D22"	"Acute tonsillitis"	"Melanocytic nevi"	1	344	122	466
"J03"	"D50"	"Acute tonsillitis"	"Iron deficiency anemia"	1	208	116	324
"J03"	"D68"	"Acute tonsillitis"	"Other coagulation defects"	1	145	52	197
"J03"	"E11"	"Acute tonsillitis"	"Type 2 diabetes mellitus"	1	558	202	760
"J03"	"E28"	"Acute tonsillitis"	"Ovarian dysfunction"	1	162	74	236
"J03"	"E34"	"Acute tonsillitis"	"Other endocrine disorders"	1	281	123	404
"J03"	"E55"	"Acute tonsillitis"	"Vitamin D deficiency"	1	113	45	158
"J03"	"E68"	"Acute tonsillitis"	"Sequelae of hyperalimentation"	1	98	0	98
"J03"	"E78"	"Acute tonsillitis"	"Disorders of lipoprotein metabolism and other lipidemias"	1	543	135	678
"J03"	"F20"	"Acute tonsillitis"	"Schizophrenia"	1	92	26	118
"J03"	"F33"	"Acute tonsillitis"	"Major depressive disorder, recurrent"	1	223	53	276
"J03"	"F41"	"Acute tonsillitis"	"Other anxiety disorders"	1	340	115	455
"J03"	"F70"	"Acute tonsillitis"	"Mild intellectual disabilities"	1	48	7	55
"J03"	"F90"	"Acute tonsillitis"	"Attention-deficit hyperactivity disorders"	1	150	40	190
"J03"	"G43"	"Acute tonsillitis"	"Migraine"	1	639	432	1071
"J03"	"G62"	"Acute tonsillitis"	"Other and unspecified polyneuropathies"	1	92	21	113
"J03"	"G95"	"Acute tonsillitis"	"Other and unspecified diseases of spinal cord"	1	53	9	62
"J03"	"H36"	"Acute tonsillitis"	"Retinal disorders in diseases classified elsewhere"	1	145	30	175
"J03"	"H47"	"Acute tonsillitis"	"Other disorders of optic [2nd] nerve and visual pathways"	1	91	26	117
"J03"	"H52"	"Acute tonsillitis"	"Disorders of refraction and accommodation"	1	565	274	839
"J03"	"H53"	"Acute tonsillitis"	"Visual disturbances"	1	335	127	462
"J03"	"H92"	"Acute tonsillitis"	"Otalgia and effusion of ear"	1	382	215	597
"J03"	"I21"	"Acute tonsillitis"	"Acute myocardial infarction"	1	217	121	338
"J03"	"I26"	"Acute tonsillitis"	"Pulmonary embolism"	1	126	52	178
"J03"	"I46"	"Acute tonsillitis"	"Cardiac arrest"	1	104	2	106
"J03"	"I48"	"Acute tonsillitis"	"Atrial fibrillation and flutter"	1	339	155	494
"J03"	"I63"	"Acute tonsillitis"	"Cerebral infarction"	1	227	53	280
"J03"	"I73"	"Acute tonsillitis"	"Other peripheral vascular diseases"	1	105	31	136
"J03"	"I80"	"Acute tonsillitis"	"Phlebitis and thrombophlebitis"	1	307	154	461
"J03"	"J15"	"Acute tonsillitis"	"Bacterial pneumonia, not elsewhere classified"	1	657	469	1126
"J03"	"K00"	"Acute tonsillitis"	"Disorders of tooth development and eruption"	1	200	77	277
"J03"	"K21"	"Acute tonsillitis"	"Gastro-esophageal reflux disease"	1	576	408	984
"J03"	"K25"	"Acute tonsillitis"	"Gastric ulcer"	1	167	85	252
"J03"	"K57"	"Acute tonsillitis"	"Diverticular disease of intestine"	1	266	35	301
"J03"	"K76"	"Acute tonsillitis"	"Other diseases of liver"	1	120	45	165
"J03"	"K80"	"Acute tonsillitis"	"Cholelithiasis"	1	648	426	1074
"J03"	"K92"	"Acute tonsillitis"	"Other diseases of digestive system"	1	317	190	507
"J03"	"L89"	"Acute tonsillitis"	"Pressure ulcer"	1	49	4	53
"J03"	"L97"	"Acute tonsillitis"	"Non-pressure chronic ulcer of lower limb, NEC"	1	71	8	79
"J03"	"L98"	"Acute tonsillitis"	"Oth disorders of skin, subcu, not elsewhere classified"	1	212	63	275
"J03"	"M17"	"Acute tonsillitis"	"Osteoarthritis of knee"	1	428	125	553
"J03"	"M23"	"Acute tonsillitis"	"Internal derangement of knee"	1	1454	955	2409
"J03"	"M47"	"Acute tonsillitis"	"Spondylosis"	1	260	60	320
"J03"	"M51"	"Acute tonsillitis"	"Thoracic, thoracolum, and lumbosacral intvrt disc disorders"	1	762	349	1111
"J03"	"M53"	"Acute tonsillitis"	"Other and unspecified dorsopathies, not elsewhere classified"	1	177	56	233
"J03"	"M54"	"Acute tonsillitis"	"Dorsalgia"	1	1796	1280	3076
"J03"	"M67"	"Acute tonsillitis"	"Other disorders of synovium and tendon"	1	610	331	941
"J03"	"M72"	"Acute tonsillitis"	"Fibroblastic disorders"	1	154	69	223
"J03"	"M79"	"Acute tonsillitis"	"Oth and unsp soft tissue disorders, not elsewhere classified"	1	1804	1454	3258
"J03"	"M85"	"Acute tonsillitis"	"Other disorders of bone density and structure"	1	162	17	179
"J03"	"M99"	"Acute tonsillitis"	"Biomechanical lesions, not elsewhere classified"	1	86	21	107
"J03"	"N17"	"Acute tonsillitis"	"Acute kidney failure"	1	96	34	130
"J03"	"N20"	"Acute tonsillitis"	"Calculus of kidney and ureter"	1	455	306	761
"J03"	"N87"	"Acute tonsillitis"	"Dysplasia of cervix uteri"	1	326	136	462
"J03"	"O72"	"Acute tonsillitis"	"Postpartum hemorrhage"	1	2006	961	2967
"J03"	"O92"	"Acute tonsillitis"	"Oth disord of brst/lactatn assoc w pregnancy and the puerp"	1	199	66	265
"J04"	"C18"	"Acute laryngitis and tracheitis"	"Malignant neoplasm of colon"	1	37	3	40
"J04"	"E86"	"Acute laryngitis and tracheitis"	"Volume depletion"	1	171	76	247
"J04"	"J96"	"Acute laryngitis and tracheitis"	"Respiratory failure, not elsewhere classified"	1	228	118	346
"J04"	"N18"	"Acute laryngitis and tracheitis"	"Chronic kidney disease (CKD)"	1	46	3	49
"J04"	"N39"	"Acute laryngitis and tracheitis"	"Other disorders of urinary system"	1	198	57	255
"J04"	"O72"	"Acute laryngitis and tracheitis"	"Postpartum hemorrhage"	1	201	26	227
"J05"	"B02"	"Acute obstructive laryngitis [croup] and epiglottitis"	"Zoster [herpes zoster]"	1	41	6	47
"J05"	"D69"	"Acute obstructive laryngitis [croup] and epiglottitis"	"Purpura and other hemorrhagic conditions"	1	223	49	272
"J05"	"E10"	"Acute obstructive laryngitis [croup] and epiglottitis"	"Type 1 diabetes mellitus"	1	117	8	125
"J05"	"E22"	"Acute obstructive laryngitis [croup] and epiglottitis"	"Hyperfunction of pituitary gland"	1	57	0	57
"J05"	"E23"	"Acute obstructive laryngitis [croup] and epiglottitis"	"Hypofunction and other disorders of the pituitary gland"	1	64	0	64
"J05"	"E30"	"Acute obstructive laryngitis [croup] and epiglottitis"	"Disorders of puberty, not elsewhere classified"	1	91	0	91
"J05"	"E78"	"Acute obstructive laryngitis [croup] and epiglottitis"	"Disorders of lipoprotein metabolism and other lipidemias"	1	93	9	102
"J05"	"F10"	"Acute obstructive laryngitis [croup] and epiglottitis"	"Alcohol related disorders"	1	117	0	117
"J05"	"F70"	"Acute obstructive laryngitis [croup] and epiglottitis"	"Mild intellectual disabilities"	1	64	0	64
"J05"	"F71"	"Acute obstructive laryngitis [croup] and epiglottitis"	"Moderate intellectual disabilities"	1	32	2	34
"J05"	"F79"	"Acute obstructive laryngitis [croup] and epiglottitis"	"Unspecified intellectual disabilities"	1	115	6	121
"J05"	"F90"	"Acute obstructive laryngitis [croup] and epiglottitis"	"Attention-deficit hyperactivity disorders"	1	127	0	127
"J05"	"G43"	"Acute obstructive laryngitis [croup] and epiglottitis"	"Migraine"	1	170	0	170
"J05"	"G93"	"Acute obstructive laryngitis [croup] and epiglottitis"	"Other disorders of brain"	1	46	4	50
"J05"	"H26"	"Acute obstructive laryngitis [croup] and epiglottitis"	"Other cataract"	1	38	2	40
"J05"	"H47"	"Acute obstructive laryngitis [croup] and epiglottitis"	"Other disorders of optic [2nd] nerve and visual pathways"	1	48	0	48
"J05"	"H49"	"Acute obstructive laryngitis [croup] and epiglottitis"	"Paralytic strabismus"	1	39	1	40
"J05"	"H50"	"Acute obstructive laryngitis [croup] and epiglottitis"	"Other strabismus"	1	501	55	556
"J05"	"H52"	"Acute obstructive laryngitis [croup] and epiglottitis"	"Disorders of refraction and accommodation"	1	492	18	510
"J05"	"H53"	"Acute obstructive laryngitis [croup] and epiglottitis"	"Visual disturbances"	1	183	0	183
"J05"	"H57"	"Acute obstructive laryngitis [croup] and epiglottitis"	"Other disorders of eye and adnexa"	1	212	0	212
"J05"	"H90"	"Acute obstructive laryngitis [croup] and epiglottitis"	"Conductive and sensorineural hearing loss"	1	284	16	300
"J05"	"H91"	"Acute obstructive laryngitis [croup] and epiglottitis"	"Other and unspecified hearing loss"	1	267	38	305
"J05"	"I20"	"Acute obstructive laryngitis [croup] and epiglottitis"	"Angina pectoris"	1	64	19	83
"J05"	"I47"	"Acute obstructive laryngitis [croup] and epiglottitis"	"Paroxysmal tachycardia"	1	72	0	72
"J05"	"I49"	"Acute obstructive laryngitis [croup] and epiglottitis"	"Other cardiac arrhythmias"	1	38	0	38
"J05"	"I88"	"Acute obstructive laryngitis [croup] and epiglottitis"	"Nonspecific lymphadenitis"	1	133	8	141
"J05"	"J15"	"Acute obstructive laryngitis [croup] and epiglottitis"	"Bacterial pneumonia, not elsewhere classified"	1	422	184	606
"J05"	"J34"	"Acute obstructive laryngitis [croup] and epiglottitis"	"Other and unspecified disorders of nose and nasal sinuses"	1	49	0	49
"J05"	"K01"	"Acute obstructive laryngitis [croup] and epiglottitis"	"Embedded and impacted teeth"	1	26	0	26
"J05"	"K02"	"Acute obstructive laryngitis [croup] and epiglottitis"	"Dental caries"	1	215	17	232
"J05"	"K29"	"Acute obstructive laryngitis [croup] and epiglottitis"	"Gastritis and duodenitis"	1	102	4	106
"J05"	"K35"	"Acute obstructive laryngitis [croup] and epiglottitis"	"Acute appendicitis"	1	411	0	411
"J05"	"K52"	"Acute obstructive laryngitis [croup] and epiglottitis"	"Other and unsp noninfective gastroenteritis and colitis"	1	282	160	442
"J05"	"L01"	"Acute obstructive laryngitis [croup] and epiglottitis"	"Impetigo"	1	252	132	384
"J05"	"L03"	"Acute obstructive laryngitis [croup] and epiglottitis"	"Cellulitis and acute lymphangitis"	1	244	75	319
"J05"	"L90"	"Acute obstructive laryngitis [croup] and epiglottitis"	"Atrophic disorders of skin"	1	54	0	54
"J05"	"M02"	"Acute obstructive laryngitis [croup] and epiglottitis"	"Postinfective and reactive arthropathies"	1	359	97	456
"J05"	"M08"	"Acute obstructive laryngitis [croup] and epiglottitis"	"Juvenile arthritis"	1	71	1	72
"J05"	"M17"	"Acute obstructive laryngitis [croup] and epiglottitis"	"Osteoarthritis of knee"	1	54	6	60
"J05"	"M22"	"Acute obstructive laryngitis [croup] and epiglottitis"	"Disorder of patella"	1	66	0	66
"J05"	"M23"	"Acute obstructive laryngitis [croup] and epiglottitis"	"Internal derangement of knee"	1	200	0	200
"J05"	"M24"	"Acute obstructive laryngitis [croup] and epiglottitis"	"Other specific joint derangements"	1	207	15	222
"J05"	"M54"	"Acute obstructive laryngitis [croup] and epiglottitis"	"Dorsalgia"	1	253	0	253
"J05"	"M62"	"Acute obstructive laryngitis [croup] and epiglottitis"	"Other disorders of muscle"	1	223	0	223
"J05"	"M65"	"Acute obstructive laryngitis [croup] and epiglottitis"	"Synovitis and tenosynovitis"	1	122	0	122
"J05"	"M67"	"Acute obstructive laryngitis [croup] and epiglottitis"	"Other disorders of synovium and tendon"	1	188	0	188
"J05"	"M89"	"Acute obstructive laryngitis [croup] and epiglottitis"	"Other disorders of bone"	1	31	0	31
"J05"	"N18"	"Acute obstructive laryngitis [croup] and epiglottitis"	"Chronic kidney disease (CKD)"	1	38	0	38
"J05"	"N44"	"Acute obstructive laryngitis [croup] and epiglottitis"	"Noninflammatory disorders of testis"	1	78	0	78
"J05"	"N47"	"Acute obstructive laryngitis [croup] and epiglottitis"	"Disorders of prepuce"	1	1023	47	1070
"J05"	"O04"	"Acute obstructive laryngitis [croup] and epiglottitis"	"Complications following (induced) termination of pregnancy"	1	50	0	50
"J05"	"O72"	"Acute obstructive laryngitis [croup] and epiglottitis"	"Postpartum hemorrhage"	1	42	0	42
"J05"	"Q17"	"Acute obstructive laryngitis [croup] and epiglottitis"	"Other congenital malformations of ear"	1	146	0	146
"J05"	"Q53"	"Acute obstructive laryngitis [croup] and epiglottitis"	"Undescended and ectopic testicle"	1	529	289	818
"J06"	"H52"	"Acute upper resp infections of multiple and unsp sites"	"Disorders of refraction and accommodation"	1	339	209	548
"J11"	"C34"	"Influenza due to unidentified influenza virus"	"Malignant neoplasm of bronchus and lung"	1	140	28	168
"J11"	"C61"	"Influenza due to unidentified influenza virus"	"Malignant neoplasm of prostate"	1	85	20	105
"J11"	"C78"	"Influenza due to unidentified influenza virus"	"Secondary malignant neoplasm of resp and digestive organs"	1	114	12	126
"J11"	"C79"	"Influenza due to unidentified influenza virus"	"Secondary malignant neoplasm of other and unspecified sites"	1	92	14	106
"J11"	"E86"	"Influenza due to unidentified influenza virus"	"Volume depletion"	1	774	494	1268
"J11"	"M54"	"Influenza due to unidentified influenza virus"	"Dorsalgia"	1	807	592	1399
"J11"	"O72"	"Influenza due to unidentified influenza virus"	"Postpartum hemorrhage"	1	510	143	653
"J12"	"J45"	"Viral pneumonia, not elsewhere classified"	"Asthma"	1	3280	2420	5700
"J12"	"K35"	"Viral pneumonia, not elsewhere classified"	"Acute appendicitis"	1	102	0	102
"J13"	"C78"	"Pneumonia due to Streptococcus pneumoniae"	"Secondary malignant neoplasm of resp and digestive organs"	1	151	69	220
"J13"	"I46"	"Pneumonia due to Streptococcus pneumoniae"	"Cardiac arrest"	1	240	89	329
"J15"	"I46"	"Bacterial pneumonia, not elsewhere classified"	"Cardiac arrest"	1	2241	1443	3684
"J18"	"A04"	"Pneumonia, unspecified organism"	"Other bacterial intestinal infections"	1	4779	2893	7672
"J18"	"B44"	"Pneumonia, unspecified organism"	"Aspergillosis"	1	566	262	828
"J18"	"C22"	"Pneumonia, unspecified organism"	"Malignant neoplasm of liver and intrahepatic bile ducts"	1	577	331	908
"J18"	"C25"	"Pneumonia, unspecified organism"	"Malignant neoplasm of pancreas"	1	900	660	1560
"J18"	"D80"	"Pneumonia, unspecified organism"	"Immunodeficiency with predominantly antibody defects"	1	491	208	699
"J18"	"D83"	"Pneumonia, unspecified organism"	"Common variable immunodeficiency"	1	314	73	387
"J18"	"E41"	"Pneumonia, unspecified organism"	"Nutritional marasmus"	1	961	574	1535
"J18"	"F41"	"Pneumonia, unspecified organism"	"Other anxiety disorders"	1	3888	2005	5893
"J18"	"F84"	"Pneumonia, unspecified organism"	"Pervasive developmental disorders"	1	298	137	435
"J18"	"I27"	"Pneumonia, unspecified organism"	"Other pulmonary heart diseases"	1	3129	2630	5759
"J18"	"I46"	"Pneumonia, unspecified organism"	"Cardiac arrest"	1	9909	0	9909
"J18"	"J03"	"Pneumonia, unspecified organism"	"Acute tonsillitis"	1	3596	3067	6663
"J18"	"J06"	"Pneumonia, unspecified organism"	"Acute upper resp infections of multiple and unsp sites"	1	3965	2775	6740
"J18"	"J15"	"Pneumonia, unspecified organism"	"Bacterial pneumonia, not elsewhere classified"	1	32849	25087	57936
"J18"	"J35"	"Pneumonia, unspecified organism"	"Chronic diseases of tonsils and adenoids"	1	2808	2146	4954
"J18"	"J47"	"Pneumonia, unspecified organism"	"Bronchiectasis"	1	2501	989	3490
"J18"	"J96"	"Pneumonia, unspecified organism"	"Respiratory failure, not elsewhere classified"	1	34553	29837	64390
"J18"	"N28"	"Pneumonia, unspecified organism"	"Oth disorders of kidney and ureter, not elsewhere classified"	1	1895	1545	3440
"J18"	"O72"	"Pneumonia, unspecified organism"	"Postpartum hemorrhage"	1	1134	888	2022
"J18"	"Q17"	"Pneumonia, unspecified organism"	"Other congenital malformations of ear"	1	141	56	197
"J20"	"A08"	"Acute bronchitis"	"Viral and other specified intestinal infections"	1	1188	873	2061
"J20"	"B96"	"Acute bronchitis"	"Oth bacterial agents as the cause of diseases classd elswhr"	1	181	42	223
"J20"	"C15"	"Acute bronchitis"	"Malignant neoplasm of esophagus"	1	54	10	64
"J20"	"C22"	"Acute bronchitis"	"Malignant neoplasm of liver and intrahepatic bile ducts"	1	36	1	37
"J20"	"C25"	"Acute bronchitis"	"Malignant neoplasm of pancreas"	1	91	2	93
"J20"	"C61"	"Acute bronchitis"	"Malignant neoplasm of prostate"	1	217	92	309
"J20"	"C77"	"Acute bronchitis"	"Secondary and unspecified malignant neoplasm of lymph nodes"	1	132	39	171
"J20"	"C78"	"Acute bronchitis"	"Secondary malignant neoplasm of resp and digestive organs"	1	429	51	480
"J20"	"D16"	"Acute bronchitis"	"Benign neoplasm of bone and articular cartilage"	1	82	4	86
"J20"	"D23"	"Acute bronchitis"	"Other benign neoplasms of skin"	1	283	95	378
"J20"	"D63"	"Acute bronchitis"	"Anemia in chronic diseases classified elsewhere"	1	287	94	381
"J20"	"D69"	"Acute bronchitis"	"Purpura and other hemorrhagic conditions"	1	452	92	544
"J20"	"E30"	"Acute bronchitis"	"Disorders of puberty, not elsewhere classified"	1	98	0	98
"J20"	"E89"	"Acute bronchitis"	"Postproc endocrine and metabolic comp and disorders, NEC"	1	90	25	115
"J20"	"F17"	"Acute bronchitis"	"Nicotine dependence"	1	414	86	500
"J20"	"F43"	"Acute bronchitis"	"Reaction to severe stress, and adjustment disorders"	1	291	38	329
"J20"	"F84"	"Acute bronchitis"	"Pervasive developmental disorders"	1	190	0	190
"J20"	"F98"	"Acute bronchitis"	"Oth behav/emotn disord w onset usly occur in chldhd and adol"	1	405	35	440
"J20"	"H10"	"Acute bronchitis"	"Conjunctivitis"	1	1448	893	2341
"J20"	"H47"	"Acute bronchitis"	"Other disorders of optic [2nd] nerve and visual pathways"	1	131	11	142
"J20"	"H49"	"Acute bronchitis"	"Paralytic strabismus"	1	82	23	105
"J20"	"H52"	"Acute bronchitis"	"Disorders of refraction and accommodation"	1	948	56	1004
"J20"	"H53"	"Acute bronchitis"	"Visual disturbances"	1	408	61	469
"J20"	"H72"	"Acute bronchitis"	"Perforation of tympanic membrane"	1	257	0	257
"J20"	"H90"	"Acute bronchitis"	"Conductive and sensorineural hearing loss"	1	685	187	872
"J20"	"I27"	"Acute bronchitis"	"Other pulmonary heart diseases"	1	373	156	529
"J20"	"I61"	"Acute bronchitis"	"Nontraumatic intracerebral hemorrhage"	1	202	78	280
"J20"	"I63"	"Acute bronchitis"	"Cerebral infarction"	1	634	364	998
"J20"	"J03"	"Acute bronchitis"	"Acute tonsillitis"	1	5145	0	5145
"J20"	"J06"	"Acute bronchitis"	"Acute upper resp infections of multiple and unsp sites"	1	3176	2727	5903
"J20"	"J13"	"Acute bronchitis"	"Pneumonia due to Streptococcus pneumoniae"	1	589	372	961
"J20"	"J22"	"Acute bronchitis"	"Unspecified acute lower respiratory infection"	1	395	59	454
"J20"	"J30"	"Acute bronchitis"	"Vasomotor and allergic rhinitis"	1	1419	107	1526
"J20"	"J40"	"Acute bronchitis"	"Bronchitis, not specified as acute or chronic"	1	893	609	1502
"J20"	"J81"	"Acute bronchitis"	"Pulmonary edema"	1	376	196	572
"J20"	"K01"	"Acute bronchitis"	"Embedded and impacted teeth"	1	59	0	59
"J20"	"K56"	"Acute bronchitis"	"Paralytic ileus and intestinal obstruction without hernia"	1	402	188	590
"J20"	"K72"	"Acute bronchitis"	"Hepatic failure, not elsewhere classified"	1	109	13	122
"J20"	"K83"	"Acute bronchitis"	"Other diseases of biliary tract"	1	140	38	178
"J20"	"L02"	"Acute bronchitis"	"Cutaneous abscess, furuncle and carbuncle"	1	761	321	1082
"J20"	"L20"	"Acute bronchitis"	"Atopic dermatitis"	1	1596	1147	2743
"J20"	"M10"	"Acute bronchitis"	"Gout"	1	326	184	510
"J20"	"M22"	"Acute bronchitis"	"Disorder of patella"	1	164	0	164
"J20"	"M23"	"Acute bronchitis"	"Internal derangement of knee"	1	710	109	819
"J20"	"M65"	"Acute bronchitis"	"Synovitis and tenosynovitis"	1	386	168	554
"J20"	"M67"	"Acute bronchitis"	"Other disorders of synovium and tendon"	1	400	30	430
"J20"	"M75"	"Acute bronchitis"	"Shoulder lesions"	1	640	261	901
"J20"	"M80"	"Acute bronchitis"	"Osteoporosis with current pathological fracture"	1	591	236	827
"J20"	"N12"	"Acute bronchitis"	"Tubulo-interstitial nephritis, not spcf as acute or chronic"	1	129	47	176
"J20"	"N13"	"Acute bronchitis"	"Obstructive and reflux uropathy"	1	218	103	321
"J20"	"N39"	"Acute bronchitis"	"Other disorders of urinary system"	1	1857	674	2531
"J20"	"N43"	"Acute bronchitis"	"Hydrocele and spermatocele"	1	304	181	485
"J20"	"O72"	"Acute bronchitis"	"Postpartum hemorrhage"	1	413	0	413
"J20"	"Q17"	"Acute bronchitis"	"Other congenital malformations of ear"	1	97	0	97
"J20"	"Q53"	"Acute bronchitis"	"Undescended and ectopic testicle"	1	1120	280	1400
"J20"	"Q66"	"Acute bronchitis"	"Congenital deformities of feet"	1	486	192	678
"J21"	"H65"	"Acute bronchiolitis"	"Nonsuppurative otitis media"	1	756	285	1041
"J21"	"J06"	"Acute bronchiolitis"	"Acute upper resp infections of multiple and unsp sites"	1	825	567	1392
"J22"	"D84"	"Unspecified acute lower respiratory infection"	"Other immunodeficiencies"	1	62	17	79
"J30"	"A41"	"Vasomotor and allergic rhinitis"	"Other sepsis"	1	259	4	263
"J30"	"C18"	"Vasomotor and allergic rhinitis"	"Malignant neoplasm of colon"	1	91	0	91
"J30"	"C20"	"Vasomotor and allergic rhinitis"	"Malignant neoplasm of rectum"	1	29	0	29
"J30"	"C34"	"Vasomotor and allergic rhinitis"	"Malignant neoplasm of bronchus and lung"	1	113	0	113
"J30"	"C64"	"Vasomotor and allergic rhinitis"	"Malignant neoplasm of kidney, except renal pelvis"	1	28	0	28
"J30"	"C71"	"Vasomotor and allergic rhinitis"	"Malignant neoplasm of brain"	1	27	1	28
"J30"	"D17"	"Vasomotor and allergic rhinitis"	"Benign lipomatous neoplasm"	1	262	81	343
"J30"	"D50"	"Vasomotor and allergic rhinitis"	"Iron deficiency anemia"	1	154	14	168
"J30"	"D68"	"Vasomotor and allergic rhinitis"	"Other coagulation defects"	1	147	23	170
"J30"	"E05"	"Vasomotor and allergic rhinitis"	"Thyrotoxicosis [hyperthyroidism]"	1	201	91	292
"J30"	"E23"	"Vasomotor and allergic rhinitis"	"Hypofunction and other disorders of the pituitary gland"	1	76	16	92
"J30"	"E66"	"Vasomotor and allergic rhinitis"	"Overweight and obesity"	1	1523	564	2087
"J30"	"E83"	"Vasomotor and allergic rhinitis"	"Disorders of mineral metabolism"	1	60	0	60
"J30"	"E86"	"Vasomotor and allergic rhinitis"	"Volume depletion"	1	202	103	305
"J30"	"E87"	"Vasomotor and allergic rhinitis"	"Other disorders of fluid, electrolyte and acid-base balance"	1	188	0	188
"J30"	"E89"	"Vasomotor and allergic rhinitis"	"Postproc endocrine and metabolic comp and disorders, NEC"	1	48	2	50
"J30"	"F06"	"Vasomotor and allergic rhinitis"	"Other mental disorders due to known physiological condition"	1	26	0	26
"J30"	"F17"	"Vasomotor and allergic rhinitis"	"Nicotine dependence"	1	298	115	413
"J30"	"F31"	"Vasomotor and allergic rhinitis"	"Bipolar disorder"	1	29	0	29
"J30"	"F41"	"Vasomotor and allergic rhinitis"	"Other anxiety disorders"	1	214	39	253
"J30"	"G43"	"Vasomotor and allergic rhinitis"	"Migraine"	1	402	261	663
"J30"	"G45"	"Vasomotor and allergic rhinitis"	"Transient cerebral ischemic attacks and related syndromes"	1	197	27	224
"J30"	"G56"	"Vasomotor and allergic rhinitis"	"Mononeuropathies of upper limb"	1	555	166	721
"J30"	"G95"	"Vasomotor and allergic rhinitis"	"Other and unspecified diseases of spinal cord"	1	44	0	44
"J30"	"G96"	"Vasomotor and allergic rhinitis"	"Other disorders of central nervous system"	1	230	3	233
"J30"	"H25"	"Vasomotor and allergic rhinitis"	"Age-related cataract"	1	610	45	655
"J30"	"H35"	"Vasomotor and allergic rhinitis"	"Other retinal disorders"	1	250	28	278
"J30"	"H36"	"Vasomotor and allergic rhinitis"	"Retinal disorders in diseases classified elsewhere"	1	98	23	121
"J30"	"H53"	"Vasomotor and allergic rhinitis"	"Visual disturbances"	1	232	72	304
"J30"	"H91"	"Vasomotor and allergic rhinitis"	"Other and unspecified hearing loss"	1	658	237	895
"J30"	"I20"	"Vasomotor and allergic rhinitis"	"Angina pectoris"	1	545	168	713
"J30"	"I21"	"Vasomotor and allergic rhinitis"	"Acute myocardial infarction"	1	215	47	262
"J30"	"I26"	"Vasomotor and allergic rhinitis"	"Pulmonary embolism"	1	134	16	150
"J30"	"I34"	"Vasomotor and allergic rhinitis"	"Nonrheumatic mitral valve disorders"	1	66	12	78
"J30"	"I42"	"Vasomotor and allergic rhinitis"	"Cardiomyopathy"	1	57	9	66
"J30"	"I46"	"Vasomotor and allergic rhinitis"	"Cardiac arrest"	1	57	0	57
"J30"	"I48"	"Vasomotor and allergic rhinitis"	"Atrial fibrillation and flutter"	1	511	37	548
"J30"	"I51"	"Vasomotor and allergic rhinitis"	"Complications and ill-defined descriptions of heart disease"	1	75	14	89
"J30"	"I61"	"Vasomotor and allergic rhinitis"	"Nontraumatic intracerebral hemorrhage"	1	57	0	57
"J30"	"I63"	"Vasomotor and allergic rhinitis"	"Cerebral infarction"	1	205	7	212
"J30"	"I67"	"Vasomotor and allergic rhinitis"	"Other cerebrovascular diseases"	1	33	1	34
"J30"	"I71"	"Vasomotor and allergic rhinitis"	"Aortic aneurysm and dissection"	1	83	0	83
"J30"	"I83"	"Vasomotor and allergic rhinitis"	"Varicose veins of lower extremities"	1	438	154	592
"J30"	"J15"	"Vasomotor and allergic rhinitis"	"Bacterial pneumonia, not elsewhere classified"	1	361	139	500
"J30"	"J96"	"Vasomotor and allergic rhinitis"	"Respiratory failure, not elsewhere classified"	1	320	95	415
"J30"	"K22"	"Vasomotor and allergic rhinitis"	"Other diseases of esophagus"	1	151	58	209
"J30"	"K43"	"Vasomotor and allergic rhinitis"	"Ventral hernia"	1	137	33	170
"J30"	"K44"	"Vasomotor and allergic rhinitis"	"Diaphragmatic hernia"	1	359	137	496
"J30"	"K56"	"Vasomotor and allergic rhinitis"	"Paralytic ileus and intestinal obstruction without hernia"	1	123	27	150
"J30"	"K59"	"Vasomotor and allergic rhinitis"	"Other functional intestinal disorders"	1	871	539	1410
"J30"	"K63"	"Vasomotor and allergic rhinitis"	"Other diseases of intestine"	1	68	4	72
"J30"	"K76"	"Vasomotor and allergic rhinitis"	"Other diseases of liver"	1	131	16	147
"J30"	"K80"	"Vasomotor and allergic rhinitis"	"Cholelithiasis"	1	615	205	820
"J30"	"K92"	"Vasomotor and allergic rhinitis"	"Other diseases of digestive system"	1	183	36	219
"J30"	"L90"	"Vasomotor and allergic rhinitis"	"Atrophic disorders of skin"	1	230	89	319
"J30"	"L97"	"Vasomotor and allergic rhinitis"	"Non-pressure chronic ulcer of lower limb, NEC"	1	42	0	42
"J30"	"M06"	"Vasomotor and allergic rhinitis"	"Other rheumatoid arthritis"	1	136	40	176
"J30"	"M16"	"Vasomotor and allergic rhinitis"	"Osteoarthritis of hip"	1	375	41	416
"J30"	"M17"	"Vasomotor and allergic rhinitis"	"Osteoarthritis of knee"	1	846	108	954
"J30"	"M23"	"Vasomotor and allergic rhinitis"	"Internal derangement of knee"	1	1473	685	2158
"J30"	"M25"	"Vasomotor and allergic rhinitis"	"Other joint disorder, not elsewhere classified"	1	598	242	840
"J30"	"M46"	"Vasomotor and allergic rhinitis"	"Other inflammatory spondylopathies"	1	77	7	84
"J30"	"M48"	"Vasomotor and allergic rhinitis"	"Other spondylopathies"	1	290	15	305
"J30"	"M51"	"Vasomotor and allergic rhinitis"	"Thoracic, thoracolum, and lumbosacral intvrt disc disorders"	1	800	325	1125
"J30"	"M54"	"Vasomotor and allergic rhinitis"	"Dorsalgia"	1	1427	718	2145
"J30"	"M67"	"Vasomotor and allergic rhinitis"	"Other disorders of synovium and tendon"	1	587	211	798
"J30"	"M72"	"Vasomotor and allergic rhinitis"	"Fibroblastic disorders"	1	196	37	233
"J30"	"M75"	"Vasomotor and allergic rhinitis"	"Shoulder lesions"	1	1248	265	1513
"J30"	"M99"	"Vasomotor and allergic rhinitis"	"Biomechanical lesions, not elsewhere classified"	1	94	21	115
"J30"	"N17"	"Vasomotor and allergic rhinitis"	"Acute kidney failure"	1	53	0	53
"J30"	"N18"	"Vasomotor and allergic rhinitis"	"Chronic kidney disease (CKD)"	1	142	0	142
"J30"	"N20"	"Vasomotor and allergic rhinitis"	"Calculus of kidney and ureter"	1	322	129	451
"J30"	"N39"	"Vasomotor and allergic rhinitis"	"Other disorders of urinary system"	1	606	146	752
"J30"	"N45"	"Vasomotor and allergic rhinitis"	"Orchitis and epididymitis"	1	114	45	159
"J30"	"N46"	"Vasomotor and allergic rhinitis"	"Male infertility"	1	206	46	252
"J30"	"N50"	"Vasomotor and allergic rhinitis"	"Other and unspecified disorders of male genital organs"	1	173	54	227
"J30"	"N63"	"Vasomotor and allergic rhinitis"	"Unspecified lump in breast"	1	226	85	311
"J30"	"N83"	"Vasomotor and allergic rhinitis"	"Noninflammatory disord of ovary, fallop and broad ligament"	1	310	175	485
"J30"	"N93"	"Vasomotor and allergic rhinitis"	"Other abnormal uterine and vaginal bleeding"	1	160	49	209
"J30"	"N94"	"Vasomotor and allergic rhinitis"	"Pain and oth cond assoc w fem gntl org and menstrual cycle"	1	292	167	459
"J30"	"N97"	"Vasomotor and allergic rhinitis"	"Female infertility"	1	362	201	563
"J30"	"O24"	"Vasomotor and allergic rhinitis"	"Diabetes in pregnancy, childbirth, and the puerperium"	1	134	54	188
"J30"	"O42"	"Vasomotor and allergic rhinitis"	"Premature rupture of membranes"	1	298	173	471
"J30"	"O70"	"Vasomotor and allergic rhinitis"	"Perineal laceration during delivery"	1	1165	710	1875
"J30"	"O72"	"Vasomotor and allergic rhinitis"	"Postpartum hemorrhage"	1	1632	0	1632
"J30"	"O75"	"Vasomotor and allergic rhinitis"	"Oth complications of labor and delivery, NEC"	1	198	106	304
"J30"	"Q61"	"Vasomotor and allergic rhinitis"	"Cystic kidney disease"	1	46	8	54
"J31"	"C34"	"Chronic rhinitis, nasopharyngitis and pharyngitis"	"Malignant neoplasm of bronchus and lung"	1	63	5	68
"J31"	"I50"	"Chronic rhinitis, nasopharyngitis and pharyngitis"	"Heart failure"	1	132	39	171
"J31"	"O72"	"Chronic rhinitis, nasopharyngitis and pharyngitis"	"Postpartum hemorrhage"	1	214	52	266
"J32"	"A49"	"Chronic sinusitis"	"Bacterial infection of unspecified site"	1	255	49	304
"J32"	"C16"	"Chronic sinusitis"	"Malignant neoplasm of stomach"	1	37	2	39
"J32"	"C18"	"Chronic sinusitis"	"Malignant neoplasm of colon"	1	98	15	113
"J32"	"C61"	"Chronic sinusitis"	"Malignant neoplasm of prostate"	1	166	29	195
"J32"	"C77"	"Chronic sinusitis"	"Secondary and unspecified malignant neoplasm of lymph nodes"	1	70	14	84
"J32"	"C79"	"Chronic sinusitis"	"Secondary malignant neoplasm of other and unspecified sites"	1	119	4	123
"J32"	"D50"	"Chronic sinusitis"	"Iron deficiency anemia"	1	150	44	194
"J32"	"D63"	"Chronic sinusitis"	"Anemia in chronic diseases classified elsewhere"	1	76	6	82
"J32"	"D64"	"Chronic sinusitis"	"Other anemias"	1	373	81	454
"J32"	"E78"	"Chronic sinusitis"	"Disorders of lipoprotein metabolism and other lipidemias"	1	657	244	901
"J32"	"E83"	"Chronic sinusitis"	"Disorders of mineral metabolism"	1	62	11	73
"J32"	"E87"	"Chronic sinusitis"	"Other disorders of fluid, electrolyte and acid-base balance"	1	270	27	297
"J32"	"G95"	"Chronic sinusitis"	"Other and unspecified diseases of spinal cord"	1	59	7	66
"J32"	"H26"	"Chronic sinusitis"	"Other cataract"	1	219	82	301
"J32"	"H57"	"Chronic sinusitis"	"Other disorders of eye and adnexa"	1	207	109	316
"J32"	"I10"	"Chronic sinusitis"	"Essential (primary) hypertension"	1	1471	754	2225
"J32"	"I42"	"Chronic sinusitis"	"Cardiomyopathy"	1	67	19	86
"J32"	"I50"	"Chronic sinusitis"	"Heart failure"	1	426	96	522
"J32"	"I69"	"Chronic sinusitis"	"Sequelae of cerebrovascular disease"	1	343	69	412
"J32"	"I70"	"Chronic sinusitis"	"Atherosclerosis"	1	159	67	226
"J32"	"I73"	"Chronic sinusitis"	"Other peripheral vascular diseases"	1	183	36	219
"J32"	"J69"	"Chronic sinusitis"	"Pneumonitis due to solids and liquids"	1	35	0	35
"J32"	"J81"	"Chronic sinusitis"	"Pulmonary edema"	1	45	8	53
"J32"	"J96"	"Chronic sinusitis"	"Respiratory failure, not elsewhere classified"	1	385	46	431
"J32"	"K22"	"Chronic sinusitis"	"Other diseases of esophagus"	1	116	40	156
"J32"	"K55"	"Chronic sinusitis"	"Vascular disorders of intestine"	1	31	0	31
"J32"	"K56"	"Chronic sinusitis"	"Paralytic ileus and intestinal obstruction without hernia"	1	130	46	176
"J32"	"K59"	"Chronic sinusitis"	"Other functional intestinal disorders"	1	749	254	1003
"J32"	"K62"	"Chronic sinusitis"	"Other diseases of anus and rectum"	1	269	134	403
"J32"	"K63"	"Chronic sinusitis"	"Other diseases of intestine"	1	82	9	91
"J32"	"K64"	"Chronic sinusitis"	"Hemorrhoids and perianal venous thrombosis"	1	276	6	282
"J32"	"K92"	"Chronic sinusitis"	"Other diseases of digestive system"	1	183	58	241
"J32"	"L89"	"Chronic sinusitis"	"Pressure ulcer"	1	46	1	47
"J32"	"M16"	"Chronic sinusitis"	"Osteoarthritis of hip"	1	357	146	503
"J32"	"M75"	"Chronic sinusitis"	"Shoulder lesions"	1	752	479	1231
"J33"	"A41"	"Nasal polyp"	"Other sepsis"	1	235	9	244
"J33"	"A46"	"Nasal polyp"	"Erysipelas"	1	112	25	137
"J33"	"A49"	"Nasal polyp"	"Bacterial infection of unspecified site"	1	133	8	141
"J33"	"C16"	"Nasal polyp"	"Malignant neoplasm of stomach"	1	28	1	29
"J33"	"C79"	"Nasal polyp"	"Secondary malignant neoplasm of other and unspecified sites"	1	76	2	78
"J33"	"D50"	"Nasal polyp"	"Iron deficiency anemia"	1	72	10	82
"J33"	"D63"	"Nasal polyp"	"Anemia in chronic diseases classified elsewhere"	1	35	0	35
"J33"	"D64"	"Nasal polyp"	"Other anemias"	1	203	21	224
"J33"	"E11"	"Nasal polyp"	"Type 2 diabetes mellitus"	1	314	131	445
"J33"	"E78"	"Nasal polyp"	"Disorders of lipoprotein metabolism and other lipidemias"	1	377	161	538
"J33"	"E86"	"Nasal polyp"	"Volume depletion"	1	203	5	208
"J33"	"E87"	"Nasal polyp"	"Other disorders of fluid, electrolyte and acid-base balance"	1	126	3	129
"J33"	"F03"	"Nasal polyp"	"Unspecified dementia"	1	66	0	66
"J33"	"F41"	"Nasal polyp"	"Other anxiety disorders"	1	65	13	78
"J33"	"H26"	"Nasal polyp"	"Other cataract"	1	116	49	165
"J33"	"I25"	"Nasal polyp"	"Chronic ischemic heart disease"	1	308	168	476
"J33"	"I44"	"Nasal polyp"	"Atrioventricular and left bundle-branch block"	1	41	4	45
"J33"	"I46"	"Nasal polyp"	"Cardiac arrest"	1	74	0	74
"J33"	"I50"	"Nasal polyp"	"Heart failure"	1	284	36	320
"J33"	"I63"	"Nasal polyp"	"Cerebral infarction"	1	182	55	237
"J33"	"I69"	"Nasal polyp"	"Sequelae of cerebrovascular disease"	1	193	44	237
"J33"	"I71"	"Nasal polyp"	"Aortic aneurysm and dissection"	1	101	12	113
"J33"	"J81"	"Nasal polyp"	"Pulmonary edema"	1	27	2	29
"J33"	"J96"	"Nasal polyp"	"Respiratory failure, not elsewhere classified"	1	213	25	238
"J33"	"K62"	"Nasal polyp"	"Other diseases of anus and rectum"	1	163	83	246
"J33"	"K63"	"Nasal polyp"	"Other diseases of intestine"	1	40	5	45
"J33"	"L08"	"Nasal polyp"	"Other local infections of skin and subcutaneous tissue"	1	94	36	130
"J33"	"M16"	"Nasal polyp"	"Osteoarthritis of hip"	1	173	80	253
"J33"	"M17"	"Nasal polyp"	"Osteoarthritis of knee"	1	295	183	478
"J33"	"M19"	"Nasal polyp"	"Other and unspecified osteoarthritis"	1	174	68	242
"J33"	"N17"	"Nasal polyp"	"Acute kidney failure"	1	54	0	54
"J33"	"N18"	"Nasal polyp"	"Chronic kidney disease (CKD)"	1	114	3	117
"J33"	"N19"	"Nasal polyp"	"Unspecified kidney failure"	1	49	6	55
"J33"	"N30"	"Nasal polyp"	"Cystitis"	1	291	96	387
"J33"	"N39"	"Nasal polyp"	"Other disorders of urinary system"	1	232	50	282
"J34"	"A04"	"Other and unspecified disorders of nose and nasal sinuses"	"Other bacterial intestinal infections"	1	129	25	154
"J34"	"A41"	"Other and unspecified disorders of nose and nasal sinuses"	"Other sepsis"	1	454	7	461
"J34"	"A49"	"Other and unspecified disorders of nose and nasal sinuses"	"Bacterial infection of unspecified site"	1	355	49	404
"J34"	"C16"	"Other and unspecified disorders of nose and nasal sinuses"	"Malignant neoplasm of stomach"	1	37	0	37
"J34"	"C20"	"Other and unspecified disorders of nose and nasal sinuses"	"Malignant neoplasm of rectum"	1	57	0	57
"J34"	"C25"	"Other and unspecified disorders of nose and nasal sinuses"	"Malignant neoplasm of pancreas"	1	48	0	48
"J34"	"C34"	"Other and unspecified disorders of nose and nasal sinuses"	"Malignant neoplasm of bronchus and lung"	1	236	0	236
"J34"	"C43"	"Other and unspecified disorders of nose and nasal sinuses"	"Malignant melanoma of skin"	1	99	11	110
"J34"	"C44"	"Other and unspecified disorders of nose and nasal sinuses"	"Other and unspecified malignant neoplasm of skin"	1	217	14	231
"J34"	"C50"	"Other and unspecified disorders of nose and nasal sinuses"	"Malignant neoplasm of breast"	1	139	44	183
"J34"	"C64"	"Other and unspecified disorders of nose and nasal sinuses"	"Malignant neoplasm of kidney, except renal pelvis"	1	69	2	71
"J34"	"C71"	"Other and unspecified disorders of nose and nasal sinuses"	"Malignant neoplasm of brain"	1	58	1	59
"J34"	"C77"	"Other and unspecified disorders of nose and nasal sinuses"	"Secondary and unspecified malignant neoplasm of lymph nodes"	1	98	2	100
"J34"	"C79"	"Other and unspecified disorders of nose and nasal sinuses"	"Secondary malignant neoplasm of other and unspecified sites"	1	136	0	136
"J34"	"C83"	"Other and unspecified disorders of nose and nasal sinuses"	"Non-follicular lymphoma"	1	42	5	47
"J34"	"D12"	"Other and unspecified disorders of nose and nasal sinuses"	"Benign neoplasm of colon, rectum, anus and anal canal"	1	817	2	819
"J34"	"D13"	"Other and unspecified disorders of nose and nasal sinuses"	"Benign neoplasm of and ill-defined parts of digestive system"	1	68	11	79
"J34"	"D22"	"Other and unspecified disorders of nose and nasal sinuses"	"Melanocytic nevi"	1	211	86	297
"J34"	"D63"	"Other and unspecified disorders of nose and nasal sinuses"	"Anemia in chronic diseases classified elsewhere"	1	81	1	82
"J34"	"D68"	"Other and unspecified disorders of nose and nasal sinuses"	"Other coagulation defects"	1	108	44	152
"J34"	"E03"	"Other and unspecified disorders of nose and nasal sinuses"	"Other hypothyroidism"	1	352	83	435
"J34"	"E13"	"Other and unspecified disorders of nose and nasal sinuses"	"Other specified diabetes mellitus"	1	44	4	48
"J34"	"E27"	"Other and unspecified disorders of nose and nasal sinuses"	"Other disorders of adrenal gland"	1	56	4	60
"J34"	"E29"	"Other and unspecified disorders of nose and nasal sinuses"	"Testicular dysfunction"	1	46	3	49
"J34"	"E78"	"Other and unspecified disorders of nose and nasal sinuses"	"Disorders of lipoprotein metabolism and other lipidemias"	1	1146	172	1318
"J34"	"E83"	"Other and unspecified disorders of nose and nasal sinuses"	"Disorders of mineral metabolism"	1	70	1	71
"J34"	"E86"	"Other and unspecified disorders of nose and nasal sinuses"	"Volume depletion"	1	381	16	397
"J34"	"E87"	"Other and unspecified disorders of nose and nasal sinuses"	"Other disorders of fluid, electrolyte and acid-base balance"	1	272	1	273
"J34"	"E89"	"Other and unspecified disorders of nose and nasal sinuses"	"Postproc endocrine and metabolic comp and disorders, NEC"	1	66	11	77
"J34"	"F03"	"Other and unspecified disorders of nose and nasal sinuses"	"Unspecified dementia"	1	101	0	101
"J34"	"F06"	"Other and unspecified disorders of nose and nasal sinuses"	"Other mental disorders due to known physiological condition"	1	56	6	62
"J34"	"G31"	"Other and unspecified disorders of nose and nasal sinuses"	"Oth degenerative diseases of nervous system, NEC"	1	28	1	29
"J34"	"G45"	"Other and unspecified disorders of nose and nasal sinuses"	"Transient cerebral ischemic attacks and related syndromes"	1	320	66	386
"J34"	"G63"	"Other and unspecified disorders of nose and nasal sinuses"	"Polyneuropathy in diseases classified elsewhere"	1	43	4	47
"J34"	"G93"	"Other and unspecified disorders of nose and nasal sinuses"	"Other disorders of brain"	1	64	14	78
"J34"	"G95"	"Other and unspecified disorders of nose and nasal sinuses"	"Other and unspecified diseases of spinal cord"	1	64	0	64
"J34"	"H25"	"Other and unspecified disorders of nose and nasal sinuses"	"Age-related cataract"	1	832	88	920
"J34"	"H40"	"Other and unspecified disorders of nose and nasal sinuses"	"Glaucoma"	1	100	36	136
"J34"	"H43"	"Other and unspecified disorders of nose and nasal sinuses"	"Disorders of vitreous body"	1	149	24	173
"J34"	"H53"	"Other and unspecified disorders of nose and nasal sinuses"	"Visual disturbances"	1	220	70	290
"J34"	"I10"	"Other and unspecified disorders of nose and nasal sinuses"	"Essential (primary) hypertension"	1	2261	554	2815
"J34"	"I20"	"Other and unspecified disorders of nose and nasal sinuses"	"Angina pectoris"	1	1010	351	1361
"J34"	"I21"	"Other and unspecified disorders of nose and nasal sinuses"	"Acute myocardial infarction"	1	546	102	648
"J34"	"I34"	"Other and unspecified disorders of nose and nasal sinuses"	"Nonrheumatic mitral valve disorders"	1	82	14	96
"J34"	"I35"	"Other and unspecified disorders of nose and nasal sinuses"	"Nonrheumatic aortic valve disorders"	1	246	0	246
"J34"	"I44"	"Other and unspecified disorders of nose and nasal sinuses"	"Atrioventricular and left bundle-branch block"	1	100	11	111
"J34"	"I48"	"Other and unspecified disorders of nose and nasal sinuses"	"Atrial fibrillation and flutter"	1	768	72	840
"J34"	"I51"	"Other and unspecified disorders of nose and nasal sinuses"	"Complications and ill-defined descriptions of heart disease"	1	83	17	100
"J34"	"I63"	"Other and unspecified disorders of nose and nasal sinuses"	"Cerebral infarction"	1	428	27	455
"J34"	"I67"	"Other and unspecified disorders of nose and nasal sinuses"	"Other cerebrovascular diseases"	1	64	7	71
"J34"	"I69"	"Other and unspecified disorders of nose and nasal sinuses"	"Sequelae of cerebrovascular disease"	1	414	27	441
"J34"	"I70"	"Other and unspecified disorders of nose and nasal sinuses"	"Atherosclerosis"	1	196	50	246
"J34"	"I72"	"Other and unspecified disorders of nose and nasal sinuses"	"Other aneurysm"	1	45	4	49
"J34"	"I74"	"Other and unspecified disorders of nose and nasal sinuses"	"Arterial embolism and thrombosis"	1	54	10	64
"J34"	"I80"	"Other and unspecified disorders of nose and nasal sinuses"	"Phlebitis and thrombophlebitis"	1	424	94	518
"J34"	"I82"	"Other and unspecified disorders of nose and nasal sinuses"	"Other venous embolism and thrombosis"	1	76	6	82
"J34"	"I83"	"Other and unspecified disorders of nose and nasal sinuses"	"Varicose veins of lower extremities"	1	405	245	650
"J34"	"I95"	"Other and unspecified disorders of nose and nasal sinuses"	"Hypotension"	1	114	18	132
"J34"	"J10"	"Other and unspecified disorders of nose and nasal sinuses"	"Influenza due to other identified influenza virus"	1	38	1	39
"J34"	"J15"	"Other and unspecified disorders of nose and nasal sinuses"	"Bacterial pneumonia, not elsewhere classified"	1	468	31	499
"J34"	"J43"	"Other and unspecified disorders of nose and nasal sinuses"	"Emphysema"	1	114	31	145
"J34"	"J81"	"Other and unspecified disorders of nose and nasal sinuses"	"Pulmonary edema"	1	40	0	40
"J34"	"J84"	"Other and unspecified disorders of nose and nasal sinuses"	"Other interstitial pulmonary diseases"	1	87	11	98
"J34"	"J90"	"Other and unspecified disorders of nose and nasal sinuses"	"Pleural effusion, not elsewhere classified"	1	79	5	84
"J34"	"J96"	"Other and unspecified disorders of nose and nasal sinuses"	"Respiratory failure, not elsewhere classified"	1	500	5	505
"J34"	"K25"	"Other and unspecified disorders of nose and nasal sinuses"	"Gastric ulcer"	1	258	107	365
"J34"	"K40"	"Other and unspecified disorders of nose and nasal sinuses"	"Inguinal hernia"	1	670	490	1160
"J34"	"K55"	"Other and unspecified disorders of nose and nasal sinuses"	"Vascular disorders of intestine"	1	38	1	39
"J34"	"K56"	"Other and unspecified disorders of nose and nasal sinuses"	"Paralytic ileus and intestinal obstruction without hernia"	1	180	13	193
"J34"	"K60"	"Other and unspecified disorders of nose and nasal sinuses"	"Fissure and fistula of anal and rectal regions"	1	319	169	488
"J34"	"K63"	"Other and unspecified disorders of nose and nasal sinuses"	"Other diseases of intestine"	1	117	4	121
"J34"	"K80"	"Other and unspecified disorders of nose and nasal sinuses"	"Cholelithiasis"	1	614	267	881
"J34"	"K85"	"Other and unspecified disorders of nose and nasal sinuses"	"Acute pancreatitis"	1	134	39	173
"J34"	"K92"	"Other and unspecified disorders of nose and nasal sinuses"	"Other diseases of digestive system"	1	280	103	383
"J34"	"L08"	"Other and unspecified disorders of nose and nasal sinuses"	"Other local infections of skin and subcutaneous tissue"	1	465	205	670
"J34"	"L40"	"Other and unspecified disorders of nose and nasal sinuses"	"Psoriasis"	1	187	65	252
"J34"	"L89"	"Other and unspecified disorders of nose and nasal sinuses"	"Pressure ulcer"	1	47	0	47
"J34"	"L97"	"Other and unspecified disorders of nose and nasal sinuses"	"Non-pressure chronic ulcer of lower limb, NEC"	1	81	0	81
"J34"	"M06"	"Other and unspecified disorders of nose and nasal sinuses"	"Other rheumatoid arthritis"	1	123	51	174
"J34"	"M16"	"Other and unspecified disorders of nose and nasal sinuses"	"Osteoarthritis of hip"	1	503	63	566
"J34"	"M17"	"Other and unspecified disorders of nose and nasal sinuses"	"Osteoarthritis of knee"	1	1095	251	1346
"J34"	"M21"	"Other and unspecified disorders of nose and nasal sinuses"	"Other acquired deformities of limbs"	1	199	102	301
"J34"	"M25"	"Other and unspecified disorders of nose and nasal sinuses"	"Other joint disorder, not elsewhere classified"	1	589	258	847
"J34"	"M46"	"Other and unspecified disorders of nose and nasal sinuses"	"Other inflammatory spondylopathies"	1	99	30	129
"J34"	"M48"	"Other and unspecified disorders of nose and nasal sinuses"	"Other spondylopathies"	1	505	42	547
"J34"	"M51"	"Other and unspecified disorders of nose and nasal sinuses"	"Thoracic, thoracolum, and lumbosacral intvrt disc disorders"	1	1281	659	1940
"J34"	"M54"	"Other and unspecified disorders of nose and nasal sinuses"	"Dorsalgia"	1	1860	1294	3154
"J34"	"M65"	"Other and unspecified disorders of nose and nasal sinuses"	"Synovitis and tenosynovitis"	1	589	422	1011
"J34"	"M67"	"Other and unspecified disorders of nose and nasal sinuses"	"Other disorders of synovium and tendon"	1	595	342	937
"J34"	"M76"	"Other and unspecified disorders of nose and nasal sinuses"	"Enthesopathies, lower limb, excluding foot"	1	391	223	614
"J34"	"M77"	"Other and unspecified disorders of nose and nasal sinuses"	"Other enthesopathies"	1	477	213	690
"J34"	"M80"	"Other and unspecified disorders of nose and nasal sinuses"	"Osteoporosis with current pathological fracture"	1	131	0	131
"J34"	"M85"	"Other and unspecified disorders of nose and nasal sinuses"	"Other disorders of bone density and structure"	1	276	39	315
"J34"	"N17"	"Other and unspecified disorders of nose and nasal sinuses"	"Acute kidney failure"	1	118	0	118
"J34"	"N28"	"Other and unspecified disorders of nose and nasal sinuses"	"Oth disorders of kidney and ureter, not elsewhere classified"	1	72	4	76
"J34"	"N30"	"Other and unspecified disorders of nose and nasal sinuses"	"Cystitis"	1	807	299	1106
"J34"	"N39"	"Other and unspecified disorders of nose and nasal sinuses"	"Other disorders of urinary system"	1	689	155	844
"J34"	"N46"	"Other and unspecified disorders of nose and nasal sinuses"	"Male infertility"	1	393	140	533
"J34"	"N50"	"Other and unspecified disorders of nose and nasal sinuses"	"Other and unspecified disorders of male genital organs"	1	352	114	466
"J35"	"A04"	"Chronic diseases of tonsils and adenoids"	"Other bacterial intestinal infections"	1	165	38	203
"J35"	"A41"	"Chronic diseases of tonsils and adenoids"	"Other sepsis"	1	331	89	420
"J35"	"A46"	"Chronic diseases of tonsils and adenoids"	"Erysipelas"	1	336	3	339
"J35"	"B36"	"Chronic diseases of tonsils and adenoids"	"Other superficial mycoses"	1	75	7	82
"J35"	"B95"	"Chronic diseases of tonsils and adenoids"	"Strep as the cause of diseases classified elsewhere"	1	71	6	77
"J35"	"C18"	"Chronic diseases of tonsils and adenoids"	"Malignant neoplasm of colon"	1	41	2	43
"J35"	"C34"	"Chronic diseases of tonsils and adenoids"	"Malignant neoplasm of bronchus and lung"	1	100	6	106
"J35"	"C61"	"Chronic diseases of tonsils and adenoids"	"Malignant neoplasm of prostate"	1	42	0	42
"J35"	"C62"	"Chronic diseases of tonsils and adenoids"	"Malignant neoplasm of testis"	1	28	1	29
"J35"	"C71"	"Chronic diseases of tonsils and adenoids"	"Malignant neoplasm of brain"	1	37	0	37
"J35"	"C79"	"Chronic diseases of tonsils and adenoids"	"Secondary malignant neoplasm of other and unspecified sites"	1	82	0	82
"J35"	"D12"	"Chronic diseases of tonsils and adenoids"	"Benign neoplasm of colon, rectum, anus and anal canal"	1	335	1	336
"J35"	"D16"	"Chronic diseases of tonsils and adenoids"	"Benign neoplasm of bone and articular cartilage"	1	145	44	189
"J35"	"D21"	"Chronic diseases of tonsils and adenoids"	"Other benign neoplasms of connective and other soft tissue"	1	141	25	166
"J35"	"D27"	"Chronic diseases of tonsils and adenoids"	"Benign neoplasm of ovary"	1	313	26	339
"J35"	"D43"	"Chronic diseases of tonsils and adenoids"	"Neoplasm of uncertain behavior of brain and cnsl"	1	40	0	40
"J35"	"D50"	"Chronic diseases of tonsils and adenoids"	"Iron deficiency anemia"	1	205	19	224
"J35"	"D62"	"Chronic diseases of tonsils and adenoids"	"Acute posthemorrhagic anemia"	1	91	7	98
"J35"	"D68"	"Chronic diseases of tonsils and adenoids"	"Other coagulation defects"	1	276	10	286
"J35"	"D72"	"Chronic diseases of tonsils and adenoids"	"Other disorders of white blood cells"	1	55	8	63
"J35"	"D75"	"Chronic diseases of tonsils and adenoids"	"Other and unsp diseases of blood and blood-forming organs"	1	41	1	42
"J35"	"E03"	"Chronic diseases of tonsils and adenoids"	"Other hypothyroidism"	1	529	0	529
"J35"	"E10"	"Chronic diseases of tonsils and adenoids"	"Type 1 diabetes mellitus"	1	318	95	413
"J35"	"E13"	"Chronic diseases of tonsils and adenoids"	"Other specified diabetes mellitus"	1	39	0	39
"J35"	"E28"	"Chronic diseases of tonsils and adenoids"	"Ovarian dysfunction"	1	421	0	421
"J35"	"E29"	"Chronic diseases of tonsils and adenoids"	"Testicular dysfunction"	1	36	1	37
"J35"	"E30"	"Chronic diseases of tonsils and adenoids"	"Disorders of puberty, not elsewhere classified"	1	255	68	323
"J35"	"E34"	"Chronic diseases of tonsils and adenoids"	"Other endocrine disorders"	1	367	74	441
"J35"	"E55"	"Chronic diseases of tonsils and adenoids"	"Vitamin D deficiency"	1	185	0	185
"J35"	"E64"	"Chronic diseases of tonsils and adenoids"	"Sequelae of malnutrition and other nutritional deficiencies"	1	80	25	105
"J35"	"E65"	"Chronic diseases of tonsils and adenoids"	"Localized adiposity"	1	223	1	224
"J35"	"E87"	"Chronic diseases of tonsils and adenoids"	"Other disorders of fluid, electrolyte and acid-base balance"	1	148	33	181
"J35"	"E89"	"Chronic diseases of tonsils and adenoids"	"Postproc endocrine and metabolic comp and disorders, NEC"	1	118	3	121
"J35"	"F11"	"Chronic diseases of tonsils and adenoids"	"Opioid related disorders"	1	46	3	49
"J35"	"F12"	"Chronic diseases of tonsils and adenoids"	"Cannabis related disorders"	1	82	5	87
"J35"	"F17"	"Chronic diseases of tonsils and adenoids"	"Nicotine dependence"	1	726	0	726
"J35"	"F32"	"Chronic diseases of tonsils and adenoids"	"Depressive episode"	1	368	25	393
"J35"	"F41"	"Chronic diseases of tonsils and adenoids"	"Other anxiety disorders"	1	391	0	391
"J35"	"F43"	"Chronic diseases of tonsils and adenoids"	"Reaction to severe stress, and adjustment disorders"	1	600	50	650
"J35"	"F44"	"Chronic diseases of tonsils and adenoids"	"Dissociative and conversion disorders"	1	68	4	72
"J35"	"F45"	"Chronic diseases of tonsils and adenoids"	"Somatoform disorders"	1	156	36	192
"J35"	"F60"	"Chronic diseases of tonsils and adenoids"	"Specific personality disorders"	1	131	0	131
"J35"	"F71"	"Chronic diseases of tonsils and adenoids"	"Moderate intellectual disabilities"	1	71	6	77
"J35"	"F79"	"Chronic diseases of tonsils and adenoids"	"Unspecified intellectual disabilities"	1	201	42	243
"J35"	"F84"	"Chronic diseases of tonsils and adenoids"	"Pervasive developmental disorders"	1	199	6	205
"J35"	"F90"	"Chronic diseases of tonsils and adenoids"	"Attention-deficit hyperactivity disorders"	1	347	13	360
"J35"	"F95"	"Chronic diseases of tonsils and adenoids"	"Tic disorder"	1	203	21	224
"J35"	"F99"	"Chronic diseases of tonsils and adenoids"	"Mental disorder, not otherwise specified"	1	93	15	108
"J35"	"G44"	"Chronic diseases of tonsils and adenoids"	"Other headache syndromes"	1	992	59	1051
"J35"	"G45"	"Chronic diseases of tonsils and adenoids"	"Transient cerebral ischemic attacks and related syndromes"	1	167	6	173
"J35"	"G56"	"Chronic diseases of tonsils and adenoids"	"Mononeuropathies of upper limb"	1	914	5	919
"J35"	"G62"	"Chronic diseases of tonsils and adenoids"	"Other and unspecified polyneuropathies"	1	108	0	108
"J35"	"G93"	"Chronic diseases of tonsils and adenoids"	"Other disorders of brain"	1	162	23	185
"J35"	"G96"	"Chronic diseases of tonsils and adenoids"	"Other disorders of central nervous system"	1	329	0	329
"J35"	"G97"	"Chronic diseases of tonsils and adenoids"	"Intraop and postproc comp and disorders of nervous sys, NEC"	1	66	1	67
"J35"	"G98"	"Chronic diseases of tonsils and adenoids"	"Other disorders of nervous system not elsewhere classified"	1	231	0	231
"J35"	"H00"	"Chronic diseases of tonsils and adenoids"	"Hordeolum and chalazion"	1	221	94	315
"J35"	"H01"	"Chronic diseases of tonsils and adenoids"	"Other inflammation of eyelid"	1	86	1	87
"J35"	"H02"	"Chronic diseases of tonsils and adenoids"	"Other disorders of eyelid"	1	250	26	276
"J35"	"H10"	"Chronic diseases of tonsils and adenoids"	"Conjunctivitis"	1	1008	621	1629
"J35"	"H25"	"Chronic diseases of tonsils and adenoids"	"Age-related cataract"	1	296	25	321
"J35"	"H26"	"Chronic diseases of tonsils and adenoids"	"Other cataract"	1	136	14	150
"J35"	"H33"	"Chronic diseases of tonsils and adenoids"	"Retinal detachments and breaks"	1	75	9	84
"J35"	"H36"	"Chronic diseases of tonsils and adenoids"	"Retinal disorders in diseases classified elsewhere"	1	102	0	102
"J35"	"H47"	"Chronic diseases of tonsils and adenoids"	"Other disorders of optic [2nd] nerve and visual pathways"	1	185	15	200
"J35"	"H49"	"Chronic diseases of tonsils and adenoids"	"Paralytic strabismus"	1	82	15	97
"J35"	"H50"	"Chronic diseases of tonsils and adenoids"	"Other strabismus"	1	550	318	868
"J35"	"H57"	"Chronic diseases of tonsils and adenoids"	"Other disorders of eye and adnexa"	1	460	10	470
"J35"	"H72"	"Chronic diseases of tonsils and adenoids"	"Perforation of tympanic membrane"	1	895	495	1390
"J35"	"H91"	"Chronic diseases of tonsils and adenoids"	"Other and unspecified hearing loss"	1	900	229	1129
"J35"	"I25"	"Chronic diseases of tonsils and adenoids"	"Chronic ischemic heart disease"	1	277	42	319
"J35"	"I30"	"Chronic diseases of tonsils and adenoids"	"Acute pericarditis"	1	84	12	96
"J35"	"I34"	"Chronic diseases of tonsils and adenoids"	"Nonrheumatic mitral valve disorders"	1	65	11	76
"J35"	"I42"	"Chronic diseases of tonsils and adenoids"	"Cardiomyopathy"	1	72	16	88
"J35"	"I45"	"Chronic diseases of tonsils and adenoids"	"Other conduction disorders"	1	88	17	105
"J35"	"I49"	"Chronic diseases of tonsils and adenoids"	"Other cardiac arrhythmias"	1	278	23	301
"J35"	"I50"	"Chronic diseases of tonsils and adenoids"	"Heart failure"	1	179	30	209
"J35"	"I51"	"Chronic diseases of tonsils and adenoids"	"Complications and ill-defined descriptions of heart disease"	1	93	8	101
"J35"	"I63"	"Chronic diseases of tonsils and adenoids"	"Cerebral infarction"	1	171	0	171
"J35"	"I67"	"Chronic diseases of tonsils and adenoids"	"Other cerebrovascular diseases"	1	51	2	53
"J35"	"I69"	"Chronic diseases of tonsils and adenoids"	"Sequelae of cerebrovascular disease"	1	175	0	175
"J35"	"I71"	"Chronic diseases of tonsils and adenoids"	"Aortic aneurysm and dissection"	1	43	0	43
"J35"	"I82"	"Chronic diseases of tonsils and adenoids"	"Other venous embolism and thrombosis"	1	60	0	60
"J35"	"I83"	"Chronic diseases of tonsils and adenoids"	"Varicose veins of lower extremities"	1	530	32	562
"J35"	"I95"	"Chronic diseases of tonsils and adenoids"	"Hypotension"	1	91	0	91
"J35"	"I99"	"Chronic diseases of tonsils and adenoids"	"Other and unspecified disorders of circulatory system"	1	37	3	40
"J35"	"J09"	"Chronic diseases of tonsils and adenoids"	"Influenza due to certain identified influenza viruses"	1	61	7	68
"J35"	"J15"	"Chronic diseases of tonsils and adenoids"	"Bacterial pneumonia, not elsewhere classified"	1	507	181	688
"J35"	"J32"	"Chronic diseases of tonsils and adenoids"	"Chronic sinusitis"	1	688	450	1138
"J35"	"J47"	"Chronic diseases of tonsils and adenoids"	"Bronchiectasis"	1	73	1	74
"J35"	"J90"	"Chronic diseases of tonsils and adenoids"	"Pleural effusion, not elsewhere classified"	1	53	7	60
"J35"	"K01"	"Chronic diseases of tonsils and adenoids"	"Embedded and impacted teeth"	1	413	43	456
"J35"	"K20"	"Chronic diseases of tonsils and adenoids"	"Esophagitis"	1	149	35	184
"J35"	"K21"	"Chronic diseases of tonsils and adenoids"	"Gastro-esophageal reflux disease"	1	1058	385	1443
"J35"	"K35"	"Chronic diseases of tonsils and adenoids"	"Acute appendicitis"	1	1424	577	2001
"J35"	"K37"	"Chronic diseases of tonsils and adenoids"	"Unspecified appendicitis"	1	190	0	190
"J35"	"K42"	"Chronic diseases of tonsils and adenoids"	"Umbilical hernia"	1	298	100	398
"J35"	"K43"	"Chronic diseases of tonsils and adenoids"	"Ventral hernia"	1	241	16	257
"J35"	"K44"	"Chronic diseases of tonsils and adenoids"	"Diaphragmatic hernia"	1	456	77	533
"J35"	"K51"	"Chronic diseases of tonsils and adenoids"	"Ulcerative colitis"	1	338	24	362
"J35"	"K56"	"Chronic diseases of tonsils and adenoids"	"Paralytic ileus and intestinal obstruction without hernia"	1	162	28	190
"J35"	"K58"	"Chronic diseases of tonsils and adenoids"	"Irritable bowel syndrome"	1	1007	69	1076
"J35"	"K59"	"Chronic diseases of tonsils and adenoids"	"Other functional intestinal disorders"	1	2329	816	3145
"J35"	"K60"	"Chronic diseases of tonsils and adenoids"	"Fissure and fistula of anal and rectal regions"	1	407	88	495
"J35"	"K62"	"Chronic diseases of tonsils and adenoids"	"Other diseases of anus and rectum"	1	672	78	750
"J35"	"K65"	"Chronic diseases of tonsils and adenoids"	"Peritonitis"	1	81	15	96
"J35"	"K72"	"Chronic diseases of tonsils and adenoids"	"Hepatic failure, not elsewhere classified"	1	27	2	29
"J35"	"K76"	"Chronic diseases of tonsils and adenoids"	"Other diseases of liver"	1	184	8	192
"J35"	"K85"	"Chronic diseases of tonsils and adenoids"	"Acute pancreatitis"	1	139	6	145
"J35"	"K86"	"Chronic diseases of tonsils and adenoids"	"Other diseases of pancreas"	1	46	3	49
"J35"	"K90"	"Chronic diseases of tonsils and adenoids"	"Intestinal malabsorption"	1	214	39	253
"J35"	"K91"	"Chronic diseases of tonsils and adenoids"	"Intraop and postproc comp and disorders of dgstv sys, NEC"	1	66	1	67
"J35"	"K92"	"Chronic diseases of tonsils and adenoids"	"Other diseases of digestive system"	1	358	54	412
"J35"	"L02"	"Chronic diseases of tonsils and adenoids"	"Cutaneous abscess, furuncle and carbuncle"	1	1124	233	1357
"J35"	"L05"	"Chronic diseases of tonsils and adenoids"	"Pilonidal cyst and sinus"	1	483	13	496
"J35"	"L08"	"Chronic diseases of tonsils and adenoids"	"Other local infections of skin and subcutaneous tissue"	1	940	93	1033
"J35"	"L30"	"Chronic diseases of tonsils and adenoids"	"Other and unspecified dermatitis"	1	413	65	478
"J35"	"L70"	"Chronic diseases of tonsils and adenoids"	"Acne"	1	149	10	159
"J35"	"L72"	"Chronic diseases of tonsils and adenoids"	"Follicular cysts of skin and subcutaneous tissue"	1	147	26	173
"J35"	"L73"	"Chronic diseases of tonsils and adenoids"	"Other follicular disorders"	1	222	10	232
"J35"	"L90"	"Chronic diseases of tonsils and adenoids"	"Atrophic disorders of skin"	1	556	30	586
"J35"	"L91"	"Chronic diseases of tonsils and adenoids"	"Hypertrophic disorders of skin"	1	70	19	89
"J35"	"L97"	"Chronic diseases of tonsils and adenoids"	"Non-pressure chronic ulcer of lower limb, NEC"	1	57	0	57
"J35"	"M06"	"Chronic diseases of tonsils and adenoids"	"Other rheumatoid arthritis"	1	158	21	179
"J35"	"M10"	"Chronic diseases of tonsils and adenoids"	"Gout"	1	87	9	96
"J35"	"M20"	"Chronic diseases of tonsils and adenoids"	"Acquired deformities of fingers and toes"	1	514	72	586
"J35"	"M22"	"Chronic diseases of tonsils and adenoids"	"Disorder of patella"	1	1246	454	1700
"J35"	"M25"	"Chronic diseases of tonsils and adenoids"	"Other joint disorder, not elsewhere classified"	1	1115	115	1230
"J35"	"M31"	"Chronic diseases of tonsils and adenoids"	"Other necrotizing vasculopathies"	1	37	3	40
"J35"	"M32"	"Chronic diseases of tonsils and adenoids"	"Systemic lupus erythematosus (SLE)"	1	25	0	25
"J35"	"M35"	"Chronic diseases of tonsils and adenoids"	"Other systemic involvement of connective tissue"	1	518	165	683
"J35"	"M45"	"Chronic diseases of tonsils and adenoids"	"Ankylosing spondylitis"	1	56	2	58
"J35"	"M46"	"Chronic diseases of tonsils and adenoids"	"Other inflammatory spondylopathies"	1	88	0	88
"J35"	"M47"	"Chronic diseases of tonsils and adenoids"	"Spondylosis"	1	361	1	362
"J35"	"M53"	"Chronic diseases of tonsils and adenoids"	"Other and unspecified dorsopathies, not elsewhere classified"	1	341	7	348
"J35"	"M60"	"Chronic diseases of tonsils and adenoids"	"Myositis"	1	44	0	44
"J35"	"M62"	"Chronic diseases of tonsils and adenoids"	"Other disorders of muscle"	1	1969	371	2340
"J35"	"M71"	"Chronic diseases of tonsils and adenoids"	"Other bursopathies"	1	142	38	180
"J35"	"M72"	"Chronic diseases of tonsils and adenoids"	"Fibroblastic disorders"	1	232	4	236
"J35"	"M79"	"Chronic diseases of tonsils and adenoids"	"Oth and unsp soft tissue disorders, not elsewhere classified"	1	4140	0	4140
"J35"	"M81"	"Chronic diseases of tonsils and adenoids"	"Osteoporosis without current pathological fracture"	1	227	2	229
"J35"	"M83"	"Chronic diseases of tonsils and adenoids"	"Adult osteomalacia"	1	41	1	42
"J35"	"M84"	"Chronic diseases of tonsils and adenoids"	"Disorder of continuity of bone"	1	80	3	83
"J35"	"M85"	"Chronic diseases of tonsils and adenoids"	"Other disorders of bone density and structure"	1	214	0	214
"J35"	"M89"	"Chronic diseases of tonsils and adenoids"	"Other disorders of bone"	1	132	38	170
"J35"	"M92"	"Chronic diseases of tonsils and adenoids"	"Other juvenile osteochondrosis"	1	200	48	248
"J35"	"M94"	"Chronic diseases of tonsils and adenoids"	"Other disorders of cartilage"	1	82	4	86
"J35"	"M96"	"Chronic diseases of tonsils and adenoids"	"Intraop and postproc comp and disorders of ms sys, NEC"	1	40	0	40
"J35"	"N12"	"Chronic diseases of tonsils and adenoids"	"Tubulo-interstitial nephritis, not spcf as acute or chronic"	1	157	11	168
"J35"	"N13"	"Chronic diseases of tonsils and adenoids"	"Obstructive and reflux uropathy"	1	162	53	215
"J35"	"N20"	"Chronic diseases of tonsils and adenoids"	"Calculus of kidney and ureter"	1	723	36	759
"J35"	"N32"	"Chronic diseases of tonsils and adenoids"	"Other disorders of bladder"	1	65	9	74
"J35"	"N39"	"Chronic diseases of tonsils and adenoids"	"Other disorders of urinary system"	1	1114	157	1271
"J35"	"N44"	"Chronic diseases of tonsils and adenoids"	"Noninflammatory disorders of testis"	1	160	35	195
"J35"	"N46"	"Chronic diseases of tonsils and adenoids"	"Male infertility"	1	292	2	294
"J35"	"N62"	"Chronic diseases of tonsils and adenoids"	"Hypertrophy of breast"	1	604	115	719
"J35"	"N63"	"Chronic diseases of tonsils and adenoids"	"Unspecified lump in breast"	1	459	0	459
"J35"	"N70"	"Chronic diseases of tonsils and adenoids"	"Salpingitis and oophoritis"	1	356	122	478
"J35"	"N71"	"Chronic diseases of tonsils and adenoids"	"Inflammatory disease of uterus, except cervix"	1	334	38	372
"J35"	"N75"	"Chronic diseases of tonsils and adenoids"	"Diseases of Bartholin's gland"	1	161	3	164
"J35"	"N76"	"Chronic diseases of tonsils and adenoids"	"Other inflammation of vagina and vulva"	1	470	44	514
"J35"	"N80"	"Chronic diseases of tonsils and adenoids"	"Endometriosis"	1	412	6	418
"J35"	"N81"	"Chronic diseases of tonsils and adenoids"	"Female genital prolapse"	1	290	0	290
"J35"	"N83"	"Chronic diseases of tonsils and adenoids"	"Noninflammatory disord of ovary, fallop and broad ligament"	1	959	46	1005
"J35"	"N84"	"Chronic diseases of tonsils and adenoids"	"Polyp of female genital tract"	1	284	0	284
"J35"	"N85"	"Chronic diseases of tonsils and adenoids"	"Other noninflammatory disorders of uterus, except cervix"	1	46	4	50
"J35"	"N90"	"Chronic diseases of tonsils and adenoids"	"Other noninflammatory disorders of vulva and perineum"	1	183	37	220
"J35"	"N93"	"Chronic diseases of tonsils and adenoids"	"Other abnormal uterine and vaginal bleeding"	1	407	0	407
"J35"	"N94"	"Chronic diseases of tonsils and adenoids"	"Pain and oth cond assoc w fem gntl org and menstrual cycle"	1	880	60	940
"J35"	"N96"	"Chronic diseases of tonsils and adenoids"	"Recurrent pregnancy loss"	1	83	0	83
"J35"	"O00"	"Chronic diseases of tonsils and adenoids"	"Ectopic pregnancy"	1	308	41	349
"J35"	"O02"	"Chronic diseases of tonsils and adenoids"	"Other abnormal products of conception"	1	1161	65	1226
"J35"	"O03"	"Chronic diseases of tonsils and adenoids"	"Spontaneous abortion"	1	1172	186	1358
"J35"	"O12"	"Chronic diseases of tonsils and adenoids"	"Gestational edema and proteinuria without hypertension"	1	165	10	175
"J35"	"O22"	"Chronic diseases of tonsils and adenoids"	"Venous complications and hemorrhoids in pregnancy"	1	34	1	35
"J35"	"O32"	"Chronic diseases of tonsils and adenoids"	"Maternal care for malpresentation of fetus"	1	534	19	553
"J35"	"O35"	"Chronic diseases of tonsils and adenoids"	"Maternal care for known or suspected fetal abnlt and damage"	1	181	0	181
"J35"	"O43"	"Chronic diseases of tonsils and adenoids"	"Placental disorders"	1	26	0	26
"J35"	"O44"	"Chronic diseases of tonsils and adenoids"	"Placenta previa"	1	67	0	67
"J35"	"O45"	"Chronic diseases of tonsils and adenoids"	"Premature separation of placenta [abruptio placentae]"	1	68	8	76
"J35"	"O46"	"Chronic diseases of tonsils and adenoids"	"Antepartum hemorrhage, not elsewhere classified"	1	269	21	290
"J35"	"O47"	"Chronic diseases of tonsils and adenoids"	"False labor"	1	1003	13	1016
"J35"	"O61"	"Chronic diseases of tonsils and adenoids"	"Failed induction of labor"	1	58	0	58
"J35"	"O64"	"Chronic diseases of tonsils and adenoids"	"Obstructed labor due to malposition and malpresent of fetus"	1	489	48	537
"J35"	"O67"	"Chronic diseases of tonsils and adenoids"	"Labor and delivery comp by intrapartum hemorrhage, NEC"	1	54	0	54
"J35"	"O68"	"Chronic diseases of tonsils and adenoids"	"Labor and delivery comp by abnlt of fetal acid-base balance"	1	2220	0	2220
"J35"	"O70"	"Chronic diseases of tonsils and adenoids"	"Perineal laceration during delivery"	1	3926	0	3926
"J35"	"O71"	"Chronic diseases of tonsils and adenoids"	"Other obstetric trauma"	1	642	90	732
"J35"	"O72"	"Chronic diseases of tonsils and adenoids"	"Postpartum hemorrhage"	1	3775	0	3775
"J35"	"O75"	"Chronic diseases of tonsils and adenoids"	"Oth complications of labor and delivery, NEC"	1	580	0	580
"J35"	"O87"	"Chronic diseases of tonsils and adenoids"	"Venous complications and hemorrhoids in the puerperium"	1	60	0	60
"J35"	"O90"	"Chronic diseases of tonsils and adenoids"	"Complications of the puerperium, not elsewhere classified"	1	311	0	311
"J35"	"O92"	"Chronic diseases of tonsils and adenoids"	"Oth disord of brst/lactatn assoc w pregnancy and the puerp"	1	363	0	363
"J35"	"Q23"	"Chronic diseases of tonsils and adenoids"	"Congenital malformations of aortic and mitral valves"	1	85	27	112
"J35"	"Q27"	"Chronic diseases of tonsils and adenoids"	"Other congenital malformations of peripheral vascular system"	1	54	4	58
"J35"	"Q61"	"Chronic diseases of tonsils and adenoids"	"Cystic kidney disease"	1	57	6	63
"J35"	"Q93"	"Chronic diseases of tonsils and adenoids"	"Monosomies and deletions from the autosomes, NEC"	1	62	12	74
"J36"	"A46"	"Peritonsillar abscess"	"Erysipelas"	1	161	19	180
"J36"	"A49"	"Peritonsillar abscess"	"Bacterial infection of unspecified site"	1	144	19	163
"J36"	"B18"	"Peritonsillar abscess"	"Chronic viral hepatitis"	1	31	3	34
"J36"	"B37"	"Peritonsillar abscess"	"Candidiasis"	1	72	19	91
"J36"	"C18"	"Peritonsillar abscess"	"Malignant neoplasm of colon"	1	42	2	44
"J36"	"C20"	"Peritonsillar abscess"	"Malignant neoplasm of rectum"	1	24	1	25
"J36"	"C50"	"Peritonsillar abscess"	"Malignant neoplasm of breast"	1	79	10	89
"J36"	"C78"	"Peritonsillar abscess"	"Secondary malignant neoplasm of resp and digestive organs"	1	69	0	69
"J36"	"C79"	"Peritonsillar abscess"	"Secondary malignant neoplasm of other and unspecified sites"	1	42	0	42
"J36"	"C83"	"Peritonsillar abscess"	"Non-follicular lymphoma"	1	36	4	40
"J36"	"D12"	"Peritonsillar abscess"	"Benign neoplasm of colon, rectum, anus and anal canal"	1	165	0	165
"J36"	"D22"	"Peritonsillar abscess"	"Melanocytic nevi"	1	115	16	131
"J36"	"D23"	"Peritonsillar abscess"	"Other benign neoplasms of skin"	1	94	36	130
"J36"	"D63"	"Peritonsillar abscess"	"Anemia in chronic diseases classified elsewhere"	1	30	0	30
"J36"	"E11"	"Peritonsillar abscess"	"Type 2 diabetes mellitus"	1	260	42	302
"J36"	"E86"	"Peritonsillar abscess"	"Volume depletion"	1	212	32	244
"J36"	"F41"	"Peritonsillar abscess"	"Other anxiety disorders"	1	126	3	129
"J36"	"F43"	"Peritonsillar abscess"	"Reaction to severe stress, and adjustment disorders"	1	88	18	106
"J36"	"G45"	"Peritonsillar abscess"	"Transient cerebral ischemic attacks and related syndromes"	1	91	16	107
"J36"	"G56"	"Peritonsillar abscess"	"Mononeuropathies of upper limb"	1	272	35	307
"J36"	"H02"	"Peritonsillar abscess"	"Other disorders of eyelid"	1	69	7	76
"J36"	"H26"	"Peritonsillar abscess"	"Other cataract"	1	68	15	83
"J36"	"H36"	"Peritonsillar abscess"	"Retinal disorders in diseases classified elsewhere"	1	70	12	82
"J36"	"H43"	"Peritonsillar abscess"	"Disorders of vitreous body"	1	31	2	33
"J36"	"H81"	"Peritonsillar abscess"	"Disorders of vestibular function"	1	72	22	94
"J36"	"I20"	"Peritonsillar abscess"	"Angina pectoris"	1	231	81	312
"J36"	"I48"	"Peritonsillar abscess"	"Atrial fibrillation and flutter"	1	251	48	299
"J36"	"I50"	"Peritonsillar abscess"	"Heart failure"	1	160	19	179
"J36"	"I61"	"Peritonsillar abscess"	"Nontraumatic intracerebral hemorrhage"	1	48	1	49
"J36"	"I63"	"Peritonsillar abscess"	"Cerebral infarction"	1	138	1	139
"J36"	"I69"	"Peritonsillar abscess"	"Sequelae of cerebrovascular disease"	1	128	1	129
"J36"	"I71"	"Peritonsillar abscess"	"Aortic aneurysm and dissection"	1	34	0	34
"J36"	"I73"	"Peritonsillar abscess"	"Other peripheral vascular diseases"	1	76	7	83
"J36"	"I80"	"Peritonsillar abscess"	"Phlebitis and thrombophlebitis"	1	126	38	164
"J36"	"I82"	"Peritonsillar abscess"	"Other venous embolism and thrombosis"	1	37	3	40
"J36"	"J01"	"Peritonsillar abscess"	"Acute sinusitis"	1	85	17	102
"J36"	"J18"	"Peritonsillar abscess"	"Pneumonia, unspecified organism"	1	455	136	591
"J36"	"J96"	"Peritonsillar abscess"	"Respiratory failure, not elsewhere classified"	1	188	14	202
"J36"	"K30"	"Peritonsillar abscess"	"Functional dyspepsia"	1	183	64	247
"J36"	"K44"	"Peritonsillar abscess"	"Diaphragmatic hernia"	1	102	27	129
"J36"	"K51"	"Peritonsillar abscess"	"Ulcerative colitis"	1	88	30	118
"J36"	"K56"	"Peritonsillar abscess"	"Paralytic ileus and intestinal obstruction without hernia"	1	61	6	67
"J36"	"K58"	"Peritonsillar abscess"	"Irritable bowel syndrome"	1	156	38	194
"J36"	"K59"	"Peritonsillar abscess"	"Other functional intestinal disorders"	1	379	58	437
"J36"	"K62"	"Peritonsillar abscess"	"Other diseases of anus and rectum"	1	197	29	226
"J36"	"K63"	"Peritonsillar abscess"	"Other diseases of intestine"	1	33	0	33
"J36"	"K80"	"Peritonsillar abscess"	"Cholelithiasis"	1	326	70	396
"J36"	"K81"	"Peritonsillar abscess"	"Cholecystitis"	1	47	5	52
"J36"	"K92"	"Peritonsillar abscess"	"Other diseases of digestive system"	1	121	31	152
"J36"	"L02"	"Peritonsillar abscess"	"Cutaneous abscess, furuncle and carbuncle"	1	394	217	611
"J36"	"L08"	"Peritonsillar abscess"	"Other local infections of skin and subcutaneous tissue"	1	209	62	271
"J36"	"L30"	"Peritonsillar abscess"	"Other and unspecified dermatitis"	1	98	15	113
"J36"	"M06"	"Peritonsillar abscess"	"Other rheumatoid arthritis"	1	56	10	66
"J36"	"M10"	"Peritonsillar abscess"	"Gout"	1	65	7	72
"J36"	"M16"	"Peritonsillar abscess"	"Osteoarthritis of hip"	1	138	18	156
"J36"	"M20"	"Peritonsillar abscess"	"Acquired deformities of fingers and toes"	1	124	44	168
"J36"	"M23"	"Peritonsillar abscess"	"Internal derangement of knee"	1	674	282	956
"J36"	"M25"	"Peritonsillar abscess"	"Other joint disorder, not elsewhere classified"	1	249	33	282
"J36"	"M48"	"Peritonsillar abscess"	"Other spondylopathies"	1	87	6	93
"J36"	"M50"	"Peritonsillar abscess"	"Cervical disc disorders"	1	104	16	120
"J36"	"M51"	"Peritonsillar abscess"	"Thoracic, thoracolum, and lumbosacral intvrt disc disorders"	1	353	82	435
"J36"	"M54"	"Peritonsillar abscess"	"Dorsalgia"	1	723	225	948
"J36"	"M65"	"Peritonsillar abscess"	"Synovitis and tenosynovitis"	1	247	101	348
"J36"	"M67"	"Peritonsillar abscess"	"Other disorders of synovium and tendon"	1	251	78	329
"J36"	"M77"	"Peritonsillar abscess"	"Other enthesopathies"	1	155	28	183
"J36"	"M79"	"Peritonsillar abscess"	"Oth and unsp soft tissue disorders, not elsewhere classified"	1	574	260	834
"J36"	"M81"	"Peritonsillar abscess"	"Osteoporosis without current pathological fracture"	1	126	1	127
"J36"	"M85"	"Peritonsillar abscess"	"Other disorders of bone density and structure"	1	72	0	72
"J36"	"N18"	"Peritonsillar abscess"	"Chronic kidney disease (CKD)"	1	76	0	76
"J36"	"N19"	"Peritonsillar abscess"	"Unspecified kidney failure"	1	35	0	35
"J36"	"N30"	"Peritonsillar abscess"	"Cystitis"	1	415	114	529
"J36"	"N39"	"Peritonsillar abscess"	"Other disorders of urinary system"	1	275	25	300
"J36"	"N45"	"Peritonsillar abscess"	"Orchitis and epididymitis"	1	82	26	108
"J36"	"N50"	"Peritonsillar abscess"	"Other and unspecified disorders of male genital organs"	1	94	24	118
"J36"	"N83"	"Peritonsillar abscess"	"Noninflammatory disord of ovary, fallop and broad ligament"	1	159	43	202
"J36"	"N93"	"Peritonsillar abscess"	"Other abnormal uterine and vaginal bleeding"	1	61	7	68
"J36"	"N97"	"Peritonsillar abscess"	"Female infertility"	1	181	38	219
"J36"	"O04"	"Peritonsillar abscess"	"Complications following (induced) termination of pregnancy"	1	708	524	1232
"J36"	"O13"	"Peritonsillar abscess"	"Gestational hypertension without significant proteinuria"	1	40	3	43
"J36"	"O14"	"Peritonsillar abscess"	"Pre-eclampsia"	1	76	25	101
"J36"	"O21"	"Peritonsillar abscess"	"Excessive vomiting in pregnancy"	1	69	12	81
"J36"	"O23"	"Peritonsillar abscess"	"Infections of genitourinary tract in pregnancy"	1	136	28	164
"J36"	"O26"	"Peritonsillar abscess"	"Maternal care for oth conditions predom related to pregnancy"	1	191	75	266
"J36"	"O34"	"Peritonsillar abscess"	"Maternal care for abnormality of pelvic organs"	1	122	18	140
"J36"	"O42"	"Peritonsillar abscess"	"Premature rupture of membranes"	1	177	35	212
"J36"	"O47"	"Peritonsillar abscess"	"False labor"	1	141	49	190
"J36"	"O63"	"Peritonsillar abscess"	"Long labor"	1	68	20	88
"J36"	"O68"	"Peritonsillar abscess"	"Labor and delivery comp by abnlt of fetal acid-base balance"	1	351	110	461
"J36"	"O70"	"Peritonsillar abscess"	"Perineal laceration during delivery"	1	684	170	854
"J36"	"O72"	"Peritonsillar abscess"	"Postpartum hemorrhage"	1	819	0	819
"J36"	"O92"	"Peritonsillar abscess"	"Oth disord of brst/lactatn assoc w pregnancy and the puerp"	1	73	1	74
"J37"	"C18"	"Chronic laryngitis and laryngotracheitis"	"Malignant neoplasm of colon"	1	93	4	97
"J37"	"C61"	"Chronic laryngitis and laryngotracheitis"	"Malignant neoplasm of prostate"	1	91	5	96
"J37"	"C78"	"Chronic laryngitis and laryngotracheitis"	"Secondary malignant neoplasm of resp and digestive organs"	1	173	0	173
"J37"	"C79"	"Chronic laryngitis and laryngotracheitis"	"Secondary malignant neoplasm of other and unspecified sites"	1	131	0	131
"J37"	"D63"	"Chronic laryngitis and laryngotracheitis"	"Anemia in chronic diseases classified elsewhere"	1	67	0	67
"J37"	"E10"	"Chronic laryngitis and laryngotracheitis"	"Type 1 diabetes mellitus"	1	162	48	210
"J37"	"E16"	"Chronic laryngitis and laryngotracheitis"	"Other disorders of pancreatic internal secretion"	1	38	4	42
"J37"	"F03"	"Chronic laryngitis and laryngotracheitis"	"Unspecified dementia"	1	69	0	69
"J37"	"H36"	"Chronic laryngitis and laryngotracheitis"	"Retinal disorders in diseases classified elsewhere"	1	66	8	74
"J37"	"I25"	"Chronic laryngitis and laryngotracheitis"	"Chronic ischemic heart disease"	1	452	144	596
"J37"	"I69"	"Chronic laryngitis and laryngotracheitis"	"Sequelae of cerebrovascular disease"	1	283	7	290
"J37"	"J95"	"Chronic laryngitis and laryngotracheitis"	"Intraop and postproc comp and disorders of resp sys, NEC"	1	100	3	103
"J37"	"K22"	"Chronic laryngitis and laryngotracheitis"	"Other diseases of esophagus"	1	185	52	237
"J37"	"K56"	"Chronic laryngitis and laryngotracheitis"	"Paralytic ileus and intestinal obstruction without hernia"	1	99	11	110
"J37"	"M16"	"Chronic laryngitis and laryngotracheitis"	"Osteoarthritis of hip"	1	216	52	268
"J37"	"N30"	"Chronic laryngitis and laryngotracheitis"	"Cystitis"	1	354	54	408
"J37"	"N40"	"Chronic laryngitis and laryngotracheitis"	"Benign prostatic hyperplasia"	1	184	96	280
"J38"	"A46"	"Diseases of vocal cords and larynx, not elsewhere classified"	"Erysipelas"	1	235	96	331
"J38"	"C34"	"Diseases of vocal cords and larynx, not elsewhere classified"	"Malignant neoplasm of bronchus and lung"	1	842	641	1483
"J38"	"D22"	"Diseases of vocal cords and larynx, not elsewhere classified"	"Melanocytic nevi"	1	74	23	97
"J38"	"D63"	"Diseases of vocal cords and larynx, not elsewhere classified"	"Anemia in chronic diseases classified elsewhere"	1	242	52	294
"J38"	"E64"	"Diseases of vocal cords and larynx, not elsewhere classified"	"Sequelae of malnutrition and other nutritional deficiencies"	1	135	58	193
"J38"	"E66"	"Diseases of vocal cords and larynx, not elsewhere classified"	"Overweight and obesity"	1	565	285	850
"J38"	"E78"	"Diseases of vocal cords and larynx, not elsewhere classified"	"Disorders of lipoprotein metabolism and other lipidemias"	1	795	413	1208
"J38"	"E86"	"Diseases of vocal cords and larynx, not elsewhere classified"	"Volume depletion"	1	887	141	1028
"J38"	"E87"	"Diseases of vocal cords and larynx, not elsewhere classified"	"Other disorders of fluid, electrolyte and acid-base balance"	1	570	85	655
"J38"	"F03"	"Diseases of vocal cords and larynx, not elsewhere classified"	"Unspecified dementia"	1	205	0	205
"J38"	"F32"	"Diseases of vocal cords and larynx, not elsewhere classified"	"Depressive episode"	1	304	134	438
"J38"	"G47"	"Diseases of vocal cords and larynx, not elsewhere classified"	"Sleep disorders"	1	690	229	919
"J38"	"I10"	"Diseases of vocal cords and larynx, not elsewhere classified"	"Essential (primary) hypertension"	1	1794	1221	3015
"J38"	"I35"	"Diseases of vocal cords and larynx, not elsewhere classified"	"Nonrheumatic aortic valve disorders"	1	290	75	365
"J38"	"I44"	"Diseases of vocal cords and larynx, not elsewhere classified"	"Atrioventricular and left bundle-branch block"	1	110	45	155
"J38"	"I49"	"Diseases of vocal cords and larynx, not elsewhere classified"	"Other cardiac arrhythmias"	1	244	126	370
"J38"	"I63"	"Diseases of vocal cords and larynx, not elsewhere classified"	"Cerebral infarction"	1	451	224	675
"J38"	"K52"	"Diseases of vocal cords and larynx, not elsewhere classified"	"Other and unsp noninfective gastroenteritis and colitis"	1	317	130	447
"J38"	"K59"	"Diseases of vocal cords and larynx, not elsewhere classified"	"Other functional intestinal disorders"	1	1136	348	1484
"J38"	"K64"	"Diseases of vocal cords and larynx, not elsewhere classified"	"Hemorrhoids and perianal venous thrombosis"	1	203	0	203
"J38"	"K76"	"Diseases of vocal cords and larynx, not elsewhere classified"	"Other diseases of liver"	1	115	45	160
"J38"	"L97"	"Diseases of vocal cords and larynx, not elsewhere classified"	"Non-pressure chronic ulcer of lower limb, NEC"	1	151	24	175
"J38"	"M48"	"Diseases of vocal cords and larynx, not elsewhere classified"	"Other spondylopathies"	1	367	147	514
"J38"	"M81"	"Diseases of vocal cords and larynx, not elsewhere classified"	"Osteoporosis without current pathological fracture"	1	646	125	771
"J38"	"M85"	"Diseases of vocal cords and larynx, not elsewhere classified"	"Other disorders of bone density and structure"	1	265	58	323
"J38"	"N30"	"Diseases of vocal cords and larynx, not elsewhere classified"	"Cystitis"	1	793	338	1131
"J38"	"N39"	"Diseases of vocal cords and larynx, not elsewhere classified"	"Other disorders of urinary system"	1	862	251	1113
"J38"	"N95"	"Diseases of vocal cords and larynx, not elsewhere classified"	"Menopausal and other perimenopausal disorders"	1	178	92	270
"J38"	"O72"	"Diseases of vocal cords and larynx, not elsewhere classified"	"Postpartum hemorrhage"	1	351	13	364
"J39"	"O72"	"Other diseases of upper respiratory tract"	"Postpartum hemorrhage"	1	99	38	137
"J40"	"C79"	"Bronchitis, not specified as acute or chronic"	"Secondary malignant neoplasm of other and unspecified sites"	1	72	11	83
"J40"	"J96"	"Bronchitis, not specified as acute or chronic"	"Respiratory failure, not elsewhere classified"	1	615	271	886
"J40"	"M81"	"Bronchitis, not specified as acute or chronic"	"Osteoporosis without current pathological fracture"	1	300	145	445
"J41"	"C79"	"Simple and mucopurulent chronic bronchitis"	"Secondary malignant neoplasm of other and unspecified sites"	1	161	8	169
"J41"	"F32"	"Simple and mucopurulent chronic bronchitis"	"Depressive episode"	1	273	144	417
"J41"	"I61"	"Simple and mucopurulent chronic bronchitis"	"Nontraumatic intracerebral hemorrhage"	1	80	25	105
"J41"	"M80"	"Simple and mucopurulent chronic bronchitis"	"Osteoporosis with current pathological fracture"	1	375	189	564
"J41"	"M85"	"Simple and mucopurulent chronic bronchitis"	"Other disorders of bone density and structure"	1	154	0	154
"J42"	"A41"	"Unspecified chronic bronchitis"	"Other sepsis"	1	2676	662	3338
"J42"	"B96"	"Unspecified chronic bronchitis"	"Oth bacterial agents as the cause of diseases classd elswhr"	1	129	35	164
"J42"	"C15"	"Unspecified chronic bronchitis"	"Malignant neoplasm of esophagus"	1	166	38	204
"J42"	"C16"	"Unspecified chronic bronchitis"	"Malignant neoplasm of stomach"	1	143	42	185
"J42"	"C18"	"Unspecified chronic bronchitis"	"Malignant neoplasm of colon"	1	517	302	819
"J42"	"C25"	"Unspecified chronic bronchitis"	"Malignant neoplasm of pancreas"	1	222	33	255
"J42"	"C34"	"Unspecified chronic bronchitis"	"Malignant neoplasm of bronchus and lung"	1	2188	639	2827
"J42"	"C44"	"Unspecified chronic bronchitis"	"Other and unspecified malignant neoplasm of skin"	1	487	248	735
"J42"	"C78"	"Unspecified chronic bronchitis"	"Secondary malignant neoplasm of resp and digestive organs"	1	1058	138	1196
"J42"	"D63"	"Unspecified chronic bronchitis"	"Anemia in chronic diseases classified elsewhere"	1	529	121	650
"J42"	"D64"	"Unspecified chronic bronchitis"	"Other anemias"	1	2615	1213	3828
"J42"	"E55"	"Unspecified chronic bronchitis"	"Vitamin D deficiency"	1	261	99	360
"J42"	"E87"	"Unspecified chronic bronchitis"	"Other disorders of fluid, electrolyte and acid-base balance"	1	1732	598	2330
"J42"	"F05"	"Unspecified chronic bronchitis"	"Delirium due to known physiological condition"	1	443	74	517
"J42"	"F32"	"Unspecified chronic bronchitis"	"Depressive episode"	1	1172	906	2078
"J42"	"F33"	"Unspecified chronic bronchitis"	"Major depressive disorder, recurrent"	1	561	313	874
"J42"	"F41"	"Unspecified chronic bronchitis"	"Other anxiety disorders"	1	522	181	703
"J42"	"G30"	"Unspecified chronic bronchitis"	"Alzheimer's disease"	1	167	9	176
"J42"	"G95"	"Unspecified chronic bronchitis"	"Other and unspecified diseases of spinal cord"	1	111	38	149
"J42"	"H35"	"Unspecified chronic bronchitis"	"Other retinal disorders"	1	923	541	1464
"J42"	"I27"	"Unspecified chronic bronchitis"	"Other pulmonary heart diseases"	1	1162	851	2013
"J42"	"I46"	"Unspecified chronic bronchitis"	"Cardiac arrest"	1	1208	110	1318
"J42"	"I73"	"Unspecified chronic bronchitis"	"Other peripheral vascular diseases"	1	798	418	1216
"J42"	"J22"	"Unspecified chronic bronchitis"	"Unspecified acute lower respiratory infection"	1	533	186	719
"J42"	"J95"	"Unspecified chronic bronchitis"	"Intraop and postproc comp and disorders of resp sys, NEC"	1	160	50	210
"J42"	"J96"	"Unspecified chronic bronchitis"	"Respiratory failure, not elsewhere classified"	1	7985	0	7985
"J42"	"K92"	"Unspecified chronic bronchitis"	"Other diseases of digestive system"	1	1348	676	2024
"J42"	"L97"	"Unspecified chronic bronchitis"	"Non-pressure chronic ulcer of lower limb, NEC"	1	701	210	911
"J42"	"M80"	"Unspecified chronic bronchitis"	"Osteoporosis with current pathological fracture"	1	1636	890	2526
"J42"	"M81"	"Unspecified chronic bronchitis"	"Osteoporosis without current pathological fracture"	1	2736	1242	3978
"J42"	"N30"	"Unspecified chronic bronchitis"	"Cystitis"	1	3490	2212	5702
"J42"	"N39"	"Unspecified chronic bronchitis"	"Other disorders of urinary system"	1	2378	992	3370
"J43"	"A04"	"Emphysema"	"Other bacterial intestinal infections"	1	192	61	253
"J43"	"B44"	"Emphysema"	"Aspergillosis"	1	89	31	120
"J43"	"B96"	"Emphysema"	"Oth bacterial agents as the cause of diseases classd elswhr"	1	84	19	103
"J43"	"C25"	"Emphysema"	"Malignant neoplasm of pancreas"	1	76	13	89
"J43"	"C34"	"Emphysema"	"Malignant neoplasm of bronchus and lung"	1	1030	341	1371
"J43"	"C77"	"Emphysema"	"Secondary and unspecified malignant neoplasm of lymph nodes"	1	135	41	176
"J43"	"I61"	"Emphysema"	"Nontraumatic intracerebral hemorrhage"	1	145	63	208
"J43"	"J81"	"Emphysema"	"Pulmonary edema"	1	286	155	441
"J43"	"K59"	"Emphysema"	"Other functional intestinal disorders"	1	976	559	1535
"J43"	"M80"	"Emphysema"	"Osteoporosis with current pathological fracture"	1	731	349	1080
"J43"	"M81"	"Emphysema"	"Osteoporosis without current pathological fracture"	1	1412	808	2220
"J43"	"M85"	"Emphysema"	"Other disorders of bone density and structure"	1	314	156	470
"J43"	"N17"	"Emphysema"	"Acute kidney failure"	1	261	98	359
"J44"	"A41"	"Other chronic obstructive pulmonary disease"	"Other sepsis"	1	19592	0	19592
"J44"	"A46"	"Other chronic obstructive pulmonary disease"	"Erysipelas"	1	4252	3377	7629
"J44"	"A49"	"Other chronic obstructive pulmonary disease"	"Bacterial infection of unspecified site"	1	4610	1706	6316
"J44"	"B02"	"Other chronic obstructive pulmonary disease"	"Zoster [herpes zoster]"	1	886	617	1503
"J44"	"B95"	"Other chronic obstructive pulmonary disease"	"Strep as the cause of diseases classified elsewhere"	1	339	125	464
"J44"	"B96"	"Other chronic obstructive pulmonary disease"	"Oth bacterial agents as the cause of diseases classd elswhr"	1	769	161	930
"J44"	"C13"	"Other chronic obstructive pulmonary disease"	"Malignant neoplasm of hypopharynx"	1	165	83	248
"J44"	"C15"	"Other chronic obstructive pulmonary disease"	"Malignant neoplasm of esophagus"	1	681	303	984
"J44"	"C16"	"Other chronic obstructive pulmonary disease"	"Malignant neoplasm of stomach"	1	621	275	896
"J44"	"C24"	"Other chronic obstructive pulmonary disease"	"Malignant neoplasm of other and unsp parts of biliary tract"	1	221	52	273
"J44"	"C26"	"Other chronic obstructive pulmonary disease"	"Malignant neoplasm of other and ill-defined digestive organs"	1	67	19	86
"J44"	"C34"	"Other chronic obstructive pulmonary disease"	"Malignant neoplasm of bronchus and lung"	1	15702	0	15702
"J44"	"C38"	"Other chronic obstructive pulmonary disease"	"Malignant neoplasm of heart, mediastinum and pleura"	1	189	96	285
"J44"	"C64"	"Other chronic obstructive pulmonary disease"	"Malignant neoplasm of kidney, except renal pelvis"	1	554	395	949
"J44"	"C71"	"Other chronic obstructive pulmonary disease"	"Malignant neoplasm of brain"	1	434	158	592
"J44"	"C76"	"Other chronic obstructive pulmonary disease"	"Malignant neoplasm of other and ill-defined sites"	1	280	152	432
"J44"	"C77"	"Other chronic obstructive pulmonary disease"	"Secondary and unspecified malignant neoplasm of lymph nodes"	1	1551	658	2209
"J44"	"C80"	"Other chronic obstructive pulmonary disease"	"Malignant neoplasm without specification of site"	1	698	169	867
"J44"	"C92"	"Other chronic obstructive pulmonary disease"	"Myeloid leukemia"	1	286	171	457
"J44"	"D47"	"Other chronic obstructive pulmonary disease"	"Oth neoplm of uncrt behav of lymphoid, hematpoetc & rel tiss"	1	636	362	998
"J44"	"D64"	"Other chronic obstructive pulmonary disease"	"Other anemias"	1	11677	7364	19041
"J44"	"E13"	"Other chronic obstructive pulmonary disease"	"Other specified diabetes mellitus"	1	504	285	789
"J44"	"E25"	"Other chronic obstructive pulmonary disease"	"Adrenogenital disorders"	1	283	101	384
"J44"	"E46"	"Other chronic obstructive pulmonary disease"	"Unspecified protein-calorie malnutrition"	1	307	108	415
"J44"	"E50"	"Other chronic obstructive pulmonary disease"	"Vitamin A deficiency"	1	347	210	557
"J44"	"E53"	"Other chronic obstructive pulmonary disease"	"Deficiency of other B group vitamins"	1	575	356	931
"J44"	"E55"	"Other chronic obstructive pulmonary disease"	"Vitamin D deficiency"	1	1525	888	2413
"J44"	"E64"	"Other chronic obstructive pulmonary disease"	"Sequelae of malnutrition and other nutritional deficiencies"	1	1239	556	1795
"J44"	"E87"	"Other chronic obstructive pulmonary disease"	"Other disorders of fluid, electrolyte and acid-base balance"	1	9738	5286	15024
"J44"	"F01"	"Other chronic obstructive pulmonary disease"	"Vascular dementia"	1	1099	419	1518
"J44"	"F03"	"Other chronic obstructive pulmonary disease"	"Unspecified dementia"	1	5338	2524	7862
"J44"	"F06"	"Other chronic obstructive pulmonary disease"	"Other mental disorders due to known physiological condition"	1	702	419	1121
"J44"	"G47"	"Other chronic obstructive pulmonary disease"	"Sleep disorders"	1	3625	1887	5512
"J44"	"G53"	"Other chronic obstructive pulmonary disease"	"Cranial nerve disorders in diseases classified elsewhere"	1	65	18	83
"J44"	"G93"	"Other chronic obstructive pulmonary disease"	"Other disorders of brain"	1	541	362	903
"J44"	"G98"	"Other chronic obstructive pulmonary disease"	"Other disorders of nervous system not elsewhere classified"	1	391	194	585
"J44"	"H57"	"Other chronic obstructive pulmonary disease"	"Other disorders of eye and adnexa"	1	491	327	818
"J44"	"I27"	"Other chronic obstructive pulmonary disease"	"Other pulmonary heart diseases"	1	5258	3084	8342
"J44"	"I46"	"Other chronic obstructive pulmonary disease"	"Cardiac arrest"	1	6784	0	6784
"J44"	"I51"	"Other chronic obstructive pulmonary disease"	"Complications and ill-defined descriptions of heart disease"	1	1677	1154	2831
"J44"	"I52"	"Other chronic obstructive pulmonary disease"	"Other heart disorders in diseases classified elsewhere"	1	103	32	135
"J44"	"J14"	"Other chronic obstructive pulmonary disease"	"Pneumonia due to Hemophilus influenzae"	1	1492	911	2403
"J44"	"J15"	"Other chronic obstructive pulmonary disease"	"Bacterial pneumonia, not elsewhere classified"	1	30925	0	30925
"J44"	"J22"	"Other chronic obstructive pulmonary disease"	"Unspecified acute lower respiratory infection"	1	2783	1390	4173
"J44"	"J47"	"Other chronic obstructive pulmonary disease"	"Bronchiectasis"	1	1829	1187	3016
"J44"	"J95"	"Other chronic obstructive pulmonary disease"	"Intraop and postproc comp and disorders of resp sys, NEC"	1	911	431	1342
"J44"	"K55"	"Other chronic obstructive pulmonary disease"	"Vascular disorders of intestine"	1	1272	532	1804
"J44"	"K59"	"Other chronic obstructive pulmonary disease"	"Other functional intestinal disorders"	1	18129	0	18129
"J44"	"K64"	"Other chronic obstructive pulmonary disease"	"Hemorrhoids and perianal venous thrombosis"	1	1296	265	1561
"J44"	"K92"	"Other chronic obstructive pulmonary disease"	"Other diseases of digestive system"	1	5369	4039	9408
"J44"	"L89"	"Other chronic obstructive pulmonary disease"	"Pressure ulcer"	1	2146	894	3040
"J44"	"M10"	"Other chronic obstructive pulmonary disease"	"Gout"	1	2469	1998	4467
"J44"	"M81"	"Other chronic obstructive pulmonary disease"	"Osteoporosis without current pathological fracture"	1	19793	0	19793
"J45"	"A26"	"Asthma"	"Erysipeloid"	1	121	11	132
"J45"	"A41"	"Asthma"	"Other sepsis"	1	4309	0	4309
"J45"	"A46"	"Asthma"	"Erysipelas"	1	2116	664	2780
"J45"	"B27"	"Asthma"	"Infectious mononucleosis"	1	444	180	624
"J45"	"B37"	"Asthma"	"Candidiasis"	1	1151	621	1772
"J45"	"B44"	"Asthma"	"Aspergillosis"	1	132	15	147
"J45"	"C34"	"Asthma"	"Malignant neoplasm of bronchus and lung"	1	2288	0	2288
"J45"	"C48"	"Asthma"	"Malignant neoplasm of retroperitoneum and peritoneum"	1	50	3	53
"J45"	"C71"	"Asthma"	"Malignant neoplasm of brain"	1	201	31	232
"J45"	"C79"	"Asthma"	"Secondary malignant neoplasm of other and unspecified sites"	1	926	38	964
"J45"	"C80"	"Asthma"	"Malignant neoplasm without specification of site"	1	166	12	178
"J45"	"C83"	"Asthma"	"Non-follicular lymphoma"	1	181	55	236
"J45"	"D09"	"Asthma"	"Carcinoma in situ of other and unspecified sites"	1	119	10	129
"J45"	"D12"	"Asthma"	"Benign neoplasm of colon, rectum, anus and anal canal"	1	2516	883	3399
"J45"	"D17"	"Asthma"	"Benign lipomatous neoplasm"	1	860	593	1453
"J45"	"D21"	"Asthma"	"Other benign neoplasms of connective and other soft tissue"	1	242	112	354
"J45"	"D22"	"Asthma"	"Melanocytic nevi"	1	814	131	945
"J45"	"D23"	"Asthma"	"Other benign neoplasms of skin"	1	821	517	1338
"J45"	"D33"	"Asthma"	"Benign neoplasm of brain and oth prt central nervous system"	1	141	68	209
"J45"	"D43"	"Asthma"	"Neoplasm of uncertain behavior of brain and cnsl"	1	138	22	160
"J45"	"D46"	"Asthma"	"Myelodysplastic syndromes"	1	119	11	130
"J45"	"D61"	"Asthma"	"Oth aplastic anemias and other bone marrow failure syndromes"	1	87	25	112
"J45"	"D72"	"Asthma"	"Other disorders of white blood cells"	1	394	206	600
"J45"	"E03"	"Asthma"	"Other hypothyroidism"	1	1857	1146	3003
"J45"	"E06"	"Asthma"	"Thyroiditis"	1	303	114	417
"J45"	"E10"	"Asthma"	"Type 1 diabetes mellitus"	1	1710	1248	2958
"J45"	"E21"	"Asthma"	"Hyperparathyroidism and other disorders of parathyroid gland"	1	379	105	484
"J45"	"E22"	"Asthma"	"Hyperfunction of pituitary gland"	1	244	46	290
"J45"	"E29"	"Asthma"	"Testicular dysfunction"	1	83	11	94
"J45"	"E65"	"Asthma"	"Localized adiposity"	1	337	183	520
"J45"	"E78"	"Asthma"	"Disorders of lipoprotein metabolism and other lipidemias"	1	3992	2526	6518
"J45"	"E85"	"Asthma"	"Amyloidosis"	1	43	6	49
"J45"	"F02"	"Asthma"	"Dementia in other diseases classified elsewhere"	1	75	13	88
"J45"	"F32"	"Asthma"	"Depressive episode"	1	1918	933	2851
"J45"	"F33"	"Asthma"	"Major depressive disorder, recurrent"	1	1349	501	1850
"J45"	"F41"	"Asthma"	"Other anxiety disorders"	1	1719	418	2137
"J45"	"F44"	"Asthma"	"Dissociative and conversion disorders"	1	185	58	243
"J45"	"F45"	"Asthma"	"Somatoform disorders"	1	392	200	592
"J45"	"F79"	"Asthma"	"Unspecified intellectual disabilities"	1	222	96	318
"J45"	"G20"	"Asthma"	"Parkinson's disease"	1	294	84	378
"J45"	"G43"	"Asthma"	"Migraine"	1	1518	832	2350
"J45"	"G51"	"Asthma"	"Facial nerve disorders"	1	309	140	449
"J45"	"G90"	"Asthma"	"Disorders of autonomic nervous system"	1	123	48	171
"J45"	"H20"	"Asthma"	"Iridocyclitis"	1	244	142	386
"J45"	"H36"	"Asthma"	"Retinal disorders in diseases classified elsewhere"	1	570	137	707
"J45"	"H43"	"Asthma"	"Disorders of vitreous body"	1	500	192	692
"J45"	"H49"	"Asthma"	"Paralytic strabismus"	1	182	70	252
"J45"	"H52"	"Asthma"	"Disorders of refraction and accommodation"	1	1458	555	2013
"J45"	"H53"	"Asthma"	"Visual disturbances"	1	1023	260	1283
"J45"	"H54"	"Asthma"	"Blindness and low vision"	1	459	249	708
"J45"	"H57"	"Asthma"	"Other disorders of eye and adnexa"	1	889	168	1057
"J45"	"H90"	"Asthma"	"Conductive and sensorineural hearing loss"	1	1360	882	2242
"J45"	"H91"	"Asthma"	"Other and unspecified hearing loss"	1	3235	2663	5898
"J45"	"I25"	"Asthma"	"Chronic ischemic heart disease"	1	5058	3695	8753
"J45"	"I33"	"Asthma"	"Acute and subacute endocarditis"	1	158	61	219
"J45"	"I35"	"Asthma"	"Nonrheumatic aortic valve disorders"	1	1670	532	2202
"J45"	"I51"	"Asthma"	"Complications and ill-defined descriptions of heart disease"	1	667	269	936
"J45"	"I60"	"Asthma"	"Nontraumatic subarachnoid hemorrhage"	1	237	132	369
"J45"	"I61"	"Asthma"	"Nontraumatic intracerebral hemorrhage"	1	532	170	702
"J45"	"I63"	"Asthma"	"Cerebral infarction"	1	2024	716	2740
"J45"	"I67"	"Asthma"	"Other cerebrovascular diseases"	1	251	90	341
"J45"	"I69"	"Asthma"	"Sequelae of cerebrovascular disease"	1	2469	846	3315
"J45"	"I71"	"Asthma"	"Aortic aneurysm and dissection"	1	741	235	976
"J45"	"I72"	"Asthma"	"Other aneurysm"	1	168	54	222
"J45"	"I73"	"Asthma"	"Other peripheral vascular diseases"	1	1043	390	1433
"J45"	"I80"	"Asthma"	"Phlebitis and thrombophlebitis"	1	1797	961	2758
"J45"	"I86"	"Asthma"	"Varicose veins of other sites"	1	136	58	194
"J45"	"I88"	"Asthma"	"Nonspecific lymphadenitis"	1	376	207	583
"J45"	"J01"	"Asthma"	"Acute sinusitis"	1	906	372	1278
"J45"	"J03"	"Asthma"	"Acute tonsillitis"	1	3818	2367	6185
"J45"	"J09"	"Asthma"	"Influenza due to certain identified influenza viruses"	1	378	59	437
"J45"	"J22"	"Asthma"	"Unspecified acute lower respiratory infection"	1	853	192	1045
"J45"	"J41"	"Asthma"	"Simple and mucopurulent chronic bronchitis"	1	1284	1010	2294
"J45"	"J47"	"Asthma"	"Bronchiectasis"	1	1569	622	2191
"J45"	"J81"	"Asthma"	"Pulmonary edema"	1	794	264	1058
"J45"	"J84"	"Asthma"	"Other interstitial pulmonary diseases"	1	1113	613	1726
"J45"	"J85"	"Asthma"	"Abscess of lung and mediastinum"	1	159	58	217
"J45"	"J90"	"Asthma"	"Pleural effusion, not elsewhere classified"	1	635	208	843
"J45"	"J91"	"Asthma"	"Pleural effusion in conditions classified elsewhere"	1	294	84	378
"J45"	"J96"	"Asthma"	"Respiratory failure, not elsewhere classified"	1	12039	0	12039
"J45"	"K00"	"Asthma"	"Disorders of tooth development and eruption"	1	486	32	518
"J45"	"K01"	"Asthma"	"Embedded and impacted teeth"	1	344	81	425
"J45"	"K02"	"Asthma"	"Dental caries"	1	810	295	1105
"J45"	"K03"	"Asthma"	"Other diseases of hard tissues of teeth"	1	137	27	164
"J45"	"K21"	"Asthma"	"Gastro-esophageal reflux disease"	1	2728	2288	5016
"J45"	"K31"	"Asthma"	"Other diseases of stomach and duodenum"	1	230	130	360
"J45"	"K45"	"Asthma"	"Other abdominal hernia"	1	367	190	557
"J45"	"K46"	"Asthma"	"Unspecified abdominal hernia"	1	159	70	229
"J45"	"K62"	"Asthma"	"Other diseases of anus and rectum"	1	2115	1200	3315
"J45"	"K70"	"Asthma"	"Alcoholic liver disease"	1	568	246	814
"J45"	"K71"	"Asthma"	"Toxic liver disease"	1	153	60	213
"J45"	"K72"	"Asthma"	"Hepatic failure, not elsewhere classified"	1	324	45	369
"J45"	"K86"	"Asthma"	"Other diseases of pancreas"	1	366	193	559
"J45"	"K91"	"Asthma"	"Intraop and postproc comp and disorders of dgstv sys, NEC"	1	353	122	475
"J45"	"L02"	"Asthma"	"Cutaneous abscess, furuncle and carbuncle"	1	1872	1412	3284
"J45"	"L08"	"Asthma"	"Other local infections of skin and subcutaneous tissue"	1	1708	626	2334
"J45"	"L29"	"Asthma"	"Pruritus"	1	303	117	420
"J45"	"L30"	"Asthma"	"Other and unspecified dermatitis"	1	1415	728	2143
"J45"	"L81"	"Asthma"	"Other disorders of pigmentation"	1	145	44	189
"J45"	"M15"	"Asthma"	"Polyosteoarthritis"	1	503	282	785
"J45"	"M20"	"Asthma"	"Acquired deformities of fingers and toes"	1	1107	845	1952
"J45"	"M21"	"Asthma"	"Other acquired deformities of limbs"	1	1061	465	1526
"J45"	"M24"	"Asthma"	"Other specific joint derangements"	1	930	459	1389
"J45"	"M41"	"Asthma"	"Scoliosis"	1	694	236	930
"J45"	"M54"	"Asthma"	"Dorsalgia"	1	5505	4043	9548
"J45"	"M65"	"Asthma"	"Synovitis and tenosynovitis"	1	1662	1278	2940
"J45"	"M67"	"Asthma"	"Other disorders of synovium and tendon"	1	1692	699	2391
"J45"	"M75"	"Asthma"	"Shoulder lesions"	1	3743	1836	5579
"J45"	"M79"	"Asthma"	"Oth and unsp soft tissue disorders, not elsewhere classified"	1	6418	3207	9625
"J45"	"M81"	"Asthma"	"Osteoporosis without current pathological fracture"	1	5831	0	5831
"J45"	"M92"	"Asthma"	"Other juvenile osteochondrosis"	1	273	48	321
"J45"	"N10"	"Asthma"	"Acute pyelonephritis"	1	866	659	1525
"J45"	"N13"	"Asthma"	"Obstructive and reflux uropathy"	1	653	300	953
"J45"	"N18"	"Asthma"	"Chronic kidney disease (CKD)"	1	1691	234	1925
"J45"	"N19"	"Asthma"	"Unspecified kidney failure"	1	882	169	1051
"J45"	"N20"	"Asthma"	"Calculus of kidney and ureter"	1	1176	840	2016
"J45"	"N44"	"Asthma"	"Noninflammatory disorders of testis"	1	256	51	307
"J45"	"N46"	"Asthma"	"Male infertility"	1	380	74	454
"J45"	"N47"	"Asthma"	"Disorders of prepuce"	1	1782	724	2506
"J45"	"N48"	"Asthma"	"Other disorders of penis"	1	494	306	800
"J45"	"N50"	"Asthma"	"Other and unspecified disorders of male genital organs"	1	570	129	699
"J45"	"O23"	"Asthma"	"Infections of genitourinary tract in pregnancy"	1	621	403	1024
"J45"	"O24"	"Asthma"	"Diabetes in pregnancy, childbirth, and the puerperium"	1	449	225	674
"J45"	"O35"	"Asthma"	"Maternal care for known or suspected fetal abnlt and damage"	1	194	23	217
"J45"	"O36"	"Asthma"	"Maternal care for other fetal problems"	1	899	610	1509
"J45"	"O47"	"Asthma"	"False labor"	1	774	554	1328
"J45"	"O63"	"Asthma"	"Long labor"	1	413	274	687
"J45"	"O67"	"Asthma"	"Labor and delivery comp by intrapartum hemorrhage, NEC"	1	62	9	71
"J45"	"O73"	"Asthma"	"Retained placenta and membranes, without hemorrhage"	1	161	71	232
"J45"	"O90"	"Asthma"	"Complications of the puerperium, not elsewhere classified"	1	392	117	509
"J45"	"Q55"	"Asthma"	"Other congenital malformations of male genital organs"	1	203	102	305
"J45"	"Q93"	"Asthma"	"Monosomies and deletions from the autosomes, NEC"	1	86	27	113
"J47"	"C34"	"Bronchiectasis"	"Malignant neoplasm of bronchus and lung"	1	145	69	214
"J47"	"F03"	"Bronchiectasis"	"Unspecified dementia"	1	66	12	78
"J84"	"A49"	"Other interstitial pulmonary diseases"	"Bacterial infection of unspecified site"	1	413	237	650
"J84"	"C34"	"Other interstitial pulmonary diseases"	"Malignant neoplasm of bronchus and lung"	1	944	559	1503
"J84"	"G30"	"Other interstitial pulmonary diseases"	"Alzheimer's disease"	1	78	15	93
"J84"	"I46"	"Other interstitial pulmonary diseases"	"Cardiac arrest"	1	444	102	546
"J84"	"J67"	"Other interstitial pulmonary diseases"	"Hypersensitivity pneumonitis due to organic dust"	1	319	162	481
"J84"	"J96"	"Other interstitial pulmonary diseases"	"Respiratory failure, not elsewhere classified"	1	2868	2341	5209
"J84"	"M81"	"Other interstitial pulmonary diseases"	"Osteoporosis without current pathological fracture"	1	965	731	1696
"J84"	"M85"	"Other interstitial pulmonary diseases"	"Other disorders of bone density and structure"	1	492	297	789
"J86"	"K64"	"Pyothorax"	"Hemorrhoids and perianal venous thrombosis"	1	42	3	45
"J90"	"C45"	"Pleural effusion, not elsewhere classified"	"Mesothelioma"	1	1085	286	1371
"J90"	"I46"	"Pleural effusion, not elsewhere classified"	"Cardiac arrest"	1	530	348	878
"J91"	"F41"	"Pleural effusion in conditions classified elsewhere"	"Other anxiety disorders"	1	376	149	525
"J92"	"C79"	"Pleural plaque"	"Secondary malignant neoplasm of other and unspecified sites"	1	82	5	87
"J92"	"J96"	"Pleural plaque"	"Respiratory failure, not elsewhere classified"	1	410	142	552
"J93"	"G47"	"Pneumothorax and air leak"	"Sleep disorders"	1	444	114	558
"J93"	"K59"	"Pneumothorax and air leak"	"Other functional intestinal disorders"	1	974	548	1522
"J93"	"K64"	"Pneumothorax and air leak"	"Hemorrhoids and perianal venous thrombosis"	1	118	7	125
"J94"	"C38"	"Other pleural conditions"	"Malignant neoplasm of heart, mediastinum and pleura"	1	190	90	280
"J94"	"F41"	"Other pleural conditions"	"Other anxiety disorders"	1	237	57	294
"J95"	"F41"	"Intraop and postproc comp and disorders of resp sys, NEC"	"Other anxiety disorders"	1	169	68	237
"J98"	"A04"	"Other respiratory disorders"	"Other bacterial intestinal infections"	1	287	177	464
"J98"	"D63"	"Other respiratory disorders"	"Anemia in chronic diseases classified elsewhere"	1	239	136	375
"J98"	"F03"	"Other respiratory disorders"	"Unspecified dementia"	1	312	184	496
"J98"	"G30"	"Other respiratory disorders"	"Alzheimer's disease"	1	86	14	100
"J98"	"M85"	"Other respiratory disorders"	"Other disorders of bone density and structure"	1	340	216	556
"J99"	"A41"	"Respiratory disorders in diseases classified elsewhere"	"Other sepsis"	1	128	23	151
"J99"	"J15"	"Respiratory disorders in diseases classified elsewhere"	"Bacterial pneumonia, not elsewhere classified"	1	160	54	214
"K00"	"A63"	"Disorders of tooth development and eruption"	"Oth predominantly sexually transmitted diseases, NEC"	1	103	28	131
"K00"	"D17"	"Disorders of tooth development and eruption"	"Benign lipomatous neoplasm"	1	50	4	54
"K00"	"E04"	"Disorders of tooth development and eruption"	"Other nontoxic goiter"	1	45	4	49
"K00"	"E28"	"Disorders of tooth development and eruption"	"Ovarian dysfunction"	1	71	2	73
"K00"	"E66"	"Disorders of tooth development and eruption"	"Overweight and obesity"	1	367	1	368
"K00"	"F17"	"Disorders of tooth development and eruption"	"Nicotine dependence"	1	60	0	60
"K00"	"G96"	"Disorders of tooth development and eruption"	"Other disorders of central nervous system"	1	37	5	42
"K00"	"I83"	"Disorders of tooth development and eruption"	"Varicose veins of lower extremities"	1	90	8	98
"K00"	"J34"	"Disorders of tooth development and eruption"	"Other and unspecified disorders of nose and nasal sinuses"	1	119	49	168
"K00"	"K64"	"Disorders of tooth development and eruption"	"Hemorrhoids and perianal venous thrombosis"	1	38	0	38
"K00"	"L90"	"Disorders of tooth development and eruption"	"Atrophic disorders of skin"	1	87	30	117
"K00"	"M16"	"Disorders of tooth development and eruption"	"Osteoarthritis of hip"	1	32	3	35
"K00"	"M17"	"Disorders of tooth development and eruption"	"Osteoarthritis of knee"	1	62	2	64
"K00"	"M19"	"Disorders of tooth development and eruption"	"Other and unspecified osteoarthritis"	1	54	0	54
"K00"	"M23"	"Disorders of tooth development and eruption"	"Internal derangement of knee"	1	432	203	635
"K00"	"M47"	"Disorders of tooth development and eruption"	"Spondylosis"	1	29	1	30
"K00"	"M51"	"Disorders of tooth development and eruption"	"Thoracic, thoracolum, and lumbosacral intvrt disc disorders"	1	109	8	117
"K00"	"M67"	"Disorders of tooth development and eruption"	"Other disorders of synovium and tendon"	1	200	70	270
"K00"	"M75"	"Disorders of tooth development and eruption"	"Shoulder lesions"	1	225	16	241
"K00"	"M85"	"Disorders of tooth development and eruption"	"Other disorders of bone density and structure"	1	30	0	30
"K00"	"N20"	"Disorders of tooth development and eruption"	"Calculus of kidney and ureter"	1	68	16	84
"K00"	"N62"	"Disorders of tooth development and eruption"	"Hypertrophy of breast"	1	83	27	110
"K00"	"N80"	"Disorders of tooth development and eruption"	"Endometriosis"	1	41	4	45
"K00"	"N83"	"Disorders of tooth development and eruption"	"Noninflammatory disord of ovary, fallop and broad ligament"	1	104	21	125
"K00"	"N92"	"Disorders of tooth development and eruption"	"Excessive, frequent and irregular menstruation"	1	196	37	233
"K00"	"N93"	"Disorders of tooth development and eruption"	"Other abnormal uterine and vaginal bleeding"	1	44	0	44
"K00"	"N94"	"Disorders of tooth development and eruption"	"Pain and oth cond assoc w fem gntl org and menstrual cycle"	1	125	26	151
"K00"	"N97"	"Disorders of tooth development and eruption"	"Female infertility"	1	163	1	164
"K00"	"O02"	"Disorders of tooth development and eruption"	"Other abnormal products of conception"	1	144	1	145
"K00"	"O03"	"Disorders of tooth development and eruption"	"Spontaneous abortion"	1	154	31	185
"K00"	"O08"	"Disorders of tooth development and eruption"	"Complications following ectopic and molar pregnancy"	1	86	3	89
"K00"	"O14"	"Disorders of tooth development and eruption"	"Pre-eclampsia"	1	59	0	59
"K00"	"O20"	"Disorders of tooth development and eruption"	"Hemorrhage in early pregnancy"	1	134	25	159
"K00"	"O23"	"Disorders of tooth development and eruption"	"Infections of genitourinary tract in pregnancy"	1	73	0	73
"K00"	"O24"	"Disorders of tooth development and eruption"	"Diabetes in pregnancy, childbirth, and the puerperium"	1	40	0	40
"K00"	"O26"	"Disorders of tooth development and eruption"	"Maternal care for oth conditions predom related to pregnancy"	1	118	12	130
"K00"	"O30"	"Disorders of tooth development and eruption"	"Multiple gestation"	1	43	6	49
"K00"	"O32"	"Disorders of tooth development and eruption"	"Maternal care for malpresentation of fetus"	1	86	11	97
"K00"	"O34"	"Disorders of tooth development and eruption"	"Maternal care for abnormality of pelvic organs"	1	76	0	76
"K00"	"O46"	"Disorders of tooth development and eruption"	"Antepartum hemorrhage, not elsewhere classified"	1	39	0	39
"K00"	"O47"	"Disorders of tooth development and eruption"	"False labor"	1	105	6	111
"K00"	"O63"	"Disorders of tooth development and eruption"	"Long labor"	1	82	14	96
"K00"	"O68"	"Disorders of tooth development and eruption"	"Labor and delivery comp by abnlt of fetal acid-base balance"	1	296	0	296
"K00"	"O70"	"Disorders of tooth development and eruption"	"Perineal laceration during delivery"	1	597	0	597
"K00"	"O71"	"Disorders of tooth development and eruption"	"Other obstetric trauma"	1	78	8	86
"K00"	"O72"	"Disorders of tooth development and eruption"	"Postpartum hemorrhage"	1	437	0	437
"K00"	"O82"	"Disorders of tooth development and eruption"	"Encounter for cesarean delivery without indication"	1	271	11	282
"K00"	"O90"	"Disorders of tooth development and eruption"	"Complications of the puerperium, not elsewhere classified"	1	31	0	31
"K01"	"C18"	"Embedded and impacted teeth"	"Malignant neoplasm of colon"	1	41	6	47
"K01"	"E05"	"Embedded and impacted teeth"	"Thyrotoxicosis [hyperthyroidism]"	1	89	21	110
"K01"	"E64"	"Embedded and impacted teeth"	"Sequelae of malnutrition and other nutritional deficiencies"	1	160	44	204
"K01"	"H25"	"Embedded and impacted teeth"	"Age-related cataract"	1	234	86	320
"K01"	"J44"	"Embedded and impacted teeth"	"Other chronic obstructive pulmonary disease"	1	172	83	255
"K01"	"K58"	"Embedded and impacted teeth"	"Irritable bowel syndrome"	1	125	45	170
"K01"	"M19"	"Embedded and impacted teeth"	"Other and unspecified osteoarthritis"	1	119	26	145
"K01"	"M23"	"Embedded and impacted teeth"	"Internal derangement of knee"	1	398	213	611
"K01"	"M51"	"Embedded and impacted teeth"	"Thoracic, thoracolum, and lumbosacral intvrt disc disorders"	1	152	67	219
"K01"	"M65"	"Embedded and impacted teeth"	"Synovitis and tenosynovitis"	1	156	78	234
"K01"	"M70"	"Embedded and impacted teeth"	"Soft tissue disorders related to use, overuse and pressure"	1	105	35	140
"K01"	"M76"	"Embedded and impacted teeth"	"Enthesopathies, lower limb, excluding foot"	1	104	42	146
"K01"	"M77"	"Embedded and impacted teeth"	"Other enthesopathies"	1	94	26	120
"K01"	"N20"	"Embedded and impacted teeth"	"Calculus of kidney and ureter"	1	111	30	141
"K01"	"N46"	"Embedded and impacted teeth"	"Male infertility"	1	62	0	62
"K01"	"N92"	"Embedded and impacted teeth"	"Excessive, frequent and irregular menstruation"	1	184	83	267
"K01"	"O03"	"Embedded and impacted teeth"	"Spontaneous abortion"	1	158	36	194
"K01"	"O08"	"Embedded and impacted teeth"	"Complications following ectopic and molar pregnancy"	1	70	3	73
"K01"	"O14"	"Embedded and impacted teeth"	"Pre-eclampsia"	1	55	4	59
"K01"	"O20"	"Embedded and impacted teeth"	"Hemorrhage in early pregnancy"	1	117	30	147
"K01"	"O21"	"Embedded and impacted teeth"	"Excessive vomiting in pregnancy"	1	60	4	64
"K01"	"O23"	"Embedded and impacted teeth"	"Infections of genitourinary tract in pregnancy"	1	101	5	106
"K01"	"O26"	"Embedded and impacted teeth"	"Maternal care for oth conditions predom related to pregnancy"	1	146	28	174
"K01"	"O32"	"Embedded and impacted teeth"	"Maternal care for malpresentation of fetus"	1	80	3	83
"K01"	"O36"	"Embedded and impacted teeth"	"Maternal care for other fetal problems"	1	120	0	120
"K01"	"O42"	"Embedded and impacted teeth"	"Premature rupture of membranes"	1	123	0	123
"K01"	"O63"	"Embedded and impacted teeth"	"Long labor"	1	58	4	62
"K01"	"O68"	"Embedded and impacted teeth"	"Labor and delivery comp by abnlt of fetal acid-base balance"	1	253	0	253
"K01"	"O71"	"Embedded and impacted teeth"	"Other obstetric trauma"	1	89	12	101
"K01"	"O72"	"Embedded and impacted teeth"	"Postpartum hemorrhage"	1	459	0	459
"K01"	"O75"	"Embedded and impacted teeth"	"Oth complications of labor and delivery, NEC"	1	69	0	69
"K01"	"O80"	"Embedded and impacted teeth"	"Encounter for full-term uncomplicated delivery"	1	727	146	873
"K01"	"O86"	"Embedded and impacted teeth"	"Other puerperal infections"	1	27	1	28
"K01"	"O92"	"Embedded and impacted teeth"	"Oth disord of brst/lactatn assoc w pregnancy and the puerp"	1	47	0	47
"K01"	"O99"	"Embedded and impacted teeth"	"Oth maternal diseases classd elsw but compl preg/chldbrth"	1	417	0	417
"K02"	"A41"	"Dental caries"	"Other sepsis"	1	1018	510	1528
"K02"	"A49"	"Dental caries"	"Bacterial infection of unspecified site"	1	560	250	810
"K02"	"C80"	"Dental caries"	"Malignant neoplasm without specification of site"	1	151	54	205
"K02"	"D64"	"Dental caries"	"Other anemias"	1	745	461	1206
"K02"	"E41"	"Dental caries"	"Nutritional marasmus"	1	100	20	120
"K02"	"E64"	"Dental caries"	"Sequelae of malnutrition and other nutritional deficiencies"	1	397	111	508
"K02"	"E83"	"Dental caries"	"Disorders of mineral metabolism"	1	183	89	272
"K02"	"E87"	"Dental caries"	"Other disorders of fluid, electrolyte and acid-base balance"	1	615	292	907
"K02"	"F05"	"Dental caries"	"Delirium due to known physiological condition"	1	164	54	218
"K02"	"I31"	"Dental caries"	"Other diseases of pericardium"	1	120	40	160
"K02"	"I38"	"Dental caries"	"Endocarditis, valve unspecified"	1	97	34	131
"K02"	"I46"	"Dental caries"	"Cardiac arrest"	1	316	29	345
"K02"	"J96"	"Dental caries"	"Respiratory failure, not elsewhere classified"	1	960	339	1299
"K02"	"K22"	"Dental caries"	"Other diseases of esophagus"	1	225	129	354
"K02"	"N17"	"Dental caries"	"Acute kidney failure"	1	272	134	406
"K02"	"O72"	"Dental caries"	"Postpartum hemorrhage"	1	214	0	214
"K03"	"E64"	"Other diseases of hard tissues of teeth"	"Sequelae of malnutrition and other nutritional deficiencies"	1	97	23	120
"K03"	"O72"	"Other diseases of hard tissues of teeth"	"Postpartum hemorrhage"	1	82	0	82
"K04"	"A04"	"Diseases of pulp and periapical tissues"	"Other bacterial intestinal infections"	1	243	83	326
"K04"	"A41"	"Diseases of pulp and periapical tissues"	"Other sepsis"	1	1297	510	1807
"K04"	"C18"	"Diseases of pulp and periapical tissues"	"Malignant neoplasm of colon"	1	169	75	244
"K04"	"D64"	"Diseases of pulp and periapical tissues"	"Other anemias"	1	1018	526	1544
"K04"	"E41"	"Diseases of pulp and periapical tissues"	"Nutritional marasmus"	1	112	15	127
"K04"	"E64"	"Diseases of pulp and periapical tissues"	"Sequelae of malnutrition and other nutritional deficiencies"	1	461	144	605
"K04"	"E86"	"Diseases of pulp and periapical tissues"	"Volume depletion"	1	1227	351	1578
"K04"	"E87"	"Diseases of pulp and periapical tissues"	"Other disorders of fluid, electrolyte and acid-base balance"	1	842	255	1097
"K04"	"F41"	"Diseases of pulp and periapical tissues"	"Other anxiety disorders"	1	534	138	672
"K04"	"H25"	"Diseases of pulp and periapical tissues"	"Age-related cataract"	1	1048	677	1725
"K04"	"I31"	"Diseases of pulp and periapical tissues"	"Other diseases of pericardium"	1	247	58	305
"K04"	"I38"	"Diseases of pulp and periapical tissues"	"Endocarditis, valve unspecified"	1	183	64	247
"K04"	"I44"	"Diseases of pulp and periapical tissues"	"Atrioventricular and left bundle-branch block"	1	290	142	432
"K04"	"J18"	"Diseases of pulp and periapical tissues"	"Pneumonia, unspecified organism"	1	2288	1253	3541
"K04"	"J90"	"Diseases of pulp and periapical tissues"	"Pleural effusion, not elsewhere classified"	1	447	129	576
"K04"	"J96"	"Diseases of pulp and periapical tissues"	"Respiratory failure, not elsewhere classified"	1	1266	264	1530
"K05"	"A04"	"Gingivitis and periodontal diseases"	"Other bacterial intestinal infections"	1	265	87	352
"K05"	"A41"	"Gingivitis and periodontal diseases"	"Other sepsis"	1	1578	502	2080
"K05"	"A49"	"Gingivitis and periodontal diseases"	"Bacterial infection of unspecified site"	1	875	239	1114
"K05"	"B44"	"Gingivitis and periodontal diseases"	"Aspergillosis"	1	58	13	71
"K05"	"B59"	"Gingivitis and periodontal diseases"	"Pneumocystosis"	1	43	7	50
"K05"	"B95"	"Gingivitis and periodontal diseases"	"Strep as the cause of diseases classified elsewhere"	1	89	22	111
"K05"	"C25"	"Gingivitis and periodontal diseases"	"Malignant neoplasm of pancreas"	1	88	6	94
"K05"	"C79"	"Gingivitis and periodontal diseases"	"Secondary malignant neoplasm of other and unspecified sites"	1	500	211	711
"K05"	"D64"	"Gingivitis and periodontal diseases"	"Other anemias"	1	1218	571	1789
"K05"	"E63"	"Gingivitis and periodontal diseases"	"Other nutritional deficiencies"	1	61	13	74
"K05"	"F05"	"Gingivitis and periodontal diseases"	"Delirium due to known physiological condition"	1	356	36	392
"K05"	"H25"	"Gingivitis and periodontal diseases"	"Age-related cataract"	1	1105	766	1871
"K05"	"I33"	"Gingivitis and periodontal diseases"	"Acute and subacute endocarditis"	1	331	106	437
"K05"	"I44"	"Gingivitis and periodontal diseases"	"Atrioventricular and left bundle-branch block"	1	336	138	474
"K05"	"I46"	"Gingivitis and periodontal diseases"	"Cardiac arrest"	1	402	30	432
"K05"	"I51"	"Gingivitis and periodontal diseases"	"Complications and ill-defined descriptions of heart disease"	1	272	124	396
"K05"	"I71"	"Gingivitis and periodontal diseases"	"Aortic aneurysm and dissection"	1	292	168	460
"K05"	"I95"	"Gingivitis and periodontal diseases"	"Hypotension"	1	320	93	413
"K05"	"J18"	"Gingivitis and periodontal diseases"	"Pneumonia, unspecified organism"	1	2753	1339	4092
"K05"	"J81"	"Gingivitis and periodontal diseases"	"Pulmonary edema"	1	188	69	257
"K05"	"J95"	"Gingivitis and periodontal diseases"	"Intraop and postproc comp and disorders of resp sys, NEC"	1	337	65	402
"K05"	"J96"	"Gingivitis and periodontal diseases"	"Respiratory failure, not elsewhere classified"	1	1362	305	1667
"K05"	"K22"	"Gingivitis and periodontal diseases"	"Other diseases of esophagus"	1	315	147	462
"K05"	"K59"	"Gingivitis and periodontal diseases"	"Other functional intestinal disorders"	1	1580	527	2107
"K05"	"K92"	"Gingivitis and periodontal diseases"	"Other diseases of digestive system"	1	469	325	794
"K05"	"L98"	"Gingivitis and periodontal diseases"	"Oth disorders of skin, subcu, not elsewhere classified"	1	251	140	391
"K05"	"N28"	"Gingivitis and periodontal diseases"	"Oth disorders of kidney and ureter, not elsewhere classified"	1	170	81	251
"K05"	"O72"	"Gingivitis and periodontal diseases"	"Postpartum hemorrhage"	1	169	69	238
"K08"	"A49"	"Other disorders of teeth and supporting structures"	"Bacterial infection of unspecified site"	1	531	188	719
"K08"	"C78"	"Other disorders of teeth and supporting structures"	"Secondary malignant neoplasm of resp and digestive organs"	1	475	55	530
"K08"	"E86"	"Other disorders of teeth and supporting structures"	"Volume depletion"	1	1111	276	1387
"K08"	"E87"	"Other disorders of teeth and supporting structures"	"Other disorders of fluid, electrolyte and acid-base balance"	1	643	194	837
"K08"	"I08"	"Other disorders of teeth and supporting structures"	"Multiple valve diseases"	1	72	15	87
"K08"	"I48"	"Other disorders of teeth and supporting structures"	"Atrial fibrillation and flutter"	1	1095	746	1841
"K08"	"J18"	"Other disorders of teeth and supporting structures"	"Pneumonia, unspecified organism"	1	1844	999	2843
"K08"	"K57"	"Other disorders of teeth and supporting structures"	"Diverticular disease of intestine"	1	406	247	653
"K08"	"M48"	"Other disorders of teeth and supporting structures"	"Other spondylopathies"	1	259	152	411
"K08"	"N18"	"Other disorders of teeth and supporting structures"	"Chronic kidney disease (CKD)"	1	406	186	592
"K09"	"I10"	"Cysts of oral region, not elsewhere classified"	"Essential (primary) hypertension"	1	341	178	519
"K09"	"I48"	"Cysts of oral region, not elsewhere classified"	"Atrial fibrillation and flutter"	1	181	57	238
"K09"	"I50"	"Cysts of oral region, not elsewhere classified"	"Heart failure"	1	125	43	168
"K09"	"I69"	"Cysts of oral region, not elsewhere classified"	"Sequelae of cerebrovascular disease"	1	99	23	122
"K09"	"J18"	"Cysts of oral region, not elsewhere classified"	"Pneumonia, unspecified organism"	1	261	98	359
"K09"	"J44"	"Cysts of oral region, not elsewhere classified"	"Other chronic obstructive pulmonary disease"	1	171	56	227
"K09"	"K59"	"Cysts of oral region, not elsewhere classified"	"Other functional intestinal disorders"	1	192	60	252
"K09"	"K92"	"Cysts of oral region, not elsewhere classified"	"Other diseases of digestive system"	1	55	13	68
"K09"	"N30"	"Cysts of oral region, not elsewhere classified"	"Cystitis"	1	156	51	207
"K09"	"O70"	"Cysts of oral region, not elsewhere classified"	"Perineal laceration during delivery"	1	51	11	62
"K09"	"O72"	"Cysts of oral region, not elsewhere classified"	"Postpartum hemorrhage"	1	60	0	60
"K11"	"A41"	"Diseases of salivary glands"	"Other sepsis"	1	429	163	592
"K11"	"C34"	"Diseases of salivary glands"	"Malignant neoplasm of bronchus and lung"	1	280	6	286
"K11"	"C61"	"Diseases of salivary glands"	"Malignant neoplasm of prostate"	1	104	40	144
"K11"	"F41"	"Diseases of salivary glands"	"Other anxiety disorders"	1	124	45	169
"K11"	"I26"	"Diseases of salivary glands"	"Pulmonary embolism"	1	128	45	173
"K11"	"J15"	"Diseases of salivary glands"	"Bacterial pneumonia, not elsewhere classified"	1	371	128	499
"K11"	"J44"	"Diseases of salivary glands"	"Other chronic obstructive pulmonary disease"	1	452	271	723
"K11"	"K59"	"Diseases of salivary glands"	"Other functional intestinal disorders"	1	578	301	879
"K11"	"L97"	"Diseases of salivary glands"	"Non-pressure chronic ulcer of lower limb, NEC"	1	87	26	113
"K11"	"M48"	"Diseases of salivary glands"	"Other spondylopathies"	1	217	101	318
"K11"	"M85"	"Diseases of salivary glands"	"Other disorders of bone density and structure"	1	147	36	183
"K11"	"N18"	"Diseases of salivary glands"	"Chronic kidney disease (CKD)"	1	190	63	253
"K11"	"N39"	"Diseases of salivary glands"	"Other disorders of urinary system"	1	455	259	714
"K12"	"A41"	"Stomatitis and related lesions"	"Other sepsis"	1	481	233	714
"K12"	"A49"	"Stomatitis and related lesions"	"Bacterial infection of unspecified site"	1	256	146	402
"K12"	"O72"	"Stomatitis and related lesions"	"Postpartum hemorrhage"	1	262	92	354
"K13"	"C18"	"Other diseases of lip and oral mucosa"	"Malignant neoplasm of colon"	1	87	21	108
"K13"	"C61"	"Other diseases of lip and oral mucosa"	"Malignant neoplasm of prostate"	1	105	30	135
"K13"	"C78"	"Other diseases of lip and oral mucosa"	"Secondary malignant neoplasm of resp and digestive organs"	1	171	8	179
"K13"	"C79"	"Other diseases of lip and oral mucosa"	"Secondary malignant neoplasm of other and unspecified sites"	1	128	11	139
"K13"	"E64"	"Other diseases of lip and oral mucosa"	"Sequelae of malnutrition and other nutritional deficiencies"	1	91	25	116
"K13"	"H25"	"Other diseases of lip and oral mucosa"	"Age-related cataract"	1	651	266	917
"K13"	"I48"	"Other diseases of lip and oral mucosa"	"Atrial fibrillation and flutter"	1	562	166	728
"K13"	"I70"	"Other diseases of lip and oral mucosa"	"Atherosclerosis"	1	191	99	290
"K13"	"M19"	"Other diseases of lip and oral mucosa"	"Other and unspecified osteoarthritis"	1	184	89	273
"K13"	"N18"	"Other diseases of lip and oral mucosa"	"Chronic kidney disease (CKD)"	1	185	23	208
"K20"	"A04"	"Esophagitis"	"Other bacterial intestinal infections"	1	346	133	479
"K20"	"A41"	"Esophagitis"	"Other sepsis"	1	1953	494	2447
"K20"	"C61"	"Esophagitis"	"Malignant neoplasm of prostate"	1	356	168	524
"K20"	"C71"	"Esophagitis"	"Malignant neoplasm of brain"	1	68	9	77
"K20"	"C78"	"Esophagitis"	"Secondary malignant neoplasm of resp and digestive organs"	1	719	135	854
"K20"	"E55"	"Esophagitis"	"Vitamin D deficiency"	1	204	83	287
"K20"	"E64"	"Esophagitis"	"Sequelae of malnutrition and other nutritional deficiencies"	1	267	122	389
"K20"	"E78"	"Esophagitis"	"Disorders of lipoprotein metabolism and other lipidemias"	1	1135	752	1887
"K20"	"F05"	"Esophagitis"	"Delirium due to known physiological condition"	1	388	63	451
"K20"	"F41"	"Esophagitis"	"Other anxiety disorders"	1	411	160	571
"K20"	"G62"	"Esophagitis"	"Other and unspecified polyneuropathies"	1	386	236	622
"K20"	"H25"	"Esophagitis"	"Age-related cataract"	1	1672	1145	2817
"K20"	"I35"	"Esophagitis"	"Nonrheumatic aortic valve disorders"	1	583	210	793
"K20"	"I44"	"Esophagitis"	"Atrioventricular and left bundle-branch block"	1	255	131	386
"K20"	"I48"	"Esophagitis"	"Atrial fibrillation and flutter"	1	1808	990	2798
"K20"	"I49"	"Esophagitis"	"Other cardiac arrhythmias"	1	387	205	592
"K20"	"I69"	"Esophagitis"	"Sequelae of cerebrovascular disease"	1	1187	736	1923
"K20"	"J18"	"Esophagitis"	"Pneumonia, unspecified organism"	1	3814	1993	5807
"K20"	"J44"	"Esophagitis"	"Other chronic obstructive pulmonary disease"	1	1696	1284	2980
"K20"	"J96"	"Esophagitis"	"Respiratory failure, not elsewhere classified"	1	1528	260	1788
"K20"	"K43"	"Esophagitis"	"Ventral hernia"	1	421	271	692
"K20"	"K52"	"Esophagitis"	"Other and unsp noninfective gastroenteritis and colitis"	1	763	482	1245
"K20"	"K62"	"Esophagitis"	"Other diseases of anus and rectum"	1	909	684	1593
"K20"	"N39"	"Esophagitis"	"Other disorders of urinary system"	1	1730	722	2452
"K21"	"A41"	"Gastro-esophageal reflux disease"	"Other sepsis"	1	3534	0	3534
"K21"	"A49"	"Gastro-esophageal reflux disease"	"Bacterial infection of unspecified site"	1	1429	225	1654
"K21"	"C18"	"Gastro-esophageal reflux disease"	"Malignant neoplasm of colon"	1	938	317	1255
"K21"	"C20"	"Gastro-esophageal reflux disease"	"Malignant neoplasm of rectum"	1	276	131	407
"K21"	"C34"	"Gastro-esophageal reflux disease"	"Malignant neoplasm of bronchus and lung"	1	1509	135	1644
"K21"	"C64"	"Gastro-esophageal reflux disease"	"Malignant neoplasm of kidney, except renal pelvis"	1	247	47	294
"K21"	"C67"	"Gastro-esophageal reflux disease"	"Malignant neoplasm of bladder"	1	235	103	338
"K21"	"C71"	"Gastro-esophageal reflux disease"	"Malignant neoplasm of brain"	1	166	19	185
"K21"	"C77"	"Gastro-esophageal reflux disease"	"Secondary and unspecified malignant neoplasm of lymph nodes"	1	603	105	708
"K21"	"C78"	"Gastro-esophageal reflux disease"	"Secondary malignant neoplasm of resp and digestive organs"	1	1589	0	1589
"K21"	"C79"	"Gastro-esophageal reflux disease"	"Secondary malignant neoplasm of other and unspecified sites"	1	937	19	956
"K21"	"C80"	"Gastro-esophageal reflux disease"	"Malignant neoplasm without specification of site"	1	195	12	207
"K21"	"C83"	"Gastro-esophageal reflux disease"	"Non-follicular lymphoma"	1	190	72	262
"K21"	"D09"	"Gastro-esophageal reflux disease"	"Carcinoma in situ of other and unspecified sites"	1	111	0	111
"K21"	"D32"	"Gastro-esophageal reflux disease"	"Benign neoplasm of meninges"	1	124	35	159
"K21"	"D46"	"Gastro-esophageal reflux disease"	"Myelodysplastic syndromes"	1	136	16	152
"K21"	"D62"	"Gastro-esophageal reflux disease"	"Acute posthemorrhagic anemia"	1	587	352	939
"K21"	"D64"	"Gastro-esophageal reflux disease"	"Other anemias"	1	3715	1706	5421
"K21"	"E11"	"Gastro-esophageal reflux disease"	"Type 2 diabetes mellitus"	1	2789	2058	4847
"K21"	"E86"	"Gastro-esophageal reflux disease"	"Volume depletion"	1	5301	0	5301
"K21"	"E87"	"Gastro-esophageal reflux disease"	"Other disorders of fluid, electrolyte and acid-base balance"	1	2441	549	2990
"K21"	"F17"	"Gastro-esophageal reflux disease"	"Nicotine dependence"	1	1478	922	2400
"K21"	"F31"	"Gastro-esophageal reflux disease"	"Bipolar disorder"	1	180	87	267
"K21"	"F41"	"Gastro-esophageal reflux disease"	"Other anxiety disorders"	1	991	463	1454
"K21"	"F43"	"Gastro-esophageal reflux disease"	"Reaction to severe stress, and adjustment disorders"	1	654	422	1076
"K21"	"H25"	"Gastro-esophageal reflux disease"	"Age-related cataract"	1	4538	2137	6675
"K21"	"H26"	"Gastro-esophageal reflux disease"	"Other cataract"	1	1266	635	1901
"K21"	"H35"	"Gastro-esophageal reflux disease"	"Other retinal disorders"	1	1488	663	2151
"K21"	"I10"	"Gastro-esophageal reflux disease"	"Essential (primary) hypertension"	1	7820	6175	13995
"K21"	"I26"	"Gastro-esophageal reflux disease"	"Pulmonary embolism"	1	992	300	1292
"K21"	"I33"	"Gastro-esophageal reflux disease"	"Acute and subacute endocarditis"	1	124	35	159
"K21"	"I50"	"Gastro-esophageal reflux disease"	"Heart failure"	1	3175	1282	4457
"K21"	"I63"	"Gastro-esophageal reflux disease"	"Cerebral infarction"	1	2017	742	2759
"K21"	"I71"	"Gastro-esophageal reflux disease"	"Aortic aneurysm and dissection"	1	744	178	922
"K21"	"I73"	"Gastro-esophageal reflux disease"	"Other peripheral vascular diseases"	1	1281	516	1797
"K21"	"I74"	"Gastro-esophageal reflux disease"	"Arterial embolism and thrombosis"	1	192	103	295
"K21"	"I89"	"Gastro-esophageal reflux disease"	"Oth noninfective disorders of lymphatic vessels and nodes"	1	214	81	295
"K21"	"J90"	"Gastro-esophageal reflux disease"	"Pleural effusion, not elsewhere classified"	1	598	129	727
"K21"	"J96"	"Gastro-esophageal reflux disease"	"Respiratory failure, not elsewhere classified"	1	3063	0	3063
"K21"	"K55"	"Gastro-esophageal reflux disease"	"Vascular disorders of intestine"	1	438	96	534
"K21"	"K57"	"Gastro-esophageal reflux disease"	"Diverticular disease of intestine"	1	3808	1712	5520
"K21"	"K59"	"Gastro-esophageal reflux disease"	"Other functional intestinal disorders"	1	6554	3658	10212
"K21"	"K64"	"Gastro-esophageal reflux disease"	"Hemorrhoids and perianal venous thrombosis"	1	1661	0	1661
"K21"	"K74"	"Gastro-esophageal reflux disease"	"Fibrosis and cirrhosis of liver"	1	496	213	709
"K21"	"M46"	"Gastro-esophageal reflux disease"	"Other inflammatory spondylopathies"	1	178	90	268
"K21"	"M90"	"Gastro-esophageal reflux disease"	"Osteopathies in diseases classified elsewhere"	1	35	4	39
"K21"	"O72"	"Gastro-esophageal reflux disease"	"Postpartum hemorrhage"	1	1071	573	1644
"K22"	"A04"	"Other diseases of esophagus"	"Other bacterial intestinal infections"	1	302	129	431
"K22"	"C25"	"Other diseases of esophagus"	"Malignant neoplasm of pancreas"	1	139	45	184
"K22"	"E87"	"Other diseases of esophagus"	"Other disorders of fluid, electrolyte and acid-base balance"	1	1025	623	1648
"K22"	"J15"	"Other diseases of esophagus"	"Bacterial pneumonia, not elsewhere classified"	1	1415	621	2036
"K22"	"K59"	"Other diseases of esophagus"	"Other functional intestinal disorders"	1	1747	1167	2914
"K22"	"L89"	"Other diseases of esophagus"	"Pressure ulcer"	1	202	89	291
"K22"	"M80"	"Other diseases of esophagus"	"Osteoporosis with current pathological fracture"	1	527	330	857
"K22"	"N18"	"Other diseases of esophagus"	"Chronic kidney disease (CKD)"	1	581	293	874
"K25"	"A04"	"Gastric ulcer"	"Other bacterial intestinal infections"	1	916	316	1232
"K25"	"B37"	"Gastric ulcer"	"Candidiasis"	1	1120	868	1988
"K25"	"B96"	"Gastric ulcer"	"Oth bacterial agents as the cause of diseases classd elswhr"	1	212	109	321
"K25"	"C18"	"Gastric ulcer"	"Malignant neoplasm of colon"	1	1091	721	1812
"K25"	"C77"	"Gastric ulcer"	"Secondary and unspecified malignant neoplasm of lymph nodes"	1	441	157	598
"K25"	"C92"	"Gastric ulcer"	"Myeloid leukemia"	1	120	50	170
"K25"	"D09"	"Gastric ulcer"	"Carcinoma in situ of other and unspecified sites"	1	83	25	108
"K25"	"D12"	"Gastric ulcer"	"Benign neoplasm of colon, rectum, anus and anal canal"	1	1854	1445	3299
"K25"	"E16"	"Gastric ulcer"	"Other disorders of pancreatic internal secretion"	1	672	419	1091
"K25"	"E55"	"Gastric ulcer"	"Vitamin D deficiency"	1	519	165	684
"K25"	"E61"	"Gastric ulcer"	"Deficiency of other nutrient elements"	1	101	36	137
"K25"	"E86"	"Gastric ulcer"	"Volume depletion"	1	8772	0	8772
"K25"	"E87"	"Gastric ulcer"	"Other disorders of fluid, electrolyte and acid-base balance"	1	3169	1421	4590
"K25"	"F05"	"Gastric ulcer"	"Delirium due to known physiological condition"	1	924	197	1121
"K25"	"F32"	"Gastric ulcer"	"Depressive episode"	1	1733	1319	3052
"K25"	"F33"	"Gastric ulcer"	"Major depressive disorder, recurrent"	1	943	475	1418
"K25"	"G47"	"Gastric ulcer"	"Sleep disorders"	1	845	237	1082
"K25"	"G62"	"Gastric ulcer"	"Other and unspecified polyneuropathies"	1	606	440	1046
"K25"	"I46"	"Gastric ulcer"	"Cardiac arrest"	1	1335	169	1504
"K25"	"I71"	"Gastric ulcer"	"Aortic aneurysm and dissection"	1	850	607	1457
"K25"	"J69"	"Gastric ulcer"	"Pneumonitis due to solids and liquids"	1	603	188	791
"K25"	"K43"	"Gastric ulcer"	"Ventral hernia"	1	1203	735	1938
"K25"	"K55"	"Gastric ulcer"	"Vascular disorders of intestine"	1	795	367	1162
"K25"	"K56"	"Gastric ulcer"	"Paralytic ileus and intestinal obstruction without hernia"	1	1862	1090	2952
"K25"	"K59"	"Gastric ulcer"	"Other functional intestinal disorders"	1	4257	2379	6636
"K25"	"K63"	"Gastric ulcer"	"Other diseases of intestine"	1	810	512	1322
"K25"	"K72"	"Gastric ulcer"	"Hepatic failure, not elsewhere classified"	1	975	395	1370
"K25"	"K74"	"Gastric ulcer"	"Fibrosis and cirrhosis of liver"	1	938	694	1632
"K25"	"K76"	"Gastric ulcer"	"Other diseases of liver"	1	961	705	1666
"K25"	"K91"	"Gastric ulcer"	"Intraop and postproc comp and disorders of dgstv sys, NEC"	1	433	220	653
"K25"	"L97"	"Gastric ulcer"	"Non-pressure chronic ulcer of lower limb, NEC"	1	950	489	1439
"K25"	"M80"	"Gastric ulcer"	"Osteoporosis with current pathological fracture"	1	1690	893	2583
"K25"	"N17"	"Gastric ulcer"	"Acute kidney failure"	1	1374	653	2027
"K25"	"N18"	"Gastric ulcer"	"Chronic kidney disease (CKD)"	1	2431	927	3358
"K26"	"A04"	"Duodenal ulcer"	"Other bacterial intestinal infections"	1	674	212	886
"K26"	"A09"	"Duodenal ulcer"	"Infectious gastroenteritis and colitis, unspecified"	1	1179	787	1966
"K26"	"B37"	"Duodenal ulcer"	"Candidiasis"	1	757	548	1305
"K26"	"C16"	"Duodenal ulcer"	"Malignant neoplasm of stomach"	1	418	72	490
"K26"	"C17"	"Duodenal ulcer"	"Malignant neoplasm of small intestine"	1	197	41	238
"K26"	"C22"	"Duodenal ulcer"	"Malignant neoplasm of liver and intrahepatic bile ducts"	1	251	61	312
"K26"	"C34"	"Duodenal ulcer"	"Malignant neoplasm of bronchus and lung"	1	1341	181	1522
"K26"	"C79"	"Duodenal ulcer"	"Secondary malignant neoplasm of other and unspecified sites"	1	722	160	882
"K26"	"C83"	"Duodenal ulcer"	"Non-follicular lymphoma"	1	123	52	175
"K26"	"D12"	"Duodenal ulcer"	"Benign neoplasm of colon, rectum, anus and anal canal"	1	1377	717	2094
"K26"	"E13"	"Duodenal ulcer"	"Other specified diabetes mellitus"	1	172	45	217
"K26"	"E41"	"Duodenal ulcer"	"Nutritional marasmus"	1	172	28	200
"K26"	"E55"	"Duodenal ulcer"	"Vitamin D deficiency"	1	328	83	411
"K26"	"E63"	"Duodenal ulcer"	"Other nutritional deficiencies"	1	116	34	150
"K26"	"E78"	"Duodenal ulcer"	"Disorders of lipoprotein metabolism and other lipidemias"	1	1516	1098	2614
"K26"	"E87"	"Duodenal ulcer"	"Other disorders of fluid, electrolyte and acid-base balance"	1	2177	842	3019
"K26"	"F03"	"Duodenal ulcer"	"Unspecified dementia"	1	1802	726	2528
"K26"	"F05"	"Duodenal ulcer"	"Delirium due to known physiological condition"	1	675	123	798
"K26"	"F32"	"Duodenal ulcer"	"Depressive episode"	1	1155	794	1949
"K26"	"F33"	"Duodenal ulcer"	"Major depressive disorder, recurrent"	1	594	225	819
"K26"	"I44"	"Duodenal ulcer"	"Atrioventricular and left bundle-branch block"	1	490	309	799
"K26"	"I46"	"Duodenal ulcer"	"Cardiac arrest"	1	1000	85	1085
"K26"	"J44"	"Duodenal ulcer"	"Other chronic obstructive pulmonary disease"	1	3218	2577	5795
"K26"	"J69"	"Duodenal ulcer"	"Pneumonitis due to solids and liquids"	1	446	100	546
"K26"	"J84"	"Duodenal ulcer"	"Other interstitial pulmonary diseases"	1	239	114	353
"K26"	"K30"	"Duodenal ulcer"	"Functional dyspepsia"	1	1739	1299	3038
"K26"	"K31"	"Duodenal ulcer"	"Other diseases of stomach and duodenum"	1	1041	768	1809
"K26"	"K52"	"Duodenal ulcer"	"Other and unsp noninfective gastroenteritis and colitis"	1	1091	521	1612
"K26"	"K55"	"Duodenal ulcer"	"Vascular disorders of intestine"	1	472	154	626
"K26"	"K57"	"Duodenal ulcer"	"Diverticular disease of intestine"	1	1610	1151	2761
"K26"	"K58"	"Duodenal ulcer"	"Irritable bowel syndrome"	1	505	352	857
"K26"	"K62"	"Duodenal ulcer"	"Other diseases of anus and rectum"	1	1700	1392	3092
"K26"	"K72"	"Duodenal ulcer"	"Hepatic failure, not elsewhere classified"	1	705	284	989
"K26"	"M25"	"Duodenal ulcer"	"Other joint disorder, not elsewhere classified"	1	331	170	501
"K26"	"N19"	"Duodenal ulcer"	"Unspecified kidney failure"	1	1141	631	1772
"K26"	"O72"	"Duodenal ulcer"	"Postpartum hemorrhage"	1	70	17	87
"K27"	"C16"	"Peptic ulcer, site unspecified"	"Malignant neoplasm of stomach"	1	205	87	292
"K27"	"C79"	"Peptic ulcer, site unspecified"	"Secondary malignant neoplasm of other and unspecified sites"	1	184	65	249
"K27"	"F33"	"Peptic ulcer, site unspecified"	"Major depressive disorder, recurrent"	1	245	117	362
"K27"	"G47"	"Peptic ulcer, site unspecified"	"Sleep disorders"	1	170	57	227
"K27"	"J15"	"Peptic ulcer, site unspecified"	"Bacterial pneumonia, not elsewhere classified"	1	842	419	1261
"K27"	"K59"	"Peptic ulcer, site unspecified"	"Other functional intestinal disorders"	1	902	654	1556
"K27"	"N18"	"Peptic ulcer, site unspecified"	"Chronic kidney disease (CKD)"	1	453	311	764
"K29"	"A04"	"Gastritis and duodenitis"	"Other bacterial intestinal infections"	1	1159	306	1465
"K29"	"A49"	"Gastritis and duodenitis"	"Bacterial infection of unspecified site"	1	2070	340	2410
"K29"	"B34"	"Gastritis and duodenitis"	"Viral infection of unspecified site"	1	588	396	984
"K29"	"B37"	"Gastritis and duodenitis"	"Candidiasis"	1	1617	1301	2918
"K29"	"C25"	"Gastritis and duodenitis"	"Malignant neoplasm of pancreas"	1	925	118	1043
"K29"	"C44"	"Gastritis and duodenitis"	"Other and unspecified malignant neoplasm of skin"	1	1075	447	1522
"K29"	"C45"	"Gastritis and duodenitis"	"Mesothelioma"	1	52	6	58
"K29"	"C61"	"Gastritis and duodenitis"	"Malignant neoplasm of prostate"	1	923	399	1322
"K29"	"C64"	"Gastritis and duodenitis"	"Malignant neoplasm of kidney, except renal pelvis"	1	283	91	374
"K29"	"C79"	"Gastritis and duodenitis"	"Secondary malignant neoplasm of other and unspecified sites"	1	1250	106	1356
"K29"	"D22"	"Gastritis and duodenitis"	"Melanocytic nevi"	1	294	127	421
"K29"	"D43"	"Gastritis and duodenitis"	"Neoplasm of uncertain behavior of brain and cnsl"	1	101	25	126
"K29"	"D50"	"Gastritis and duodenitis"	"Iron deficiency anemia"	1	2936	2369	5305
"K29"	"E03"	"Gastritis and duodenitis"	"Other hypothyroidism"	1	1475	861	2336
"K29"	"E13"	"Gastritis and duodenitis"	"Other specified diabetes mellitus"	1	422	97	519
"K29"	"E41"	"Gastritis and duodenitis"	"Nutritional marasmus"	1	300	31	331
"K29"	"E55"	"Gastritis and duodenitis"	"Vitamin D deficiency"	1	785	189	974
"K29"	"E63"	"Gastritis and duodenitis"	"Other nutritional deficiencies"	1	175	51	226
"K29"	"E86"	"Gastritis and duodenitis"	"Volume depletion"	1	9609	0	9609
"K29"	"F05"	"Gastritis and duodenitis"	"Delirium due to known physiological condition"	1	1075	89	1164
"K29"	"F06"	"Gastritis and duodenitis"	"Other mental disorders due to known physiological condition"	1	387	74	461
"K29"	"F34"	"Gastritis and duodenitis"	"Persistent mood [affective] disorders"	1	264	139	403
"K29"	"F41"	"Gastritis and duodenitis"	"Other anxiety disorders"	1	1442	442	1884
"K29"	"G56"	"Gastritis and duodenitis"	"Mononeuropathies of upper limb"	1	1529	1246	2775
"K29"	"G62"	"Gastritis and duodenitis"	"Other and unspecified polyneuropathies"	1	1181	567	1748
"K29"	"G91"	"Gastritis and duodenitis"	"Hydrocephalus"	1	182	70	252
"K29"	"H54"	"Gastritis and duodenitis"	"Blindness and low vision"	1	422	198	620
"K29"	"I50"	"Gastritis and duodenitis"	"Heart failure"	1	5584	3673	9257
"K29"	"I69"	"Gastritis and duodenitis"	"Sequelae of cerebrovascular disease"	1	3783	1980	5763
"K29"	"I71"	"Gastritis and duodenitis"	"Aortic aneurysm and dissection"	1	1237	488	1725
"K29"	"I81"	"Gastritis and duodenitis"	"Portal vein thrombosis"	1	131	43	174
"K29"	"I95"	"Gastritis and duodenitis"	"Hypotension"	1	1375	380	1755
"K29"	"J44"	"Gastritis and duodenitis"	"Other chronic obstructive pulmonary disease"	1	5615	3457	9072
"K29"	"K42"	"Gastritis and duodenitis"	"Umbilical hernia"	1	750	477	1227
"K29"	"K56"	"Gastritis and duodenitis"	"Paralytic ileus and intestinal obstruction without hernia"	1	2077	840	2917
"K29"	"K59"	"Gastritis and duodenitis"	"Other functional intestinal disorders"	1	10900	0	10900
"K29"	"K62"	"Gastritis and duodenitis"	"Other diseases of anus and rectum"	1	3172	2187	5359
"K29"	"K63"	"Gastritis and duodenitis"	"Other diseases of intestine"	1	1004	362	1366
"K29"	"K64"	"Gastritis and duodenitis"	"Hemorrhoids and perianal venous thrombosis"	1	1479	0	1479
"K29"	"K65"	"Gastritis and duodenitis"	"Peritonitis"	1	940	386	1326
"K29"	"K74"	"Gastritis and duodenitis"	"Fibrosis and cirrhosis of liver"	1	1154	635	1789
"K29"	"K75"	"Gastritis and duodenitis"	"Other inflammatory liver diseases"	1	163	75	238
"K29"	"K80"	"Gastritis and duodenitis"	"Cholelithiasis"	1	5568	4979	10547
"K29"	"K81"	"Gastritis and duodenitis"	"Cholecystitis"	1	1130	628	1758
"K29"	"K82"	"Gastritis and duodenitis"	"Other diseases of gallbladder"	1	161	62	223
"K29"	"K86"	"Gastritis and duodenitis"	"Other diseases of pancreas"	1	1440	928	2368
"K29"	"M10"	"Gastritis and duodenitis"	"Gout"	1	1059	699	1758
"K29"	"M47"	"Gastritis and duodenitis"	"Spondylosis"	1	1532	1244	2776
"K29"	"M79"	"Gastritis and duodenitis"	"Oth and unsp soft tissue disorders, not elsewhere classified"	1	3949	2782	6731
"K29"	"M90"	"Gastritis and duodenitis"	"Osteopathies in diseases classified elsewhere"	1	38	4	42
"K29"	"N17"	"Gastritis and duodenitis"	"Acute kidney failure"	1	1401	333	1734
"K29"	"N18"	"Gastritis and duodenitis"	"Chronic kidney disease (CKD)"	1	2833	947	3780
"K29"	"N30"	"Gastritis and duodenitis"	"Cystitis"	1	6763	4102	10865
"K29"	"O72"	"Gastritis and duodenitis"	"Postpartum hemorrhage"	1	1259	189	1448
"K30"	"A41"	"Functional dyspepsia"	"Other sepsis"	1	2990	0	2990
"K30"	"A46"	"Functional dyspepsia"	"Erysipelas"	1	1045	330	1375
"K30"	"B37"	"Functional dyspepsia"	"Candidiasis"	1	816	396	1212
"K30"	"C10"	"Functional dyspepsia"	"Malignant neoplasm of oropharynx"	1	63	9	72
"K30"	"C18"	"Functional dyspepsia"	"Malignant neoplasm of colon"	1	952	307	1259
"K30"	"C43"	"Functional dyspepsia"	"Malignant melanoma of skin"	1	255	114	369
"K30"	"C44"	"Functional dyspepsia"	"Other and unspecified malignant neoplasm of skin"	1	950	188	1138
"K30"	"C49"	"Functional dyspepsia"	"Malignant neoplasm of other connective and soft tissue"	1	74	9	83
"K30"	"C56"	"Functional dyspepsia"	"Malignant neoplasm of ovary"	1	189	100	289
"K30"	"C67"	"Functional dyspepsia"	"Malignant neoplasm of bladder"	1	231	70	301
"K30"	"C71"	"Functional dyspepsia"	"Malignant neoplasm of brain"	1	179	25	204
"K30"	"C79"	"Functional dyspepsia"	"Secondary malignant neoplasm of other and unspecified sites"	1	942	26	968
"K30"	"C83"	"Functional dyspepsia"	"Non-follicular lymphoma"	1	191	66	257
"K30"	"D05"	"Functional dyspepsia"	"Carcinoma in situ of breast"	1	95	32	127
"K30"	"D09"	"Functional dyspepsia"	"Carcinoma in situ of other and unspecified sites"	1	93	0	93
"K30"	"D50"	"Functional dyspepsia"	"Iron deficiency anemia"	1	1498	519	2017
"K30"	"E03"	"Functional dyspepsia"	"Other hypothyroidism"	1	1299	631	1930
"K30"	"E11"	"Functional dyspepsia"	"Type 2 diabetes mellitus"	1	2856	1708	4564
"K30"	"E16"	"Functional dyspepsia"	"Other disorders of pancreatic internal secretion"	1	407	226	633
"K30"	"E23"	"Functional dyspepsia"	"Hypofunction and other disorders of the pituitary gland"	1	153	44	197
"K30"	"E64"	"Functional dyspepsia"	"Sequelae of malnutrition and other nutritional deficiencies"	1	503	136	639
"K30"	"E73"	"Functional dyspepsia"	"Lactose intolerance"	1	484	293	777
"K30"	"E86"	"Functional dyspepsia"	"Volume depletion"	1	4690	0	4690
"K30"	"F17"	"Functional dyspepsia"	"Nicotine dependence"	1	1560	849	2409
"K30"	"F32"	"Functional dyspepsia"	"Depressive episode"	1	1958	1145	3103
"K30"	"F33"	"Functional dyspepsia"	"Major depressive disorder, recurrent"	1	1279	343	1622
"K30"	"F41"	"Functional dyspepsia"	"Other anxiety disorders"	1	1289	465	1754
"K30"	"F43"	"Functional dyspepsia"	"Reaction to severe stress, and adjustment disorders"	1	743	347	1090
"K30"	"G44"	"Functional dyspepsia"	"Other headache syndromes"	1	937	658	1595
"K30"	"G95"	"Functional dyspepsia"	"Other and unspecified diseases of spinal cord"	1	247	38	285
"K30"	"H25"	"Functional dyspepsia"	"Age-related cataract"	1	6654	0	6654
"K30"	"I26"	"Functional dyspepsia"	"Pulmonary embolism"	1	906	248	1154
"K30"	"I33"	"Functional dyspepsia"	"Acute and subacute endocarditis"	1	118	29	147
"K30"	"I46"	"Functional dyspepsia"	"Cardiac arrest"	1	782	0	782
"K30"	"I50"	"Functional dyspepsia"	"Heart failure"	1	3370	1476	4846
"K30"	"I63"	"Functional dyspepsia"	"Cerebral infarction"	1	2180	665	2845
"K30"	"I70"	"Functional dyspepsia"	"Atherosclerosis"	1	1417	904	2321
"K30"	"I80"	"Functional dyspepsia"	"Phlebitis and thrombophlebitis"	1	1167	620	1787
"K30"	"I85"	"Functional dyspepsia"	"Esophageal varices"	1	205	77	282
"K30"	"J18"	"Functional dyspepsia"	"Pneumonia, unspecified organism"	1	9059	0	9059
"K30"	"J81"	"Functional dyspepsia"	"Pulmonary edema"	1	452	75	527
"K30"	"J90"	"Functional dyspepsia"	"Pleural effusion, not elsewhere classified"	1	529	63	592
"K30"	"K02"	"Functional dyspepsia"	"Dental caries"	1	280	161	441
"K30"	"K04"	"Functional dyspepsia"	"Diseases of pulp and periapical tissues"	1	401	225	626
"K30"	"K22"	"Functional dyspepsia"	"Other diseases of esophagus"	1	2052	1219	3271
"K30"	"K31"	"Functional dyspepsia"	"Other diseases of stomach and duodenum"	1	742	372	1114
"K30"	"K52"	"Functional dyspepsia"	"Other and unsp noninfective gastroenteritis and colitis"	1	2123	989	3112
"K30"	"K55"	"Functional dyspepsia"	"Vascular disorders of intestine"	1	436	88	524
"K30"	"K59"	"Functional dyspepsia"	"Other functional intestinal disorders"	1	9660	0	9660
"K30"	"K62"	"Functional dyspepsia"	"Other diseases of anus and rectum"	1	2517	1208	3725
"K30"	"K63"	"Functional dyspepsia"	"Other diseases of intestine"	1	690	132	822
"K30"	"K64"	"Functional dyspepsia"	"Hemorrhoids and perianal venous thrombosis"	1	1472	0	1472
"K30"	"K65"	"Functional dyspepsia"	"Peritonitis"	1	446	185	631
"K30"	"K72"	"Functional dyspepsia"	"Hepatic failure, not elsewhere classified"	1	319	44	363
"K30"	"K74"	"Functional dyspepsia"	"Fibrosis and cirrhosis of liver"	1	351	69	420
"K30"	"K76"	"Functional dyspepsia"	"Other diseases of liver"	1	896	360	1256
"K30"	"K80"	"Functional dyspepsia"	"Cholelithiasis"	1	5499	4301	9800
"K30"	"K83"	"Functional dyspepsia"	"Other diseases of biliary tract"	1	785	218	1003
"K30"	"K85"	"Functional dyspepsia"	"Acute pancreatitis"	1	949	608	1557
"K30"	"K92"	"Functional dyspepsia"	"Other diseases of digestive system"	1	1909	1211	3120
"K30"	"L29"	"Functional dyspepsia"	"Pruritus"	1	274	79	353
"K30"	"L89"	"Functional dyspepsia"	"Pressure ulcer"	1	428	31	459
"K30"	"M16"	"Functional dyspepsia"	"Osteoarthritis of hip"	1	1623	978	2601
"K30"	"M65"	"Functional dyspepsia"	"Synovitis and tenosynovitis"	1	1302	1042	2344
"K30"	"M81"	"Functional dyspepsia"	"Osteoporosis without current pathological fracture"	1	4069	0	4069
"K30"	"N13"	"Functional dyspepsia"	"Obstructive and reflux uropathy"	1	552	219	771
"K30"	"N17"	"Functional dyspepsia"	"Acute kidney failure"	1	685	27	712
"K30"	"N18"	"Functional dyspepsia"	"Chronic kidney disease (CKD)"	1	1582	201	1783
"K30"	"O72"	"Functional dyspepsia"	"Postpartum hemorrhage"	1	1827	523	2350
"K31"	"C34"	"Other diseases of stomach and duodenum"	"Malignant neoplasm of bronchus and lung"	1	154	64	218
"K31"	"F41"	"Other diseases of stomach and duodenum"	"Other anxiety disorders"	1	176	85	261
"K35"	"A49"	"Acute appendicitis"	"Bacterial infection of unspecified site"	1	725	119	844
"K35"	"B36"	"Acute appendicitis"	"Other superficial mycoses"	1	55	12	67
"K35"	"C10"	"Acute appendicitis"	"Malignant neoplasm of oropharynx"	1	25	0	25
"K35"	"C16"	"Acute appendicitis"	"Malignant neoplasm of stomach"	1	76	2	78
"K35"	"C24"	"Acute appendicitis"	"Malignant neoplasm of other and unsp parts of biliary tract"	1	26	0	26
"K35"	"C25"	"Acute appendicitis"	"Malignant neoplasm of pancreas"	1	107	0	107
"K35"	"C34"	"Acute appendicitis"	"Malignant neoplasm of bronchus and lung"	1	504	0	504
"K35"	"C44"	"Acute appendicitis"	"Other and unspecified malignant neoplasm of skin"	1	378	60	438
"K35"	"C48"	"Acute appendicitis"	"Malignant neoplasm of retroperitoneum and peritoneum"	1	27	1	28
"K35"	"C49"	"Acute appendicitis"	"Malignant neoplasm of other connective and soft tissue"	1	47	10	57
"K35"	"C50"	"Acute appendicitis"	"Malignant neoplasm of breast"	1	337	162	499
"K35"	"C61"	"Acute appendicitis"	"Malignant neoplasm of prostate"	1	288	47	335
"K35"	"C78"	"Acute appendicitis"	"Secondary malignant neoplasm of resp and digestive organs"	1	722	0	722
"K35"	"C80"	"Acute appendicitis"	"Malignant neoplasm without specification of site"	1	71	0	71
"K35"	"D21"	"Acute appendicitis"	"Other benign neoplasms of connective and other soft tissue"	1	110	41	151
"K35"	"D23"	"Acute appendicitis"	"Other benign neoplasms of skin"	1	368	179	547
"K35"	"D32"	"Acute appendicitis"	"Benign neoplasm of meninges"	1	52	11	63
"K35"	"D35"	"Acute appendicitis"	"Benign neoplasm of other and unspecified endocrine glands"	1	110	20	130
"K35"	"D43"	"Acute appendicitis"	"Neoplasm of uncertain behavior of brain and cnsl"	1	43	2	45
"K35"	"D47"	"Acute appendicitis"	"Oth neoplm of uncrt behav of lymphoid, hematpoetc & rel tiss"	1	78	4	82
"K35"	"D51"	"Acute appendicitis"	"Vitamin B12 deficiency anemia"	1	81	25	106
"K35"	"D68"	"Acute appendicitis"	"Other coagulation defects"	1	253	67	320
"K35"	"D72"	"Acute appendicitis"	"Other disorders of white blood cells"	1	78	24	102
"K35"	"D75"	"Acute appendicitis"	"Other and unsp diseases of blood and blood-forming organs"	1	83	8	91
"K35"	"D86"	"Acute appendicitis"	"Sarcoidosis"	1	138	27	165
"K35"	"E03"	"Acute appendicitis"	"Other hypothyroidism"	1	687	199	886
"K35"	"E13"	"Acute appendicitis"	"Other specified diabetes mellitus"	1	82	9	91
"K35"	"E22"	"Acute appendicitis"	"Hyperfunction of pituitary gland"	1	91	17	108
"K35"	"E23"	"Acute appendicitis"	"Hypofunction and other disorders of the pituitary gland"	1	106	23	129
"K35"	"E27"	"Acute appendicitis"	"Other disorders of adrenal gland"	1	104	28	132
"K35"	"E29"	"Acute appendicitis"	"Testicular dysfunction"	1	47	7	54
"K35"	"E55"	"Acute appendicitis"	"Vitamin D deficiency"	1	195	8	203
"K35"	"E65"	"Acute appendicitis"	"Localized adiposity"	1	136	47	183
"K35"	"E66"	"Acute appendicitis"	"Overweight and obesity"	1	3179	974	4153
"K35"	"E83"	"Acute appendicitis"	"Disorders of mineral metabolism"	1	146	9	155
"K35"	"E86"	"Acute appendicitis"	"Volume depletion"	1	1264	291	1555
"K35"	"F03"	"Acute appendicitis"	"Unspecified dementia"	1	370	50	420
"K35"	"F06"	"Acute appendicitis"	"Other mental disorders due to known physiological condition"	1	105	7	112
"K35"	"F31"	"Acute appendicitis"	"Bipolar disorder"	1	107	33	140
"K35"	"F32"	"Acute appendicitis"	"Depressive episode"	1	702	307	1009
"K35"	"F41"	"Acute appendicitis"	"Other anxiety disorders"	1	524	78	602
"K35"	"G12"	"Acute appendicitis"	"Spinal muscular atrophy and related syndromes"	1	33	4	37
"K35"	"G51"	"Acute appendicitis"	"Facial nerve disorders"	1	165	54	219
"K35"	"G96"	"Acute appendicitis"	"Other disorders of central nervous system"	1	446	18	464
"K35"	"G97"	"Acute appendicitis"	"Intraop and postproc comp and disorders of nervous sys, NEC"	1	59	5	64
"K35"	"H26"	"Acute appendicitis"	"Other cataract"	1	496	158	654
"K35"	"H35"	"Acute appendicitis"	"Other retinal disorders"	1	591	168	759
"K35"	"H44"	"Acute appendicitis"	"Disorders of globe"	1	98	18	116
"K35"	"H46"	"Acute appendicitis"	"Optic neuritis"	1	34	4	38
"K35"	"H81"	"Acute appendicitis"	"Disorders of vestibular function"	1	407	166	573
"K35"	"H90"	"Acute appendicitis"	"Conductive and sensorineural hearing loss"	1	421	239	660
"K35"	"I11"	"Acute appendicitis"	"Hypertensive heart disease"	1	190	94	284
"K35"	"I21"	"Acute appendicitis"	"Acute myocardial infarction"	1	722	413	1135
"K35"	"I30"	"Acute appendicitis"	"Acute pericarditis"	1	124	28	152
"K35"	"I35"	"Acute appendicitis"	"Nonrheumatic aortic valve disorders"	1	492	79	571
"K35"	"I42"	"Acute appendicitis"	"Cardiomyopathy"	1	172	65	237
"K35"	"I44"	"Acute appendicitis"	"Atrioventricular and left bundle-branch block"	1	203	46	249
"K35"	"I49"	"Acute appendicitis"	"Other cardiac arrhythmias"	1	483	161	644
"K35"	"I50"	"Acute appendicitis"	"Heart failure"	1	1035	406	1441
"K35"	"I51"	"Acute appendicitis"	"Complications and ill-defined descriptions of heart disease"	1	192	57	249
"K35"	"I60"	"Acute appendicitis"	"Nontraumatic subarachnoid hemorrhage"	1	91	25	116
"K35"	"I61"	"Acute appendicitis"	"Nontraumatic intracerebral hemorrhage"	1	187	26	213
"K35"	"I63"	"Acute appendicitis"	"Cerebral infarction"	1	647	161	808
"K35"	"I67"	"Acute appendicitis"	"Other cerebrovascular diseases"	1	101	20	121
"K35"	"I71"	"Acute appendicitis"	"Aortic aneurysm and dissection"	1	310	53	363
"K35"	"I72"	"Acute appendicitis"	"Other aneurysm"	1	68	13	81
"K35"	"I73"	"Acute appendicitis"	"Other peripheral vascular diseases"	1	425	88	513
"K35"	"I74"	"Acute appendicitis"	"Arterial embolism and thrombosis"	1	102	32	134
"K35"	"I83"	"Acute appendicitis"	"Varicose veins of lower extremities"	1	631	317	948
"K35"	"I85"	"Acute appendicitis"	"Esophageal varices"	1	36	4	40
"K35"	"I99"	"Acute appendicitis"	"Other and unspecified disorders of circulatory system"	1	82	28	110
"K35"	"J01"	"Acute appendicitis"	"Acute sinusitis"	1	349	61	410
"K35"	"J32"	"Acute appendicitis"	"Chronic sinusitis"	1	192	94	286
"K35"	"J43"	"Acute appendicitis"	"Emphysema"	1	113	43	156
"K35"	"J81"	"Acute appendicitis"	"Pulmonary edema"	1	142	39	181
"K35"	"J84"	"Acute appendicitis"	"Other interstitial pulmonary diseases"	1	121	15	136
"K35"	"J93"	"Acute appendicitis"	"Pneumothorax and air leak"	1	177	46	223
"K35"	"J94"	"Acute appendicitis"	"Other pleural conditions"	1	72	17	89
"K35"	"J96"	"Acute appendicitis"	"Respiratory failure, not elsewhere classified"	1	1020	169	1189
"K35"	"J98"	"Acute appendicitis"	"Other respiratory disorders"	1	193	104	297
"K35"	"K05"	"Acute appendicitis"	"Gingivitis and periodontal diseases"	1	182	35	217
"K35"	"K08"	"Acute appendicitis"	"Other disorders of teeth and supporting structures"	1	204	58	262
"K35"	"K11"	"Acute appendicitis"	"Diseases of salivary glands"	1	148	55	203
"K35"	"K21"	"Acute appendicitis"	"Gastro-esophageal reflux disease"	1	1022	368	1390
"K35"	"K22"	"Acute appendicitis"	"Other diseases of esophagus"	1	258	62	320
"K35"	"K31"	"Acute appendicitis"	"Other diseases of stomach and duodenum"	1	114	21	135
"K35"	"K46"	"Acute appendicitis"	"Unspecified abdominal hernia"	1	201	23	224
"K35"	"K52"	"Acute appendicitis"	"Other and unsp noninfective gastroenteritis and colitis"	1	956	436	1392
"K35"	"K57"	"Acute appendicitis"	"Diverticular disease of intestine"	1	1850	492	2342
"K35"	"K60"	"Acute appendicitis"	"Fissure and fistula of anal and rectal regions"	1	420	166	586
"K35"	"K76"	"Acute appendicitis"	"Other diseases of liver"	1	282	43	325
"K35"	"K83"	"Acute appendicitis"	"Other diseases of biliary tract"	1	174	44	218
"K35"	"K85"	"Acute appendicitis"	"Acute pancreatitis"	1	366	166	532
"K35"	"L05"	"Acute appendicitis"	"Pilonidal cyst and sinus"	1	328	138	466
"K35"	"L40"	"Acute appendicitis"	"Psoriasis"	1	227	68	295
"K35"	"L60"	"Acute appendicitis"	"Nail disorders"	1	306	185	491
"K35"	"L70"	"Acute appendicitis"	"Acne"	1	88	28	116
"K35"	"L72"	"Acute appendicitis"	"Follicular cysts of skin and subcutaneous tissue"	1	154	43	197
"K35"	"L73"	"Acute appendicitis"	"Other follicular disorders"	1	141	57	198
"K35"	"L97"	"Acute appendicitis"	"Non-pressure chronic ulcer of lower limb, NEC"	1	179	21	200
"K35"	"L98"	"Acute appendicitis"	"Oth disorders of skin, subcu, not elsewhere classified"	1	332	78	410
"K35"	"M20"	"Acute appendicitis"	"Acquired deformities of fingers and toes"	1	538	221	759
"K35"	"M21"	"Acute appendicitis"	"Other acquired deformities of limbs"	1	279	159	438
"K35"	"M23"	"Acute appendicitis"	"Internal derangement of knee"	1	2771	1243	4014
"K35"	"M46"	"Acute appendicitis"	"Other inflammatory spondylopathies"	1	144	14	158
"K35"	"M47"	"Acute appendicitis"	"Spondylosis"	1	599	168	767
"K35"	"M48"	"Acute appendicitis"	"Other spondylopathies"	1	521	123	644
"K35"	"M50"	"Acute appendicitis"	"Cervical disc disorders"	1	390	140	530
"K35"	"M54"	"Acute appendicitis"	"Dorsalgia"	1	2937	1229	4166
"K35"	"M81"	"Acute appendicitis"	"Osteoporosis without current pathological fracture"	1	834	168	1002
"K35"	"M95"	"Acute appendicitis"	"Oth acquired deformities of ms sys and connective tissue"	1	193	88	281
"K35"	"M96"	"Acute appendicitis"	"Intraop and postproc comp and disorders of ms sys, NEC"	1	66	11	77
"K35"	"N10"	"Acute appendicitis"	"Acute pyelonephritis"	1	527	335	862
"K35"	"N18"	"Acute appendicitis"	"Chronic kidney disease (CKD)"	1	532	60	592
"K35"	"N39"	"Acute appendicitis"	"Other disorders of urinary system"	1	1645	474	2119
"K35"	"N46"	"Acute appendicitis"	"Male infertility"	1	407	31	438
"K35"	"N50"	"Acute appendicitis"	"Other and unspecified disorders of male genital organs"	1	351	101	452
"K35"	"N64"	"Acute appendicitis"	"Other disorders of breast"	1	391	103	494
"K35"	"N75"	"Acute appendicitis"	"Diseases of Bartholin's gland"	1	107	37	144
"K35"	"N76"	"Acute appendicitis"	"Other inflammation of vagina and vulva"	1	274	119	393
"K35"	"N83"	"Acute appendicitis"	"Noninflammatory disord of ovary, fallop and broad ligament"	1	1436	988	2424
"K35"	"N87"	"Acute appendicitis"	"Dysplasia of cervix uteri"	1	463	159	622
"K35"	"N92"	"Acute appendicitis"	"Excessive, frequent and irregular menstruation"	1	1228	599	1827
"K35"	"N93"	"Acute appendicitis"	"Other abnormal uterine and vaginal bleeding"	1	303	33	336
"K35"	"N99"	"Acute appendicitis"	"Intraop and postproc comp and disorders of GU sys, NEC"	1	178	66	244
"K35"	"O08"	"Acute appendicitis"	"Complications following ectopic and molar pregnancy"	1	408	91	499
"K35"	"O10"	"Acute appendicitis"	"Pre-existing hypertension compl preg/chldbrth"	1	64	12	76
"K35"	"O14"	"Acute appendicitis"	"Pre-eclampsia"	1	298	125	423
"K35"	"O20"	"Acute appendicitis"	"Hemorrhage in early pregnancy"	1	830	508	1338
"K35"	"O26"	"Acute appendicitis"	"Maternal care for oth conditions predom related to pregnancy"	1	935	346	1281
"K35"	"O40"	"Acute appendicitis"	"Polyhydramnios"	1	88	12	100
"K35"	"O42"	"Acute appendicitis"	"Premature rupture of membranes"	1	689	169	858
"K35"	"O44"	"Acute appendicitis"	"Placenta previa"	1	67	14	81
"K35"	"O46"	"Acute appendicitis"	"Antepartum hemorrhage, not elsewhere classified"	1	229	99	328
"K35"	"O70"	"Acute appendicitis"	"Perineal laceration during delivery"	1	2704	677	3381
"K35"	"O71"	"Acute appendicitis"	"Other obstetric trauma"	1	397	256	653
"K35"	"O72"	"Acute appendicitis"	"Postpartum hemorrhage"	1	3370	0	3370
"K35"	"O90"	"Acute appendicitis"	"Complications of the puerperium, not elsewhere classified"	1	305	45	350
"K40"	"A40"	"Inguinal hernia"	"Streptococcal sepsis"	1	239	33	272
"K40"	"A41"	"Inguinal hernia"	"Other sepsis"	1	4801	0	4801
"K40"	"A46"	"Inguinal hernia"	"Erysipelas"	1	1652	385	2037
"K40"	"A49"	"Inguinal hernia"	"Bacterial infection of unspecified site"	1	1793	0	1793
"K40"	"B02"	"Inguinal hernia"	"Zoster [herpes zoster]"	1	352	94	446
"K40"	"B36"	"Inguinal hernia"	"Other superficial mycoses"	1	94	23	117
"K40"	"B44"	"Inguinal hernia"	"Aspergillosis"	1	57	2	59
"K40"	"B95"	"Inguinal hernia"	"Strep as the cause of diseases classified elsewhere"	1	151	10	161
"K40"	"B99"	"Inguinal hernia"	"Other and unspecified infectious diseases"	1	81	15	96
"K40"	"C10"	"Inguinal hernia"	"Malignant neoplasm of oropharynx"	1	99	22	121
"K40"	"C13"	"Inguinal hernia"	"Malignant neoplasm of hypopharynx"	1	92	11	103
"K40"	"C18"	"Inguinal hernia"	"Malignant neoplasm of colon"	1	1761	353	2114
"K40"	"C20"	"Inguinal hernia"	"Malignant neoplasm of rectum"	1	843	209	1052
"K40"	"C22"	"Inguinal hernia"	"Malignant neoplasm of liver and intrahepatic bile ducts"	1	268	3	271
"K40"	"C25"	"Inguinal hernia"	"Malignant neoplasm of pancreas"	1	568	8	576
"K40"	"C26"	"Inguinal hernia"	"Malignant neoplasm of other and ill-defined digestive organs"	1	33	2	35
"K40"	"C34"	"Inguinal hernia"	"Malignant neoplasm of bronchus and lung"	1	2797	0	2797
"K40"	"C41"	"Inguinal hernia"	"Malignant neoplasm of bone/artic cartl of and unsp sites"	1	65	13	78
"K40"	"C43"	"Inguinal hernia"	"Malignant melanoma of skin"	1	642	235	877
"K40"	"C61"	"Inguinal hernia"	"Malignant neoplasm of prostate"	1	4523	0	4523
"K40"	"C76"	"Inguinal hernia"	"Malignant neoplasm of other and ill-defined sites"	1	129	42	171
"K40"	"C80"	"Inguinal hernia"	"Malignant neoplasm without specification of site"	1	237	0	237
"K40"	"C82"	"Inguinal hernia"	"Follicular lymphoma"	1	134	51	185
"K40"	"C88"	"Inguinal hernia"	"Malig immunoproliferative dis and certain oth B-cell lymph"	1	124	5	129
"K40"	"C90"	"Inguinal hernia"	"Multiple myeloma and malignant plasma cell neoplasms"	1	284	35	319
"K40"	"C93"	"Inguinal hernia"	"Monocytic leukemia"	1	34	3	37
"K40"	"D12"	"Inguinal hernia"	"Benign neoplasm of colon, rectum, anus and anal canal"	1	5389	0	5389
"K40"	"D14"	"Inguinal hernia"	"Benign neoplasm of middle ear and respiratory system"	1	356	200	556
"K40"	"D18"	"Inguinal hernia"	"Hemangioma and lymphangioma, any site"	1	218	111	329
"K40"	"D21"	"Inguinal hernia"	"Other benign neoplasms of connective and other soft tissue"	1	249	103	352
"K40"	"D22"	"Inguinal hernia"	"Melanocytic nevi"	1	576	94	670
"K40"	"D23"	"Inguinal hernia"	"Other benign neoplasms of skin"	1	1057	624	1681
"K40"	"D35"	"Inguinal hernia"	"Benign neoplasm of other and unspecified endocrine glands"	1	252	39	291
"K40"	"D38"	"Inguinal hernia"	"Neoplm of uncrt behav of mid ear & resp and intrathorac org"	1	137	31	168
"K40"	"D43"	"Inguinal hernia"	"Neoplasm of uncertain behavior of brain and cnsl"	1	158	13	171
"K40"	"D51"	"Inguinal hernia"	"Vitamin B12 deficiency anemia"	1	282	102	384
"K40"	"D53"	"Inguinal hernia"	"Other nutritional anemias"	1	82	15	97
"K40"	"D61"	"Inguinal hernia"	"Oth aplastic anemias and other bone marrow failure syndromes"	1	146	23	169
"K40"	"D62"	"Inguinal hernia"	"Acute posthemorrhagic anemia"	1	723	109	832
"K40"	"D63"	"Inguinal hernia"	"Anemia in chronic diseases classified elsewhere"	1	1230	0	1230
"K40"	"D64"	"Inguinal hernia"	"Other anemias"	1	5361	0	5361
"K40"	"D65"	"Inguinal hernia"	"Disseminated intravascular coagulation"	1	48	6	54
"K40"	"D68"	"Inguinal hernia"	"Other coagulation defects"	1	434	112	546
"K40"	"D69"	"Inguinal hernia"	"Purpura and other hemorrhagic conditions"	1	571	141	712
"K40"	"D70"	"Inguinal hernia"	"Neutropenia"	1	59	8	67
"K40"	"D72"	"Inguinal hernia"	"Other disorders of white blood cells"	1	121	30	151
"K40"	"D84"	"Inguinal hernia"	"Other immunodeficiencies"	1	69	4	73
"K40"	"E03"	"Inguinal hernia"	"Other hypothyroidism"	1	865	328	1193
"K40"	"E04"	"Inguinal hernia"	"Other nontoxic goiter"	1	531	338	869
"K40"	"E05"	"Inguinal hernia"	"Thyrotoxicosis [hyperthyroidism]"	1	777	396	1173
"K40"	"E11"	"Inguinal hernia"	"Type 2 diabetes mellitus"	1	3497	1631	5128
"K40"	"E13"	"Inguinal hernia"	"Other specified diabetes mellitus"	1	151	19	170
"K40"	"E21"	"Inguinal hernia"	"Hyperparathyroidism and other disorders of parathyroid gland"	1	269	54	323
"K40"	"E22"	"Inguinal hernia"	"Hyperfunction of pituitary gland"	1	104	18	122
"K40"	"E29"	"Inguinal hernia"	"Testicular dysfunction"	1	120	14	134
"K40"	"E30"	"Inguinal hernia"	"Disorders of puberty, not elsewhere classified"	1	57	0	57
"K40"	"E34"	"Inguinal hernia"	"Other endocrine disorders"	1	351	21	372
"K40"	"E41"	"Inguinal hernia"	"Nutritional marasmus"	1	150	0	150
"K40"	"E61"	"Inguinal hernia"	"Deficiency of other nutrient elements"	1	60	2	62
"K40"	"E63"	"Inguinal hernia"	"Other nutritional deficiencies"	1	82	6	88
"K40"	"E64"	"Inguinal hernia"	"Sequelae of malnutrition and other nutritional deficiencies"	1	397	20	417
"K40"	"E70"	"Inguinal hernia"	"Disorders of aromatic amino-acid metabolism"	1	48	10	58
"K40"	"E83"	"Inguinal hernia"	"Disorders of mineral metabolism"	1	429	12	441
"K40"	"E85"	"Inguinal hernia"	"Amyloidosis"	1	63	6	69
"K40"	"E86"	"Inguinal hernia"	"Volume depletion"	1	5633	0	5633
"K40"	"E87"	"Inguinal hernia"	"Other disorders of fluid, electrolyte and acid-base balance"	1	2528	0	2528
"K40"	"F01"	"Inguinal hernia"	"Vascular dementia"	1	551	2	553
"K40"	"F05"	"Inguinal hernia"	"Delirium due to known physiological condition"	1	891	0	891
"K40"	"F17"	"Inguinal hernia"	"Nicotine dependence"	1	2841	2059	4900
"K40"	"F32"	"Inguinal hernia"	"Depressive episode"	1	1738	340	2078
"K40"	"F34"	"Inguinal hernia"	"Persistent mood [affective] disorders"	1	112	29	141
"K40"	"F41"	"Inguinal hernia"	"Other anxiety disorders"	1	834	72	906
"K40"	"F95"	"Inguinal hernia"	"Tic disorder"	1	90	8	98
"K40"	"G25"	"Inguinal hernia"	"Other extrapyramidal and movement disorders"	1	287	44	331
"K40"	"G31"	"Inguinal hernia"	"Oth degenerative diseases of nervous system, NEC"	1	393	10	403
"K40"	"G56"	"Inguinal hernia"	"Mononeuropathies of upper limb"	1	1636	907	2543
"K40"	"G62"	"Inguinal hernia"	"Other and unspecified polyneuropathies"	1	946	237	1183
"K40"	"G63"	"Inguinal hernia"	"Polyneuropathy in diseases classified elsewhere"	1	124	28	152
"K40"	"G81"	"Inguinal hernia"	"Hemiplegia and hemiparesis"	1	103	22	125
"K40"	"G82"	"Inguinal hernia"	"Paraplegia (paraparesis) and quadriplegia (quadriparesis)"	1	204	53	257
"K40"	"G91"	"Inguinal hernia"	"Hydrocephalus"	1	243	47	290
"K40"	"H02"	"Inguinal hernia"	"Other disorders of eyelid"	1	1324	387	1711
"K40"	"H04"	"Inguinal hernia"	"Disorders of lacrimal system"	1	243	105	348
"K40"	"H16"	"Inguinal hernia"	"Keratitis"	1	275	155	430
"K40"	"H40"	"Inguinal hernia"	"Glaucoma"	1	872	454	1326
"K40"	"H50"	"Inguinal hernia"	"Other strabismus"	1	473	229	702
"K40"	"H52"	"Inguinal hernia"	"Disorders of refraction and accommodation"	1	760	411	1171
"K40"	"H53"	"Inguinal hernia"	"Visual disturbances"	1	765	205	970
"K40"	"H82"	"Inguinal hernia"	"Vertiginous syndromes in diseases classified elsewhere"	1	51	8	59
"K40"	"H91"	"Inguinal hernia"	"Other and unspecified hearing loss"	1	6570	4408	10978
"K40"	"I11"	"Inguinal hernia"	"Hypertensive heart disease"	1	746	175	921
"K40"	"I15"	"Inguinal hernia"	"Secondary hypertension"	1	538	179	717
"K40"	"I21"	"Inguinal hernia"	"Acute myocardial infarction"	1	4185	2092	6277
"K40"	"I33"	"Inguinal hernia"	"Acute and subacute endocarditis"	1	272	48	320
"K40"	"I34"	"Inguinal hernia"	"Nonrheumatic mitral valve disorders"	1	1039	326	1365
"K40"	"I38"	"Inguinal hernia"	"Endocarditis, valve unspecified"	1	150	11	161
"K40"	"I45"	"Inguinal hernia"	"Other conduction disorders"	1	590	225	815
"K40"	"I46"	"Inguinal hernia"	"Cardiac arrest"	1	1411	0	1411
"K40"	"I47"	"Inguinal hernia"	"Paroxysmal tachycardia"	1	1575	982	2557
"K40"	"I48"	"Inguinal hernia"	"Atrial fibrillation and flutter"	1	11862	0	11862
"K40"	"I50"	"Inguinal hernia"	"Heart failure"	1	8946	0	8946
"K40"	"I60"	"Inguinal hernia"	"Nontraumatic subarachnoid hemorrhage"	1	237	84	321
"K40"	"I61"	"Inguinal hernia"	"Nontraumatic intracerebral hemorrhage"	1	1092	94	1186
"K40"	"I62"	"Inguinal hernia"	"Other and unspecified nontraumatic intracranial hemorrhage"	1	143	9	152
"K40"	"I65"	"Inguinal hernia"	"Occls and stenosis of precerb art, not rslt in cereb infrc"	1	347	194	541
"K40"	"I67"	"Inguinal hernia"	"Other cerebrovascular diseases"	1	357	88	445
"K40"	"I70"	"Inguinal hernia"	"Atherosclerosis"	1	2380	1128	3508
"K40"	"I71"	"Inguinal hernia"	"Aortic aneurysm and dissection"	1	2334	0	2334
"K40"	"I74"	"Inguinal hernia"	"Arterial embolism and thrombosis"	1	401	128	529
"K40"	"I80"	"Inguinal hernia"	"Phlebitis and thrombophlebitis"	1	1850	695	2545
"K40"	"I89"	"Inguinal hernia"	"Oth noninfective disorders of lymphatic vessels and nodes"	1	207	65	272
"K40"	"I99"	"Inguinal hernia"	"Other and unspecified disorders of circulatory system"	1	242	70	312
"K40"	"J03"	"Inguinal hernia"	"Acute tonsillitis"	1	810	440	1250
"K40"	"J09"	"Inguinal hernia"	"Influenza due to certain identified influenza viruses"	1	125	0	125
"K40"	"J13"	"Inguinal hernia"	"Pneumonia due to Streptococcus pneumoniae"	1	317	84	401
"K40"	"J14"	"Inguinal hernia"	"Pneumonia due to Hemophilus influenzae"	1	196	43	239
"K40"	"J15"	"Inguinal hernia"	"Bacterial pneumonia, not elsewhere classified"	1	4124	0	4124
"K40"	"J17"	"Inguinal hernia"	"Pneumonia in diseases classified elsewhere"	1	84	16	100
"K40"	"J22"	"Inguinal hernia"	"Unspecified acute lower respiratory infection"	1	472	0	472
"K40"	"J38"	"Inguinal hernia"	"Diseases of vocal cords and larynx, not elsewhere classified"	1	412	263	675
"K40"	"J43"	"Inguinal hernia"	"Emphysema"	1	679	202	881
"K40"	"J69"	"Inguinal hernia"	"Pneumonitis due to solids and liquids"	1	546	0	546
"K40"	"J85"	"Inguinal hernia"	"Abscess of lung and mediastinum"	1	148	15	163
"K40"	"J86"	"Inguinal hernia"	"Pyothorax"	1	261	67	328
"K40"	"J90"	"Inguinal hernia"	"Pleural effusion, not elsewhere classified"	1	930	64	994
"K40"	"J92"	"Inguinal hernia"	"Pleural plaque"	1	223	69	292
"K40"	"J96"	"Inguinal hernia"	"Respiratory failure, not elsewhere classified"	1	3720	0	3720
"K40"	"J98"	"Inguinal hernia"	"Other respiratory disorders"	1	755	242	997
"K40"	"K04"	"Inguinal hernia"	"Diseases of pulp and periapical tissues"	1	641	255	896
"K40"	"K05"	"Inguinal hernia"	"Gingivitis and periodontal diseases"	1	579	198	777
"K40"	"K11"	"Inguinal hernia"	"Diseases of salivary glands"	1	291	158	449
"K40"	"K12"	"Inguinal hernia"	"Stomatitis and related lesions"	1	214	92	306
"K40"	"K21"	"Inguinal hernia"	"Gastro-esophageal reflux disease"	1	2067	1475	3542
"K40"	"K27"	"Inguinal hernia"	"Peptic ulcer, site unspecified"	1	350	202	552
"K40"	"K29"	"Inguinal hernia"	"Gastritis and duodenitis"	1	1922	1577	3499
"K40"	"K55"	"Inguinal hernia"	"Vascular disorders of intestine"	1	373	34	407
"K40"	"K56"	"Inguinal hernia"	"Paralytic ileus and intestinal obstruction without hernia"	1	2289	749	3038
"K40"	"K59"	"Inguinal hernia"	"Other functional intestinal disorders"	1	7380	0	7380
"K40"	"K62"	"Inguinal hernia"	"Other diseases of anus and rectum"	1	2846	1107	3953
"K40"	"K63"	"Inguinal hernia"	"Other diseases of intestine"	1	722	79	801
"K40"	"K64"	"Inguinal hernia"	"Hemorrhoids and perianal venous thrombosis"	1	1387	0	1387
"K40"	"K72"	"Inguinal hernia"	"Hepatic failure, not elsewhere classified"	1	377	70	447
"K40"	"K74"	"Inguinal hernia"	"Fibrosis and cirrhosis of liver"	1	374	160	534
"K40"	"K76"	"Inguinal hernia"	"Other diseases of liver"	1	529	195	724
"K40"	"K82"	"Inguinal hernia"	"Other diseases of gallbladder"	1	67	17	84
"K40"	"K90"	"Inguinal hernia"	"Intestinal malabsorption"	1	182	83	265
"K40"	"K91"	"Inguinal hernia"	"Intraop and postproc comp and disorders of dgstv sys, NEC"	1	501	104	605
"K40"	"K92"	"Inguinal hernia"	"Other diseases of digestive system"	1	2460	560	3020
"K40"	"L02"	"Inguinal hernia"	"Cutaneous abscess, furuncle and carbuncle"	1	1744	1080	2824
"K40"	"L12"	"Inguinal hernia"	"Pemphigoid"	1	64	4	68
"K40"	"L50"	"Inguinal hernia"	"Urticaria"	1	433	285	718
"K40"	"L60"	"Inguinal hernia"	"Nail disorders"	1	241	123	364
"K40"	"L82"	"Inguinal hernia"	"Seborrheic keratosis"	1	352	61	413
"K40"	"L89"	"Inguinal hernia"	"Pressure ulcer"	1	626	5	631
"K40"	"L97"	"Inguinal hernia"	"Non-pressure chronic ulcer of lower limb, NEC"	1	880	69	949
"K40"	"M07"	"Inguinal hernia"	"Enteropathic arthropathies"	1	178	71	249
"K40"	"M16"	"Inguinal hernia"	"Osteoarthritis of hip"	1	3490	1873	5363
"K40"	"M18"	"Inguinal hernia"	"Osteoarthritis of first carpometacarpal joint"	1	309	117	426
"K40"	"M21"	"Inguinal hernia"	"Other acquired deformities of limbs"	1	534	264	798
"K40"	"M35"	"Inguinal hernia"	"Other systemic involvement of connective tissue"	1	821	312	1133
"K40"	"M41"	"Inguinal hernia"	"Scoliosis"	1	334	98	432
"K40"	"M46"	"Inguinal hernia"	"Other inflammatory spondylopathies"	1	207	46	253
"K40"	"M47"	"Inguinal hernia"	"Spondylosis"	1	1495	827	2322
"K40"	"M48"	"Inguinal hernia"	"Other spondylopathies"	1	2057	557	2614
"K40"	"M53"	"Inguinal hernia"	"Other and unspecified dorsopathies, not elsewhere classified"	1	467	235	702
"K40"	"M65"	"Inguinal hernia"	"Synovitis and tenosynovitis"	1	1197	937	2134
"K40"	"M66"	"Inguinal hernia"	"Spontaneous rupture of synovium and tendon"	1	191	77	268
"K40"	"M75"	"Inguinal hernia"	"Shoulder lesions"	1	3855	1959	5814
"K40"	"M76"	"Inguinal hernia"	"Enthesopathies, lower limb, excluding foot"	1	731	427	1158
"K40"	"M79"	"Inguinal hernia"	"Oth and unsp soft tissue disorders, not elsewhere classified"	1	3884	1962	5846
"K40"	"M81"	"Inguinal hernia"	"Osteoporosis without current pathological fracture"	1	3059	0	3059
"K40"	"M84"	"Inguinal hernia"	"Disorder of continuity of bone"	1	166	81	247
"K40"	"M87"	"Inguinal hernia"	"Osteonecrosis"	1	93	29	122
"K40"	"M99"	"Inguinal hernia"	"Biomechanical lesions, not elsewhere classified"	1	406	132	538
"K40"	"N15"	"Inguinal hernia"	"Other renal tubulo-interstitial diseases"	1	85	25	110
"K40"	"N17"	"Inguinal hernia"	"Acute kidney failure"	1	1144	27	1171
"K40"	"N19"	"Inguinal hernia"	"Unspecified kidney failure"	1	1316	164	1480
"K40"	"N21"	"Inguinal hernia"	"Calculus of lower urinary tract"	1	396	189	585
"K40"	"N25"	"Inguinal hernia"	"Disorders resulting from impaired renal tubular function"	1	72	16	88
"K40"	"N35"	"Inguinal hernia"	"Urethral stricture"	1	486	330	816
"K40"	"N39"	"Inguinal hernia"	"Other disorders of urinary system"	1	4997	0	4997
"K40"	"N45"	"Inguinal hernia"	"Orchitis and epididymitis"	1	1064	759	1823
"K40"	"Q17"	"Inguinal hernia"	"Other congenital malformations of ear"	1	117	48	165
"K40"	"Q67"	"Inguinal hernia"	"Congenital ms deformities of head, face, spine and chest"	1	116	42	158
"K41"	"C77"	"Femoral hernia"	"Secondary and unspecified malignant neoplasm of lymph nodes"	1	57	11	68
"K41"	"C78"	"Femoral hernia"	"Secondary malignant neoplasm of resp and digestive organs"	1	117	8	125
"K41"	"E86"	"Femoral hernia"	"Volume depletion"	1	379	112	491
"K41"	"I48"	"Femoral hernia"	"Atrial fibrillation and flutter"	1	382	234	616
"K41"	"I63"	"Femoral hernia"	"Cerebral infarction"	1	166	47	213
"K41"	"J15"	"Femoral hernia"	"Bacterial pneumonia, not elsewhere classified"	1	240	35	275
"K41"	"N18"	"Femoral hernia"	"Chronic kidney disease (CKD)"	1	78	10	88
"K42"	"A41"	"Umbilical hernia"	"Other sepsis"	1	1199	200	1399
"K42"	"C16"	"Umbilical hernia"	"Malignant neoplasm of stomach"	1	110	3	113
"K42"	"C34"	"Umbilical hernia"	"Malignant neoplasm of bronchus and lung"	1	444	3	447
"K42"	"C44"	"Umbilical hernia"	"Other and unspecified malignant neoplasm of skin"	1	375	129	504
"K42"	"C64"	"Umbilical hernia"	"Malignant neoplasm of kidney, except renal pelvis"	1	104	18	122
"K42"	"C77"	"Umbilical hernia"	"Secondary and unspecified malignant neoplasm of lymph nodes"	1	171	43	214
"K42"	"C78"	"Umbilical hernia"	"Secondary malignant neoplasm of resp and digestive organs"	1	491	34	525
"K42"	"C79"	"Umbilical hernia"	"Secondary malignant neoplasm of other and unspecified sites"	1	327	1	328
"K42"	"C80"	"Umbilical hernia"	"Malignant neoplasm without specification of site"	1	63	1	64
"K42"	"C83"	"Umbilical hernia"	"Non-follicular lymphoma"	1	87	19	106
"K42"	"D09"	"Umbilical hernia"	"Carcinoma in situ of other and unspecified sites"	1	63	9	72
"K42"	"D46"	"Umbilical hernia"	"Myelodysplastic syndromes"	1	40	4	44
"K42"	"D63"	"Umbilical hernia"	"Anemia in chronic diseases classified elsewhere"	1	217	24	241
"K42"	"E27"	"Umbilical hernia"	"Other disorders of adrenal gland"	1	59	13	72
"K42"	"E78"	"Umbilical hernia"	"Disorders of lipoprotein metabolism and other lipidemias"	1	1307	958	2265
"K42"	"E83"	"Umbilical hernia"	"Disorders of mineral metabolism"	1	145	35	180
"K42"	"F41"	"Umbilical hernia"	"Other anxiety disorders"	1	218	118	336
"K42"	"G20"	"Umbilical hernia"	"Parkinson's disease"	1	114	22	136
"K42"	"G30"	"Umbilical hernia"	"Alzheimer's disease"	1	68	0	68
"K42"	"G62"	"Umbilical hernia"	"Other and unspecified polyneuropathies"	1	251	123	374
"K42"	"G63"	"Umbilical hernia"	"Polyneuropathy in diseases classified elsewhere"	1	54	12	66
"K42"	"G95"	"Umbilical hernia"	"Other and unspecified diseases of spinal cord"	1	96	11	107
"K42"	"G96"	"Umbilical hernia"	"Other disorders of central nervous system"	1	306	43	349
"K42"	"H25"	"Umbilical hernia"	"Age-related cataract"	1	1346	586	1932
"K42"	"H26"	"Umbilical hernia"	"Other cataract"	1	339	193	532
"K42"	"H35"	"Umbilical hernia"	"Other retinal disorders"	1	412	239	651
"K42"	"I35"	"Umbilical hernia"	"Nonrheumatic aortic valve disorders"	1	544	104	648
"K42"	"I42"	"Umbilical hernia"	"Cardiomyopathy"	1	202	105	307
"K42"	"I46"	"Umbilical hernia"	"Cardiac arrest"	1	329	4	333
"K42"	"I48"	"Umbilical hernia"	"Atrial fibrillation and flutter"	1	1653	624	2277
"K42"	"I61"	"Umbilical hernia"	"Nontraumatic intracerebral hemorrhage"	1	171	39	210
"K42"	"I69"	"Umbilical hernia"	"Sequelae of cerebrovascular disease"	1	695	247	942
"K42"	"I95"	"Umbilical hernia"	"Hypotension"	1	214	42	256
"K42"	"J18"	"Umbilical hernia"	"Pneumonia, unspecified organism"	1	2147	1046	3193
"K42"	"J84"	"Umbilical hernia"	"Other interstitial pulmonary diseases"	1	110	34	144
"K42"	"J90"	"Umbilical hernia"	"Pleural effusion, not elsewhere classified"	1	211	37	248
"K42"	"J96"	"Umbilical hernia"	"Respiratory failure, not elsewhere classified"	1	1073	149	1222
"K42"	"K52"	"Umbilical hernia"	"Other and unsp noninfective gastroenteritis and colitis"	1	424	277	701
"K42"	"K56"	"Umbilical hernia"	"Paralytic ileus and intestinal obstruction without hernia"	1	655	406	1061
"K42"	"K59"	"Umbilical hernia"	"Other functional intestinal disorders"	1	1662	811	2473
"K42"	"K72"	"Umbilical hernia"	"Hepatic failure, not elsewhere classified"	1	339	144	483
"K42"	"K83"	"Umbilical hernia"	"Other diseases of biliary tract"	1	140	68	208
"K42"	"L89"	"Umbilical hernia"	"Pressure ulcer"	1	172	28	200
"K42"	"M48"	"Umbilical hernia"	"Other spondylopathies"	1	462	231	693
"K42"	"M85"	"Umbilical hernia"	"Other disorders of bone density and structure"	1	290	85	375
"K42"	"N18"	"Umbilical hernia"	"Chronic kidney disease (CKD)"	1	556	156	712
"K42"	"N30"	"Umbilical hernia"	"Cystitis"	1	1137	612	1749
"K42"	"N39"	"Umbilical hernia"	"Other disorders of urinary system"	1	1081	377	1458
"K43"	"A41"	"Ventral hernia"	"Other sepsis"	1	1739	630	2369
"K43"	"A46"	"Ventral hernia"	"Erysipelas"	1	685	336	1021
"K43"	"C44"	"Ventral hernia"	"Other and unspecified malignant neoplasm of skin"	1	503	211	714
"K43"	"C71"	"Ventral hernia"	"Malignant neoplasm of brain"	1	79	8	87
"K43"	"C77"	"Ventral hernia"	"Secondary and unspecified malignant neoplasm of lymph nodes"	1	274	132	406
"K43"	"C78"	"Ventral hernia"	"Secondary malignant neoplasm of resp and digestive organs"	1	1164	459	1623
"K43"	"C79"	"Ventral hernia"	"Secondary malignant neoplasm of other and unspecified sites"	1	678	64	742
"K43"	"C92"	"Ventral hernia"	"Myeloid leukemia"	1	64	10	74
"K43"	"D46"	"Ventral hernia"	"Myelodysplastic syndromes"	1	59	5	64
"K43"	"E16"	"Ventral hernia"	"Other disorders of pancreatic internal secretion"	1	192	70	262
"K43"	"E68"	"Ventral hernia"	"Sequelae of hyperalimentation"	1	214	119	333
"K43"	"G95"	"Ventral hernia"	"Other and unspecified diseases of spinal cord"	1	163	32	195
"K43"	"G96"	"Ventral hernia"	"Other disorders of central nervous system"	1	301	57	358
"K43"	"I26"	"Ventral hernia"	"Pulmonary embolism"	1	524	300	824
"K43"	"I35"	"Ventral hernia"	"Nonrheumatic aortic valve disorders"	1	724	222	946
"K43"	"I50"	"Ventral hernia"	"Heart failure"	1	1984	898	2882
"K43"	"I61"	"Ventral hernia"	"Nontraumatic intracerebral hemorrhage"	1	296	53	349
"K43"	"I63"	"Ventral hernia"	"Cerebral infarction"	1	1052	343	1395
"K43"	"I69"	"Ventral hernia"	"Sequelae of cerebrovascular disease"	1	1051	413	1464
"K43"	"J18"	"Ventral hernia"	"Pneumonia, unspecified organism"	1	3263	1560	4823
"K43"	"J81"	"Ventral hernia"	"Pulmonary edema"	1	246	40	286
"K43"	"K59"	"Ventral hernia"	"Other functional intestinal disorders"	1	2490	1688	4178
"K43"	"K92"	"Ventral hernia"	"Other diseases of digestive system"	1	763	554	1317
"K43"	"L98"	"Ventral hernia"	"Oth disorders of skin, subcu, not elsewhere classified"	1	468	260	728
"K43"	"M81"	"Ventral hernia"	"Osteoporosis without current pathological fracture"	1	1138	456	1594
"K43"	"N30"	"Ventral hernia"	"Cystitis"	1	1973	1245	3218
"K44"	"A41"	"Diaphragmatic hernia"	"Other sepsis"	1	3131	0	3131
"K44"	"A49"	"Diaphragmatic hernia"	"Bacterial infection of unspecified site"	1	1171	143	1314
"K44"	"C15"	"Diaphragmatic hernia"	"Malignant neoplasm of esophagus"	1	407	72	479
"K44"	"C64"	"Diaphragmatic hernia"	"Malignant neoplasm of kidney, except renal pelvis"	1	215	53	268
"K44"	"C71"	"Diaphragmatic hernia"	"Malignant neoplasm of brain"	1	161	7	168
"K44"	"C79"	"Diaphragmatic hernia"	"Secondary malignant neoplasm of other and unspecified sites"	1	851	27	878
"K44"	"D09"	"Diaphragmatic hernia"	"Carcinoma in situ of other and unspecified sites"	1	81	5	86
"K44"	"D32"	"Diaphragmatic hernia"	"Benign neoplasm of meninges"	1	96	31	127
"K44"	"D63"	"Diaphragmatic hernia"	"Anemia in chronic diseases classified elsewhere"	1	809	117	926
"K44"	"D64"	"Diaphragmatic hernia"	"Other anemias"	1	3861	2263	6124
"K44"	"E46"	"Diaphragmatic hernia"	"Unspecified protein-calorie malnutrition"	1	92	5	97
"K44"	"E53"	"Diaphragmatic hernia"	"Deficiency of other B group vitamins"	1	185	58	243
"K44"	"E61"	"Diaphragmatic hernia"	"Deficiency of other nutrient elements"	1	108	10	118
"K44"	"E64"	"Diaphragmatic hernia"	"Sequelae of malnutrition and other nutritional deficiencies"	1	528	147	675
"K44"	"E86"	"Diaphragmatic hernia"	"Volume depletion"	1	4590	0	4590
"K44"	"E87"	"Diaphragmatic hernia"	"Other disorders of fluid, electrolyte and acid-base balance"	1	2111	400	2511
"K44"	"F33"	"Diaphragmatic hernia"	"Major depressive disorder, recurrent"	1	897	238	1135
"K44"	"F34"	"Diaphragmatic hernia"	"Persistent mood [affective] disorders"	1	163	70	233
"K44"	"G91"	"Diaphragmatic hernia"	"Hydrocephalus"	1	98	37	135
"K44"	"H35"	"Diaphragmatic hernia"	"Other retinal disorders"	1	1349	668	2017
"K44"	"H43"	"Diaphragmatic hernia"	"Disorders of vitreous body"	1	328	187	515
"K44"	"H57"	"Diaphragmatic hernia"	"Other disorders of eye and adnexa"	1	182	85	267
"K44"	"I42"	"Diaphragmatic hernia"	"Cardiomyopathy"	1	393	163	556
"K44"	"I44"	"Diaphragmatic hernia"	"Atrioventricular and left bundle-branch block"	1	543	197	740
"K44"	"I63"	"Diaphragmatic hernia"	"Cerebral infarction"	1	1770	716	2486
"K44"	"I70"	"Diaphragmatic hernia"	"Atherosclerosis"	1	1242	958	2200
"K44"	"I73"	"Diaphragmatic hernia"	"Other peripheral vascular diseases"	1	986	472	1458
"K44"	"I89"	"Diaphragmatic hernia"	"Oth noninfective disorders of lymphatic vessels and nodes"	1	175	43	218
"K44"	"J22"	"Diaphragmatic hernia"	"Unspecified acute lower respiratory infection"	1	268	23	291
"K44"	"J90"	"Diaphragmatic hernia"	"Pleural effusion, not elsewhere classified"	1	538	106	644
"K44"	"K05"	"Diaphragmatic hernia"	"Gingivitis and periodontal diseases"	1	311	179	490
"K44"	"K42"	"Diaphragmatic hernia"	"Umbilical hernia"	1	577	405	982
"K44"	"K43"	"Diaphragmatic hernia"	"Ventral hernia"	1	1007	663	1670
"K44"	"K55"	"Diaphragmatic hernia"	"Vascular disorders of intestine"	1	479	141	620
"K44"	"K56"	"Diaphragmatic hernia"	"Paralytic ileus and intestinal obstruction without hernia"	1	1285	474	1759
"K44"	"K62"	"Diaphragmatic hernia"	"Other diseases of anus and rectum"	1	1839	1419	3258
"K44"	"K64"	"Diaphragmatic hernia"	"Hemorrhoids and perianal venous thrombosis"	1	1318	116	1434
"K44"	"K81"	"Diaphragmatic hernia"	"Cholecystitis"	1	584	326	910
"K44"	"K86"	"Diaphragmatic hernia"	"Other diseases of pancreas"	1	604	367	971
"K44"	"L30"	"Diaphragmatic hernia"	"Other and unspecified dermatitis"	1	336	208	544
"K44"	"L98"	"Diaphragmatic hernia"	"Oth disorders of skin, subcu, not elsewhere classified"	1	478	215	693
"K44"	"M15"	"Diaphragmatic hernia"	"Polyosteoarthritis"	1	432	264	696
"K44"	"M81"	"Diaphragmatic hernia"	"Osteoporosis without current pathological fracture"	1	2864	1241	4105
"K44"	"M85"	"Diaphragmatic hernia"	"Other disorders of bone density and structure"	1	1269	393	1662
"K45"	"A49"	"Other abdominal hernia"	"Bacterial infection of unspecified site"	1	125	36	161
"K45"	"I48"	"Other abdominal hernia"	"Atrial fibrillation and flutter"	1	351	192	543
"K45"	"I50"	"Other abdominal hernia"	"Heart failure"	1	278	135	413
"K45"	"I69"	"Other abdominal hernia"	"Sequelae of cerebrovascular disease"	1	161	80	241
"K45"	"J15"	"Other abdominal hernia"	"Bacterial pneumonia, not elsewhere classified"	1	207	60	267
"K45"	"N18"	"Other abdominal hernia"	"Chronic kidney disease (CKD)"	1	121	40	161
"K50"	"A04"	"Crohn's disease [regional enteritis]"	"Other bacterial intestinal infections"	1	410	270	680
"K50"	"A49"	"Crohn's disease [regional enteritis]"	"Bacterial infection of unspecified site"	1	325	53	378
"K50"	"C34"	"Crohn's disease [regional enteritis]"	"Malignant neoplasm of bronchus and lung"	1	187	5	192
"K50"	"C44"	"Crohn's disease [regional enteritis]"	"Other and unspecified malignant neoplasm of skin"	1	169	15	184
"K50"	"C77"	"Crohn's disease [regional enteritis]"	"Secondary and unspecified malignant neoplasm of lymph nodes"	1	61	7	68
"K50"	"C78"	"Crohn's disease [regional enteritis]"	"Secondary malignant neoplasm of resp and digestive organs"	1	233	23	256
"K50"	"E61"	"Crohn's disease [regional enteritis]"	"Deficiency of other nutrient elements"	1	54	9	63
"K50"	"E64"	"Crohn's disease [regional enteritis]"	"Sequelae of malnutrition and other nutritional deficiencies"	1	231	51	282
"K50"	"E83"	"Crohn's disease [regional enteritis]"	"Disorders of mineral metabolism"	1	124	3	127
"K50"	"F33"	"Crohn's disease [regional enteritis]"	"Major depressive disorder, recurrent"	1	161	49	210
"K50"	"G98"	"Crohn's disease [regional enteritis]"	"Other disorders of nervous system not elsewhere classified"	1	53	13	66
"K50"	"I50"	"Crohn's disease [regional enteritis]"	"Heart failure"	1	396	250	646
"K50"	"I82"	"Crohn's disease [regional enteritis]"	"Other venous embolism and thrombosis"	1	92	34	126
"K50"	"J15"	"Crohn's disease [regional enteritis]"	"Bacterial pneumonia, not elsewhere classified"	1	444	103	547
"K50"	"J47"	"Crohn's disease [regional enteritis]"	"Bronchiectasis"	1	57	5	62
"K50"	"J90"	"Crohn's disease [regional enteritis]"	"Pleural effusion, not elsewhere classified"	1	85	17	102
"K50"	"K43"	"Crohn's disease [regional enteritis]"	"Ventral hernia"	1	595	112	707
"K50"	"K63"	"Crohn's disease [regional enteritis]"	"Other diseases of intestine"	1	656	366	1022
"K50"	"K72"	"Crohn's disease [regional enteritis]"	"Hepatic failure, not elsewhere classified"	1	82	12	94
"K50"	"K85"	"Crohn's disease [regional enteritis]"	"Acute pancreatitis"	1	259	140	399
"K50"	"K91"	"Crohn's disease [regional enteritis]"	"Intraop and postproc comp and disorders of dgstv sys, NEC"	1	718	77	795
"K50"	"L02"	"Crohn's disease [regional enteritis]"	"Cutaneous abscess, furuncle and carbuncle"	1	476	267	743
"K50"	"L21"	"Crohn's disease [regional enteritis]"	"Seborrheic dermatitis"	1	124	28	152
"K50"	"L40"	"Crohn's disease [regional enteritis]"	"Psoriasis"	1	198	79	277
"K50"	"L73"	"Crohn's disease [regional enteritis]"	"Other follicular disorders"	1	124	46	170
"K50"	"L88"	"Crohn's disease [regional enteritis]"	"Pyoderma gangrenosum"	1	81	22	103
"K50"	"L98"	"Crohn's disease [regional enteritis]"	"Oth disorders of skin, subcu, not elsewhere classified"	1	265	49	314
"K50"	"M25"	"Crohn's disease [regional enteritis]"	"Other joint disorder, not elsewhere classified"	1	610	196	806
"K50"	"M75"	"Crohn's disease [regional enteritis]"	"Shoulder lesions"	1	384	201	585
"K50"	"M81"	"Crohn's disease [regional enteritis]"	"Osteoporosis without current pathological fracture"	1	703	105	808
"K50"	"N13"	"Crohn's disease [regional enteritis]"	"Obstructive and reflux uropathy"	1	182	54	236
"K50"	"N19"	"Crohn's disease [regional enteritis]"	"Unspecified kidney failure"	1	173	42	215
"K50"	"N82"	"Crohn's disease [regional enteritis]"	"Fistulae involving female genital tract"	1	123	43	166
"K50"	"N97"	"Crohn's disease [regional enteritis]"	"Female infertility"	1	228	105	333
"K50"	"O34"	"Crohn's disease [regional enteritis]"	"Maternal care for abnormality of pelvic organs"	1	123	29	152
"K50"	"O72"	"Crohn's disease [regional enteritis]"	"Postpartum hemorrhage"	1	678	97	775
"K50"	"O92"	"Crohn's disease [regional enteritis]"	"Oth disord of brst/lactatn assoc w pregnancy and the puerp"	1	84	21	105
"K50"	"O99"	"Crohn's disease [regional enteritis]"	"Oth maternal diseases classd elsw but compl preg/chldbrth"	1	1062	348	1410
"K51"	"B02"	"Ulcerative colitis"	"Zoster [herpes zoster]"	1	117	32	149
"K51"	"C15"	"Ulcerative colitis"	"Malignant neoplasm of esophagus"	1	44	0	44
"K51"	"C16"	"Ulcerative colitis"	"Malignant neoplasm of stomach"	1	55	7	62
"K51"	"C24"	"Ulcerative colitis"	"Malignant neoplasm of other and unsp parts of biliary tract"	1	48	0	48
"K51"	"C25"	"Ulcerative colitis"	"Malignant neoplasm of pancreas"	1	123	7	130
"K51"	"C61"	"Ulcerative colitis"	"Malignant neoplasm of prostate"	1	198	74	272
"K51"	"C77"	"Ulcerative colitis"	"Secondary and unspecified malignant neoplasm of lymph nodes"	1	141	19	160
"K51"	"C78"	"Ulcerative colitis"	"Secondary malignant neoplasm of resp and digestive organs"	1	409	12	421
"K51"	"C83"	"Ulcerative colitis"	"Non-follicular lymphoma"	1	55	11	66
"K51"	"D62"	"Ulcerative colitis"	"Acute posthemorrhagic anemia"	1	209	87	296
"K51"	"D64"	"Ulcerative colitis"	"Other anemias"	1	1107	472	1579
"K51"	"D72"	"Ulcerative colitis"	"Other disorders of white blood cells"	1	55	13	68
"K51"	"E03"	"Ulcerative colitis"	"Other hypothyroidism"	1	343	171	514
"K51"	"E64"	"Ulcerative colitis"	"Sequelae of malnutrition and other nutritional deficiencies"	1	266	39	305
"K51"	"E66"	"Ulcerative colitis"	"Overweight and obesity"	1	919	449	1368
"K51"	"E68"	"Ulcerative colitis"	"Sequelae of hyperalimentation"	1	46	9	55
"K51"	"E86"	"Ulcerative colitis"	"Volume depletion"	1	1874	318	2192
"K51"	"E87"	"Ulcerative colitis"	"Other disorders of fluid, electrolyte and acid-base balance"	1	743	138	881
"K51"	"F41"	"Ulcerative colitis"	"Other anxiety disorders"	1	265	69	334
"K51"	"G47"	"Ulcerative colitis"	"Sleep disorders"	1	458	60	518
"K51"	"G56"	"Ulcerative colitis"	"Mononeuropathies of upper limb"	1	436	231	667
"K51"	"G95"	"Ulcerative colitis"	"Other and unspecified diseases of spinal cord"	1	53	11	64
"K51"	"G96"	"Ulcerative colitis"	"Other disorders of central nervous system"	1	230	25	255
"K51"	"G98"	"Ulcerative colitis"	"Other disorders of nervous system not elsewhere classified"	1	103	5	108
"K51"	"H25"	"Ulcerative colitis"	"Age-related cataract"	1	1306	540	1846
"K51"	"H26"	"Ulcerative colitis"	"Other cataract"	1	391	150	541
"K51"	"H36"	"Ulcerative colitis"	"Retinal disorders in diseases classified elsewhere"	1	161	47	208
"K51"	"H43"	"Ulcerative colitis"	"Disorders of vitreous body"	1	131	48	179
"K51"	"H53"	"Ulcerative colitis"	"Visual disturbances"	1	176	65	241
"K51"	"H90"	"Ulcerative colitis"	"Conductive and sensorineural hearing loss"	1	248	146	394
"K51"	"I26"	"Ulcerative colitis"	"Pulmonary embolism"	1	397	115	512
"K51"	"I35"	"Ulcerative colitis"	"Nonrheumatic aortic valve disorders"	1	400	88	488
"K51"	"I46"	"Ulcerative colitis"	"Cardiac arrest"	1	242	7	249
"K51"	"I48"	"Ulcerative colitis"	"Atrial fibrillation and flutter"	1	1248	522	1770
"K51"	"I50"	"Ulcerative colitis"	"Heart failure"	1	938	429	1367
"K51"	"I63"	"Ulcerative colitis"	"Cerebral infarction"	1	535	235	770
"K51"	"I69"	"Ulcerative colitis"	"Sequelae of cerebrovascular disease"	1	571	261	832
"K51"	"I71"	"Ulcerative colitis"	"Aortic aneurysm and dissection"	1	191	74	265
"K51"	"I89"	"Ulcerative colitis"	"Oth noninfective disorders of lymphatic vessels and nodes"	1	66	12	78
"K51"	"J15"	"Ulcerative colitis"	"Bacterial pneumonia, not elsewhere classified"	1	829	122	951
"K51"	"J18"	"Ulcerative colitis"	"Pneumonia, unspecified organism"	1	2125	741	2866
"K51"	"J81"	"Ulcerative colitis"	"Pulmonary edema"	1	114	21	135
"K51"	"J91"	"Ulcerative colitis"	"Pleural effusion in conditions classified elsewhere"	1	67	9	76
"K51"	"J96"	"Ulcerative colitis"	"Respiratory failure, not elsewhere classified"	1	838	112	950
"K51"	"K04"	"Ulcerative colitis"	"Diseases of pulp and periapical tissues"	1	126	57	183
"K51"	"K22"	"Ulcerative colitis"	"Other diseases of esophagus"	1	234	100	334
"K51"	"K43"	"Ulcerative colitis"	"Ventral hernia"	1	733	152	885
"K51"	"K50"	"Ulcerative colitis"	"Crohn's disease [regional enteritis]"	1	3015	1846	4861
"K51"	"K56"	"Ulcerative colitis"	"Paralytic ileus and intestinal obstruction without hernia"	1	1501	289	1790
"K51"	"K63"	"Ulcerative colitis"	"Other diseases of intestine"	1	709	338	1047
"K51"	"K72"	"Ulcerative colitis"	"Hepatic failure, not elsewhere classified"	1	131	16	147
"K51"	"K81"	"Ulcerative colitis"	"Cholecystitis"	1	167	85	252
"K51"	"K83"	"Ulcerative colitis"	"Other diseases of biliary tract"	1	413	151	564
"K51"	"L21"	"Ulcerative colitis"	"Seborrheic dermatitis"	1	112	34	146
"K51"	"L30"	"Ulcerative colitis"	"Other and unspecified dermatitis"	1	395	103	498
"K51"	"L90"	"Ulcerative colitis"	"Atrophic disorders of skin"	1	270	73	343
"K51"	"M13"	"Ulcerative colitis"	"Other arthritis"	1	330	119	449
"K51"	"M17"	"Ulcerative colitis"	"Osteoarthritis of knee"	1	677	357	1034
"K51"	"M18"	"Ulcerative colitis"	"Osteoarthritis of first carpometacarpal joint"	1	119	30	149
"K51"	"M19"	"Ulcerative colitis"	"Other and unspecified osteoarthritis"	1	559	173	732
"K51"	"M48"	"Ulcerative colitis"	"Other spondylopathies"	1	426	141	567
"K51"	"M79"	"Ulcerative colitis"	"Oth and unsp soft tissue disorders, not elsewhere classified"	1	906	648	1554
"K51"	"N13"	"Ulcerative colitis"	"Obstructive and reflux uropathy"	1	215	65	280
"K51"	"N18"	"Ulcerative colitis"	"Chronic kidney disease (CKD)"	1	543	53	596
"K51"	"N20"	"Ulcerative colitis"	"Calculus of kidney and ureter"	1	487	219	706
"K51"	"O82"	"Ulcerative colitis"	"Encounter for cesarean delivery without indication"	1	638	434	1072
"K51"	"O99"	"Ulcerative colitis"	"Oth maternal diseases classd elsw but compl preg/chldbrth"	1	1656	703	2359
"K52"	"A04"	"Other and unsp noninfective gastroenteritis and colitis"	"Other bacterial intestinal infections"	1	1626	1254	2880
"K52"	"A41"	"Other and unsp noninfective gastroenteritis and colitis"	"Other sepsis"	1	3206	1840	5046
"K52"	"A49"	"Other and unsp noninfective gastroenteritis and colitis"	"Bacterial infection of unspecified site"	1	1545	791	2336
"K52"	"C79"	"Other and unsp noninfective gastroenteritis and colitis"	"Secondary malignant neoplasm of other and unspecified sites"	1	603	429	1032
"K52"	"D63"	"Other and unsp noninfective gastroenteritis and colitis"	"Anemia in chronic diseases classified elsewhere"	1	781	551	1332
"K52"	"E34"	"Other and unsp noninfective gastroenteritis and colitis"	"Other endocrine disorders"	1	239	138	377
"K52"	"F05"	"Other and unsp noninfective gastroenteritis and colitis"	"Delirium due to known physiological condition"	1	762	285	1047
"K52"	"F33"	"Other and unsp noninfective gastroenteritis and colitis"	"Major depressive disorder, recurrent"	1	861	598	1459
"K52"	"G47"	"Other and unsp noninfective gastroenteritis and colitis"	"Sleep disorders"	1	1157	496	1653
"K52"	"I95"	"Other and unsp noninfective gastroenteritis and colitis"	"Hypotension"	1	738	545	1283
"K52"	"K90"	"Other and unsp noninfective gastroenteritis and colitis"	"Intestinal malabsorption"	1	950	713	1663
"K52"	"L98"	"Other and unsp noninfective gastroenteritis and colitis"	"Oth disorders of skin, subcu, not elsewhere classified"	1	541	351	892
"K52"	"M85"	"Other and unsp noninfective gastroenteritis and colitis"	"Other disorders of bone density and structure"	1	837	579	1416
"K56"	"E86"	"Paralytic ileus and intestinal obstruction without hernia"	"Volume depletion"	1	4302	3739	8041
"K56"	"G47"	"Paralytic ileus and intestinal obstruction without hernia"	"Sleep disorders"	1	1019	458	1477
"K56"	"J09"	"Paralytic ileus and intestinal obstruction without hernia"	"Influenza due to certain identified influenza viruses"	1	56	11	67
"K56"	"K64"	"Paralytic ileus and intestinal obstruction without hernia"	"Hemorrhoids and perianal venous thrombosis"	1	326	72	398
"K56"	"K91"	"Paralytic ileus and intestinal obstruction without hernia"	"Intraop and postproc comp and disorders of dgstv sys, NEC"	1	2235	1723	3958
"K57"	"A04"	"Diverticular disease of intestine"	"Other bacterial intestinal infections"	1	1181	443	1624
"K57"	"C15"	"Diverticular disease of intestine"	"Malignant neoplasm of esophagus"	1	286	60	346
"K57"	"C16"	"Diverticular disease of intestine"	"Malignant neoplasm of stomach"	1	416	137	553
"K57"	"C25"	"Diverticular disease of intestine"	"Malignant neoplasm of pancreas"	1	848	92	940
"K57"	"C34"	"Diverticular disease of intestine"	"Malignant neoplasm of bronchus and lung"	1	2389	490	2879
"K57"	"C44"	"Diverticular disease of intestine"	"Other and unspecified malignant neoplasm of skin"	1	1530	1255	2785
"K57"	"C45"	"Diverticular disease of intestine"	"Mesothelioma"	1	58	10	68
"K57"	"C77"	"Diverticular disease of intestine"	"Secondary and unspecified malignant neoplasm of lymph nodes"	1	708	335	1043
"K57"	"C83"	"Diverticular disease of intestine"	"Non-follicular lymphoma"	1	319	189	508
"K57"	"E13"	"Diverticular disease of intestine"	"Other specified diabetes mellitus"	1	240	95	335
"K57"	"E83"	"Diverticular disease of intestine"	"Disorders of mineral metabolism"	1	647	205	852
"K57"	"F05"	"Diverticular disease of intestine"	"Delirium due to known physiological condition"	1	1377	97	1474
"K57"	"F32"	"Diverticular disease of intestine"	"Depressive episode"	1	1982	1409	3391
"K57"	"G20"	"Diverticular disease of intestine"	"Parkinson's disease"	1	540	285	825
"K57"	"G23"	"Diverticular disease of intestine"	"Other degenerative diseases of basal ganglia"	1	61	10	71
"K57"	"G30"	"Diverticular disease of intestine"	"Alzheimer's disease"	1	780	49	829
"K57"	"G31"	"Diverticular disease of intestine"	"Oth degenerative diseases of nervous system, NEC"	1	257	108	365
"K57"	"G47"	"Diverticular disease of intestine"	"Sleep disorders"	1	1641	1144	2785
"K57"	"G95"	"Diverticular disease of intestine"	"Other and unspecified diseases of spinal cord"	1	318	118	436
"K57"	"I26"	"Diverticular disease of intestine"	"Pulmonary embolism"	1	1451	940	2391
"K57"	"I61"	"Diverticular disease of intestine"	"Nontraumatic intracerebral hemorrhage"	1	983	316	1299
"K57"	"I63"	"Diverticular disease of intestine"	"Cerebral infarction"	1	2821	2164	4985
"K57"	"I95"	"Diverticular disease of intestine"	"Hypotension"	1	1246	446	1692
"K57"	"J06"	"Diverticular disease of intestine"	"Acute upper resp infections of multiple and unsp sites"	1	234	112	346
"K57"	"J15"	"Diverticular disease of intestine"	"Bacterial pneumonia, not elsewhere classified"	1	5481	0	5481
"K57"	"J18"	"Diverticular disease of intestine"	"Pneumonia, unspecified organism"	1	10130	5808	15938
"K57"	"J22"	"Diverticular disease of intestine"	"Unspecified acute lower respiratory infection"	1	498	143	641
"K57"	"J47"	"Diverticular disease of intestine"	"Bronchiectasis"	1	261	137	398
"K57"	"J84"	"Diverticular disease of intestine"	"Other interstitial pulmonary diseases"	1	510	352	862
"K57"	"J96"	"Diverticular disease of intestine"	"Respiratory failure, not elsewhere classified"	1	5361	0	5361
"K57"	"K56"	"Diverticular disease of intestine"	"Paralytic ileus and intestinal obstruction without hernia"	1	3872	2953	6825
"K57"	"K91"	"Diverticular disease of intestine"	"Intraop and postproc comp and disorders of dgstv sys, NEC"	1	1021	323	1344
"K57"	"N13"	"Diverticular disease of intestine"	"Obstructive and reflux uropathy"	1	1065	754	1819
"K57"	"N39"	"Diverticular disease of intestine"	"Other disorders of urinary system"	1	5631	3556	9187
"K58"	"A41"	"Irritable bowel syndrome"	"Other sepsis"	1	1032	48	1080
"K58"	"A49"	"Irritable bowel syndrome"	"Bacterial infection of unspecified site"	1	544	39	583
"K58"	"C18"	"Irritable bowel syndrome"	"Malignant neoplasm of colon"	1	295	86	381
"K58"	"C34"	"Irritable bowel syndrome"	"Malignant neoplasm of bronchus and lung"	1	558	0	558
"K58"	"C44"	"Irritable bowel syndrome"	"Other and unspecified malignant neoplasm of skin"	1	482	61	543
"K58"	"C50"	"Irritable bowel syndrome"	"Malignant neoplasm of breast"	1	494	244	738
"K58"	"C61"	"Irritable bowel syndrome"	"Malignant neoplasm of prostate"	1	306	39	345
"K58"	"C64"	"Irritable bowel syndrome"	"Malignant neoplasm of kidney, except renal pelvis"	1	101	7	108
"K58"	"C71"	"Irritable bowel syndrome"	"Malignant neoplasm of brain"	1	62	0	62
"K58"	"C77"	"Irritable bowel syndrome"	"Secondary and unspecified malignant neoplasm of lymph nodes"	1	203	11	214
"K58"	"C78"	"Irritable bowel syndrome"	"Secondary malignant neoplasm of resp and digestive organs"	1	522	0	522
"K58"	"C83"	"Irritable bowel syndrome"	"Non-follicular lymphoma"	1	76	16	92
"K58"	"C90"	"Irritable bowel syndrome"	"Multiple myeloma and malignant plasma cell neoplasms"	1	59	5	64
"K58"	"D68"	"Irritable bowel syndrome"	"Other coagulation defects"	1	185	57	242
"K58"	"E11"	"Irritable bowel syndrome"	"Type 2 diabetes mellitus"	1	1170	651	1821
"K58"	"F33"	"Irritable bowel syndrome"	"Major depressive disorder, recurrent"	1	658	153	811
"K58"	"G56"	"Irritable bowel syndrome"	"Mononeuropathies of upper limb"	1	1035	665	1700
"K58"	"H26"	"Irritable bowel syndrome"	"Other cataract"	1	624	216	840
"K58"	"I15"	"Irritable bowel syndrome"	"Secondary hypertension"	1	172	57	229
"K58"	"I25"	"Irritable bowel syndrome"	"Chronic ischemic heart disease"	1	1504	819	2323
"K58"	"I35"	"Irritable bowel syndrome"	"Nonrheumatic aortic valve disorders"	1	581	45	626
"K58"	"I63"	"Irritable bowel syndrome"	"Cerebral infarction"	1	829	136	965
"K58"	"I69"	"Irritable bowel syndrome"	"Sequelae of cerebrovascular disease"	1	999	169	1168
"K58"	"I80"	"Irritable bowel syndrome"	"Phlebitis and thrombophlebitis"	1	609	264	873
"K58"	"J15"	"Irritable bowel syndrome"	"Bacterial pneumonia, not elsewhere classified"	1	951	63	1014
"K58"	"J18"	"Irritable bowel syndrome"	"Pneumonia, unspecified organism"	1	2577	670	3247
"K58"	"J81"	"Irritable bowel syndrome"	"Pulmonary edema"	1	119	11	130
"K58"	"J90"	"Irritable bowel syndrome"	"Pleural effusion, not elsewhere classified"	1	183	12	195
"K58"	"J91"	"Irritable bowel syndrome"	"Pleural effusion in conditions classified elsewhere"	1	71	7	78
"K58"	"J93"	"Irritable bowel syndrome"	"Pneumothorax and air leak"	1	126	55	181
"K58"	"K31"	"Irritable bowel syndrome"	"Other diseases of stomach and duodenum"	1	179	74	253
"K58"	"K56"	"Irritable bowel syndrome"	"Paralytic ileus and intestinal obstruction without hernia"	1	708	255	963
"K58"	"K64"	"Irritable bowel syndrome"	"Hemorrhoids and perianal venous thrombosis"	1	1057	83	1140
"K58"	"K65"	"Irritable bowel syndrome"	"Peritonitis"	1	185	82	267
"K58"	"L89"	"Irritable bowel syndrome"	"Pressure ulcer"	1	148	3	151
"K58"	"M06"	"Irritable bowel syndrome"	"Other rheumatoid arthritis"	1	290	165	455
"K58"	"M81"	"Irritable bowel syndrome"	"Osteoporosis without current pathological fracture"	1	1614	260	1874
"K58"	"N13"	"Irritable bowel syndrome"	"Obstructive and reflux uropathy"	1	282	117	399
"K58"	"N19"	"Irritable bowel syndrome"	"Unspecified kidney failure"	1	260	51	311
"K58"	"O24"	"Irritable bowel syndrome"	"Diabetes in pregnancy, childbirth, and the puerperium"	1	214	106	320
"K58"	"O34"	"Irritable bowel syndrome"	"Maternal care for abnormality of pelvic organs"	1	263	131	394
"K58"	"O35"	"Irritable bowel syndrome"	"Maternal care for known or suspected fetal abnlt and damage"	1	95	31	126
"K58"	"O72"	"Irritable bowel syndrome"	"Postpartum hemorrhage"	1	3029	0	3029
"K59"	"A04"	"Other functional intestinal disorders"	"Other bacterial intestinal infections"	1	1760	1464	3224
"K59"	"E41"	"Other functional intestinal disorders"	"Nutritional marasmus"	1	526	307	833
"K59"	"F03"	"Other functional intestinal disorders"	"Unspecified dementia"	1	4173	3304	7477
"K59"	"I46"	"Other functional intestinal disorders"	"Cardiac arrest"	1	1843	407	2250
"K59"	"J06"	"Other functional intestinal disorders"	"Acute upper resp infections of multiple and unsp sites"	1	2275	1757	4032
"K59"	"J15"	"Other functional intestinal disorders"	"Bacterial pneumonia, not elsewhere classified"	1	6385	5376	11761
"K59"	"K55"	"Other functional intestinal disorders"	"Vascular disorders of intestine"	1	884	590	1474
"K59"	"O72"	"Other functional intestinal disorders"	"Postpartum hemorrhage"	1	3465	1314	4779
"K60"	"A41"	"Fissure and fistula of anal and rectal regions"	"Other sepsis"	1	701	165	866
"K60"	"C06"	"Fissure and fistula of anal and rectal regions"	"Malignant neoplasm of other and unspecified parts of mouth"	1	25	1	26
"K60"	"C16"	"Fissure and fistula of anal and rectal regions"	"Malignant neoplasm of stomach"	1	47	7	54
"K60"	"C77"	"Fissure and fistula of anal and rectal regions"	"Secondary and unspecified malignant neoplasm of lymph nodes"	1	127	14	141
"K60"	"C79"	"Fissure and fistula of anal and rectal regions"	"Secondary malignant neoplasm of other and unspecified sites"	1	186	9	195
"K60"	"C80"	"Fissure and fistula of anal and rectal regions"	"Malignant neoplasm without specification of site"	1	41	3	44
"K60"	"D35"	"Fissure and fistula of anal and rectal regions"	"Benign neoplasm of other and unspecified endocrine glands"	1	74	13	87
"K60"	"D64"	"Fissure and fistula of anal and rectal regions"	"Other anemias"	1	669	222	891
"K60"	"E11"	"Fissure and fistula of anal and rectal regions"	"Type 2 diabetes mellitus"	1	943	456	1399
"K60"	"E21"	"Fissure and fistula of anal and rectal regions"	"Hyperparathyroidism and other disorders of parathyroid gland"	1	69	12	81
"K60"	"E87"	"Fissure and fistula of anal and rectal regions"	"Other disorders of fluid, electrolyte and acid-base balance"	1	486	47	533
"K60"	"F03"	"Fissure and fistula of anal and rectal regions"	"Unspecified dementia"	1	190	17	207
"K60"	"F05"	"Fissure and fistula of anal and rectal regions"	"Delirium due to known physiological condition"	1	107	1	108
"K60"	"G45"	"Fissure and fistula of anal and rectal regions"	"Transient cerebral ischemic attacks and related syndromes"	1	243	119	362
"K60"	"G47"	"Fissure and fistula of anal and rectal regions"	"Sleep disorders"	1	812	157	969
"K60"	"G62"	"Fissure and fistula of anal and rectal regions"	"Other and unspecified polyneuropathies"	1	221	54	275
"K60"	"G96"	"Fissure and fistula of anal and rectal regions"	"Other disorders of central nervous system"	1	224	32	256
"K60"	"H25"	"Fissure and fistula of anal and rectal regions"	"Age-related cataract"	1	936	219	1155
"K60"	"H26"	"Fissure and fistula of anal and rectal regions"	"Other cataract"	1	278	85	363
"K60"	"H33"	"Fissure and fistula of anal and rectal regions"	"Retinal detachments and breaks"	1	107	42	149
"K60"	"H34"	"Fissure and fistula of anal and rectal regions"	"Retinal vascular occlusions"	1	62	14	76
"K60"	"H35"	"Fissure and fistula of anal and rectal regions"	"Other retinal disorders"	1	279	80	359
"K60"	"H53"	"Fissure and fistula of anal and rectal regions"	"Visual disturbances"	1	160	62	222
"K60"	"I27"	"Fissure and fistula of anal and rectal regions"	"Other pulmonary heart diseases"	1	66	16	82
"K60"	"I49"	"Fissure and fistula of anal and rectal regions"	"Other cardiac arrhythmias"	1	290	155	445
"K60"	"I50"	"Fissure and fistula of anal and rectal regions"	"Heart failure"	1	561	245	806
"K60"	"I61"	"Fissure and fistula of anal and rectal regions"	"Nontraumatic intracerebral hemorrhage"	1	90	17	107
"K60"	"I63"	"Fissure and fistula of anal and rectal regions"	"Cerebral infarction"	1	425	108	533
"K60"	"I69"	"Fissure and fistula of anal and rectal regions"	"Sequelae of cerebrovascular disease"	1	450	126	576
"K60"	"I72"	"Fissure and fistula of anal and rectal regions"	"Other aneurysm"	1	49	8	57
"K60"	"I73"	"Fissure and fistula of anal and rectal regions"	"Other peripheral vascular diseases"	1	271	110	381
"K60"	"I80"	"Fissure and fistula of anal and rectal regions"	"Phlebitis and thrombophlebitis"	1	327	205	532
"K60"	"J06"	"Fissure and fistula of anal and rectal regions"	"Acute upper resp infections of multiple and unsp sites"	1	205	62	267
"K60"	"J22"	"Fissure and fistula of anal and rectal regions"	"Unspecified acute lower respiratory infection"	1	62	2	64
"K60"	"J43"	"Fissure and fistula of anal and rectal regions"	"Emphysema"	1	65	19	84
"K60"	"J44"	"Fissure and fistula of anal and rectal regions"	"Other chronic obstructive pulmonary disease"	1	749	259	1008
"K60"	"J47"	"Fissure and fistula of anal and rectal regions"	"Bronchiectasis"	1	65	3	68
"K60"	"J81"	"Fissure and fistula of anal and rectal regions"	"Pulmonary edema"	1	78	18	96
"K60"	"J84"	"Fissure and fistula of anal and rectal regions"	"Other interstitial pulmonary diseases"	1	81	17	98
"K60"	"J96"	"Fissure and fistula of anal and rectal regions"	"Respiratory failure, not elsewhere classified"	1	516	46	562
"K60"	"K72"	"Fissure and fistula of anal and rectal regions"	"Hepatic failure, not elsewhere classified"	1	91	16	107
"K60"	"K74"	"Fissure and fistula of anal and rectal regions"	"Fibrosis and cirrhosis of liver"	1	106	23	129
"K60"	"K83"	"Fissure and fistula of anal and rectal regions"	"Other diseases of biliary tract"	1	119	45	164
"K60"	"K91"	"Fissure and fistula of anal and rectal regions"	"Intraop and postproc comp and disorders of dgstv sys, NEC"	1	218	115	333
"K60"	"L97"	"Fissure and fistula of anal and rectal regions"	"Non-pressure chronic ulcer of lower limb, NEC"	1	153	35	188
"K60"	"M07"	"Fissure and fistula of anal and rectal regions"	"Enteropathic arthropathies"	1	165	40	205
"K60"	"M18"	"Fissure and fistula of anal and rectal regions"	"Osteoarthritis of first carpometacarpal joint"	1	120	22	142
"K60"	"M47"	"Fissure and fistula of anal and rectal regions"	"Spondylosis"	1	463	202	665
"K60"	"M80"	"Fissure and fistula of anal and rectal regions"	"Osteoporosis with current pathological fracture"	1	204	20	224
"K60"	"M81"	"Fissure and fistula of anal and rectal regions"	"Osteoporosis without current pathological fracture"	1	527	85	612
"K60"	"N13"	"Fissure and fistula of anal and rectal regions"	"Obstructive and reflux uropathy"	1	185	99	284
"K60"	"N19"	"Fissure and fistula of anal and rectal regions"	"Unspecified kidney failure"	1	166	47	213
"K60"	"N30"	"Fissure and fistula of anal and rectal regions"	"Cystitis"	1	909	613	1522
"K60"	"O72"	"Fissure and fistula of anal and rectal regions"	"Postpartum hemorrhage"	1	855	561	1416
"K61"	"A41"	"Abscess of anal and rectal regions"	"Other sepsis"	1	868	243	1111
"K61"	"B95"	"Abscess of anal and rectal regions"	"Strep as the cause of diseases classified elsewhere"	1	91	17	108
"K61"	"C06"	"Abscess of anal and rectal regions"	"Malignant neoplasm of other and unspecified parts of mouth"	1	28	0	28
"K61"	"C13"	"Abscess of anal and rectal regions"	"Malignant neoplasm of hypopharynx"	1	25	0	25
"K61"	"C16"	"Abscess of anal and rectal regions"	"Malignant neoplasm of stomach"	1	42	0	42
"K61"	"C22"	"Abscess of anal and rectal regions"	"Malignant neoplasm of liver and intrahepatic bile ducts"	1	44	0	44
"K61"	"C25"	"Abscess of anal and rectal regions"	"Malignant neoplasm of pancreas"	1	79	2	81
"K61"	"C34"	"Abscess of anal and rectal regions"	"Malignant neoplasm of bronchus and lung"	1	402	0	402
"K61"	"C64"	"Abscess of anal and rectal regions"	"Malignant neoplasm of kidney, except renal pelvis"	1	70	8	78
"K61"	"C80"	"Abscess of anal and rectal regions"	"Malignant neoplasm without specification of site"	1	40	0	40
"K61"	"D12"	"Abscess of anal and rectal regions"	"Benign neoplasm of colon, rectum, anus and anal canal"	1	856	180	1036
"K61"	"D62"	"Abscess of anal and rectal regions"	"Acute posthemorrhagic anemia"	1	97	30	127
"K61"	"E11"	"Abscess of anal and rectal regions"	"Type 2 diabetes mellitus"	1	1067	794	1861
"K61"	"E27"	"Abscess of anal and rectal regions"	"Other disorders of adrenal gland"	1	41	3	44
"K61"	"E78"	"Abscess of anal and rectal regions"	"Disorders of lipoprotein metabolism and other lipidemias"	1	1103	298	1401
"K61"	"E83"	"Abscess of anal and rectal regions"	"Disorders of mineral metabolism"	1	104	7	111
"K61"	"F17"	"Abscess of anal and rectal regions"	"Nicotine dependence"	1	1534	1137	2671
"K61"	"F41"	"Abscess of anal and rectal regions"	"Other anxiety disorders"	1	246	53	299
"K61"	"G47"	"Abscess of anal and rectal regions"	"Sleep disorders"	1	564	63	627
"K61"	"G62"	"Abscess of anal and rectal regions"	"Other and unspecified polyneuropathies"	1	216	52	268
"K61"	"H33"	"Abscess of anal and rectal regions"	"Retinal detachments and breaks"	1	77	24	101
"K61"	"H90"	"Abscess of anal and rectal regions"	"Conductive and sensorineural hearing loss"	1	206	94	300
"K61"	"I20"	"Abscess of anal and rectal regions"	"Angina pectoris"	1	635	386	1021
"K61"	"I25"	"Abscess of anal and rectal regions"	"Chronic ischemic heart disease"	1	868	396	1264
"K61"	"I26"	"Abscess of anal and rectal regions"	"Pulmonary embolism"	1	194	47	241
"K61"	"I27"	"Abscess of anal and rectal regions"	"Other pulmonary heart diseases"	1	70	9	79
"K61"	"I34"	"Abscess of anal and rectal regions"	"Nonrheumatic mitral valve disorders"	1	84	26	110
"K61"	"I35"	"Abscess of anal and rectal regions"	"Nonrheumatic aortic valve disorders"	1	256	33	289
"K61"	"I49"	"Abscess of anal and rectal regions"	"Other cardiac arrhythmias"	1	191	82	273
"K61"	"I67"	"Abscess of anal and rectal regions"	"Other cerebrovascular diseases"	1	52	8	60
"K61"	"I69"	"Abscess of anal and rectal regions"	"Sequelae of cerebrovascular disease"	1	521	109	630
"K61"	"I82"	"Abscess of anal and rectal regions"	"Other venous embolism and thrombosis"	1	67	12	79
"K61"	"I95"	"Abscess of anal and rectal regions"	"Hypotension"	1	134	12	146
"K61"	"J06"	"Abscess of anal and rectal regions"	"Acute upper resp infections of multiple and unsp sites"	1	145	26	171
"K61"	"J10"	"Abscess of anal and rectal regions"	"Influenza due to other identified influenza virus"	1	32	1	33
"K61"	"J15"	"Abscess of anal and rectal regions"	"Bacterial pneumonia, not elsewhere classified"	1	550	52	602
"K61"	"J43"	"Abscess of anal and rectal regions"	"Emphysema"	1	82	18	100
"K61"	"J47"	"Abscess of anal and rectal regions"	"Bronchiectasis"	1	36	1	37
"K61"	"J69"	"Abscess of anal and rectal regions"	"Pneumonitis due to solids and liquids"	1	97	3	100
"K61"	"J86"	"Abscess of anal and rectal regions"	"Pyothorax"	1	61	11	72
"K61"	"J90"	"Abscess of anal and rectal regions"	"Pleural effusion, not elsewhere classified"	1	144	19	163
"K61"	"J96"	"Abscess of anal and rectal regions"	"Respiratory failure, not elsewhere classified"	1	649	31	680
"K61"	"K22"	"Abscess of anal and rectal regions"	"Other diseases of esophagus"	1	147	33	180
"K61"	"K42"	"Abscess of anal and rectal regions"	"Umbilical hernia"	1	220	67	287
"K61"	"K56"	"Abscess of anal and rectal regions"	"Paralytic ileus and intestinal obstruction without hernia"	1	419	182	601
"K61"	"K60"	"Abscess of anal and rectal regions"	"Fissure and fistula of anal and rectal regions"	1	6507	2997	9504
"K61"	"K62"	"Abscess of anal and rectal regions"	"Other diseases of anus and rectum"	1	872	537	1409
"K61"	"K64"	"Abscess of anal and rectal regions"	"Hemorrhoids and perianal venous thrombosis"	1	643	145	788
"K61"	"K74"	"Abscess of anal and rectal regions"	"Fibrosis and cirrhosis of liver"	1	125	17	142
"K61"	"K80"	"Abscess of anal and rectal regions"	"Cholelithiasis"	1	432	266	698
"K61"	"K91"	"Abscess of anal and rectal regions"	"Intraop and postproc comp and disorders of dgstv sys, NEC"	1	224	88	312
"K61"	"K92"	"Abscess of anal and rectal regions"	"Other diseases of digestive system"	1	359	145	504
"K61"	"M16"	"Abscess of anal and rectal regions"	"Osteoarthritis of hip"	1	294	124	418
"K61"	"M19"	"Abscess of anal and rectal regions"	"Other and unspecified osteoarthritis"	1	439	131	570
"K61"	"M48"	"Abscess of anal and rectal regions"	"Other spondylopathies"	1	337	59	396
"K61"	"M75"	"Abscess of anal and rectal regions"	"Shoulder lesions"	1	831	314	1145
"K61"	"M80"	"Abscess of anal and rectal regions"	"Osteoporosis with current pathological fracture"	1	152	11	163
"K61"	"M81"	"Abscess of anal and rectal regions"	"Osteoporosis without current pathological fracture"	1	325	25	350
"K61"	"M85"	"Abscess of anal and rectal regions"	"Other disorders of bone density and structure"	1	210	5	215
"K61"	"N20"	"Abscess of anal and rectal regions"	"Calculus of kidney and ureter"	1	306	179	485
"K61"	"N40"	"Abscess of anal and rectal regions"	"Benign prostatic hyperplasia"	1	330	204	534
"K62"	"C15"	"Other diseases of anus and rectum"	"Malignant neoplasm of esophagus"	1	204	49	253
"K62"	"C16"	"Other diseases of anus and rectum"	"Malignant neoplasm of stomach"	1	242	87	329
"K62"	"C17"	"Other diseases of anus and rectum"	"Malignant neoplasm of small intestine"	1	130	45	175
"K62"	"C18"	"Other diseases of anus and rectum"	"Malignant neoplasm of colon"	1	2838	1959	4797
"K62"	"C44"	"Other diseases of anus and rectum"	"Other and unspecified malignant neoplasm of skin"	1	1030	729	1759
"K62"	"C77"	"Other diseases of anus and rectum"	"Secondary and unspecified malignant neoplasm of lymph nodes"	1	628	259	887
"K62"	"C80"	"Other diseases of anus and rectum"	"Malignant neoplasm without specification of site"	1	245	46	291
"K62"	"D50"	"Other diseases of anus and rectum"	"Iron deficiency anemia"	1	1876	1479	3355
"K62"	"D64"	"Other diseases of anus and rectum"	"Other anemias"	1	5153	4064	9217
"K62"	"F03"	"Other diseases of anus and rectum"	"Unspecified dementia"	1	2278	1055	3333
"K62"	"G47"	"Other diseases of anus and rectum"	"Sleep disorders"	1	1558	637	2195
"K62"	"G96"	"Other diseases of anus and rectum"	"Other disorders of central nervous system"	1	661	239	900
"K62"	"J47"	"Other diseases of anus and rectum"	"Bronchiectasis"	1	199	54	253
"K62"	"J84"	"Other diseases of anus and rectum"	"Other interstitial pulmonary diseases"	1	346	206	552
"K62"	"J91"	"Other diseases of anus and rectum"	"Pleural effusion in conditions classified elsewhere"	1	291	108	399
"K62"	"K51"	"Other diseases of anus and rectum"	"Ulcerative colitis"	1	4118	2588	6706
"K62"	"K52"	"Other diseases of anus and rectum"	"Other and unsp noninfective gastroenteritis and colitis"	1	2508	2134	4642
"K62"	"K72"	"Other diseases of anus and rectum"	"Hepatic failure, not elsewhere classified"	1	512	206	718
"K62"	"L97"	"Other diseases of anus and rectum"	"Non-pressure chronic ulcer of lower limb, NEC"	1	769	400	1169
"K65"	"I46"	"Peritonitis"	"Cardiac arrest"	1	347	209	556
"K66"	"C34"	"Other disorders of peritoneum"	"Malignant neoplasm of bronchus and lung"	1	67	0	67
"K66"	"E86"	"Other disorders of peritoneum"	"Volume depletion"	1	236	54	290
"K66"	"I25"	"Other disorders of peritoneum"	"Chronic ischemic heart disease"	1	165	74	239
"K66"	"I69"	"Other disorders of peritoneum"	"Sequelae of cerebrovascular disease"	1	115	12	127
"K66"	"K52"	"Other disorders of peritoneum"	"Other and unsp noninfective gastroenteritis and colitis"	1	129	50	179
"K66"	"L90"	"Other disorders of peritoneum"	"Atrophic disorders of skin"	1	90	27	117
"K70"	"C02"	"Alcoholic liver disease"	"Malignant neoplasm of other and unspecified parts of tongue"	1	87	18	105
"K70"	"C06"	"Alcoholic liver disease"	"Malignant neoplasm of other and unspecified parts of mouth"	1	152	33	185
"K70"	"C22"	"Alcoholic liver disease"	"Malignant neoplasm of liver and intrahepatic bile ducts"	1	946	378	1324
"K70"	"C71"	"Alcoholic liver disease"	"Malignant neoplasm of brain"	1	48	5	53
"K70"	"C77"	"Alcoholic liver disease"	"Secondary and unspecified malignant neoplasm of lymph nodes"	1	257	19	276
"K70"	"C80"	"Alcoholic liver disease"	"Malignant neoplasm without specification of site"	1	114	15	129
"K70"	"D62"	"Alcoholic liver disease"	"Acute posthemorrhagic anemia"	1	725	501	1226
"K70"	"E13"	"Alcoholic liver disease"	"Other specified diabetes mellitus"	1	295	125	420
"K70"	"E64"	"Alcoholic liver disease"	"Sequelae of malnutrition and other nutritional deficiencies"	1	327	188	515
"K70"	"E87"	"Alcoholic liver disease"	"Other disorders of fluid, electrolyte and acid-base balance"	1	2468	1415	3883
"K70"	"F03"	"Alcoholic liver disease"	"Unspecified dementia"	1	629	269	898
"K70"	"G47"	"Alcoholic liver disease"	"Sleep disorders"	1	246	135	381
"K70"	"G93"	"Alcoholic liver disease"	"Other disorders of brain"	1	501	201	702
"K70"	"G95"	"Alcoholic liver disease"	"Other and unspecified diseases of spinal cord"	1	95	25	120
"K70"	"G96"	"Alcoholic liver disease"	"Other disorders of central nervous system"	1	328	180	508
"K70"	"I61"	"Alcoholic liver disease"	"Nontraumatic intracerebral hemorrhage"	1	537	210	747
"K70"	"I69"	"Alcoholic liver disease"	"Sequelae of cerebrovascular disease"	1	862	511	1373
"K70"	"I86"	"Alcoholic liver disease"	"Varicose veins of other sites"	1	407	217	624
"K70"	"I95"	"Alcoholic liver disease"	"Hypotension"	1	470	233	703
"K70"	"J15"	"Alcoholic liver disease"	"Bacterial pneumonia, not elsewhere classified"	1	1375	853	2228
"K70"	"J81"	"Alcoholic liver disease"	"Pulmonary edema"	1	278	124	402
"K70"	"J90"	"Alcoholic liver disease"	"Pleural effusion, not elsewhere classified"	1	405	230	635
"K70"	"J91"	"Alcoholic liver disease"	"Pleural effusion in conditions classified elsewhere"	1	230	114	344
"K70"	"J96"	"Alcoholic liver disease"	"Respiratory failure, not elsewhere classified"	1	2256	1064	3320
"K70"	"K42"	"Alcoholic liver disease"	"Umbilical hernia"	1	866	512	1378
"K70"	"K55"	"Alcoholic liver disease"	"Vascular disorders of intestine"	1	178	88	266
"K70"	"K65"	"Alcoholic liver disease"	"Peritonitis"	1	1600	911	2511
"K70"	"K71"	"Alcoholic liver disease"	"Toxic liver disease"	1	785	578	1363
"K70"	"K72"	"Alcoholic liver disease"	"Hepatic failure, not elsewhere classified"	1	4931	3038	7969
"K70"	"K74"	"Alcoholic liver disease"	"Fibrosis and cirrhosis of liver"	1	3712	2814	6526
"K70"	"L89"	"Alcoholic liver disease"	"Pressure ulcer"	1	436	224	660
"K70"	"L97"	"Alcoholic liver disease"	"Non-pressure chronic ulcer of lower limb, NEC"	1	432	216	648
"K70"	"M80"	"Alcoholic liver disease"	"Osteoporosis with current pathological fracture"	1	530	187	717
"K70"	"M81"	"Alcoholic liver disease"	"Osteoporosis without current pathological fracture"	1	861	375	1236
"K70"	"N18"	"Alcoholic liver disease"	"Chronic kidney disease (CKD)"	1	734	295	1029
"K70"	"N39"	"Alcoholic liver disease"	"Other disorders of urinary system"	1	1362	726	2088
"K71"	"O72"	"Toxic liver disease"	"Postpartum hemorrhage"	1	56	3	59
"K73"	"C22"	"Chronic hepatitis, not elsewhere classified"	"Malignant neoplasm of liver and intrahepatic bile ducts"	1	81	15	96
"K73"	"C44"	"Chronic hepatitis, not elsewhere classified"	"Other and unspecified malignant neoplasm of skin"	1	41	3	44
"K73"	"M80"	"Chronic hepatitis, not elsewhere classified"	"Osteoporosis with current pathological fracture"	1	81	27	108
"K73"	"M81"	"Chronic hepatitis, not elsewhere classified"	"Osteoporosis without current pathological fracture"	1	280	68	348
"K74"	"A41"	"Fibrosis and cirrhosis of liver"	"Other sepsis"	1	1129	895	2024
"K74"	"C22"	"Fibrosis and cirrhosis of liver"	"Malignant neoplasm of liver and intrahepatic bile ducts"	1	662	467	1129
"K74"	"E86"	"Fibrosis and cirrhosis of liver"	"Volume depletion"	1	1119	713	1832
"K74"	"G93"	"Fibrosis and cirrhosis of liver"	"Other disorders of brain"	1	277	138	415
"K76"	"A49"	"Other diseases of liver"	"Bacterial infection of unspecified site"	1	557	336	893
"K76"	"C22"	"Other diseases of liver"	"Malignant neoplasm of liver and intrahepatic bile ducts"	1	580	258	838
"K76"	"C25"	"Other diseases of liver"	"Malignant neoplasm of pancreas"	1	271	133	404
"K76"	"C77"	"Other diseases of liver"	"Secondary and unspecified malignant neoplasm of lymph nodes"	1	142	53	195
"K76"	"C78"	"Other diseases of liver"	"Secondary malignant neoplasm of resp and digestive organs"	1	581	224	805
"K76"	"C79"	"Other diseases of liver"	"Secondary malignant neoplasm of other and unspecified sites"	1	240	40	280
"K76"	"F05"	"Other diseases of liver"	"Delirium due to known physiological condition"	1	276	140	416
"K76"	"G47"	"Other diseases of liver"	"Sleep disorders"	1	465	222	687
"K76"	"G95"	"Other diseases of liver"	"Other and unspecified diseases of spinal cord"	1	90	30	120
"K76"	"I46"	"Other diseases of liver"	"Cardiac arrest"	1	343	94	437
"K76"	"M81"	"Other diseases of liver"	"Osteoporosis without current pathological fracture"	1	779	441	1220
"K76"	"N18"	"Other diseases of liver"	"Chronic kidney disease (CKD)"	1	562	314	876
"K80"	"A04"	"Cholelithiasis"	"Other bacterial intestinal infections"	1	1012	258	1270
"K80"	"A26"	"Cholelithiasis"	"Erysipeloid"	1	91	3	94
"K80"	"A40"	"Cholelithiasis"	"Streptococcal sepsis"	1	262	116	378
"K80"	"A41"	"Cholelithiasis"	"Other sepsis"	1	7910	0	7910
"K80"	"A49"	"Cholelithiasis"	"Bacterial infection of unspecified site"	1	2152	502	2654
"K80"	"B02"	"Cholelithiasis"	"Zoster [herpes zoster]"	1	360	165	525
"K80"	"B36"	"Cholelithiasis"	"Other superficial mycoses"	1	110	29	139
"K80"	"B37"	"Cholelithiasis"	"Candidiasis"	1	870	380	1250
"K80"	"B96"	"Cholelithiasis"	"Oth bacterial agents as the cause of diseases classd elswhr"	1	265	74	339
"K80"	"C16"	"Cholelithiasis"	"Malignant neoplasm of stomach"	1	317	99	416
"K80"	"C18"	"Cholelithiasis"	"Malignant neoplasm of colon"	1	1298	606	1904
"K80"	"C34"	"Cholelithiasis"	"Malignant neoplasm of bronchus and lung"	1	2190	0	2190
"K80"	"C38"	"Cholelithiasis"	"Malignant neoplasm of heart, mediastinum and pleura"	1	73	14	87
"K80"	"C45"	"Cholelithiasis"	"Mesothelioma"	1	70	4	74
"K80"	"C54"	"Cholelithiasis"	"Malignant neoplasm of corpus uteri"	1	263	158	421
"K80"	"C67"	"Cholelithiasis"	"Malignant neoplasm of bladder"	1	316	175	491
"K80"	"C76"	"Cholelithiasis"	"Malignant neoplasm of other and ill-defined sites"	1	180	57	237
"K80"	"C79"	"Cholelithiasis"	"Secondary malignant neoplasm of other and unspecified sites"	1	1381	0	1381
"K80"	"C83"	"Cholelithiasis"	"Non-follicular lymphoma"	1	323	74	397
"K80"	"C88"	"Cholelithiasis"	"Malig immunoproliferative dis and certain oth B-cell lymph"	1	70	17	87
"K80"	"D05"	"Cholelithiasis"	"Carcinoma in situ of breast"	1	135	51	186
"K80"	"D09"	"Cholelithiasis"	"Carcinoma in situ of other and unspecified sites"	1	149	5	154
"K80"	"D10"	"Cholelithiasis"	"Benign neoplasm of mouth and pharynx"	1	262	154	416
"K80"	"D32"	"Cholelithiasis"	"Benign neoplasm of meninges"	1	188	73	261
"K80"	"D46"	"Cholelithiasis"	"Myelodysplastic syndromes"	1	186	29	215
"K80"	"D50"	"Cholelithiasis"	"Iron deficiency anemia"	1	1717	530	2247
"K80"	"D61"	"Cholelithiasis"	"Oth aplastic anemias and other bone marrow failure syndromes"	1	135	55	190
"K80"	"D64"	"Cholelithiasis"	"Other anemias"	1	6198	0	6198
"K80"	"D68"	"Cholelithiasis"	"Other coagulation defects"	1	554	279	833
"K80"	"D69"	"Cholelithiasis"	"Purpura and other hemorrhagic conditions"	1	445	273	718
"K80"	"D84"	"Cholelithiasis"	"Other immunodeficiencies"	1	63	10	73
"K80"	"E10"	"Cholelithiasis"	"Type 1 diabetes mellitus"	1	2340	1742	4082
"K80"	"E21"	"Cholelithiasis"	"Hyperparathyroidism and other disorders of parathyroid gland"	1	624	123	747
"K80"	"E27"	"Cholelithiasis"	"Other disorders of adrenal gland"	1	300	73	373
"K80"	"E63"	"Cholelithiasis"	"Other nutritional deficiencies"	1	88	29	117
"K80"	"E68"	"Cholelithiasis"	"Sequelae of hyperalimentation"	1	852	137	989
"K80"	"E83"	"Cholelithiasis"	"Disorders of mineral metabolism"	1	656	76	732
"K80"	"E87"	"Cholelithiasis"	"Other disorders of fluid, electrolyte and acid-base balance"	1	3898	0	3898
"K80"	"F05"	"Cholelithiasis"	"Delirium due to known physiological condition"	1	942	33	975
"K80"	"F17"	"Cholelithiasis"	"Nicotine dependence"	1	4076	3243	7319
"K80"	"F32"	"Cholelithiasis"	"Depressive episode"	1	2249	1246	3495
"K80"	"F41"	"Cholelithiasis"	"Other anxiety disorders"	1	1457	505	1962
"K80"	"F43"	"Cholelithiasis"	"Reaction to severe stress, and adjustment disorders"	1	748	371	1119
"K80"	"G12"	"Cholelithiasis"	"Spinal muscular atrophy and related syndromes"	1	72	24	96
"K80"	"G24"	"Cholelithiasis"	"Dystonia"	1	151	64	215
"K80"	"G31"	"Cholelithiasis"	"Oth degenerative diseases of nervous system, NEC"	1	186	48	234
"K80"	"G45"	"Cholelithiasis"	"Transient cerebral ischemic attacks and related syndromes"	1	1782	1071	2853
"K80"	"G56"	"Cholelithiasis"	"Mononeuropathies of upper limb"	1	2198	1693	3891
"K80"	"G63"	"Cholelithiasis"	"Polyneuropathy in diseases classified elsewhere"	1	142	53	195
"K80"	"G93"	"Cholelithiasis"	"Other disorders of brain"	1	280	124	404
"K80"	"G95"	"Cholelithiasis"	"Other and unspecified diseases of spinal cord"	1	406	58	464
"K80"	"H26"	"Cholelithiasis"	"Other cataract"	1	1862	972	2834
"K80"	"H34"	"Cholelithiasis"	"Retinal vascular occlusions"	1	323	147	470
"K80"	"I10"	"Cholelithiasis"	"Essential (primary) hypertension"	1	14367	12007	26374
"K80"	"I21"	"Cholelithiasis"	"Acute myocardial infarction"	1	2784	2226	5010
"K80"	"I26"	"Cholelithiasis"	"Pulmonary embolism"	1	1617	559	2176
"K80"	"I34"	"Cholelithiasis"	"Nonrheumatic mitral valve disorders"	1	591	329	920
"K80"	"I42"	"Cholelithiasis"	"Cardiomyopathy"	1	505	260	765
"K80"	"I44"	"Cholelithiasis"	"Atrioventricular and left bundle-branch block"	1	908	351	1259
"K80"	"I48"	"Cholelithiasis"	"Atrial fibrillation and flutter"	1	6207	3358	9565
"K80"	"I67"	"Cholelithiasis"	"Other cerebrovascular diseases"	1	325	131	456
"K80"	"I69"	"Cholelithiasis"	"Sequelae of cerebrovascular disease"	1	3384	1452	4836
"K80"	"I72"	"Cholelithiasis"	"Other aneurysm"	1	290	112	402
"K80"	"I73"	"Cholelithiasis"	"Other peripheral vascular diseases"	1	1538	523	2061
"K80"	"I89"	"Cholelithiasis"	"Oth noninfective disorders of lymphatic vessels and nodes"	1	334	84	418
"K80"	"I95"	"Cholelithiasis"	"Hypotension"	1	1061	246	1307
"K80"	"J06"	"Cholelithiasis"	"Acute upper resp infections of multiple and unsp sites"	1	554	65	619
"K80"	"J14"	"Cholelithiasis"	"Pneumonia due to Hemophilus influenzae"	1	141	51	192
"K80"	"J15"	"Cholelithiasis"	"Bacterial pneumonia, not elsewhere classified"	1	4686	0	4686
"K80"	"J43"	"Cholelithiasis"	"Emphysema"	1	395	240	635
"K80"	"J47"	"Cholelithiasis"	"Bronchiectasis"	1	262	27	289
"K80"	"J81"	"Cholelithiasis"	"Pulmonary edema"	1	715	153	868
"K80"	"J93"	"Cholelithiasis"	"Pneumothorax and air leak"	1	359	188	547
"K80"	"J95"	"Cholelithiasis"	"Intraop and postproc comp and disorders of resp sys, NEC"	1	248	67	315
"K80"	"J96"	"Cholelithiasis"	"Respiratory failure, not elsewhere classified"	1	4313	0	4313
"K80"	"J98"	"Cholelithiasis"	"Other respiratory disorders"	1	612	322	934
"K80"	"K04"	"Cholelithiasis"	"Diseases of pulp and periapical tissues"	1	477	313	790
"K80"	"K22"	"Cholelithiasis"	"Other diseases of esophagus"	1	957	649	1606
"K80"	"K31"	"Cholelithiasis"	"Other diseases of stomach and duodenum"	1	760	363	1123
"K80"	"K45"	"Cholelithiasis"	"Other abdominal hernia"	1	520	217	737
"K80"	"K46"	"Cholelithiasis"	"Unspecified abdominal hernia"	1	316	102	418
"K80"	"K57"	"Cholelithiasis"	"Diverticular disease of intestine"	1	5282	2490	7772
"K80"	"K59"	"Cholelithiasis"	"Other functional intestinal disorders"	1	11259	0	11259
"K80"	"K62"	"Cholelithiasis"	"Other diseases of anus and rectum"	1	2642	1493	4135
"K80"	"K73"	"Cholelithiasis"	"Chronic hepatitis, not elsewhere classified"	1	270	148	418
"K80"	"K75"	"Cholelithiasis"	"Other inflammatory liver diseases"	1	541	342	883
"K80"	"K90"	"Cholelithiasis"	"Intestinal malabsorption"	1	554	177	731
"K80"	"K91"	"Cholelithiasis"	"Intraop and postproc comp and disorders of dgstv sys, NEC"	1	1304	337	1641
"K80"	"L89"	"Cholelithiasis"	"Pressure ulcer"	1	681	130	811
"K80"	"M07"	"Cholelithiasis"	"Enteropathic arthropathies"	1	358	149	507
"K80"	"M10"	"Cholelithiasis"	"Gout"	1	951	526	1477
"K80"	"M70"	"Cholelithiasis"	"Soft tissue disorders related to use, overuse and pressure"	1	1119	758	1877
"K80"	"M80"	"Cholelithiasis"	"Osteoporosis with current pathological fracture"	1	1741	453	2194
"K80"	"M85"	"Cholelithiasis"	"Other disorders of bone density and structure"	1	1632	234	1866
"K80"	"N13"	"Cholelithiasis"	"Obstructive and reflux uropathy"	1	1025	599	1624
"K80"	"N17"	"Cholelithiasis"	"Acute kidney failure"	1	1317	400	1717
"K80"	"N84"	"Cholelithiasis"	"Polyp of female genital tract"	1	1084	579	1663
"K81"	"C22"	"Cholecystitis"	"Malignant neoplasm of liver and intrahepatic bile ducts"	1	145	44	189
"K81"	"C23"	"Cholecystitis"	"Malignant neoplasm of gallbladder"	1	120	49	169
"K81"	"C24"	"Cholecystitis"	"Malignant neoplasm of other and unsp parts of biliary tract"	1	150	69	219
"K81"	"C78"	"Cholecystitis"	"Secondary malignant neoplasm of resp and digestive organs"	1	512	151	663
"K81"	"D63"	"Cholecystitis"	"Anemia in chronic diseases classified elsewhere"	1	247	60	307
"K81"	"D64"	"Cholecystitis"	"Other anemias"	1	931	604	1535
"K81"	"E86"	"Cholecystitis"	"Volume depletion"	1	1423	599	2022
"K81"	"E87"	"Cholecystitis"	"Other disorders of fluid, electrolyte and acid-base balance"	1	672	404	1076
"K81"	"G95"	"Cholecystitis"	"Other and unspecified diseases of spinal cord"	1	84	16	100
"K81"	"G96"	"Cholecystitis"	"Other disorders of central nervous system"	1	177	57	234
"K81"	"I35"	"Cholecystitis"	"Nonrheumatic aortic valve disorders"	1	356	202	558
"K81"	"I46"	"Cholecystitis"	"Cardiac arrest"	1	277	58	335
"K81"	"M81"	"Cholecystitis"	"Osteoporosis without current pathological fracture"	1	551	383	934
"K81"	"M85"	"Cholecystitis"	"Other disorders of bone density and structure"	1	211	89	300
"K83"	"A04"	"Other diseases of biliary tract"	"Other bacterial intestinal infections"	1	249	130	379
"K83"	"E13"	"Other diseases of biliary tract"	"Other specified diabetes mellitus"	1	254	111	365
"K83"	"F41"	"Other diseases of biliary tract"	"Other anxiety disorders"	1	429	149	578
"K83"	"J81"	"Other diseases of biliary tract"	"Pulmonary edema"	1	131	61	192
"K85"	"A04"	"Acute pancreatitis"	"Other bacterial intestinal infections"	1	325	134	459
"K85"	"B37"	"Acute pancreatitis"	"Candidiasis"	1	356	180	536
"K85"	"C15"	"Acute pancreatitis"	"Malignant neoplasm of esophagus"	1	78	5	83
"K85"	"C34"	"Acute pancreatitis"	"Malignant neoplasm of bronchus and lung"	1	503	49	552
"K85"	"C71"	"Acute pancreatitis"	"Malignant neoplasm of brain"	1	44	9	53
"K85"	"C78"	"Acute pancreatitis"	"Secondary malignant neoplasm of resp and digestive organs"	1	573	123	696
"K85"	"D73"	"Acute pancreatitis"	"Diseases of spleen"	1	99	36	135
"K85"	"E10"	"Acute pancreatitis"	"Type 1 diabetes mellitus"	1	1718	861	2579
"K85"	"E11"	"Acute pancreatitis"	"Type 2 diabetes mellitus"	1	2290	1286	3576
"K85"	"E13"	"Acute pancreatitis"	"Other specified diabetes mellitus"	1	764	8	772
"K85"	"G47"	"Acute pancreatitis"	"Sleep disorders"	1	390	142	532
"K85"	"G95"	"Acute pancreatitis"	"Other and unspecified diseases of spinal cord"	1	91	15	106
"K85"	"G96"	"Acute pancreatitis"	"Other disorders of central nervous system"	1	224	52	276
"K85"	"H36"	"Acute pancreatitis"	"Retinal disorders in diseases classified elsewhere"	1	270	50	320
"K85"	"I63"	"Acute pancreatitis"	"Cerebral infarction"	1	559	342	901
"K85"	"I69"	"Acute pancreatitis"	"Sequelae of cerebrovascular disease"	1	735	493	1228
"K85"	"I81"	"Acute pancreatitis"	"Portal vein thrombosis"	1	188	87	275
"K85"	"K31"	"Acute pancreatitis"	"Other diseases of stomach and duodenum"	1	349	136	485
"K85"	"K43"	"Acute pancreatitis"	"Ventral hernia"	1	756	331	1087
"K85"	"K63"	"Acute pancreatitis"	"Other diseases of intestine"	1	295	176	471
"K85"	"K70"	"Acute pancreatitis"	"Alcoholic liver disease"	1	909	624	1533
"K85"	"K72"	"Acute pancreatitis"	"Hepatic failure, not elsewhere classified"	1	355	130	485
"K85"	"K83"	"Acute pancreatitis"	"Other diseases of biliary tract"	1	1709	1252	2961
"K85"	"L97"	"Acute pancreatitis"	"Non-pressure chronic ulcer of lower limb, NEC"	1	202	53	255
"K86"	"A49"	"Other diseases of pancreas"	"Bacterial infection of unspecified site"	1	533	178	711
"K86"	"C10"	"Other diseases of pancreas"	"Malignant neoplasm of oropharynx"	1	59	0	59
"K86"	"C13"	"Other diseases of pancreas"	"Malignant neoplasm of hypopharynx"	1	49	4	53
"K86"	"C15"	"Other diseases of pancreas"	"Malignant neoplasm of esophagus"	1	66	12	78
"K86"	"C22"	"Other diseases of pancreas"	"Malignant neoplasm of liver and intrahepatic bile ducts"	1	111	20	131
"K86"	"C61"	"Other diseases of pancreas"	"Malignant neoplasm of prostate"	1	122	54	176
"K86"	"C78"	"Other diseases of pancreas"	"Secondary malignant neoplasm of resp and digestive organs"	1	614	100	714
"K86"	"C79"	"Other diseases of pancreas"	"Secondary malignant neoplasm of other and unspecified sites"	1	189	14	203
"K86"	"D64"	"Other diseases of pancreas"	"Other anemias"	1	1017	608	1625
"K86"	"E13"	"Other diseases of pancreas"	"Other specified diabetes mellitus"	1	1070	228	1298
"K86"	"E16"	"Other diseases of pancreas"	"Other disorders of pancreatic internal secretion"	1	724	189	913
"K86"	"E41"	"Other diseases of pancreas"	"Nutritional marasmus"	1	170	48	218
"K86"	"E64"	"Other diseases of pancreas"	"Sequelae of malnutrition and other nutritional deficiencies"	1	331	107	438
"K86"	"F41"	"Other diseases of pancreas"	"Other anxiety disorders"	1	251	118	369
"K86"	"G47"	"Other diseases of pancreas"	"Sleep disorders"	1	228	76	304
"K86"	"G63"	"Other diseases of pancreas"	"Polyneuropathy in diseases classified elsewhere"	1	75	22	97
"K86"	"G95"	"Other diseases of pancreas"	"Other and unspecified diseases of spinal cord"	1	43	7	50
"K86"	"H36"	"Other diseases of pancreas"	"Retinal disorders in diseases classified elsewhere"	1	322	72	394
"K86"	"I35"	"Other diseases of pancreas"	"Nonrheumatic aortic valve disorders"	1	197	89	286
"K86"	"I46"	"Other diseases of pancreas"	"Cardiac arrest"	1	281	37	318
"K86"	"I73"	"Other diseases of pancreas"	"Other peripheral vascular diseases"	1	357	137	494
"K86"	"I86"	"Other diseases of pancreas"	"Varicose veins of other sites"	1	101	30	131
"K86"	"I95"	"Other diseases of pancreas"	"Hypotension"	1	207	92	299
"K86"	"J18"	"Other diseases of pancreas"	"Pneumonia, unspecified organism"	1	1839	1165	3004
"K86"	"J69"	"Other diseases of pancreas"	"Pneumonitis due to solids and liquids"	1	156	53	209
"K86"	"J85"	"Other diseases of pancreas"	"Abscess of lung and mediastinum"	1	71	22	93
"K86"	"J90"	"Other diseases of pancreas"	"Pleural effusion, not elsewhere classified"	1	252	117	369
"K86"	"K31"	"Other diseases of pancreas"	"Other diseases of stomach and duodenum"	1	441	207	648
"K86"	"K56"	"Other diseases of pancreas"	"Paralytic ileus and intestinal obstruction without hernia"	1	491	319	810
"K86"	"K59"	"Other diseases of pancreas"	"Other functional intestinal disorders"	1	1096	851	1947
"K86"	"K75"	"Other diseases of pancreas"	"Other inflammatory liver diseases"	1	171	60	231
"K86"	"K83"	"Other diseases of pancreas"	"Other diseases of biliary tract"	1	1136	905	2041
"K86"	"L98"	"Other diseases of pancreas"	"Oth disorders of skin, subcu, not elsewhere classified"	1	152	74	226
"K86"	"M80"	"Other diseases of pancreas"	"Osteoporosis with current pathological fracture"	1	276	108	384
"K86"	"M85"	"Other diseases of pancreas"	"Other disorders of bone density and structure"	1	203	113	316
"K86"	"N19"	"Other diseases of pancreas"	"Unspecified kidney failure"	1	276	147	423
"K86"	"N39"	"Other diseases of pancreas"	"Other disorders of urinary system"	1	685	365	1050
"K90"	"C34"	"Intestinal malabsorption"	"Malignant neoplasm of bronchus and lung"	1	102	5	107
"K90"	"J15"	"Intestinal malabsorption"	"Bacterial pneumonia, not elsewhere classified"	1	204	88	292
"K90"	"M81"	"Intestinal malabsorption"	"Osteoporosis without current pathological fracture"	1	470	289	759
"K91"	"A49"	"Intraop and postproc comp and disorders of dgstv sys, NEC"	"Bacterial infection of unspecified site"	1	408	188	596
"K91"	"C34"	"Intraop and postproc comp and disorders of dgstv sys, NEC"	"Malignant neoplasm of bronchus and lung"	1	187	46	233
"K91"	"J15"	"Intraop and postproc comp and disorders of dgstv sys, NEC"	"Bacterial pneumonia, not elsewhere classified"	1	458	251	709
"K91"	"L97"	"Intraop and postproc comp and disorders of dgstv sys, NEC"	"Non-pressure chronic ulcer of lower limb, NEC"	1	106	41	147
"K91"	"M80"	"Intraop and postproc comp and disorders of dgstv sys, NEC"	"Osteoporosis with current pathological fracture"	1	168	63	231
"K91"	"M81"	"Intraop and postproc comp and disorders of dgstv sys, NEC"	"Osteoporosis without current pathological fracture"	1	393	237	630
"K91"	"N18"	"Intraop and postproc comp and disorders of dgstv sys, NEC"	"Chronic kidney disease (CKD)"	1	348	186	534
"K92"	"A04"	"Other diseases of digestive system"	"Other bacterial intestinal infections"	1	1000	663	1663
"K92"	"C34"	"Other diseases of digestive system"	"Malignant neoplasm of bronchus and lung"	1	913	625	1538
"K92"	"E41"	"Other diseases of digestive system"	"Nutritional marasmus"	1	228	91	319
"K92"	"G47"	"Other diseases of digestive system"	"Sleep disorders"	1	834	427	1261
"K92"	"I46"	"Other diseases of digestive system"	"Cardiac arrest"	1	1366	503	1869
"K92"	"I86"	"Other diseases of digestive system"	"Varicose veins of other sites"	1	396	254	650
"L00"	"J35"	"Staphylococcal scalded skin syndrome"	"Chronic diseases of tonsils and adenoids"	1	93	10	103
"L01"	"L89"	"Impetigo"	"Pressure ulcer"	1	53	11	64
"L01"	"M23"	"Impetigo"	"Internal derangement of knee"	1	140	52	192
"L01"	"M79"	"Impetigo"	"Oth and unsp soft tissue disorders, not elsewhere classified"	1	247	145	392
"L01"	"M81"	"Impetigo"	"Osteoporosis without current pathological fracture"	1	99	22	121
"L01"	"M85"	"Impetigo"	"Other disorders of bone density and structure"	1	73	4	77
"L01"	"O70"	"Impetigo"	"Perineal laceration during delivery"	1	99	32	131
"L01"	"O72"	"Impetigo"	"Postpartum hemorrhage"	1	144	0	144
"L02"	"A26"	"Cutaneous abscess, furuncle and carbuncle"	"Erysipeloid"	1	121	33	154
"L02"	"A31"	"Cutaneous abscess, furuncle and carbuncle"	"Infection due to other mycobacteria"	1	121	53	174
"L02"	"A49"	"Cutaneous abscess, furuncle and carbuncle"	"Bacterial infection of unspecified site"	1	2423	1115	3538
"L02"	"B18"	"Cutaneous abscess, furuncle and carbuncle"	"Chronic viral hepatitis"	1	888	236	1124
"L02"	"B95"	"Cutaneous abscess, furuncle and carbuncle"	"Strep as the cause of diseases classified elsewhere"	1	535	200	735
"L02"	"C15"	"Cutaneous abscess, furuncle and carbuncle"	"Malignant neoplasm of esophagus"	1	136	9	145
"L02"	"C25"	"Cutaneous abscess, furuncle and carbuncle"	"Malignant neoplasm of pancreas"	1	252	16	268
"L02"	"C61"	"Cutaneous abscess, furuncle and carbuncle"	"Malignant neoplasm of prostate"	1	527	196	723
"L02"	"C64"	"Cutaneous abscess, furuncle and carbuncle"	"Malignant neoplasm of kidney, except renal pelvis"	1	174	50	224
"L02"	"C77"	"Cutaneous abscess, furuncle and carbuncle"	"Secondary and unspecified malignant neoplasm of lymph nodes"	1	470	190	660
"L02"	"C78"	"Cutaneous abscess, furuncle and carbuncle"	"Secondary malignant neoplasm of resp and digestive organs"	1	1042	140	1182
"L02"	"C80"	"Cutaneous abscess, furuncle and carbuncle"	"Malignant neoplasm without specification of site"	1	160	23	183
"L02"	"D12"	"Cutaneous abscess, furuncle and carbuncle"	"Benign neoplasm of colon, rectum, anus and anal canal"	1	1674	438	2112
"L02"	"D13"	"Cutaneous abscess, furuncle and carbuncle"	"Benign neoplasm of and ill-defined parts of digestive system"	1	146	51	197
"L02"	"D63"	"Cutaneous abscess, furuncle and carbuncle"	"Anemia in chronic diseases classified elsewhere"	1	634	190	824
"L02"	"D84"	"Cutaneous abscess, furuncle and carbuncle"	"Other immunodeficiencies"	1	103	24	127
"L02"	"E16"	"Cutaneous abscess, furuncle and carbuncle"	"Other disorders of pancreatic internal secretion"	1	651	445	1096
"L02"	"E86"	"Cutaneous abscess, furuncle and carbuncle"	"Volume depletion"	1	2797	737	3534
"L02"	"E89"	"Cutaneous abscess, furuncle and carbuncle"	"Postproc endocrine and metabolic comp and disorders, NEC"	1	143	52	195
"L02"	"F11"	"Cutaneous abscess, furuncle and carbuncle"	"Opioid related disorders"	1	736	504	1240
"L02"	"F41"	"Cutaneous abscess, furuncle and carbuncle"	"Other anxiety disorders"	1	762	173	935
"L02"	"G25"	"Cutaneous abscess, furuncle and carbuncle"	"Other extrapyramidal and movement disorders"	1	111	36	147
"L02"	"G44"	"Cutaneous abscess, furuncle and carbuncle"	"Other headache syndromes"	1	516	314	830
"L02"	"G47"	"Cutaneous abscess, furuncle and carbuncle"	"Sleep disorders"	1	1512	325	1837
"L02"	"G93"	"Cutaneous abscess, furuncle and carbuncle"	"Other disorders of brain"	1	216	78	294
"L02"	"G96"	"Cutaneous abscess, furuncle and carbuncle"	"Other disorders of central nervous system"	1	759	68	827
"L02"	"G98"	"Cutaneous abscess, furuncle and carbuncle"	"Other disorders of nervous system not elsewhere classified"	1	286	16	302
"L02"	"H57"	"Cutaneous abscess, furuncle and carbuncle"	"Other disorders of eye and adnexa"	1	496	111	607
"L02"	"I24"	"Cutaneous abscess, furuncle and carbuncle"	"Other acute ischemic heart diseases"	1	162	82	244
"L02"	"I26"	"Cutaneous abscess, furuncle and carbuncle"	"Pulmonary embolism"	1	714	293	1007
"L02"	"I33"	"Cutaneous abscess, furuncle and carbuncle"	"Acute and subacute endocarditis"	1	290	135	425
"L02"	"I38"	"Cutaneous abscess, furuncle and carbuncle"	"Endocarditis, valve unspecified"	1	140	43	183
"L02"	"I42"	"Cutaneous abscess, furuncle and carbuncle"	"Cardiomyopathy"	1	340	177	517
"L02"	"I49"	"Cutaneous abscess, furuncle and carbuncle"	"Other cardiac arrhythmias"	1	685	381	1066
"L02"	"I61"	"Cutaneous abscess, furuncle and carbuncle"	"Nontraumatic intracerebral hemorrhage"	1	468	148	616
"L02"	"I67"	"Cutaneous abscess, furuncle and carbuncle"	"Other cerebrovascular diseases"	1	178	84	262
"L02"	"I69"	"Cutaneous abscess, furuncle and carbuncle"	"Sequelae of cerebrovascular disease"	1	1670	748	2418
"L02"	"I71"	"Cutaneous abscess, furuncle and carbuncle"	"Aortic aneurysm and dissection"	1	484	162	646
"L02"	"I85"	"Cutaneous abscess, furuncle and carbuncle"	"Esophageal varices"	1	242	83	325
"L02"	"I87"	"Cutaneous abscess, furuncle and carbuncle"	"Other disorders of veins"	1	288	98	386
"L02"	"J18"	"Cutaneous abscess, furuncle and carbuncle"	"Pneumonia, unspecified organism"	1	6071	2675	8746
"L02"	"J43"	"Cutaneous abscess, furuncle and carbuncle"	"Emphysema"	1	226	71	297
"L02"	"J44"	"Cutaneous abscess, furuncle and carbuncle"	"Other chronic obstructive pulmonary disease"	1	2881	1147	4028
"L02"	"J47"	"Cutaneous abscess, furuncle and carbuncle"	"Bronchiectasis"	1	104	8	112
"L02"	"J69"	"Cutaneous abscess, furuncle and carbuncle"	"Pneumonitis due to solids and liquids"	1	344	35	379
"L02"	"J91"	"Cutaneous abscess, furuncle and carbuncle"	"Pleural effusion in conditions classified elsewhere"	1	211	46	257
"L02"	"J96"	"Cutaneous abscess, furuncle and carbuncle"	"Respiratory failure, not elsewhere classified"	1	2946	0	2946
"L02"	"K02"	"Cutaneous abscess, furuncle and carbuncle"	"Dental caries"	1	613	440	1053
"L02"	"K21"	"Cutaneous abscess, furuncle and carbuncle"	"Gastro-esophageal reflux disease"	1	1051	789	1840
"L02"	"K43"	"Cutaneous abscess, furuncle and carbuncle"	"Ventral hernia"	1	869	639	1508
"L02"	"K52"	"Cutaneous abscess, furuncle and carbuncle"	"Other and unsp noninfective gastroenteritis and colitis"	1	993	576	1569
"L02"	"K57"	"Cutaneous abscess, furuncle and carbuncle"	"Diverticular disease of intestine"	1	1379	600	1979
"L02"	"K62"	"Cutaneous abscess, furuncle and carbuncle"	"Other diseases of anus and rectum"	1	1366	704	2070
"L02"	"K64"	"Cutaneous abscess, furuncle and carbuncle"	"Hemorrhoids and perianal venous thrombosis"	1	814	0	814
"L02"	"K72"	"Cutaneous abscess, furuncle and carbuncle"	"Hepatic failure, not elsewhere classified"	1	395	54	449
"L02"	"K76"	"Cutaneous abscess, furuncle and carbuncle"	"Other diseases of liver"	1	464	176	640
"L02"	"K83"	"Cutaneous abscess, furuncle and carbuncle"	"Other diseases of biliary tract"	1	277	119	396
"L02"	"L30"	"Cutaneous abscess, furuncle and carbuncle"	"Other and unspecified dermatitis"	1	781	416	1197
"L02"	"L72"	"Cutaneous abscess, furuncle and carbuncle"	"Follicular cysts of skin and subcutaneous tissue"	1	1355	905	2260
"L02"	"L73"	"Cutaneous abscess, furuncle and carbuncle"	"Other follicular disorders"	1	2429	1183	3612
"L02"	"L90"	"Cutaneous abscess, furuncle and carbuncle"	"Atrophic disorders of skin"	1	935	374	1309
"L02"	"L97"	"Cutaneous abscess, furuncle and carbuncle"	"Non-pressure chronic ulcer of lower limb, NEC"	1	2030	844	2874
"L02"	"L98"	"Cutaneous abscess, furuncle and carbuncle"	"Oth disorders of skin, subcu, not elsewhere classified"	1	1933	955	2888
"L02"	"M25"	"Cutaneous abscess, furuncle and carbuncle"	"Other joint disorder, not elsewhere classified"	1	1016	521	1537
"L02"	"M53"	"Cutaneous abscess, furuncle and carbuncle"	"Other and unspecified dorsopathies, not elsewhere classified"	1	394	230	624
"L02"	"M75"	"Cutaneous abscess, furuncle and carbuncle"	"Shoulder lesions"	1	2461	1160	3621
"L02"	"M81"	"Cutaneous abscess, furuncle and carbuncle"	"Osteoporosis without current pathological fracture"	1	1413	442	1855
"L02"	"M86"	"Cutaneous abscess, furuncle and carbuncle"	"Osteomyelitis"	1	1131	648	1779
"L02"	"N13"	"Cutaneous abscess, furuncle and carbuncle"	"Obstructive and reflux uropathy"	1	503	247	750
"L02"	"N17"	"Cutaneous abscess, furuncle and carbuncle"	"Acute kidney failure"	1	925	241	1166
"L02"	"N18"	"Cutaneous abscess, furuncle and carbuncle"	"Chronic kidney disease (CKD)"	1	1472	449	1921
"L02"	"N61"	"Cutaneous abscess, furuncle and carbuncle"	"Inflammatory disorders of breast"	1	760	465	1225
"L02"	"O72"	"Cutaneous abscess, furuncle and carbuncle"	"Postpartum hemorrhage"	1	1976	443	2419
"L03"	"B02"	"Cellulitis and acute lymphangitis"	"Zoster [herpes zoster]"	1	169	80	249
"L03"	"B18"	"Cellulitis and acute lymphangitis"	"Chronic viral hepatitis"	1	363	73	436
"L03"	"C25"	"Cellulitis and acute lymphangitis"	"Malignant neoplasm of pancreas"	1	97	0	97
"L03"	"C34"	"Cellulitis and acute lymphangitis"	"Malignant neoplasm of bronchus and lung"	1	372	0	372
"L03"	"C43"	"Cellulitis and acute lymphangitis"	"Malignant melanoma of skin"	1	109	27	136
"L03"	"C61"	"Cellulitis and acute lymphangitis"	"Malignant neoplasm of prostate"	1	266	10	276
"L03"	"C71"	"Cellulitis and acute lymphangitis"	"Malignant neoplasm of brain"	1	53	1	54
"L03"	"C77"	"Cellulitis and acute lymphangitis"	"Secondary and unspecified malignant neoplasm of lymph nodes"	1	184	25	209
"L03"	"D12"	"Cellulitis and acute lymphangitis"	"Benign neoplasm of colon, rectum, anus and anal canal"	1	693	11	704
"L03"	"D63"	"Cellulitis and acute lymphangitis"	"Anemia in chronic diseases classified elsewhere"	1	250	28	278
"L03"	"E11"	"Cellulitis and acute lymphangitis"	"Type 2 diabetes mellitus"	1	1192	823	2015
"L03"	"E78"	"Cellulitis and acute lymphangitis"	"Disorders of lipoprotein metabolism and other lipidemias"	1	1360	223	1583
"L03"	"F06"	"Cellulitis and acute lymphangitis"	"Other mental disorders due to known physiological condition"	1	78	3	81
"L03"	"F17"	"Cellulitis and acute lymphangitis"	"Nicotine dependence"	1	555	4	559
"L03"	"F19"	"Cellulitis and acute lymphangitis"	"Other psychoactive substance related disorders"	1	138	60	198
"L03"	"F41"	"Cellulitis and acute lymphangitis"	"Other anxiety disorders"	1	279	10	289
"L03"	"G20"	"Cellulitis and acute lymphangitis"	"Parkinson's disease"	1	110	16	126
"L03"	"G43"	"Cellulitis and acute lymphangitis"	"Migraine"	1	284	119	403
"L03"	"G45"	"Cellulitis and acute lymphangitis"	"Transient cerebral ischemic attacks and related syndromes"	1	466	139	605
"L03"	"G47"	"Cellulitis and acute lymphangitis"	"Sleep disorders"	1	617	21	638
"L03"	"H81"	"Cellulitis and acute lymphangitis"	"Disorders of vestibular function"	1	289	133	422
"L03"	"H91"	"Cellulitis and acute lymphangitis"	"Other and unspecified hearing loss"	1	1002	507	1509
"L03"	"H93"	"Cellulitis and acute lymphangitis"	"Other disorders of ear, not elsewhere classified"	1	373	150	523
"L03"	"I47"	"Cellulitis and acute lymphangitis"	"Paroxysmal tachycardia"	1	358	175	533
"L03"	"I50"	"Cellulitis and acute lymphangitis"	"Heart failure"	1	1224	375	1599
"L03"	"I61"	"Cellulitis and acute lymphangitis"	"Nontraumatic intracerebral hemorrhage"	1	225	33	258
"L03"	"I67"	"Cellulitis and acute lymphangitis"	"Other cerebrovascular diseases"	1	70	12	82
"L03"	"I69"	"Cellulitis and acute lymphangitis"	"Sequelae of cerebrovascular disease"	1	865	137	1002
"L03"	"I70"	"Cellulitis and acute lymphangitis"	"Atherosclerosis"	1	887	557	1444
"L03"	"I85"	"Cellulitis and acute lymphangitis"	"Esophageal varices"	1	109	17	126
"L03"	"J15"	"Cellulitis and acute lymphangitis"	"Bacterial pneumonia, not elsewhere classified"	1	980	62	1042
"L03"	"J44"	"Cellulitis and acute lymphangitis"	"Other chronic obstructive pulmonary disease"	1	1239	268	1507
"L03"	"J69"	"Cellulitis and acute lymphangitis"	"Pneumonitis due to solids and liquids"	1	108	0	108
"L03"	"J90"	"Cellulitis and acute lymphangitis"	"Pleural effusion, not elsewhere classified"	1	192	10	202
"L03"	"J93"	"Cellulitis and acute lymphangitis"	"Pneumothorax and air leak"	1	129	32	161
"L03"	"K21"	"Cellulitis and acute lymphangitis"	"Gastro-esophageal reflux disease"	1	658	208	866
"L03"	"K22"	"Cellulitis and acute lymphangitis"	"Other diseases of esophagus"	1	221	39	260
"L03"	"K30"	"Cellulitis and acute lymphangitis"	"Functional dyspepsia"	1	496	268	764
"L03"	"K40"	"Cellulitis and acute lymphangitis"	"Inguinal hernia"	1	603	425	1028
"L03"	"K56"	"Cellulitis and acute lymphangitis"	"Paralytic ileus and intestinal obstruction without hernia"	1	321	83	404
"L03"	"K58"	"Cellulitis and acute lymphangitis"	"Irritable bowel syndrome"	1	260	133	393
"L03"	"K72"	"Cellulitis and acute lymphangitis"	"Hepatic failure, not elsewhere classified"	1	154	1	155
"L03"	"K85"	"Cellulitis and acute lymphangitis"	"Acute pancreatitis"	1	175	73	248
"L03"	"L40"	"Cellulitis and acute lymphangitis"	"Psoriasis"	1	229	125	354
"L03"	"L89"	"Cellulitis and acute lymphangitis"	"Pressure ulcer"	1	410	84	494
"L03"	"L98"	"Cellulitis and acute lymphangitis"	"Oth disorders of skin, subcu, not elsewhere classified"	1	703	340	1043
"L03"	"M15"	"Cellulitis and acute lymphangitis"	"Polyosteoarthritis"	1	200	55	255
"L03"	"M19"	"Cellulitis and acute lymphangitis"	"Other and unspecified osteoarthritis"	1	931	165	1096
"L03"	"M41"	"Cellulitis and acute lymphangitis"	"Scoliosis"	1	100	39	139
"L03"	"M47"	"Cellulitis and acute lymphangitis"	"Spondylosis"	1	447	102	549
"L03"	"M65"	"Cellulitis and acute lymphangitis"	"Synovitis and tenosynovitis"	1	1056	614	1670
"L03"	"M72"	"Cellulitis and acute lymphangitis"	"Fibroblastic disorders"	1	376	182	558
"L03"	"M79"	"Cellulitis and acute lymphangitis"	"Oth and unsp soft tissue disorders, not elsewhere classified"	1	2358	1128	3486
"L03"	"N39"	"Cellulitis and acute lymphangitis"	"Other disorders of urinary system"	1	1243	185	1428
"L03"	"N81"	"Cellulitis and acute lymphangitis"	"Female genital prolapse"	1	214	112	326
"L03"	"N83"	"Cellulitis and acute lymphangitis"	"Noninflammatory disord of ovary, fallop and broad ligament"	1	226	113	339
"L03"	"O34"	"Cellulitis and acute lymphangitis"	"Maternal care for abnormality of pelvic organs"	1	95	32	127
"L03"	"O99"	"Cellulitis and acute lymphangitis"	"Oth maternal diseases classd elsw but compl preg/chldbrth"	1	508	137	645
"L04"	"A18"	"Acute lymphadenitis"	"Tuberculosis of other organs"	1	121	44	165
"L04"	"A31"	"Acute lymphadenitis"	"Infection due to other mycobacteria"	1	129	51	180
"L04"	"C77"	"Acute lymphadenitis"	"Secondary and unspecified malignant neoplasm of lymph nodes"	1	152	62	214
"L04"	"C85"	"Acute lymphadenitis"	"Oth and unspecified types of non-Hodgkin lymphoma"	1	198	74	272
"L04"	"D86"	"Acute lymphadenitis"	"Sarcoidosis"	1	79	14	93
"L04"	"E78"	"Acute lymphadenitis"	"Disorders of lipoprotein metabolism and other lipidemias"	1	171	21	192
"L04"	"E86"	"Acute lymphadenitis"	"Volume depletion"	1	172	70	242
"L04"	"H52"	"Acute lymphadenitis"	"Disorders of refraction and accommodation"	1	87	30	117
"L04"	"I25"	"Acute lymphadenitis"	"Chronic ischemic heart disease"	1	145	36	181
"L04"	"I50"	"Acute lymphadenitis"	"Heart failure"	1	123	19	142
"L04"	"J15"	"Acute lymphadenitis"	"Bacterial pneumonia, not elsewhere classified"	1	152	17	169
"L04"	"M41"	"Acute lymphadenitis"	"Scoliosis"	1	40	7	47
"L04"	"M54"	"Acute lymphadenitis"	"Dorsalgia"	1	353	127	480
"L04"	"M65"	"Acute lymphadenitis"	"Synovitis and tenosynovitis"	1	109	41	150
"L04"	"N30"	"Acute lymphadenitis"	"Cystitis"	1	276	86	362
"L04"	"N39"	"Acute lymphadenitis"	"Other disorders of urinary system"	1	166	41	207
"L05"	"A41"	"Pilonidal cyst and sinus"	"Other sepsis"	1	171	8	179
"L05"	"C18"	"Pilonidal cyst and sinus"	"Malignant neoplasm of colon"	1	31	2	33
"L05"	"C50"	"Pilonidal cyst and sinus"	"Malignant neoplasm of breast"	1	41	2	43
"L05"	"C77"	"Pilonidal cyst and sinus"	"Secondary and unspecified malignant neoplasm of lymph nodes"	1	39	0	39
"L05"	"C78"	"Pilonidal cyst and sinus"	"Secondary malignant neoplasm of resp and digestive organs"	1	64	0	64
"L05"	"D50"	"Pilonidal cyst and sinus"	"Iron deficiency anemia"	1	72	5	77
"L05"	"D64"	"Pilonidal cyst and sinus"	"Other anemias"	1	134	18	152
"L05"	"D68"	"Pilonidal cyst and sinus"	"Other coagulation defects"	1	64	9	73
"L05"	"E05"	"Pilonidal cyst and sinus"	"Thyrotoxicosis [hyperthyroidism]"	1	79	3	82
"L05"	"E13"	"Pilonidal cyst and sinus"	"Other specified diabetes mellitus"	1	37	1	38
"L05"	"E28"	"Pilonidal cyst and sinus"	"Ovarian dysfunction"	1	138	32	170
"L05"	"E66"	"Pilonidal cyst and sinus"	"Overweight and obesity"	1	1422	347	1769
"L05"	"G45"	"Pilonidal cyst and sinus"	"Transient cerebral ischemic attacks and related syndromes"	1	108	5	113
"L05"	"G47"	"Pilonidal cyst and sinus"	"Sleep disorders"	1	404	0	404
"L05"	"G62"	"Pilonidal cyst and sinus"	"Other and unspecified polyneuropathies"	1	63	8	71
"L05"	"G96"	"Pilonidal cyst and sinus"	"Other disorders of central nervous system"	1	77	0	77
"L05"	"H25"	"Pilonidal cyst and sinus"	"Age-related cataract"	1	143	17	160
"L05"	"H35"	"Pilonidal cyst and sinus"	"Other retinal disorders"	1	76	13	89
"L05"	"H36"	"Pilonidal cyst and sinus"	"Retinal disorders in diseases classified elsewhere"	1	157	31	188
"L05"	"H57"	"Pilonidal cyst and sinus"	"Other disorders of eye and adnexa"	1	107	16	123
"L05"	"H81"	"Pilonidal cyst and sinus"	"Disorders of vestibular function"	1	70	19	89
"L05"	"H91"	"Pilonidal cyst and sinus"	"Other and unspecified hearing loss"	1	179	72	251
"L05"	"H93"	"Pilonidal cyst and sinus"	"Other disorders of ear, not elsewhere classified"	1	100	32	132
"L05"	"I15"	"Pilonidal cyst and sinus"	"Secondary hypertension"	1	41	7	48
"L05"	"I26"	"Pilonidal cyst and sinus"	"Pulmonary embolism"	1	63	4	67
"L05"	"I47"	"Pilonidal cyst and sinus"	"Paroxysmal tachycardia"	1	83	30	113
"L05"	"I50"	"Pilonidal cyst and sinus"	"Heart failure"	1	156	18	174
"L05"	"I51"	"Pilonidal cyst and sinus"	"Complications and ill-defined descriptions of heart disease"	1	52	5	57
"L05"	"I63"	"Pilonidal cyst and sinus"	"Cerebral infarction"	1	126	3	129
"L05"	"I69"	"Pilonidal cyst and sinus"	"Sequelae of cerebrovascular disease"	1	115	11	126
"L05"	"J06"	"Pilonidal cyst and sinus"	"Acute upper resp infections of multiple and unsp sites"	1	101	16	117
"L05"	"J96"	"Pilonidal cyst and sinus"	"Respiratory failure, not elsewhere classified"	1	161	0	161
"L05"	"K30"	"Pilonidal cyst and sinus"	"Functional dyspepsia"	1	222	106	328
"L05"	"K42"	"Pilonidal cyst and sinus"	"Umbilical hernia"	1	102	23	125
"L05"	"K43"	"Pilonidal cyst and sinus"	"Ventral hernia"	1	75	16	91
"L05"	"K56"	"Pilonidal cyst and sinus"	"Paralytic ileus and intestinal obstruction without hernia"	1	83	20	103
"L05"	"K59"	"Pilonidal cyst and sinus"	"Other functional intestinal disorders"	1	408	140	548
"L05"	"K81"	"Pilonidal cyst and sinus"	"Cholecystitis"	1	59	3	62
"L05"	"K83"	"Pilonidal cyst and sinus"	"Other diseases of biliary tract"	1	25	1	26
"L05"	"K85"	"Pilonidal cyst and sinus"	"Acute pancreatitis"	1	78	24	102
"L05"	"L08"	"Pilonidal cyst and sinus"	"Other local infections of skin and subcutaneous tissue"	1	413	218	631
"L05"	"L68"	"Pilonidal cyst and sinus"	"Hypertrichosis"	1	152	58	210
"L05"	"L72"	"Pilonidal cyst and sinus"	"Follicular cysts of skin and subcutaneous tissue"	1	141	56	197
"L05"	"L73"	"Pilonidal cyst and sinus"	"Other follicular disorders"	1	411	121	532
"L05"	"L98"	"Pilonidal cyst and sinus"	"Oth disorders of skin, subcu, not elsewhere classified"	1	263	65	328
"L05"	"M17"	"Pilonidal cyst and sinus"	"Osteoarthritis of knee"	1	306	17	323
"L05"	"M48"	"Pilonidal cyst and sinus"	"Other spondylopathies"	1	121	1	122
"L05"	"M50"	"Pilonidal cyst and sinus"	"Cervical disc disorders"	1	109	22	131
"L05"	"M51"	"Pilonidal cyst and sinus"	"Thoracic, thoracolum, and lumbosacral intvrt disc disorders"	1	523	126	649
"L05"	"M65"	"Pilonidal cyst and sinus"	"Synovitis and tenosynovitis"	1	279	139	418
"L05"	"M67"	"Pilonidal cyst and sinus"	"Other disorders of synovium and tendon"	1	293	143	436
"L05"	"M72"	"Pilonidal cyst and sinus"	"Fibroblastic disorders"	1	91	11	102
"L05"	"M75"	"Pilonidal cyst and sinus"	"Shoulder lesions"	1	681	81	762
"L05"	"M76"	"Pilonidal cyst and sinus"	"Enthesopathies, lower limb, excluding foot"	1	143	60	203
"L05"	"M77"	"Pilonidal cyst and sinus"	"Other enthesopathies"	1	183	48	231
"L05"	"M79"	"Pilonidal cyst and sinus"	"Oth and unsp soft tissue disorders, not elsewhere classified"	1	582	329	911
"L05"	"M80"	"Pilonidal cyst and sinus"	"Osteoporosis with current pathological fracture"	1	29	0	29
"L05"	"M85"	"Pilonidal cyst and sinus"	"Other disorders of bone density and structure"	1	60	2	62
"L05"	"N18"	"Pilonidal cyst and sinus"	"Chronic kidney disease (CKD)"	1	88	3	91
"L05"	"N49"	"Pilonidal cyst and sinus"	"Inflammatory disorders of male genital organs, NEC"	1	115	39	154
"L05"	"N83"	"Pilonidal cyst and sinus"	"Noninflammatory disord of ovary, fallop and broad ligament"	1	145	47	192
"L05"	"N92"	"Pilonidal cyst and sinus"	"Excessive, frequent and irregular menstruation"	1	276	57	333
"L05"	"N93"	"Pilonidal cyst and sinus"	"Other abnormal uterine and vaginal bleeding"	1	61	11	72
"L05"	"O03"	"Pilonidal cyst and sinus"	"Spontaneous abortion"	1	184	89	273
"L05"	"O08"	"Pilonidal cyst and sinus"	"Complications following ectopic and molar pregnancy"	1	80	23	103
"L05"	"O21"	"Pilonidal cyst and sinus"	"Excessive vomiting in pregnancy"	1	68	10	78
"L05"	"O32"	"Pilonidal cyst and sinus"	"Maternal care for malpresentation of fetus"	1	137	8	145
"L05"	"O34"	"Pilonidal cyst and sinus"	"Maternal care for abnormality of pelvic organs"	1	132	0	132
"L05"	"O42"	"Pilonidal cyst and sinus"	"Premature rupture of membranes"	1	243	29	272
"L05"	"O47"	"Pilonidal cyst and sinus"	"False labor"	1	163	29	192
"L05"	"O62"	"Pilonidal cyst and sinus"	"Abnormalities of forces of labor"	1	750	203	953
"L05"	"O63"	"Pilonidal cyst and sinus"	"Long labor"	1	128	19	147
"L05"	"O64"	"Pilonidal cyst and sinus"	"Obstructed labor due to malposition and malpresent of fetus"	1	134	21	155
"L05"	"O71"	"Pilonidal cyst and sinus"	"Other obstetric trauma"	1	169	46	215
"L05"	"O75"	"Pilonidal cyst and sinus"	"Oth complications of labor and delivery, NEC"	1	159	9	168
"L05"	"O80"	"Pilonidal cyst and sinus"	"Encounter for full-term uncomplicated delivery"	1	1182	401	1583
"L05"	"O82"	"Pilonidal cyst and sinus"	"Encounter for cesarean delivery without indication"	1	579	56	635
"L05"	"O91"	"Pilonidal cyst and sinus"	"Infect of breast assoc w pregnancy, the puerp and lactation"	1	40	3	43
"L05"	"O99"	"Pilonidal cyst and sinus"	"Oth maternal diseases classd elsw but compl preg/chldbrth"	1	834	33	867
"L05"	"Q61"	"Pilonidal cyst and sinus"	"Cystic kidney disease"	1	32	3	35
"L08"	"B95"	"Other local infections of skin and subcutaneous tissue"	"Strep as the cause of diseases classified elsewhere"	1	228	121	349
"L08"	"C16"	"Other local infections of skin and subcutaneous tissue"	"Malignant neoplasm of stomach"	1	60	8	68
"L08"	"C78"	"Other local infections of skin and subcutaneous tissue"	"Secondary malignant neoplasm of resp and digestive organs"	1	417	76	493
"L08"	"C79"	"Other local infections of skin and subcutaneous tissue"	"Secondary malignant neoplasm of other and unspecified sites"	1	326	70	396
"L08"	"D64"	"Other local infections of skin and subcutaneous tissue"	"Other anemias"	1	1226	820	2046
"L08"	"E13"	"Other local infections of skin and subcutaneous tissue"	"Other specified diabetes mellitus"	1	176	90	266
"L08"	"F41"	"Other local infections of skin and subcutaneous tissue"	"Other anxiety disorders"	1	391	200	591
"L08"	"J22"	"Other local infections of skin and subcutaneous tissue"	"Unspecified acute lower respiratory infection"	1	109	42	151
"L08"	"J47"	"Other local infections of skin and subcutaneous tissue"	"Bronchiectasis"	1	65	16	81
"L08"	"K57"	"Other local infections of skin and subcutaneous tissue"	"Diverticular disease of intestine"	1	631	414	1045
"L08"	"K59"	"Other local infections of skin and subcutaneous tissue"	"Other functional intestinal disorders"	1	1435	1159	2594
"L08"	"K64"	"Other local infections of skin and subcutaneous tissue"	"Hemorrhoids and perianal venous thrombosis"	1	444	17	461
"L08"	"L89"	"Other local infections of skin and subcutaneous tissue"	"Pressure ulcer"	1	612	381	993
"L08"	"M85"	"Other local infections of skin and subcutaneous tissue"	"Other disorders of bone density and structure"	1	300	108	408
"L08"	"O72"	"Other local infections of skin and subcutaneous tissue"	"Postpartum hemorrhage"	1	972	379	1351
"L20"	"A46"	"Atopic dermatitis"	"Erysipelas"	1	211	117	328
"L20"	"A49"	"Atopic dermatitis"	"Bacterial infection of unspecified site"	1	238	120	358
"L20"	"B02"	"Atopic dermatitis"	"Zoster [herpes zoster]"	1	72	15	87
"L20"	"C34"	"Atopic dermatitis"	"Malignant neoplasm of bronchus and lung"	1	39	0	39
"L20"	"C78"	"Atopic dermatitis"	"Secondary malignant neoplasm of resp and digestive organs"	1	42	0	42
"L20"	"C79"	"Atopic dermatitis"	"Secondary malignant neoplasm of other and unspecified sites"	1	28	0	28
"L20"	"E11"	"Atopic dermatitis"	"Type 2 diabetes mellitus"	1	106	38	144
"L20"	"E22"	"Atopic dermatitis"	"Hyperfunction of pituitary gland"	1	47	6	53
"L20"	"E23"	"Atopic dermatitis"	"Hypofunction and other disorders of the pituitary gland"	1	45	7	52
"L20"	"E64"	"Atopic dermatitis"	"Sequelae of malnutrition and other nutritional deficiencies"	1	217	97	314
"L20"	"G43"	"Atopic dermatitis"	"Migraine"	1	248	32	280
"L20"	"G47"	"Atopic dermatitis"	"Sleep disorders"	1	233	38	271
"L20"	"G56"	"Atopic dermatitis"	"Mononeuropathies of upper limb"	1	142	27	169
"L20"	"G93"	"Atopic dermatitis"	"Other disorders of brain"	1	30	3	33
"L20"	"H52"	"Atopic dermatitis"	"Disorders of refraction and accommodation"	1	271	72	343
"L20"	"H72"	"Atopic dermatitis"	"Perforation of tympanic membrane"	1	90	18	108
"L20"	"H91"	"Atopic dermatitis"	"Other and unspecified hearing loss"	1	162	81	243
"L20"	"H93"	"Atopic dermatitis"	"Other disorders of ear, not elsewhere classified"	1	97	30	127
"L20"	"I47"	"Atopic dermatitis"	"Paroxysmal tachycardia"	1	85	21	106
"L20"	"J22"	"Atopic dermatitis"	"Unspecified acute lower respiratory infection"	1	29	1	30
"L20"	"J34"	"Atopic dermatitis"	"Other and unspecified disorders of nose and nasal sinuses"	1	141	22	163
"L20"	"J96"	"Atopic dermatitis"	"Respiratory failure, not elsewhere classified"	1	192	94	286
"L20"	"K01"	"Atopic dermatitis"	"Embedded and impacted teeth"	1	50	10	60
"L20"	"K02"	"Atopic dermatitis"	"Dental caries"	1	115	49	164
"L20"	"K30"	"Atopic dermatitis"	"Functional dyspepsia"	1	112	48	160
"L20"	"K35"	"Atopic dermatitis"	"Acute appendicitis"	1	223	87	310
"L20"	"K59"	"Atopic dermatitis"	"Other functional intestinal disorders"	1	784	490	1274
"L20"	"K62"	"Atopic dermatitis"	"Other diseases of anus and rectum"	1	180	59	239
"L20"	"K64"	"Atopic dermatitis"	"Hemorrhoids and perianal venous thrombosis"	1	73	0	73
"L20"	"L08"	"Atopic dermatitis"	"Other local infections of skin and subcutaneous tissue"	1	365	139	504
"L20"	"M22"	"Atopic dermatitis"	"Disorder of patella"	1	169	43	212
"L20"	"M23"	"Atopic dermatitis"	"Internal derangement of knee"	1	488	71	559
"L20"	"M50"	"Atopic dermatitis"	"Cervical disc disorders"	1	81	16	97
"L20"	"M53"	"Atopic dermatitis"	"Other and unspecified dorsopathies, not elsewhere classified"	1	58	8	66
"L20"	"M54"	"Atopic dermatitis"	"Dorsalgia"	1	463	110	573
"L20"	"M65"	"Atopic dermatitis"	"Synovitis and tenosynovitis"	1	190	52	242
"L20"	"M76"	"Atopic dermatitis"	"Enthesopathies, lower limb, excluding foot"	1	164	21	185
"L20"	"M81"	"Atopic dermatitis"	"Osteoporosis without current pathological fracture"	1	164	21	185
"L20"	"M85"	"Atopic dermatitis"	"Other disorders of bone density and structure"	1	113	0	113
"L20"	"N17"	"Atopic dermatitis"	"Acute kidney failure"	1	43	6	49
"L20"	"N18"	"Atopic dermatitis"	"Chronic kidney disease (CKD)"	1	68	15	83
"L20"	"N20"	"Atopic dermatitis"	"Calculus of kidney and ureter"	1	111	20	131
"L20"	"N30"	"Atopic dermatitis"	"Cystitis"	1	461	172	633
"L20"	"N62"	"Atopic dermatitis"	"Hypertrophy of breast"	1	92	15	107
"L20"	"N92"	"Atopic dermatitis"	"Excessive, frequent and irregular menstruation"	1	249	53	302
"L20"	"O20"	"Atopic dermatitis"	"Hemorrhage in early pregnancy"	1	188	67	255
"L20"	"O24"	"Atopic dermatitis"	"Diabetes in pregnancy, childbirth, and the puerperium"	1	62	1	63
"L20"	"O30"	"Atopic dermatitis"	"Multiple gestation"	1	48	9	57
"L20"	"O32"	"Atopic dermatitis"	"Maternal care for malpresentation of fetus"	1	100	27	127
"L20"	"O34"	"Atopic dermatitis"	"Maternal care for abnormality of pelvic organs"	1	108	9	117
"L20"	"O36"	"Atopic dermatitis"	"Maternal care for other fetal problems"	1	205	21	226
"L20"	"O64"	"Atopic dermatitis"	"Obstructed labor due to malposition and malpresent of fetus"	1	73	21	94
"L20"	"O68"	"Atopic dermatitis"	"Labor and delivery comp by abnlt of fetal acid-base balance"	1	433	66	499
"L20"	"O70"	"Atopic dermatitis"	"Perineal laceration during delivery"	1	827	81	908
"L20"	"O75"	"Atopic dermatitis"	"Oth complications of labor and delivery, NEC"	1	118	16	134
"L20"	"O82"	"Atopic dermatitis"	"Encounter for cesarean delivery without indication"	1	409	55	464
"L20"	"O92"	"Atopic dermatitis"	"Oth disord of brst/lactatn assoc w pregnancy and the puerp"	1	60	0	60
"L21"	"A41"	"Seborrheic dermatitis"	"Other sepsis"	1	268	110	378
"L21"	"E86"	"Seborrheic dermatitis"	"Volume depletion"	1	335	106	441
"L21"	"J18"	"Seborrheic dermatitis"	"Pneumonia, unspecified organism"	1	545	333	878
"L21"	"J69"	"Seborrheic dermatitis"	"Pneumonitis due to solids and liquids"	1	52	10	62
"L21"	"N39"	"Seborrheic dermatitis"	"Other disorders of urinary system"	1	305	120	425
"L22"	"J03"	"Diaper dermatitis"	"Acute tonsillitis"	1	115	37	152
"L23"	"C34"	"Allergic contact dermatitis"	"Malignant neoplasm of bronchus and lung"	1	117	0	117
"L23"	"C77"	"Allergic contact dermatitis"	"Secondary and unspecified malignant neoplasm of lymph nodes"	1	49	3	52
"L23"	"C78"	"Allergic contact dermatitis"	"Secondary malignant neoplasm of resp and digestive organs"	1	86	0	86
"L23"	"C79"	"Allergic contact dermatitis"	"Secondary malignant neoplasm of other and unspecified sites"	1	63	0	63
"L23"	"D50"	"Allergic contact dermatitis"	"Iron deficiency anemia"	1	87	13	100
"L23"	"D63"	"Allergic contact dermatitis"	"Anemia in chronic diseases classified elsewhere"	1	44	0	44
"L23"	"E11"	"Allergic contact dermatitis"	"Type 2 diabetes mellitus"	1	318	115	433
"L23"	"H91"	"Allergic contact dermatitis"	"Other and unspecified hearing loss"	1	341	148	489
"L23"	"I25"	"Allergic contact dermatitis"	"Chronic ischemic heart disease"	1	332	117	449
"L23"	"I48"	"Allergic contact dermatitis"	"Atrial fibrillation and flutter"	1	402	58	460
"L23"	"I49"	"Allergic contact dermatitis"	"Other cardiac arrhythmias"	1	106	30	136
"L23"	"I63"	"Allergic contact dermatitis"	"Cerebral infarction"	1	195	14	209
"L23"	"I69"	"Allergic contact dermatitis"	"Sequelae of cerebrovascular disease"	1	218	16	234
"L23"	"J96"	"Allergic contact dermatitis"	"Respiratory failure, not elsewhere classified"	1	232	0	232
"L23"	"K57"	"Allergic contact dermatitis"	"Diverticular disease of intestine"	1	221	47	268
"L23"	"M75"	"Allergic contact dermatitis"	"Shoulder lesions"	1	449	191	640
"L23"	"N18"	"Allergic contact dermatitis"	"Chronic kidney disease (CKD)"	1	126	6	132
"L23"	"N39"	"Allergic contact dermatitis"	"Other disorders of urinary system"	1	343	78	421
"L24"	"C78"	"Irritant contact dermatitis"	"Secondary malignant neoplasm of resp and digestive organs"	1	31	0	31
"L24"	"D64"	"Irritant contact dermatitis"	"Other anemias"	1	67	2	69
"L24"	"I10"	"Irritant contact dermatitis"	"Essential (primary) hypertension"	1	320	25	345
"L24"	"I20"	"Irritant contact dermatitis"	"Angina pectoris"	1	98	20	118
"L24"	"I25"	"Irritant contact dermatitis"	"Chronic ischemic heart disease"	1	94	13	107
"L24"	"J18"	"Irritant contact dermatitis"	"Pneumonia, unspecified organism"	1	188	39	227
"L24"	"J96"	"Irritant contact dermatitis"	"Respiratory failure, not elsewhere classified"	1	47	0	47
"L24"	"K80"	"Irritant contact dermatitis"	"Cholelithiasis"	1	115	35	150
"L24"	"M51"	"Irritant contact dermatitis"	"Thoracic, thoracolum, and lumbosacral intvrt disc disorders"	1	164	49	213
"L24"	"M75"	"Irritant contact dermatitis"	"Shoulder lesions"	1	243	54	297
"L24"	"N92"	"Irritant contact dermatitis"	"Excessive, frequent and irregular menstruation"	1	153	73	226
"L24"	"O72"	"Irritant contact dermatitis"	"Postpartum hemorrhage"	1	283	50	333
"L24"	"O99"	"Irritant contact dermatitis"	"Oth maternal diseases classd elsw but compl preg/chldbrth"	1	203	104	307
"L25"	"M17"	"Unspecified contact dermatitis"	"Osteoarthritis of knee"	1	97	18	115
"L27"	"A41"	"Dermatitis due to substances taken internally"	"Other sepsis"	1	351	149	500
"L27"	"E86"	"Dermatitis due to substances taken internally"	"Volume depletion"	1	361	140	501
"L27"	"J15"	"Dermatitis due to substances taken internally"	"Bacterial pneumonia, not elsewhere classified"	1	266	98	364
"L28"	"C78"	"Lichen simplex chronicus and prurigo"	"Secondary malignant neoplasm of resp and digestive organs"	1	71	3	74
"L29"	"C34"	"Pruritus"	"Malignant neoplasm of bronchus and lung"	1	86	16	102
"L30"	"A04"	"Other and unspecified dermatitis"	"Other bacterial intestinal infections"	1	232	131	363
"L30"	"A41"	"Other and unspecified dermatitis"	"Other sepsis"	1	1344	581	1925
"L30"	"C34"	"Other and unspecified dermatitis"	"Malignant neoplasm of bronchus and lung"	1	427	83	510
"L30"	"G47"	"Other and unspecified dermatitis"	"Sleep disorders"	1	535	283	818
"L30"	"J18"	"Other and unspecified dermatitis"	"Pneumonia, unspecified organism"	1	2193	1750	3943
"L30"	"J22"	"Other and unspecified dermatitis"	"Unspecified acute lower respiratory infection"	1	182	56	238
"L30"	"J96"	"Other and unspecified dermatitis"	"Respiratory failure, not elsewhere classified"	1	1082	319	1401
"L30"	"K72"	"Other and unspecified dermatitis"	"Hepatic failure, not elsewhere classified"	1	145	47	192
"L30"	"L89"	"Other and unspecified dermatitis"	"Pressure ulcer"	1	328	151	479
"L30"	"M81"	"Other and unspecified dermatitis"	"Osteoporosis without current pathological fracture"	1	784	484	1268
"L30"	"N17"	"Other and unspecified dermatitis"	"Acute kidney failure"	1	339	122	461
"L30"	"O72"	"Other and unspecified dermatitis"	"Postpartum hemorrhage"	1	774	427	1201
"L40"	"A04"	"Psoriasis"	"Other bacterial intestinal infections"	1	158	39	197
"L40"	"A41"	"Psoriasis"	"Other sepsis"	1	922	133	1055
"L40"	"C15"	"Psoriasis"	"Malignant neoplasm of esophagus"	1	47	6	53
"L40"	"C16"	"Psoriasis"	"Malignant neoplasm of stomach"	1	50	4	54
"L40"	"C22"	"Psoriasis"	"Malignant neoplasm of liver and intrahepatic bile ducts"	1	67	1	68
"L40"	"C77"	"Psoriasis"	"Secondary and unspecified malignant neoplasm of lymph nodes"	1	179	18	197
"L40"	"C79"	"Psoriasis"	"Secondary malignant neoplasm of other and unspecified sites"	1	183	3	186
"L40"	"D63"	"Psoriasis"	"Anemia in chronic diseases classified elsewhere"	1	160	23	183
"L40"	"D64"	"Psoriasis"	"Other anemias"	1	768	193	961
"L40"	"E86"	"Psoriasis"	"Volume depletion"	1	907	135	1042
"L40"	"G47"	"Psoriasis"	"Sleep disorders"	1	417	166	583
"L40"	"I27"	"Psoriasis"	"Other pulmonary heart diseases"	1	100	35	135
"L40"	"I49"	"Psoriasis"	"Other cardiac arrhythmias"	1	226	124	350
"L40"	"I50"	"Psoriasis"	"Heart failure"	1	862	372	1234
"L40"	"I69"	"Psoriasis"	"Sequelae of cerebrovascular disease"	1	704	252	956
"L40"	"J15"	"Psoriasis"	"Bacterial pneumonia, not elsewhere classified"	1	666	144	810
"L40"	"J22"	"Psoriasis"	"Unspecified acute lower respiratory infection"	1	109	2	111
"L40"	"J91"	"Psoriasis"	"Pleural effusion in conditions classified elsewhere"	1	52	8	60
"L40"	"J96"	"Psoriasis"	"Respiratory failure, not elsewhere classified"	1	685	76	761
"L40"	"K56"	"Psoriasis"	"Paralytic ileus and intestinal obstruction without hernia"	1	225	96	321
"L40"	"K64"	"Psoriasis"	"Hemorrhoids and perianal venous thrombosis"	1	240	36	276
"L40"	"K72"	"Psoriasis"	"Hepatic failure, not elsewhere classified"	1	173	17	190
"L40"	"K74"	"Psoriasis"	"Fibrosis and cirrhosis of liver"	1	249	91	340
"L40"	"L89"	"Psoriasis"	"Pressure ulcer"	1	189	26	215
"L40"	"L97"	"Psoriasis"	"Non-pressure chronic ulcer of lower limb, NEC"	1	310	113	423
"L40"	"M19"	"Psoriasis"	"Other and unspecified osteoarthritis"	1	566	365	931
"L40"	"M81"	"Psoriasis"	"Osteoporosis without current pathological fracture"	1	763	232	995
"L40"	"M85"	"Psoriasis"	"Other disorders of bone density and structure"	1	363	82	445
"L43"	"C06"	"Lichen planus"	"Malignant neoplasm of other and unspecified parts of mouth"	1	82	14	96
"L43"	"C34"	"Lichen planus"	"Malignant neoplasm of bronchus and lung"	1	74	2	76
"L43"	"C78"	"Lichen planus"	"Secondary malignant neoplasm of resp and digestive organs"	1	78	3	81
"L43"	"D64"	"Lichen planus"	"Other anemias"	1	148	25	173
"L43"	"I69"	"Lichen planus"	"Sequelae of cerebrovascular disease"	1	128	28	156
"L43"	"J18"	"Lichen planus"	"Pneumonia, unspecified organism"	1	337	91	428
"L43"	"J44"	"Lichen planus"	"Other chronic obstructive pulmonary disease"	1	197	87	284
"L43"	"J96"	"Lichen planus"	"Respiratory failure, not elsewhere classified"	1	125	0	125
"L43"	"K59"	"Lichen planus"	"Other functional intestinal disorders"	1	201	88	289
"L43"	"N18"	"Lichen planus"	"Chronic kidney disease (CKD)"	1	65	9	74
"L50"	"A41"	"Urticaria"	"Other sepsis"	1	583	167	750
"L50"	"C16"	"Urticaria"	"Malignant neoplasm of stomach"	1	25	0	25
"L50"	"C34"	"Urticaria"	"Malignant neoplasm of bronchus and lung"	1	227	6	233
"L50"	"C61"	"Urticaria"	"Malignant neoplasm of prostate"	1	139	36	175
"L50"	"D50"	"Urticaria"	"Iron deficiency anemia"	1	207	87	294
"L50"	"D63"	"Urticaria"	"Anemia in chronic diseases classified elsewhere"	1	129	17	146
"L50"	"D64"	"Urticaria"	"Other anemias"	1	470	141	611
"L50"	"E86"	"Urticaria"	"Volume depletion"	1	589	259	848
"L50"	"E87"	"Urticaria"	"Other disorders of fluid, electrolyte and acid-base balance"	1	375	87	462
"L50"	"F03"	"Urticaria"	"Unspecified dementia"	1	163	20	183
"L50"	"F17"	"Urticaria"	"Nicotine dependence"	1	394	109	503
"L50"	"F33"	"Urticaria"	"Major depressive disorder, recurrent"	1	204	63	267
"L50"	"F60"	"Urticaria"	"Specific personality disorders"	1	70	14	84
"L50"	"I35"	"Urticaria"	"Nonrheumatic aortic valve disorders"	1	243	54	297
"L50"	"I46"	"Urticaria"	"Cardiac arrest"	1	134	1	135
"L50"	"I48"	"Urticaria"	"Atrial fibrillation and flutter"	1	643	297	940
"L50"	"I50"	"Urticaria"	"Heart failure"	1	517	250	767
"L50"	"I63"	"Urticaria"	"Cerebral infarction"	1	388	124	512
"L50"	"J44"	"Urticaria"	"Other chronic obstructive pulmonary disease"	1	670	415	1085
"L50"	"J90"	"Urticaria"	"Pleural effusion, not elsewhere classified"	1	106	21	127
"L50"	"J96"	"Urticaria"	"Respiratory failure, not elsewhere classified"	1	547	123	670
"L50"	"K56"	"Urticaria"	"Paralytic ileus and intestinal obstruction without hernia"	1	194	81	275
"L50"	"K59"	"Urticaria"	"Other functional intestinal disorders"	1	1105	656	1761
"L50"	"K70"	"Urticaria"	"Alcoholic liver disease"	1	94	17	111
"L50"	"K72"	"Urticaria"	"Hepatic failure, not elsewhere classified"	1	58	2	60
"L50"	"K92"	"Urticaria"	"Other diseases of digestive system"	1	257	120	377
"L50"	"L98"	"Urticaria"	"Oth disorders of skin, subcu, not elsewhere classified"	1	380	203	583
"L50"	"N17"	"Urticaria"	"Acute kidney failure"	1	146	22	168
"L50"	"N39"	"Urticaria"	"Other disorders of urinary system"	1	883	468	1351
"L52"	"M85"	"Erythema nodosum"	"Other disorders of bone density and structure"	1	38	1	39
"L53"	"A41"	"Other erythematous conditions"	"Other sepsis"	1	175	63	238
"L57"	"C34"	"Skin changes due to chronic expsr to nonionizing radiation"	"Malignant neoplasm of bronchus and lung"	1	258	92	350
"L57"	"J96"	"Skin changes due to chronic expsr to nonionizing radiation"	"Respiratory failure, not elsewhere classified"	1	343	196	539
"L60"	"C34"	"Nail disorders"	"Malignant neoplasm of bronchus and lung"	1	99	12	111
"L60"	"F17"	"Nail disorders"	"Nicotine dependence"	1	128	40	168
"L60"	"J44"	"Nail disorders"	"Other chronic obstructive pulmonary disease"	1	303	171	474
"L60"	"K59"	"Nail disorders"	"Other functional intestinal disorders"	1	530	320	850
"L60"	"L89"	"Nail disorders"	"Pressure ulcer"	1	115	49	164
"L60"	"M75"	"Nail disorders"	"Shoulder lesions"	1	593	254	847
"L60"	"M85"	"Nail disorders"	"Other disorders of bone density and structure"	1	129	32	161
"L60"	"N46"	"Nail disorders"	"Male infertility"	1	113	0	113
"L60"	"O70"	"Nail disorders"	"Perineal laceration during delivery"	1	335	166	501
"L60"	"O92"	"Nail disorders"	"Oth disord of brst/lactatn assoc w pregnancy and the puerp"	1	58	10	68
"L68"	"C50"	"Hypertrichosis"	"Malignant neoplasm of breast"	1	98	4	102
"L68"	"C78"	"Hypertrichosis"	"Secondary malignant neoplasm of resp and digestive organs"	1	35	0	35
"L68"	"D24"	"Hypertrichosis"	"Benign neoplasm of breast"	1	109	31	140
"L68"	"E11"	"Hypertrichosis"	"Type 2 diabetes mellitus"	1	412	60	472
"L68"	"E65"	"Hypertrichosis"	"Localized adiposity"	1	129	22	151
"L68"	"E86"	"Hypertrichosis"	"Volume depletion"	1	64	2	66
"L68"	"G47"	"Hypertrichosis"	"Sleep disorders"	1	161	4	165
"L68"	"I83"	"Hypertrichosis"	"Varicose veins of lower extremities"	1	202	49	251
"L68"	"J18"	"Hypertrichosis"	"Pneumonia, unspecified organism"	1	192	39	231
"L68"	"J44"	"Hypertrichosis"	"Other chronic obstructive pulmonary disease"	1	111	7	118
"L68"	"K59"	"Hypertrichosis"	"Other functional intestinal disorders"	1	268	58	326
"L68"	"M23"	"Hypertrichosis"	"Internal derangement of knee"	1	407	134	541
"L68"	"M25"	"Hypertrichosis"	"Other joint disorder, not elsewhere classified"	1	176	34	210
"L68"	"M51"	"Hypertrichosis"	"Thoracic, thoracolum, and lumbosacral intvrt disc disorders"	1	305	74	379
"L68"	"M79"	"Hypertrichosis"	"Oth and unsp soft tissue disorders, not elsewhere classified"	1	473	144	617
"L68"	"N60"	"Hypertrichosis"	"Benign mammary dysplasia"	1	82	21	103
"L68"	"O70"	"Hypertrichosis"	"Perineal laceration during delivery"	1	509	335	844
"L70"	"G56"	"Acne"	"Mononeuropathies of upper limb"	1	59	13	72
"L70"	"M75"	"Acne"	"Shoulder lesions"	1	136	38	174
"L70"	"O72"	"Acne"	"Postpartum hemorrhage"	1	374	24	398
"L70"	"O82"	"Acne"	"Encounter for cesarean delivery without indication"	1	123	40	163
"L71"	"C61"	"Rosacea"	"Malignant neoplasm of prostate"	1	66	10	76
"L71"	"C78"	"Rosacea"	"Secondary malignant neoplasm of resp and digestive organs"	1	66	12	78
"L72"	"C18"	"Follicular cysts of skin and subcutaneous tissue"	"Malignant neoplasm of colon"	1	110	25	135
"L72"	"C78"	"Follicular cysts of skin and subcutaneous tissue"	"Secondary malignant neoplasm of resp and digestive organs"	1	209	1	210
"L72"	"D63"	"Follicular cysts of skin and subcutaneous tissue"	"Anemia in chronic diseases classified elsewhere"	1	60	4	64
"L72"	"E78"	"Follicular cysts of skin and subcutaneous tissue"	"Disorders of lipoprotein metabolism and other lipidemias"	1	365	227	592
"L72"	"E87"	"Follicular cysts of skin and subcutaneous tissue"	"Other disorders of fluid, electrolyte and acid-base balance"	1	202	22	224
"L72"	"F33"	"Follicular cysts of skin and subcutaneous tissue"	"Major depressive disorder, recurrent"	1	72	21	93
"L72"	"F41"	"Follicular cysts of skin and subcutaneous tissue"	"Other anxiety disorders"	1	99	19	118
"L72"	"H25"	"Follicular cysts of skin and subcutaneous tissue"	"Age-related cataract"	1	508	223	731
"L72"	"I35"	"Follicular cysts of skin and subcutaneous tissue"	"Nonrheumatic aortic valve disorders"	1	125	26	151
"L72"	"I50"	"Follicular cysts of skin and subcutaneous tissue"	"Heart failure"	1	297	87	384
"L72"	"I69"	"Follicular cysts of skin and subcutaneous tissue"	"Sequelae of cerebrovascular disease"	1	200	81	281
"L72"	"I73"	"Follicular cysts of skin and subcutaneous tissue"	"Other peripheral vascular diseases"	1	142	52	194
"L72"	"K56"	"Follicular cysts of skin and subcutaneous tissue"	"Paralytic ileus and intestinal obstruction without hernia"	1	107	40	147
"L72"	"K59"	"Follicular cysts of skin and subcutaneous tissue"	"Other functional intestinal disorders"	1	408	144	552
"L72"	"M48"	"Follicular cysts of skin and subcutaneous tissue"	"Other spondylopathies"	1	166	86	252
"L72"	"M80"	"Follicular cysts of skin and subcutaneous tissue"	"Osteoporosis with current pathological fracture"	1	99	17	116
"L72"	"M81"	"Follicular cysts of skin and subcutaneous tissue"	"Osteoporosis without current pathological fracture"	1	236	92	328
"L72"	"M85"	"Follicular cysts of skin and subcutaneous tissue"	"Other disorders of bone density and structure"	1	158	46	204
"L72"	"N17"	"Follicular cysts of skin and subcutaneous tissue"	"Acute kidney failure"	1	77	5	82
"L73"	"E68"	"Other follicular disorders"	"Sequelae of hyperalimentation"	1	67	12	79
"L73"	"F33"	"Other follicular disorders"	"Major depressive disorder, recurrent"	1	96	30	126
"L73"	"I10"	"Other follicular disorders"	"Essential (primary) hypertension"	1	585	210	795
"L73"	"M75"	"Other follicular disorders"	"Shoulder lesions"	1	395	149	544
"L81"	"O72"	"Other disorders of pigmentation"	"Postpartum hemorrhage"	1	231	100	331
"L85"	"A41"	"Other epidermal thickening"	"Other sepsis"	1	142	63	205
"L90"	"A41"	"Atrophic disorders of skin"	"Other sepsis"	1	362	215	577
"L90"	"C34"	"Atrophic disorders of skin"	"Malignant neoplasm of bronchus and lung"	1	202	22	224
"L90"	"C78"	"Atrophic disorders of skin"	"Secondary malignant neoplasm of resp and digestive organs"	1	372	54	426
"L90"	"D63"	"Atrophic disorders of skin"	"Anemia in chronic diseases classified elsewhere"	1	96	30	126
"L90"	"D64"	"Atrophic disorders of skin"	"Other anemias"	1	420	223	643
"L90"	"E86"	"Atrophic disorders of skin"	"Volume depletion"	1	441	159	600
"L90"	"G96"	"Atrophic disorders of skin"	"Other disorders of central nervous system"	1	177	42	219
"L90"	"I35"	"Atrophic disorders of skin"	"Nonrheumatic aortic valve disorders"	1	267	125	392
"L90"	"I48"	"Atrophic disorders of skin"	"Atrial fibrillation and flutter"	1	526	340	866
"L90"	"I50"	"Atrophic disorders of skin"	"Heart failure"	1	339	181	520
"L90"	"I63"	"Atrophic disorders of skin"	"Cerebral infarction"	1	295	171	466
"L90"	"I69"	"Atrophic disorders of skin"	"Sequelae of cerebrovascular disease"	1	289	158	447
"L90"	"J06"	"Atrophic disorders of skin"	"Acute upper resp infections of multiple and unsp sites"	1	108	44	152
"L90"	"J15"	"Atrophic disorders of skin"	"Bacterial pneumonia, not elsewhere classified"	1	409	123	532
"L90"	"J44"	"Atrophic disorders of skin"	"Other chronic obstructive pulmonary disease"	1	492	326	818
"L90"	"J96"	"Atrophic disorders of skin"	"Respiratory failure, not elsewhere classified"	1	296	116	412
"L90"	"N17"	"Atrophic disorders of skin"	"Acute kidney failure"	1	94	33	127
"L90"	"N18"	"Atrophic disorders of skin"	"Chronic kidney disease (CKD)"	1	213	77	290
"L90"	"O72"	"Atrophic disorders of skin"	"Postpartum hemorrhage"	1	1082	411	1493
"L91"	"O72"	"Hypertrophic disorders of skin"	"Postpartum hemorrhage"	1	188	0	188
"L91"	"O99"	"Hypertrophic disorders of skin"	"Oth maternal diseases classd elsw but compl preg/chldbrth"	1	154	36	190
"L92"	"C78"	"Granulomatous disorders of skin and subcutaneous tissue"	"Secondary malignant neoplasm of resp and digestive organs"	1	38	0	38
"L93"	"A41"	"Lupus erythematosus"	"Other sepsis"	1	125	29	154
"L93"	"C78"	"Lupus erythematosus"	"Secondary malignant neoplasm of resp and digestive organs"	1	30	0	30
"L93"	"E87"	"Lupus erythematosus"	"Other disorders of fluid, electrolyte and acid-base balance"	1	80	20	100
"L93"	"I50"	"Lupus erythematosus"	"Heart failure"	1	120	50	170
"L93"	"M80"	"Lupus erythematosus"	"Osteoporosis with current pathological fracture"	1	77	21	98
"L93"	"M85"	"Lupus erythematosus"	"Other disorders of bone density and structure"	1	100	26	126
"L94"	"J96"	"Other localized connective tissue disorders"	"Respiratory failure, not elsewhere classified"	1	73	14	87
"L94"	"M81"	"Other localized connective tissue disorders"	"Osteoporosis without current pathological fracture"	1	89	27	116
"L95"	"I46"	"Vasculitis limited to skin, not elsewhere classified"	"Cardiac arrest"	1	68	6	74
"L95"	"J96"	"Vasculitis limited to skin, not elsewhere classified"	"Respiratory failure, not elsewhere classified"	1	230	60	290
"L97"	"A49"	"Non-pressure chronic ulcer of lower limb, NEC"	"Bacterial infection of unspecified site"	1	1297	955	2252
"L97"	"C15"	"Non-pressure chronic ulcer of lower limb, NEC"	"Malignant neoplasm of esophagus"	1	77	11	88
"L97"	"C34"	"Non-pressure chronic ulcer of lower limb, NEC"	"Malignant neoplasm of bronchus and lung"	1	504	214	718
"L97"	"E86"	"Non-pressure chronic ulcer of lower limb, NEC"	"Volume depletion"	1	2594	2049	4643
"L97"	"F05"	"Non-pressure chronic ulcer of lower limb, NEC"	"Delirium due to known physiological condition"	1	531	316	847
"L97"	"I46"	"Non-pressure chronic ulcer of lower limb, NEC"	"Cardiac arrest"	1	873	184	1057
"L97"	"I97"	"Non-pressure chronic ulcer of lower limb, NEC"	"Intraop and postproc comp and disorders of circ sys, NEC"	1	338	195	533
"L97"	"J15"	"Non-pressure chronic ulcer of lower limb, NEC"	"Bacterial pneumonia, not elsewhere classified"	1	1647	1184	2831
"L97"	"J69"	"Non-pressure chronic ulcer of lower limb, NEC"	"Pneumonitis due to solids and liquids"	1	252	94	346
"L97"	"K64"	"Non-pressure chronic ulcer of lower limb, NEC"	"Hemorrhoids and perianal venous thrombosis"	1	127	39	166
"L97"	"N17"	"Non-pressure chronic ulcer of lower limb, NEC"	"Acute kidney failure"	1	739	463	1202
"L98"	"A41"	"Oth disorders of skin, subcu, not elsewhere classified"	"Other sepsis"	1	1841	1107	2948
"L98"	"C34"	"Oth disorders of skin, subcu, not elsewhere classified"	"Malignant neoplasm of bronchus and lung"	1	418	139	557
"L98"	"C78"	"Oth disorders of skin, subcu, not elsewhere classified"	"Secondary malignant neoplasm of resp and digestive organs"	1	404	126	530
"L98"	"F05"	"Oth disorders of skin, subcu, not elsewhere classified"	"Delirium due to known physiological condition"	1	305	150	455
"L98"	"I46"	"Oth disorders of skin, subcu, not elsewhere classified"	"Cardiac arrest"	1	527	88	615
"M00"	"C34"	"Pyogenic arthritis"	"Malignant neoplasm of bronchus and lung"	1	124	15	139
"M00"	"C79"	"Pyogenic arthritis"	"Secondary malignant neoplasm of other and unspecified sites"	1	81	16	97
"M00"	"O72"	"Pyogenic arthritis"	"Postpartum hemorrhage"	1	58	4	62
"M02"	"C15"	"Postinfective and reactive arthropathies"	"Malignant neoplasm of esophagus"	1	25	0	25
"M02"	"C18"	"Postinfective and reactive arthropathies"	"Malignant neoplasm of colon"	1	91	9	100
"M02"	"C34"	"Postinfective and reactive arthropathies"	"Malignant neoplasm of bronchus and lung"	1	192	7	199
"M02"	"C43"	"Postinfective and reactive arthropathies"	"Malignant melanoma of skin"	1	39	5	44
"M02"	"C77"	"Postinfective and reactive arthropathies"	"Secondary and unspecified malignant neoplasm of lymph nodes"	1	80	3	83
"M02"	"D86"	"Postinfective and reactive arthropathies"	"Sarcoidosis"	1	294	141	435
"M02"	"E11"	"Postinfective and reactive arthropathies"	"Type 2 diabetes mellitus"	1	373	222	595
"M02"	"E86"	"Postinfective and reactive arthropathies"	"Volume depletion"	1	431	151	582
"M02"	"F17"	"Postinfective and reactive arthropathies"	"Nicotine dependence"	1	165	6	171
"M02"	"G44"	"Postinfective and reactive arthropathies"	"Other headache syndromes"	1	145	43	188
"M02"	"H20"	"Postinfective and reactive arthropathies"	"Iridocyclitis"	1	230	109	339
"M02"	"H90"	"Postinfective and reactive arthropathies"	"Conductive and sensorineural hearing loss"	1	148	62	210
"M02"	"I69"	"Postinfective and reactive arthropathies"	"Sequelae of cerebrovascular disease"	1	285	53	338
"M02"	"J44"	"Postinfective and reactive arthropathies"	"Other chronic obstructive pulmonary disease"	1	427	180	607
"M02"	"K21"	"Postinfective and reactive arthropathies"	"Gastro-esophageal reflux disease"	1	250	147	397
"M02"	"K56"	"Postinfective and reactive arthropathies"	"Paralytic ileus and intestinal obstruction without hernia"	1	138	52	190
"M02"	"K70"	"Postinfective and reactive arthropathies"	"Alcoholic liver disease"	1	72	11	83
"M02"	"L30"	"Postinfective and reactive arthropathies"	"Other and unspecified dermatitis"	1	192	70	262
"M02"	"M07"	"Postinfective and reactive arthropathies"	"Enteropathic arthropathies"	1	420	113	533
"M02"	"M15"	"Postinfective and reactive arthropathies"	"Polyosteoarthritis"	1	219	122	341
"M02"	"M16"	"Postinfective and reactive arthropathies"	"Osteoarthritis of hip"	1	390	190	580
"M02"	"M17"	"Postinfective and reactive arthropathies"	"Osteoarthritis of knee"	1	780	452	1232
"M02"	"M79"	"Postinfective and reactive arthropathies"	"Oth and unsp soft tissue disorders, not elsewhere classified"	1	1241	963	2204
"M02"	"M81"	"Postinfective and reactive arthropathies"	"Osteoporosis without current pathological fracture"	1	461	61	522
"M02"	"M91"	"Postinfective and reactive arthropathies"	"Juvenile osteochondrosis of hip and pelvis"	1	141	54	195
"M02"	"N39"	"Postinfective and reactive arthropathies"	"Other disorders of urinary system"	1	541	190	731
"M02"	"O72"	"Postinfective and reactive arthropathies"	"Postpartum hemorrhage"	1	370	14	384
"M05"	"A40"	"Rheumatoid arthritis with rheumatoid factor"	"Streptococcal sepsis"	1	81	26	107
"M05"	"A41"	"Rheumatoid arthritis with rheumatoid factor"	"Other sepsis"	1	1555	152	1707
"M05"	"A49"	"Rheumatoid arthritis with rheumatoid factor"	"Bacterial infection of unspecified site"	1	626	64	690
"M05"	"B37"	"Rheumatoid arthritis with rheumatoid factor"	"Candidiasis"	1	300	73	373
"M05"	"C15"	"Rheumatoid arthritis with rheumatoid factor"	"Malignant neoplasm of esophagus"	1	47	6	53
"M05"	"C16"	"Rheumatoid arthritis with rheumatoid factor"	"Malignant neoplasm of stomach"	1	63	13	76
"M05"	"C22"	"Rheumatoid arthritis with rheumatoid factor"	"Malignant neoplasm of liver and intrahepatic bile ducts"	1	47	1	48
"M05"	"C34"	"Rheumatoid arthritis with rheumatoid factor"	"Malignant neoplasm of bronchus and lung"	1	704	126	830
"M05"	"C64"	"Rheumatoid arthritis with rheumatoid factor"	"Malignant neoplasm of kidney, except renal pelvis"	1	65	18	83
"M05"	"C90"	"Rheumatoid arthritis with rheumatoid factor"	"Multiple myeloma and malignant plasma cell neoplasms"	1	56	11	67
"M05"	"D50"	"Rheumatoid arthritis with rheumatoid factor"	"Iron deficiency anemia"	1	470	223	693
"M05"	"D61"	"Rheumatoid arthritis with rheumatoid factor"	"Oth aplastic anemias and other bone marrow failure syndromes"	1	178	30	208
"M05"	"D62"	"Rheumatoid arthritis with rheumatoid factor"	"Acute posthemorrhagic anemia"	1	231	73	304
"M05"	"D63"	"Rheumatoid arthritis with rheumatoid factor"	"Anemia in chronic diseases classified elsewhere"	1	413	101	514
"M05"	"D72"	"Rheumatoid arthritis with rheumatoid factor"	"Other disorders of white blood cells"	1	95	36	131
"M05"	"E78"	"Rheumatoid arthritis with rheumatoid factor"	"Disorders of lipoprotein metabolism and other lipidemias"	1	755	559	1314
"M05"	"F03"	"Rheumatoid arthritis with rheumatoid factor"	"Unspecified dementia"	1	472	32	504
"M05"	"G20"	"Rheumatoid arthritis with rheumatoid factor"	"Parkinson's disease"	1	107	33	140
"M05"	"G30"	"Rheumatoid arthritis with rheumatoid factor"	"Alzheimer's disease"	1	127	3	130
"M05"	"G47"	"Rheumatoid arthritis with rheumatoid factor"	"Sleep disorders"	1	291	90	381
"M05"	"G96"	"Rheumatoid arthritis with rheumatoid factor"	"Other disorders of central nervous system"	1	186	42	228
"M05"	"I44"	"Rheumatoid arthritis with rheumatoid factor"	"Atrioventricular and left bundle-branch block"	1	194	64	258
"M05"	"I50"	"Rheumatoid arthritis with rheumatoid factor"	"Heart failure"	1	1740	736	2476
"M05"	"J06"	"Rheumatoid arthritis with rheumatoid factor"	"Acute upper resp infections of multiple and unsp sites"	1	94	13	107
"M05"	"J09"	"Rheumatoid arthritis with rheumatoid factor"	"Influenza due to certain identified influenza viruses"	1	52	0	52
"M05"	"J18"	"Rheumatoid arthritis with rheumatoid factor"	"Pneumonia, unspecified organism"	1	3462	1327	4789
"M05"	"J43"	"Rheumatoid arthritis with rheumatoid factor"	"Emphysema"	1	222	118	340
"M05"	"J44"	"Rheumatoid arthritis with rheumatoid factor"	"Other chronic obstructive pulmonary disease"	1	1594	940	2534
"M05"	"J47"	"Rheumatoid arthritis with rheumatoid factor"	"Bronchiectasis"	1	163	42	205
"M05"	"J86"	"Rheumatoid arthritis with rheumatoid factor"	"Pyothorax"	1	110	36	146
"M05"	"K56"	"Rheumatoid arthritis with rheumatoid factor"	"Paralytic ileus and intestinal obstruction without hernia"	1	350	134	484
"M05"	"K59"	"Rheumatoid arthritis with rheumatoid factor"	"Other functional intestinal disorders"	1	1149	371	1520
"M05"	"K62"	"Rheumatoid arthritis with rheumatoid factor"	"Other diseases of anus and rectum"	1	499	319	818
"M05"	"K64"	"Rheumatoid arthritis with rheumatoid factor"	"Hemorrhoids and perianal venous thrombosis"	1	227	17	244
"M05"	"K72"	"Rheumatoid arthritis with rheumatoid factor"	"Hepatic failure, not elsewhere classified"	1	71	13	84
"M05"	"L89"	"Rheumatoid arthritis with rheumatoid factor"	"Pressure ulcer"	1	417	33	450
"M05"	"L98"	"Rheumatoid arthritis with rheumatoid factor"	"Oth disorders of skin, subcu, not elsewhere classified"	1	431	105	536
"M05"	"M43"	"Rheumatoid arthritis with rheumatoid factor"	"Other deforming dorsopathies"	1	290	159	449
"M05"	"M48"	"Rheumatoid arthritis with rheumatoid factor"	"Other spondylopathies"	1	577	318	895
"M05"	"M80"	"Rheumatoid arthritis with rheumatoid factor"	"Osteoporosis with current pathological fracture"	1	1245	314	1559
"M05"	"M85"	"Rheumatoid arthritis with rheumatoid factor"	"Other disorders of bone density and structure"	1	1213	480	1693
"M05"	"M86"	"Rheumatoid arthritis with rheumatoid factor"	"Osteomyelitis"	1	154	58	212
"M05"	"N18"	"Rheumatoid arthritis with rheumatoid factor"	"Chronic kidney disease (CKD)"	1	560	108	668
"M05"	"N30"	"Rheumatoid arthritis with rheumatoid factor"	"Cystitis"	1	1797	611	2408
"M05"	"N39"	"Rheumatoid arthritis with rheumatoid factor"	"Other disorders of urinary system"	1	1319	401	1720
"M06"	"A04"	"Other rheumatoid arthritis"	"Other bacterial intestinal infections"	1	360	77	437
"M06"	"A09"	"Other rheumatoid arthritis"	"Infectious gastroenteritis and colitis, unspecified"	1	730	462	1192
"M06"	"A49"	"Other rheumatoid arthritis"	"Bacterial infection of unspecified site"	1	782	139	921
"M06"	"B02"	"Other rheumatoid arthritis"	"Zoster [herpes zoster]"	1	207	82	289
"M06"	"C18"	"Other rheumatoid arthritis"	"Malignant neoplasm of colon"	1	302	113	415
"M06"	"C25"	"Other rheumatoid arthritis"	"Malignant neoplasm of pancreas"	1	125	9	134
"M06"	"C34"	"Other rheumatoid arthritis"	"Malignant neoplasm of bronchus and lung"	1	786	101	887
"M06"	"C71"	"Other rheumatoid arthritis"	"Malignant neoplasm of brain"	1	56	6	62
"M06"	"C77"	"Other rheumatoid arthritis"	"Secondary and unspecified malignant neoplasm of lymph nodes"	1	191	45	236
"M06"	"C78"	"Other rheumatoid arthritis"	"Secondary malignant neoplasm of resp and digestive organs"	1	547	31	578
"M06"	"C79"	"Other rheumatoid arthritis"	"Secondary malignant neoplasm of other and unspecified sites"	1	385	27	412
"M06"	"C80"	"Other rheumatoid arthritis"	"Malignant neoplasm without specification of site"	1	80	4	84
"M06"	"C92"	"Other rheumatoid arthritis"	"Myeloid leukemia"	1	87	9	96
"M06"	"D46"	"Other rheumatoid arthritis"	"Myelodysplastic syndromes"	1	105	30	135
"M06"	"D50"	"Other rheumatoid arthritis"	"Iron deficiency anemia"	1	663	302	965
"M06"	"D61"	"Other rheumatoid arthritis"	"Oth aplastic anemias and other bone marrow failure syndromes"	1	177	57	234
"M06"	"D63"	"Other rheumatoid arthritis"	"Anemia in chronic diseases classified elsewhere"	1	492	132	624
"M06"	"D64"	"Other rheumatoid arthritis"	"Other anemias"	1	2095	895	2990
"M06"	"D68"	"Other rheumatoid arthritis"	"Other coagulation defects"	1	140	65	205
"M06"	"E13"	"Other rheumatoid arthritis"	"Other specified diabetes mellitus"	1	89	21	110
"M06"	"E41"	"Other rheumatoid arthritis"	"Nutritional marasmus"	1	66	2	68
"M06"	"E87"	"Other rheumatoid arthritis"	"Other disorders of fluid, electrolyte and acid-base balance"	1	1003	186	1189
"M06"	"G47"	"Other rheumatoid arthritis"	"Sleep disorders"	1	425	128	553
"M06"	"G62"	"Other rheumatoid arthritis"	"Other and unspecified polyneuropathies"	1	355	189	544
"M06"	"H16"	"Other rheumatoid arthritis"	"Keratitis"	1	152	70	222
"M06"	"I00"	"Other rheumatoid arthritis"	"Rheumatic fever without heart involvement"	1	208	103	311
"M06"	"I25"	"Other rheumatoid arthritis"	"Chronic ischemic heart disease"	1	1817	1511	3328
"M06"	"I26"	"Other rheumatoid arthritis"	"Pulmonary embolism"	1	518	234	752
"M06"	"I33"	"Other rheumatoid arthritis"	"Acute and subacute endocarditis"	1	89	31	120
"M06"	"I35"	"Other rheumatoid arthritis"	"Nonrheumatic aortic valve disorders"	1	845	254	1099
"M06"	"I49"	"Other rheumatoid arthritis"	"Other cardiac arrhythmias"	1	414	270	684
"M06"	"I50"	"Other rheumatoid arthritis"	"Heart failure"	1	2209	1072	3281
"M06"	"I70"	"Other rheumatoid arthritis"	"Atherosclerosis"	1	980	455	1435
"M06"	"J22"	"Other rheumatoid arthritis"	"Unspecified acute lower respiratory infection"	1	205	37	242
"M06"	"J47"	"Other rheumatoid arthritis"	"Bronchiectasis"	1	126	23	149
"M06"	"J84"	"Other rheumatoid arthritis"	"Other interstitial pulmonary diseases"	1	477	178	655
"M06"	"K52"	"Other rheumatoid arthritis"	"Other and unsp noninfective gastroenteritis and colitis"	1	634	273	907
"M06"	"K72"	"Other rheumatoid arthritis"	"Hepatic failure, not elsewhere classified"	1	103	20	123
"M06"	"L89"	"Other rheumatoid arthritis"	"Pressure ulcer"	1	519	66	585
"M06"	"L95"	"Other rheumatoid arthritis"	"Vasculitis limited to skin, not elsewhere classified"	1	123	46	169
"M06"	"L97"	"Other rheumatoid arthritis"	"Non-pressure chronic ulcer of lower limb, NEC"	1	743	126	869
"M06"	"M46"	"Other rheumatoid arthritis"	"Other inflammatory spondylopathies"	1	226	122	348
"M06"	"M48"	"Other rheumatoid arthritis"	"Other spondylopathies"	1	766	413	1179
"M06"	"M81"	"Other rheumatoid arthritis"	"Osteoporosis without current pathological fracture"	1	2878	1091	3969
"M06"	"M84"	"Other rheumatoid arthritis"	"Disorder of continuity of bone"	1	118	28	146
"M06"	"N06"	"Other rheumatoid arthritis"	"Isolated proteinuria with specified morphological lesion"	1	210	62	272
"M06"	"N13"	"Other rheumatoid arthritis"	"Obstructive and reflux uropathy"	1	211	98	309
"M06"	"N17"	"Other rheumatoid arthritis"	"Acute kidney failure"	1	398	88	486
"M06"	"N19"	"Other rheumatoid arthritis"	"Unspecified kidney failure"	1	431	139	570
"M06"	"N30"	"Other rheumatoid arthritis"	"Cystitis"	1	2326	959	3285
"M06"	"N39"	"Other rheumatoid arthritis"	"Other disorders of urinary system"	1	1855	641	2496
"M06"	"O72"	"Other rheumatoid arthritis"	"Postpartum hemorrhage"	1	303	188	491
"M07"	"A49"	"Enteropathic arthropathies"	"Bacterial infection of unspecified site"	1	152	45	197
"M07"	"D12"	"Enteropathic arthropathies"	"Benign neoplasm of colon, rectum, anus and anal canal"	1	250	129	379
"M07"	"G47"	"Enteropathic arthropathies"	"Sleep disorders"	1	236	108	344
"M07"	"I48"	"Enteropathic arthropathies"	"Atrial fibrillation and flutter"	1	317	157	474
"M07"	"J18"	"Enteropathic arthropathies"	"Pneumonia, unspecified organism"	1	523	273	796
"M07"	"M81"	"Enteropathic arthropathies"	"Osteoporosis without current pathological fracture"	1	443	174	617
"M07"	"M85"	"Enteropathic arthropathies"	"Other disorders of bone density and structure"	1	428	160	588
"M08"	"E27"	"Juvenile arthritis"	"Other disorders of adrenal gland"	1	25	1	26
"M08"	"E66"	"Juvenile arthritis"	"Overweight and obesity"	1	94	4	98
"M08"	"F43"	"Juvenile arthritis"	"Reaction to severe stress, and adjustment disorders"	1	126	34	160
"M08"	"H20"	"Juvenile arthritis"	"Iridocyclitis"	1	207	75	282
"M08"	"L70"	"Juvenile arthritis"	"Acne"	1	33	1	34
"M08"	"M19"	"Juvenile arthritis"	"Other and unspecified osteoarthritis"	1	75	12	87
"M08"	"M45"	"Juvenile arthritis"	"Ankylosing spondylitis"	1	44	6	50
"M08"	"M54"	"Juvenile arthritis"	"Dorsalgia"	1	104	40	144
"M08"	"M75"	"Juvenile arthritis"	"Shoulder lesions"	1	42	2	44
"M08"	"M81"	"Juvenile arthritis"	"Osteoporosis without current pathological fracture"	1	74	9	83
"M08"	"O62"	"Juvenile arthritis"	"Abnormalities of forces of labor"	1	43	0	43
"M08"	"O70"	"Juvenile arthritis"	"Perineal laceration during delivery"	1	64	0	64
"M08"	"O99"	"Juvenile arthritis"	"Oth maternal diseases classd elsw but compl preg/chldbrth"	1	93	0	93
"M10"	"A41"	"Gout"	"Other sepsis"	1	2866	1235	4101
"M10"	"A49"	"Gout"	"Bacterial infection of unspecified site"	1	1250	679	1929
"M10"	"B37"	"Gout"	"Candidiasis"	1	383	226	609
"M10"	"B95"	"Gout"	"Strep as the cause of diseases classified elsewhere"	1	79	26	105
"M10"	"C25"	"Gout"	"Malignant neoplasm of pancreas"	1	195	23	218
"M10"	"E83"	"Gout"	"Disorders of mineral metabolism"	1	334	147	481
"M10"	"E87"	"Gout"	"Other disorders of fluid, electrolyte and acid-base balance"	1	1615	857	2472
"M10"	"F05"	"Gout"	"Delirium due to known physiological condition"	1	649	191	840
"M10"	"J15"	"Gout"	"Bacterial pneumonia, not elsewhere classified"	1	1808	999	2807
"M10"	"J96"	"Gout"	"Respiratory failure, not elsewhere classified"	1	1867	674	2541
"M10"	"K92"	"Gout"	"Other diseases of digestive system"	1	990	760	1750
"M10"	"L57"	"Gout"	"Skin changes due to chronic expsr to nonionizing radiation"	1	198	74	272
"M10"	"L89"	"Gout"	"Pressure ulcer"	1	522	143	665
"M10"	"N18"	"Gout"	"Chronic kidney disease (CKD)"	1	2793	2411	5204
"M10"	"N19"	"Gout"	"Unspecified kidney failure"	1	1586	1104	2690
"M10"	"N28"	"Gout"	"Oth disorders of kidney and ureter, not elsewhere classified"	1	694	411	1105
"M10"	"N39"	"Gout"	"Other disorders of urinary system"	1	2095	1593	3688
"M11"	"C78"	"Other crystal arthropathies"	"Secondary malignant neoplasm of resp and digestive organs"	1	44	1	45
"M13"	"A41"	"Other arthritis"	"Other sepsis"	1	1307	519	1826
"M13"	"A49"	"Other arthritis"	"Bacterial infection of unspecified site"	1	676	398	1074
"M13"	"C16"	"Other arthritis"	"Malignant neoplasm of stomach"	1	71	20	91
"M13"	"C71"	"Other arthritis"	"Malignant neoplasm of brain"	1	52	7	59
"M13"	"C78"	"Other arthritis"	"Secondary malignant neoplasm of resp and digestive organs"	1	380	51	431
"M13"	"D47"	"Other arthritis"	"Oth neoplm of uncrt behav of lymphoid, hematpoetc & rel tiss"	1	182	73	255
"M13"	"F41"	"Other arthritis"	"Other anxiety disorders"	1	206	84	290
"M13"	"G47"	"Other arthritis"	"Sleep disorders"	1	524	221	745
"M13"	"H57"	"Other arthritis"	"Other disorders of eye and adnexa"	1	272	149	421
"M13"	"I69"	"Other arthritis"	"Sequelae of cerebrovascular disease"	1	703	430	1133
"M13"	"K72"	"Other arthritis"	"Hepatic failure, not elsewhere classified"	1	80	18	98
"M13"	"L97"	"Other arthritis"	"Non-pressure chronic ulcer of lower limb, NEC"	1	330	135	465
"M13"	"M05"	"Other arthritis"	"Rheumatoid arthritis with rheumatoid factor"	1	2193	1150	3343
"M13"	"M06"	"Other arthritis"	"Other rheumatoid arthritis"	1	2633	1821	4454
"M13"	"M46"	"Other arthritis"	"Other inflammatory spondylopathies"	1	405	224	629
"M13"	"M81"	"Other arthritis"	"Osteoporosis without current pathological fracture"	1	1349	700	2049
"M14"	"A41"	"Arthropathies in other diseases classified elsewhere"	"Other sepsis"	1	230	89	319
"M14"	"E86"	"Arthropathies in other diseases classified elsewhere"	"Volume depletion"	1	154	46	200
"M14"	"E87"	"Arthropathies in other diseases classified elsewhere"	"Other disorders of fluid, electrolyte and acid-base balance"	1	135	53	188
"M14"	"N17"	"Arthropathies in other diseases classified elsewhere"	"Acute kidney failure"	1	86	20	106
"M15"	"C18"	"Polyosteoarthritis"	"Malignant neoplasm of colon"	1	189	97	286
"M15"	"C34"	"Polyosteoarthritis"	"Malignant neoplasm of bronchus and lung"	1	324	22	346
"M15"	"C71"	"Polyosteoarthritis"	"Malignant neoplasm of brain"	1	36	3	39
"M15"	"C77"	"Polyosteoarthritis"	"Secondary and unspecified malignant neoplasm of lymph nodes"	1	118	41	159
"M15"	"C78"	"Polyosteoarthritis"	"Secondary malignant neoplasm of resp and digestive organs"	1	254	18	272
"M15"	"C79"	"Polyosteoarthritis"	"Secondary malignant neoplasm of other and unspecified sites"	1	215	8	223
"M15"	"D50"	"Polyosteoarthritis"	"Iron deficiency anemia"	1	337	199	536
"M15"	"D64"	"Polyosteoarthritis"	"Other anemias"	1	1026	500	1526
"M15"	"F03"	"Polyosteoarthritis"	"Unspecified dementia"	1	598	144	742
"M15"	"J96"	"Polyosteoarthritis"	"Respiratory failure, not elsewhere classified"	1	619	78	697
"M15"	"K59"	"Polyosteoarthritis"	"Other functional intestinal disorders"	1	1095	621	1716
"M15"	"N39"	"Polyosteoarthritis"	"Other disorders of urinary system"	1	1172	719	1891
"M16"	"A04"	"Osteoarthritis of hip"	"Other bacterial intestinal infections"	1	947	47	994
"M16"	"A08"	"Osteoarthritis of hip"	"Viral and other specified intestinal infections"	1	441	202	643
"M16"	"A46"	"Osteoarthritis of hip"	"Erysipelas"	1	2676	761	3437
"M16"	"A49"	"Osteoarthritis of hip"	"Bacterial infection of unspecified site"	1	2354	0	2354
"M16"	"B36"	"Osteoarthritis of hip"	"Other superficial mycoses"	1	83	19	102
"M16"	"B37"	"Osteoarthritis of hip"	"Candidiasis"	1	805	153	958
"M16"	"B95"	"Osteoarthritis of hip"	"Strep as the cause of diseases classified elsewhere"	1	137	19	156
"M16"	"B96"	"Osteoarthritis of hip"	"Oth bacterial agents as the cause of diseases classd elswhr"	1	257	8	265
"M16"	"C10"	"Osteoarthritis of hip"	"Malignant neoplasm of oropharynx"	1	74	10	84
"M16"	"C18"	"Osteoarthritis of hip"	"Malignant neoplasm of colon"	1	1656	437	2093
"M16"	"C22"	"Osteoarthritis of hip"	"Malignant neoplasm of liver and intrahepatic bile ducts"	1	270	0	270
"M16"	"C23"	"Osteoarthritis of hip"	"Malignant neoplasm of gallbladder"	1	50	0	50
"M16"	"C26"	"Osteoarthritis of hip"	"Malignant neoplasm of other and ill-defined digestive organs"	1	31	0	31
"M16"	"C34"	"Osteoarthritis of hip"	"Malignant neoplasm of bronchus and lung"	1	2758	0	2758
"M16"	"C38"	"Osteoarthritis of hip"	"Malignant neoplasm of heart, mediastinum and pleura"	1	51	4	55
"M16"	"C41"	"Osteoarthritis of hip"	"Malignant neoplasm of bone/artic cartl of and unsp sites"	1	71	22	93
"M16"	"C45"	"Osteoarthritis of hip"	"Mesothelioma"	1	74	0	74
"M16"	"C48"	"Osteoarthritis of hip"	"Malignant neoplasm of retroperitoneum and peritoneum"	1	51	3	54
"M16"	"C56"	"Osteoarthritis of hip"	"Malignant neoplasm of ovary"	1	290	122	412
"M16"	"C61"	"Osteoarthritis of hip"	"Malignant neoplasm of prostate"	1	1766	653	2419
"M16"	"C65"	"Osteoarthritis of hip"	"Malignant neoplasm of renal pelvis"	1	79	24	103
"M16"	"C71"	"Osteoarthritis of hip"	"Malignant neoplasm of brain"	1	341	13	354
"M16"	"C76"	"Osteoarthritis of hip"	"Malignant neoplasm of other and ill-defined sites"	1	132	39	171
"M16"	"C77"	"Osteoarthritis of hip"	"Secondary and unspecified malignant neoplasm of lymph nodes"	1	775	120	895
"M16"	"C80"	"Osteoarthritis of hip"	"Malignant neoplasm without specification of site"	1	319	2	321
"M16"	"C85"	"Osteoarthritis of hip"	"Oth and unspecified types of non-Hodgkin lymphoma"	1	264	122	386
"M16"	"C88"	"Osteoarthritis of hip"	"Malig immunoproliferative dis and certain oth B-cell lymph"	1	90	21	111
"M16"	"C91"	"Osteoarthritis of hip"	"Lymphoid leukemia"	1	261	96	357
"M16"	"C92"	"Osteoarthritis of hip"	"Myeloid leukemia"	1	191	19	210
"M16"	"C93"	"Osteoarthritis of hip"	"Monocytic leukemia"	1	38	1	39
"M16"	"D09"	"Osteoarthritis of hip"	"Carcinoma in situ of other and unspecified sites"	1	217	16	233
"M16"	"D35"	"Osteoarthritis of hip"	"Benign neoplasm of other and unspecified endocrine glands"	1	239	131	370
"M16"	"D38"	"Osteoarthritis of hip"	"Neoplm of uncrt behav of mid ear & resp and intrathorac org"	1	123	27	150
"M16"	"D47"	"Osteoarthritis of hip"	"Oth neoplm of uncrt behav of lymphoid, hematpoetc & rel tiss"	1	539	70	609
"M16"	"D53"	"Osteoarthritis of hip"	"Other nutritional anemias"	1	110	13	123
"M16"	"D62"	"Osteoarthritis of hip"	"Acute posthemorrhagic anemia"	1	1716	252	1968
"M16"	"D69"	"Osteoarthritis of hip"	"Purpura and other hemorrhagic conditions"	1	445	153	598
"M16"	"D70"	"Osteoarthritis of hip"	"Neutropenia"	1	71	18	89
"M16"	"D72"	"Osteoarthritis of hip"	"Other disorders of white blood cells"	1	143	57	200
"M16"	"E03"	"Osteoarthritis of hip"	"Other hypothyroidism"	1	1686	1014	2700
"M16"	"E10"	"Osteoarthritis of hip"	"Type 1 diabetes mellitus"	1	1843	1207	3050
"M16"	"E11"	"Osteoarthritis of hip"	"Type 2 diabetes mellitus"	1	4597	3223	7820
"M16"	"E13"	"Osteoarthritis of hip"	"Other specified diabetes mellitus"	1	197	45	242
"M16"	"E16"	"Osteoarthritis of hip"	"Other disorders of pancreatic internal secretion"	1	512	150	662
"M16"	"E21"	"Osteoarthritis of hip"	"Hyperparathyroidism and other disorders of parathyroid gland"	1	510	172	682
"M16"	"E41"	"Osteoarthritis of hip"	"Nutritional marasmus"	1	123	0	123
"M16"	"E50"	"Osteoarthritis of hip"	"Vitamin A deficiency"	1	92	8	100
"M16"	"E61"	"Osteoarthritis of hip"	"Deficiency of other nutrient elements"	1	86	7	93
"M16"	"E63"	"Osteoarthritis of hip"	"Other nutritional deficiencies"	1	92	4	96
"M16"	"E64"	"Osteoarthritis of hip"	"Sequelae of malnutrition and other nutritional deficiencies"	1	440	31	471
"M16"	"E70"	"Osteoarthritis of hip"	"Disorders of aromatic amino-acid metabolism"	1	58	15	73
"M16"	"E83"	"Osteoarthritis of hip"	"Disorders of mineral metabolism"	1	664	72	736
"M16"	"E87"	"Osteoarthritis of hip"	"Other disorders of fluid, electrolyte and acid-base balance"	1	4080	0	4080
"M16"	"F01"	"Osteoarthritis of hip"	"Vascular dementia"	1	602	0	602
"M16"	"F03"	"Osteoarthritis of hip"	"Unspecified dementia"	1	3203	0	3203
"M16"	"F06"	"Osteoarthritis of hip"	"Other mental disorders due to known physiological condition"	1	330	18	348
"M16"	"G23"	"Osteoarthritis of hip"	"Other degenerative diseases of basal ganglia"	1	81	1	82
"M16"	"G62"	"Osteoarthritis of hip"	"Other and unspecified polyneuropathies"	1	1208	507	1715
"M16"	"G82"	"Osteoarthritis of hip"	"Paraplegia (paraparesis) and quadriplegia (quadriparesis)"	1	195	96	291
"M16"	"G91"	"Osteoarthritis of hip"	"Hydrocephalus"	1	276	38	314
"M16"	"G93"	"Osteoarthritis of hip"	"Other disorders of brain"	1	205	66	271
"M16"	"G95"	"Osteoarthritis of hip"	"Other and unspecified diseases of spinal cord"	1	554	65	619
"M16"	"G96"	"Osteoarthritis of hip"	"Other disorders of central nervous system"	1	1035	98	1133
"M16"	"H02"	"Osteoarthritis of hip"	"Other disorders of eyelid"	1	1137	753	1890
"M16"	"H34"	"Osteoarthritis of hip"	"Retinal vascular occlusions"	1	556	223	779
"M16"	"H40"	"Osteoarthritis of hip"	"Glaucoma"	1	1022	757	1779
"M16"	"H54"	"Osteoarthritis of hip"	"Blindness and low vision"	1	445	112	557
"M16"	"I11"	"Osteoarthritis of hip"	"Hypertensive heart disease"	1	1050	243	1293
"M16"	"I12"	"Osteoarthritis of hip"	"Hypertensive chronic kidney disease"	1	180	59	239
"M16"	"I21"	"Osteoarthritis of hip"	"Acute myocardial infarction"	1	4301	2240	6541
"M16"	"I25"	"Osteoarthritis of hip"	"Chronic ischemic heart disease"	1	6922	4497	11419
"M16"	"I26"	"Osteoarthritis of hip"	"Pulmonary embolism"	1	2123	431	2554
"M16"	"I27"	"Osteoarthritis of hip"	"Other pulmonary heart diseases"	1	603	96	699
"M16"	"I31"	"Osteoarthritis of hip"	"Other diseases of pericardium"	1	155	58	213
"M16"	"I36"	"Osteoarthritis of hip"	"Nonrheumatic tricuspid valve disorders"	1	100	32	132
"M16"	"I38"	"Osteoarthritis of hip"	"Endocarditis, valve unspecified"	1	143	16	159
"M16"	"I42"	"Osteoarthritis of hip"	"Cardiomyopathy"	1	660	241	901
"M16"	"I46"	"Osteoarthritis of hip"	"Cardiac arrest"	1	1288	0	1288
"M16"	"I49"	"Osteoarthritis of hip"	"Other cardiac arrhythmias"	1	1899	1012	2911
"M16"	"I67"	"Osteoarthritis of hip"	"Other cerebrovascular diseases"	1	364	150	514
"M16"	"I69"	"Osteoarthritis of hip"	"Sequelae of cerebrovascular disease"	1	5587	0	5587
"M16"	"I71"	"Osteoarthritis of hip"	"Aortic aneurysm and dissection"	1	1473	302	1775
"M16"	"I74"	"Osteoarthritis of hip"	"Arterial embolism and thrombosis"	1	448	130	578
"M16"	"I80"	"Osteoarthritis of hip"	"Phlebitis and thrombophlebitis"	1	3111	1630	4741
"M16"	"I81"	"Osteoarthritis of hip"	"Portal vein thrombosis"	1	50	10	60
"M16"	"I82"	"Osteoarthritis of hip"	"Other venous embolism and thrombosis"	1	574	154	728
"M16"	"I89"	"Osteoarthritis of hip"	"Oth noninfective disorders of lymphatic vessels and nodes"	1	321	116	437
"M16"	"I95"	"Osteoarthritis of hip"	"Hypotension"	1	1359	93	1452
"M16"	"I99"	"Osteoarthritis of hip"	"Other and unspecified disorders of circulatory system"	1	197	99	296
"M16"	"J09"	"Osteoarthritis of hip"	"Influenza due to certain identified influenza viruses"	1	131	0	131
"M16"	"J10"	"Osteoarthritis of hip"	"Influenza due to other identified influenza virus"	1	127	0	127
"M16"	"J13"	"Osteoarthritis of hip"	"Pneumonia due to Streptococcus pneumoniae"	1	254	96	350
"M16"	"J15"	"Osteoarthritis of hip"	"Bacterial pneumonia, not elsewhere classified"	1	4421	0	4421
"M16"	"J17"	"Osteoarthritis of hip"	"Pneumonia in diseases classified elsewhere"	1	59	12	71
"M16"	"J18"	"Osteoarthritis of hip"	"Pneumonia, unspecified organism"	1	13987	0	13987
"M16"	"J47"	"Osteoarthritis of hip"	"Bronchiectasis"	1	248	63	311
"M16"	"J84"	"Osteoarthritis of hip"	"Other interstitial pulmonary diseases"	1	582	100	682
"M16"	"J85"	"Osteoarthritis of hip"	"Abscess of lung and mediastinum"	1	80	17	97
"M16"	"J90"	"Osteoarthritis of hip"	"Pleural effusion, not elsewhere classified"	1	962	42	1004
"M16"	"J91"	"Osteoarthritis of hip"	"Pleural effusion in conditions classified elsewhere"	1	382	26	408
"M16"	"J93"	"Osteoarthritis of hip"	"Pneumothorax and air leak"	1	329	111	440
"M16"	"J95"	"Osteoarthritis of hip"	"Intraop and postproc comp and disorders of resp sys, NEC"	1	202	12	214
"M16"	"J96"	"Osteoarthritis of hip"	"Respiratory failure, not elsewhere classified"	1	3905	0	3905
"M16"	"K02"	"Osteoarthritis of hip"	"Dental caries"	1	263	135	398
"M16"	"K08"	"Osteoarthritis of hip"	"Other disorders of teeth and supporting structures"	1	361	225	586
"M16"	"K26"	"Osteoarthritis of hip"	"Duodenal ulcer"	1	1309	893	2202
"M16"	"K31"	"Osteoarthritis of hip"	"Other diseases of stomach and duodenum"	1	303	95	398
"M16"	"K52"	"Osteoarthritis of hip"	"Other and unsp noninfective gastroenteritis and colitis"	1	1807	635	2442
"M16"	"K56"	"Osteoarthritis of hip"	"Paralytic ileus and intestinal obstruction without hernia"	1	1761	406	2167
"M16"	"K57"	"Osteoarthritis of hip"	"Diverticular disease of intestine"	1	4137	2029	6166
"M16"	"K74"	"Osteoarthritis of hip"	"Fibrosis and cirrhosis of liver"	1	322	99	421
"M16"	"K82"	"Osteoarthritis of hip"	"Other diseases of gallbladder"	1	82	25	107
"M16"	"K85"	"Osteoarthritis of hip"	"Acute pancreatitis"	1	577	386	963
"M16"	"K92"	"Osteoarthritis of hip"	"Other diseases of digestive system"	1	3147	0	3147
"M16"	"L82"	"Osteoarthritis of hip"	"Seborrheic keratosis"	1	306	101	407
"M16"	"L95"	"Osteoarthritis of hip"	"Vasculitis limited to skin, not elsewhere classified"	1	108	44	152
"M16"	"L97"	"Osteoarthritis of hip"	"Non-pressure chronic ulcer of lower limb, NEC"	1	1814	0	1814
"M16"	"M00"	"Osteoarthritis of hip"	"Pyogenic arthritis"	1	394	227	621
"M16"	"M10"	"Osteoarthritis of hip"	"Gout"	1	1544	580	2124
"M16"	"M48"	"Osteoarthritis of hip"	"Other spondylopathies"	1	5973	3697	9670
"M16"	"M80"	"Osteoarthritis of hip"	"Osteoporosis with current pathological fracture"	1	2770	661	3431
"M16"	"M86"	"Osteoarthritis of hip"	"Osteomyelitis"	1	333	163	496
"M16"	"M96"	"Osteoarthritis of hip"	"Intraop and postproc comp and disorders of ms sys, NEC"	1	478	176	654
"M16"	"N08"	"Osteoarthritis of hip"	"Glomerular disorders in diseases classified elsewhere"	1	58	11	69
"M16"	"N10"	"Osteoarthritis of hip"	"Acute pyelonephritis"	1	567	309	876
"M16"	"N13"	"Osteoarthritis of hip"	"Obstructive and reflux uropathy"	1	895	225	1120
"M16"	"N19"	"Osteoarthritis of hip"	"Unspecified kidney failure"	1	1377	125	1502
"M16"	"N25"	"Osteoarthritis of hip"	"Disorders resulting from impaired renal tubular function"	1	81	20	101
"M16"	"N28"	"Osteoarthritis of hip"	"Oth disorders of kidney and ureter, not elsewhere classified"	1	551	74	625
"M16"	"Q61"	"Osteoarthritis of hip"	"Cystic kidney disease"	1	216	89	305
"M17"	"A08"	"Osteoarthritis of knee"	"Viral and other specified intestinal infections"	1	479	329	808
"M17"	"A49"	"Osteoarthritis of knee"	"Bacterial infection of unspecified site"	1	2868	0	2868
"M17"	"B44"	"Osteoarthritis of knee"	"Aspergillosis"	1	33	1	34
"M17"	"B59"	"Osteoarthritis of knee"	"Pneumocystosis"	1	32	1	33
"M17"	"C02"	"Osteoarthritis of knee"	"Malignant neoplasm of other and unspecified parts of tongue"	1	56	12	68
"M17"	"C04"	"Osteoarthritis of knee"	"Malignant neoplasm of floor of mouth"	1	45	5	50
"M17"	"C06"	"Osteoarthritis of knee"	"Malignant neoplasm of other and unspecified parts of mouth"	1	154	20	174
"M17"	"C16"	"Osteoarthritis of knee"	"Malignant neoplasm of stomach"	1	470	6	476
"M17"	"C17"	"Osteoarthritis of knee"	"Malignant neoplasm of small intestine"	1	89	2	91
"M17"	"C18"	"Osteoarthritis of knee"	"Malignant neoplasm of colon"	1	1865	395	2260
"M17"	"C23"	"Osteoarthritis of knee"	"Malignant neoplasm of gallbladder"	1	50	0	50
"M17"	"C25"	"Osteoarthritis of knee"	"Malignant neoplasm of pancreas"	1	753	0	753
"M17"	"C26"	"Osteoarthritis of knee"	"Malignant neoplasm of other and ill-defined digestive organs"	1	34	0	34
"M17"	"C38"	"Osteoarthritis of knee"	"Malignant neoplasm of heart, mediastinum and pleura"	1	72	1	73
"M17"	"C41"	"Osteoarthritis of knee"	"Malignant neoplasm of bone/artic cartl of and unsp sites"	1	59	9	68
"M17"	"C44"	"Osteoarthritis of knee"	"Other and unspecified malignant neoplasm of skin"	1	2916	804	3720
"M17"	"C48"	"Osteoarthritis of knee"	"Malignant neoplasm of retroperitoneum and peritoneum"	1	71	2	73
"M17"	"C49"	"Osteoarthritis of knee"	"Malignant neoplasm of other connective and soft tissue"	1	157	46	203
"M17"	"C64"	"Osteoarthritis of knee"	"Malignant neoplasm of kidney, except renal pelvis"	1	487	66	553
"M17"	"C76"	"Osteoarthritis of knee"	"Malignant neoplasm of other and ill-defined sites"	1	133	36	169
"M17"	"C80"	"Osteoarthritis of knee"	"Malignant neoplasm without specification of site"	1	311	0	311
"M17"	"C88"	"Osteoarthritis of knee"	"Malig immunoproliferative dis and certain oth B-cell lymph"	1	103	15	118
"M17"	"C90"	"Osteoarthritis of knee"	"Multiple myeloma and malignant plasma cell neoplasms"	1	362	26	388
"M17"	"C95"	"Osteoarthritis of knee"	"Leukemia of unspecified cell type"	1	71	8	79
"M17"	"D09"	"Osteoarthritis of knee"	"Carcinoma in situ of other and unspecified sites"	1	286	9	295
"M17"	"D12"	"Osteoarthritis of knee"	"Benign neoplasm of colon, rectum, anus and anal canal"	1	7595	0	7595
"M17"	"D43"	"Osteoarthritis of knee"	"Neoplasm of uncertain behavior of brain and cnsl"	1	245	56	301
"M17"	"D47"	"Osteoarthritis of knee"	"Oth neoplm of uncrt behav of lymphoid, hematpoetc & rel tiss"	1	685	58	743
"M17"	"D50"	"Osteoarthritis of knee"	"Iron deficiency anemia"	1	2764	0	2764
"M17"	"D61"	"Osteoarthritis of knee"	"Oth aplastic anemias and other bone marrow failure syndromes"	1	201	19	220
"M17"	"D62"	"Osteoarthritis of knee"	"Acute posthemorrhagic anemia"	1	1589	171	1760
"M17"	"D63"	"Osteoarthritis of knee"	"Anemia in chronic diseases classified elsewhere"	1	1314	0	1314
"M17"	"D64"	"Osteoarthritis of knee"	"Other anemias"	1	8122	0	8122
"M17"	"D69"	"Osteoarthritis of knee"	"Purpura and other hemorrhagic conditions"	1	580	204	784
"M17"	"D84"	"Osteoarthritis of knee"	"Other immunodeficiencies"	1	71	10	81
"M17"	"E03"	"Osteoarthritis of knee"	"Other hypothyroidism"	1	2517	1323	3840
"M17"	"E11"	"Osteoarthritis of knee"	"Type 2 diabetes mellitus"	1	7441	4542	11983
"M17"	"E13"	"Osteoarthritis of knee"	"Other specified diabetes mellitus"	1	313	50	363
"M17"	"E21"	"Osteoarthritis of knee"	"Hyperparathyroidism and other disorders of parathyroid gland"	1	742	231	973
"M17"	"E23"	"Osteoarthritis of knee"	"Hypofunction and other disorders of the pituitary gland"	1	185	90	275
"M17"	"E27"	"Osteoarthritis of knee"	"Other disorders of adrenal gland"	1	306	78	384
"M17"	"E35"	"Osteoarthritis of knee"	"Disorders of endocrine glands in diseases classd elswhr"	1	47	7	54
"M17"	"E41"	"Osteoarthritis of knee"	"Nutritional marasmus"	1	111	0	111
"M17"	"E46"	"Osteoarthritis of knee"	"Unspecified protein-calorie malnutrition"	1	76	0	76
"M17"	"E50"	"Osteoarthritis of knee"	"Vitamin A deficiency"	1	124	8	132
"M17"	"E51"	"Osteoarthritis of knee"	"Thiamine deficiency"	1	67	10	77
"M17"	"E61"	"Osteoarthritis of knee"	"Deficiency of other nutrient elements"	1	99	14	113
"M17"	"E83"	"Osteoarthritis of knee"	"Disorders of mineral metabolism"	1	822	54	876
"M17"	"E86"	"Osteoarthritis of knee"	"Volume depletion"	1	7114	0	7114
"M17"	"F01"	"Osteoarthritis of knee"	"Vascular dementia"	1	709	0	709
"M17"	"F05"	"Osteoarthritis of knee"	"Delirium due to known physiological condition"	1	1206	0	1206
"M17"	"F17"	"Osteoarthritis of knee"	"Nicotine dependence"	1	1322	565	1887
"M17"	"F22"	"Osteoarthritis of knee"	"Delusional disorders"	1	92	29	121
"M17"	"F31"	"Osteoarthritis of knee"	"Bipolar disorder"	1	243	112	355
"M17"	"F32"	"Osteoarthritis of knee"	"Depressive episode"	1	2603	904	3507
"M17"	"F41"	"Osteoarthritis of knee"	"Other anxiety disorders"	1	1162	224	1386
"M17"	"G24"	"Osteoarthritis of knee"	"Dystonia"	1	169	77	246
"M17"	"G30"	"Osteoarthritis of knee"	"Alzheimer's disease"	1	888	0	888
"M17"	"G63"	"Osteoarthritis of knee"	"Polyneuropathy in diseases classified elsewhere"	1	253	54	307
"M17"	"G90"	"Osteoarthritis of knee"	"Disorders of autonomic nervous system"	1	202	79	281
"M17"	"G91"	"Osteoarthritis of knee"	"Hydrocephalus"	1	336	42	378
"M17"	"G95"	"Osteoarthritis of knee"	"Other and unspecified diseases of spinal cord"	1	616	44	660
"M17"	"G96"	"Osteoarthritis of knee"	"Other disorders of central nervous system"	1	1576	184	1760
"M17"	"H02"	"Osteoarthritis of knee"	"Other disorders of eyelid"	1	1891	1060	2951
"M17"	"H34"	"Osteoarthritis of knee"	"Retinal vascular occlusions"	1	665	243	908
"M17"	"H36"	"Osteoarthritis of knee"	"Retinal disorders in diseases classified elsewhere"	1	821	453	1274
"M17"	"H40"	"Osteoarthritis of knee"	"Glaucoma"	1	1303	821	2124
"M17"	"H57"	"Osteoarthritis of knee"	"Other disorders of eye and adnexa"	1	702	303	1005
"M17"	"I00"	"Osteoarthritis of knee"	"Rheumatic fever without heart involvement"	1	103	38	141
"M17"	"I10"	"Osteoarthritis of knee"	"Essential (primary) hypertension"	1	38044	0	38044
"M17"	"I11"	"Osteoarthritis of knee"	"Hypertensive heart disease"	1	1283	300	1583
"M17"	"I12"	"Osteoarthritis of knee"	"Hypertensive chronic kidney disease"	1	198	91	289
"M17"	"I15"	"Osteoarthritis of knee"	"Secondary hypertension"	1	1125	602	1727
"M17"	"I24"	"Osteoarthritis of knee"	"Other acute ischemic heart diseases"	1	333	187	520
"M17"	"I25"	"Osteoarthritis of knee"	"Chronic ischemic heart disease"	1	8298	4838	13136
"M17"	"I27"	"Osteoarthritis of knee"	"Other pulmonary heart diseases"	1	722	88	810
"M17"	"I36"	"Osteoarthritis of knee"	"Nonrheumatic tricuspid valve disorders"	1	129	25	154
"M17"	"I42"	"Osteoarthritis of knee"	"Cardiomyopathy"	1	874	247	1121
"M17"	"I44"	"Osteoarthritis of knee"	"Atrioventricular and left bundle-branch block"	1	1761	263	2024
"M17"	"I50"	"Osteoarthritis of knee"	"Heart failure"	1	11141	0	11141
"M17"	"I60"	"Osteoarthritis of knee"	"Nontraumatic subarachnoid hemorrhage"	1	314	186	500
"M17"	"I61"	"Osteoarthritis of knee"	"Nontraumatic intracerebral hemorrhage"	1	1287	139	1426
"M17"	"I63"	"Osteoarthritis of knee"	"Cerebral infarction"	1	6321	0	6321
"M17"	"I70"	"Osteoarthritis of knee"	"Atherosclerosis"	1	3228	1324	4552
"M17"	"I72"	"Osteoarthritis of knee"	"Other aneurysm"	1	413	87	500
"M17"	"I81"	"Osteoarthritis of knee"	"Portal vein thrombosis"	1	64	17	81
"M17"	"I89"	"Osteoarthritis of knee"	"Oth noninfective disorders of lymphatic vessels and nodes"	1	478	173	651
"M17"	"I95"	"Osteoarthritis of knee"	"Hypotension"	1	1534	124	1658
"M17"	"I97"	"Osteoarthritis of knee"	"Intraop and postproc comp and disorders of circ sys, NEC"	1	193	70	263
"M17"	"J06"	"Osteoarthritis of knee"	"Acute upper resp infections of multiple and unsp sites"	1	495	71	566
"M17"	"J09"	"Osteoarthritis of knee"	"Influenza due to certain identified influenza viruses"	1	183	0	183
"M17"	"J10"	"Osteoarthritis of knee"	"Influenza due to other identified influenza virus"	1	174	0	174
"M17"	"J12"	"Osteoarthritis of knee"	"Viral pneumonia, not elsewhere classified"	1	93	20	113
"M17"	"J14"	"Osteoarthritis of knee"	"Pneumonia due to Hemophilus influenzae"	1	143	17	160
"M17"	"J16"	"Osteoarthritis of knee"	"Pneumonia due to oth infectious organisms, NEC"	1	115	36	151
"M17"	"J18"	"Osteoarthritis of knee"	"Pneumonia, unspecified organism"	1	15187	0	15187
"M17"	"J40"	"Osteoarthritis of knee"	"Bronchitis, not specified as acute or chronic"	1	193	102	295
"M17"	"J43"	"Osteoarthritis of knee"	"Emphysema"	1	358	117	475
"M17"	"J80"	"Osteoarthritis of knee"	"Acute respiratory distress syndrome"	1	67	4	71
"M17"	"J81"	"Osteoarthritis of knee"	"Pulmonary edema"	1	917	13	930
"M17"	"J84"	"Osteoarthritis of knee"	"Other interstitial pulmonary diseases"	1	703	61	764
"M17"	"J91"	"Osteoarthritis of knee"	"Pleural effusion in conditions classified elsewhere"	1	465	28	493
"M17"	"J92"	"Osteoarthritis of knee"	"Pleural plaque"	1	193	63	256
"M17"	"J93"	"Osteoarthritis of knee"	"Pneumothorax and air leak"	1	380	115	495
"M17"	"J95"	"Osteoarthritis of knee"	"Intraop and postproc comp and disorders of resp sys, NEC"	1	237	15	252
"M17"	"K05"	"Osteoarthritis of knee"	"Gingivitis and periodontal diseases"	1	603	316	919
"M17"	"K25"	"Osteoarthritis of knee"	"Gastric ulcer"	1	2558	1498	4056
"M17"	"K28"	"Osteoarthritis of knee"	"Gastrojejunal ulcer"	1	177	52	229
"M17"	"K55"	"Osteoarthritis of knee"	"Vascular disorders of intestine"	1	474	12	486
"M17"	"K56"	"Osteoarthritis of knee"	"Paralytic ileus and intestinal obstruction without hernia"	1	2060	476	2536
"M17"	"K59"	"Osteoarthritis of knee"	"Other functional intestinal disorders"	1	9106	0	9106
"M17"	"K63"	"Osteoarthritis of knee"	"Other diseases of intestine"	1	862	104	966
"M17"	"K65"	"Osteoarthritis of knee"	"Peritonitis"	1	677	234	911
"M17"	"K72"	"Osteoarthritis of knee"	"Hepatic failure, not elsewhere classified"	1	381	42	423
"M17"	"K74"	"Osteoarthritis of knee"	"Fibrosis and cirrhosis of liver"	1	468	113	581
"M17"	"K75"	"Osteoarthritis of knee"	"Other inflammatory liver diseases"	1	126	39	165
"M17"	"K76"	"Osteoarthritis of knee"	"Other diseases of liver"	1	775	482	1257
"M17"	"K81"	"Osteoarthritis of knee"	"Cholecystitis"	1	895	501	1396
"M17"	"K82"	"Osteoarthritis of knee"	"Other diseases of gallbladder"	1	104	36	140
"M17"	"K86"	"Osteoarthritis of knee"	"Other diseases of pancreas"	1	412	171	583
"M17"	"L08"	"Osteoarthritis of knee"	"Other local infections of skin and subcutaneous tissue"	1	1419	940	2359
"M17"	"L12"	"Osteoarthritis of knee"	"Pemphigoid"	1	119	11	130
"M17"	"L28"	"Osteoarthritis of knee"	"Lichen simplex chronicus and prurigo"	1	192	103	295
"M17"	"L57"	"Osteoarthritis of knee"	"Skin changes due to chronic expsr to nonionizing radiation"	1	878	144	1022
"M17"	"L88"	"Osteoarthritis of knee"	"Pyoderma gangrenosum"	1	54	13	67
"M17"	"L89"	"Osteoarthritis of knee"	"Pressure ulcer"	1	1179	0	1179
"M17"	"L95"	"Osteoarthritis of knee"	"Vasculitis limited to skin, not elsewhere classified"	1	134	56	190
"M17"	"L98"	"Osteoarthritis of knee"	"Oth disorders of skin, subcu, not elsewhere classified"	1	1257	372	1629
"M17"	"M00"	"Osteoarthritis of knee"	"Pyogenic arthritis"	1	1089	606	1695
"M17"	"M10"	"Osteoarthritis of knee"	"Gout"	1	2347	1094	3441
"M17"	"M13"	"Osteoarthritis of knee"	"Other arthritis"	1	1781	1395	3176
"M17"	"M15"	"Osteoarthritis of knee"	"Polyosteoarthritis"	1	2364	1275	3639
"M17"	"M19"	"Osteoarthritis of knee"	"Other and unspecified osteoarthritis"	1	8318	4369	12687
"M17"	"M31"	"Osteoarthritis of knee"	"Other necrotizing vasculopathies"	1	536	341	877
"M17"	"N08"	"Osteoarthritis of knee"	"Glomerular disorders in diseases classified elsewhere"	1	61	11	72
"M17"	"N10"	"Osteoarthritis of knee"	"Acute pyelonephritis"	1	751	440	1191
"M17"	"N13"	"Osteoarthritis of knee"	"Obstructive and reflux uropathy"	1	974	312	1286
"M17"	"N15"	"Osteoarthritis of knee"	"Other renal tubulo-interstitial diseases"	1	114	44	158
"M17"	"N17"	"Osteoarthritis of knee"	"Acute kidney failure"	1	1697	0	1697
"M17"	"N19"	"Osteoarthritis of knee"	"Unspecified kidney failure"	1	1509	123	1632
"M17"	"N39"	"Osteoarthritis of knee"	"Other disorders of urinary system"	1	10547	0	10547
"M18"	"A41"	"Osteoarthritis of first carpometacarpal joint"	"Other sepsis"	1	426	67	493
"M18"	"C25"	"Osteoarthritis of first carpometacarpal joint"	"Malignant neoplasm of pancreas"	1	76	0	76
"M18"	"C34"	"Osteoarthritis of first carpometacarpal joint"	"Malignant neoplasm of bronchus and lung"	1	288	9	297
"M18"	"C44"	"Osteoarthritis of first carpometacarpal joint"	"Other and unspecified malignant neoplasm of skin"	1	204	90	294
"M18"	"C71"	"Osteoarthritis of first carpometacarpal joint"	"Malignant neoplasm of brain"	1	30	1	31
"M18"	"C79"	"Osteoarthritis of first carpometacarpal joint"	"Secondary malignant neoplasm of other and unspecified sites"	1	155	0	155
"M18"	"C80"	"Osteoarthritis of first carpometacarpal joint"	"Malignant neoplasm without specification of site"	1	27	1	28
"M18"	"D64"	"Osteoarthritis of first carpometacarpal joint"	"Other anemias"	1	429	149	578
"M18"	"E86"	"Osteoarthritis of first carpometacarpal joint"	"Volume depletion"	1	477	55	532
"M18"	"G20"	"Osteoarthritis of first carpometacarpal joint"	"Parkinson's disease"	1	51	11	62
"M18"	"H25"	"Osteoarthritis of first carpometacarpal joint"	"Age-related cataract"	1	1096	636	1732
"M18"	"I50"	"Osteoarthritis of first carpometacarpal joint"	"Heart failure"	1	454	218	672
"M18"	"I63"	"Osteoarthritis of first carpometacarpal joint"	"Cerebral infarction"	1	388	111	499
"M18"	"J15"	"Osteoarthritis of first carpometacarpal joint"	"Bacterial pneumonia, not elsewhere classified"	1	407	105	512
"M18"	"J69"	"Osteoarthritis of first carpometacarpal joint"	"Pneumonitis due to solids and liquids"	1	34	0	34
"M18"	"J90"	"Osteoarthritis of first carpometacarpal joint"	"Pleural effusion, not elsewhere classified"	1	82	14	96
"M18"	"M81"	"Osteoarthritis of first carpometacarpal joint"	"Osteoporosis without current pathological fracture"	1	605	382	987
"M18"	"N17"	"Osteoarthritis of first carpometacarpal joint"	"Acute kidney failure"	1	108	29	137
"M19"	"B37"	"Other and unspecified osteoarthritis"	"Candidiasis"	1	475	302	777
"M19"	"C10"	"Other and unspecified osteoarthritis"	"Malignant neoplasm of oropharynx"	1	66	15	81
"M19"	"C15"	"Other and unspecified osteoarthritis"	"Malignant neoplasm of esophagus"	1	219	23	242
"M19"	"C22"	"Other and unspecified osteoarthritis"	"Malignant neoplasm of liver and intrahepatic bile ducts"	1	202	21	223
"M19"	"C34"	"Other and unspecified osteoarthritis"	"Malignant neoplasm of bronchus and lung"	1	1341	105	1446
"M19"	"C48"	"Other and unspecified osteoarthritis"	"Malignant neoplasm of retroperitoneum and peritoneum"	1	39	4	43
"M19"	"C71"	"Other and unspecified osteoarthritis"	"Malignant neoplasm of brain"	1	150	26	176
"M19"	"C77"	"Other and unspecified osteoarthritis"	"Secondary and unspecified malignant neoplasm of lymph nodes"	1	472	135	607
"M19"	"C78"	"Other and unspecified osteoarthritis"	"Secondary malignant neoplasm of resp and digestive organs"	1	1280	77	1357
"M19"	"C79"	"Other and unspecified osteoarthritis"	"Secondary malignant neoplasm of other and unspecified sites"	1	774	59	833
"M19"	"C80"	"Other and unspecified osteoarthritis"	"Malignant neoplasm without specification of site"	1	201	9	210
"M19"	"C92"	"Other and unspecified osteoarthritis"	"Myeloid leukemia"	1	116	19	135
"M19"	"D12"	"Other and unspecified osteoarthritis"	"Benign neoplasm of colon, rectum, anus and anal canal"	1	2919	1938	4857
"M19"	"D47"	"Other and unspecified osteoarthritis"	"Oth neoplm of uncrt behav of lymphoid, hematpoetc & rel tiss"	1	332	101	433
"M19"	"D50"	"Other and unspecified osteoarthritis"	"Iron deficiency anemia"	1	1025	584	1609
"M19"	"E41"	"Other and unspecified osteoarthritis"	"Nutritional marasmus"	1	108	7	115
"M19"	"E46"	"Other and unspecified osteoarthritis"	"Unspecified protein-calorie malnutrition"	1	53	6	59
"M19"	"E53"	"Other and unspecified osteoarthritis"	"Deficiency of other B group vitamins"	1	232	128	360
"M19"	"E55"	"Other and unspecified osteoarthritis"	"Vitamin D deficiency"	1	570	380	950
"M19"	"E83"	"Other and unspecified osteoarthritis"	"Disorders of mineral metabolism"	1	445	143	588
"M19"	"E87"	"Other and unspecified osteoarthritis"	"Other disorders of fluid, electrolyte and acid-base balance"	1	2215	784	2999
"M19"	"I27"	"Other and unspecified osteoarthritis"	"Other pulmonary heart diseases"	1	317	135	452
"M19"	"I44"	"Other and unspecified osteoarthritis"	"Atrioventricular and left bundle-branch block"	1	604	355	959
"M19"	"I50"	"Other and unspecified osteoarthritis"	"Heart failure"	1	3060	2242	5302
"M19"	"I69"	"Other and unspecified osteoarthritis"	"Sequelae of cerebrovascular disease"	1	2310	1630	3940
"M19"	"I73"	"Other and unspecified osteoarthritis"	"Other peripheral vascular diseases"	1	1111	882	1993
"M19"	"J10"	"Other and unspecified osteoarthritis"	"Influenza due to other identified influenza virus"	1	121	9	130
"M19"	"J15"	"Other and unspecified osteoarthritis"	"Bacterial pneumonia, not elsewhere classified"	1	2550	781	3331
"M19"	"J22"	"Other and unspecified osteoarthritis"	"Unspecified acute lower respiratory infection"	1	346	92	438
"M19"	"J81"	"Other and unspecified osteoarthritis"	"Pulmonary edema"	1	430	104	534
"M19"	"K59"	"Other and unspecified osteoarthritis"	"Other functional intestinal disorders"	1	3785	2623	6408
"M19"	"K72"	"Other and unspecified osteoarthritis"	"Hepatic failure, not elsewhere classified"	1	235	74	309
"M19"	"N17"	"Other and unspecified osteoarthritis"	"Acute kidney failure"	1	819	233	1052
"M19"	"N18"	"Other and unspecified osteoarthritis"	"Chronic kidney disease (CKD)"	1	1539	582	2121
"M19"	"N39"	"Other and unspecified osteoarthritis"	"Other disorders of urinary system"	1	3422	2705	6127
"M20"	"A04"	"Acquired deformities of fingers and toes"	"Other bacterial intestinal infections"	1	264	33	297
"M20"	"A40"	"Acquired deformities of fingers and toes"	"Streptococcal sepsis"	1	75	18	93
"M20"	"A46"	"Acquired deformities of fingers and toes"	"Erysipelas"	1	734	294	1028
"M20"	"B02"	"Acquired deformities of fingers and toes"	"Zoster [herpes zoster]"	1	168	51	219
"M20"	"C06"	"Acquired deformities of fingers and toes"	"Malignant neoplasm of other and unspecified parts of mouth"	1	45	8	53
"M20"	"C16"	"Acquired deformities of fingers and toes"	"Malignant neoplasm of stomach"	1	97	0	97
"M20"	"C18"	"Acquired deformities of fingers and toes"	"Malignant neoplasm of colon"	1	510	71	581
"M20"	"C56"	"Acquired deformities of fingers and toes"	"Malignant neoplasm of ovary"	1	156	36	192
"M20"	"C77"	"Acquired deformities of fingers and toes"	"Secondary and unspecified malignant neoplasm of lymph nodes"	1	377	19	396
"M20"	"C78"	"Acquired deformities of fingers and toes"	"Secondary malignant neoplasm of resp and digestive organs"	1	693	0	693
"M20"	"C79"	"Acquired deformities of fingers and toes"	"Secondary malignant neoplasm of other and unspecified sites"	1	485	0	485
"M20"	"C80"	"Acquired deformities of fingers and toes"	"Malignant neoplasm without specification of site"	1	62	0	62
"M20"	"C83"	"Acquired deformities of fingers and toes"	"Non-follicular lymphoma"	1	124	8	132
"M20"	"C90"	"Acquired deformities of fingers and toes"	"Multiple myeloma and malignant plasma cell neoplasms"	1	77	1	78
"M20"	"C92"	"Acquired deformities of fingers and toes"	"Myeloid leukemia"	1	52	10	62
"M20"	"D12"	"Acquired deformities of fingers and toes"	"Benign neoplasm of colon, rectum, anus and anal canal"	1	1737	409	2146
"M20"	"D22"	"Acquired deformities of fingers and toes"	"Melanocytic nevi"	1	285	142	427
"M20"	"D43"	"Acquired deformities of fingers and toes"	"Neoplasm of uncertain behavior of brain and cnsl"	1	57	12	69
"M20"	"D46"	"Acquired deformities of fingers and toes"	"Myelodysplastic syndromes"	1	64	0	64
"M20"	"D47"	"Acquired deformities of fingers and toes"	"Oth neoplm of uncrt behav of lymphoid, hematpoetc & rel tiss"	1	195	12	207
"M20"	"D62"	"Acquired deformities of fingers and toes"	"Acute posthemorrhagic anemia"	1	234	42	276
"M20"	"D64"	"Acquired deformities of fingers and toes"	"Other anemias"	1	1576	182	1758
"M20"	"E11"	"Acquired deformities of fingers and toes"	"Type 2 diabetes mellitus"	1	1208	832	2040
"M20"	"E41"	"Acquired deformities of fingers and toes"	"Nutritional marasmus"	1	35	0	35
"M20"	"E78"	"Acquired deformities of fingers and toes"	"Disorders of lipoprotein metabolism and other lipidemias"	1	2182	795	2977
"M20"	"E83"	"Acquired deformities of fingers and toes"	"Disorders of mineral metabolism"	1	242	15	257
"M20"	"F01"	"Acquired deformities of fingers and toes"	"Vascular dementia"	1	126	0	126
"M20"	"F03"	"Acquired deformities of fingers and toes"	"Unspecified dementia"	1	634	0	634
"M20"	"F05"	"Acquired deformities of fingers and toes"	"Delirium due to known physiological condition"	1	232	0	232
"M20"	"F32"	"Acquired deformities of fingers and toes"	"Depressive episode"	1	678	298	976
"M20"	"F41"	"Acquired deformities of fingers and toes"	"Other anxiety disorders"	1	378	72	450
"M20"	"F43"	"Acquired deformities of fingers and toes"	"Reaction to severe stress, and adjustment disorders"	1	280	165	445
"M20"	"G30"	"Acquired deformities of fingers and toes"	"Alzheimer's disease"	1	195	0	195
"M20"	"G31"	"Acquired deformities of fingers and toes"	"Oth degenerative diseases of nervous system, NEC"	1	80	9	89
"M20"	"G45"	"Acquired deformities of fingers and toes"	"Transient cerebral ischemic attacks and related syndromes"	1	876	361	1237
"M20"	"G95"	"Acquired deformities of fingers and toes"	"Other and unspecified diseases of spinal cord"	1	141	19	160
"M20"	"G96"	"Acquired deformities of fingers and toes"	"Other disorders of central nervous system"	1	513	64	577
"M20"	"H18"	"Acquired deformities of fingers and toes"	"Other disorders of cornea"	1	158	76	234
"M20"	"H35"	"Acquired deformities of fingers and toes"	"Other retinal disorders"	1	1278	380	1658
"M20"	"H40"	"Acquired deformities of fingers and toes"	"Glaucoma"	1	387	209	596
"M20"	"H57"	"Acquired deformities of fingers and toes"	"Other disorders of eye and adnexa"	1	310	94	404
"M20"	"H91"	"Acquired deformities of fingers and toes"	"Other and unspecified hearing loss"	1	2110	1373	3483
"M20"	"I11"	"Acquired deformities of fingers and toes"	"Hypertensive heart disease"	1	215	46	261
"M20"	"I15"	"Acquired deformities of fingers and toes"	"Secondary hypertension"	1	261	101	362
"M20"	"I24"	"Acquired deformities of fingers and toes"	"Other acute ischemic heart diseases"	1	98	37	135
"M20"	"I25"	"Acquired deformities of fingers and toes"	"Chronic ischemic heart disease"	1	1577	830	2407
"M20"	"I27"	"Acquired deformities of fingers and toes"	"Other pulmonary heart diseases"	1	150	35	185
"M20"	"I34"	"Acquired deformities of fingers and toes"	"Nonrheumatic mitral valve disorders"	1	332	76	408
"M20"	"I35"	"Acquired deformities of fingers and toes"	"Nonrheumatic aortic valve disorders"	1	1057	48	1105
"M20"	"I42"	"Acquired deformities of fingers and toes"	"Cardiomyopathy"	1	185	62	247
"M20"	"I45"	"Acquired deformities of fingers and toes"	"Other conduction disorders"	1	154	74	228
"M20"	"I50"	"Acquired deformities of fingers and toes"	"Heart failure"	1	1629	301	1930
"M20"	"I72"	"Acquired deformities of fingers and toes"	"Other aneurysm"	1	108	24	132
"M20"	"I87"	"Acquired deformities of fingers and toes"	"Other disorders of veins"	1	148	66	214
"M20"	"J06"	"Acquired deformities of fingers and toes"	"Acute upper resp infections of multiple and unsp sites"	1	201	46	247
"M20"	"J10"	"Acquired deformities of fingers and toes"	"Influenza due to other identified influenza virus"	1	43	0	43
"M20"	"J18"	"Acquired deformities of fingers and toes"	"Pneumonia, unspecified organism"	1	3847	0	3847
"M20"	"J43"	"Acquired deformities of fingers and toes"	"Emphysema"	1	151	34	185
"M20"	"J47"	"Acquired deformities of fingers and toes"	"Bronchiectasis"	1	157	22	179
"M20"	"J84"	"Acquired deformities of fingers and toes"	"Other interstitial pulmonary diseases"	1	224	31	255
"M20"	"J85"	"Acquired deformities of fingers and toes"	"Abscess of lung and mediastinum"	1	35	3	38
"M20"	"J91"	"Acquired deformities of fingers and toes"	"Pleural effusion in conditions classified elsewhere"	1	99	8	107
"M20"	"K05"	"Acquired deformities of fingers and toes"	"Gingivitis and periodontal diseases"	1	196	96	292
"M20"	"K22"	"Acquired deformities of fingers and toes"	"Other diseases of esophagus"	1	348	122	470
"M20"	"K31"	"Acquired deformities of fingers and toes"	"Other diseases of stomach and duodenum"	1	110	27	137
"M20"	"K55"	"Acquired deformities of fingers and toes"	"Vascular disorders of intestine"	1	126	10	136
"M20"	"K57"	"Acquired deformities of fingers and toes"	"Diverticular disease of intestine"	1	1905	429	2334
"M20"	"K59"	"Acquired deformities of fingers and toes"	"Other functional intestinal disorders"	1	2308	605	2913
"M20"	"K62"	"Acquired deformities of fingers and toes"	"Other diseases of anus and rectum"	1	966	494	1460
"M20"	"K63"	"Acquired deformities of fingers and toes"	"Other diseases of intestine"	1	272	29	301
"M20"	"K64"	"Acquired deformities of fingers and toes"	"Hemorrhoids and perianal venous thrombosis"	1	841	2	843
"M20"	"K65"	"Acquired deformities of fingers and toes"	"Peritonitis"	1	150	57	207
"M20"	"K83"	"Acquired deformities of fingers and toes"	"Other diseases of biliary tract"	1	216	42	258
"M20"	"L30"	"Acquired deformities of fingers and toes"	"Other and unspecified dermatitis"	1	403	169	572
"M20"	"L89"	"Acquired deformities of fingers and toes"	"Pressure ulcer"	1	370	45	415
"M20"	"M15"	"Acquired deformities of fingers and toes"	"Polyosteoarthritis"	1	602	337	939
"M20"	"M16"	"Acquired deformities of fingers and toes"	"Osteoarthritis of hip"	1	1787	936	2723
"M20"	"M17"	"Acquired deformities of fingers and toes"	"Osteoarthritis of knee"	1	2910	2175	5085
"M20"	"M47"	"Acquired deformities of fingers and toes"	"Spondylosis"	1	1110	669	1779
"M20"	"M75"	"Acquired deformities of fingers and toes"	"Shoulder lesions"	1	2444	1696	4140
"M20"	"M81"	"Acquired deformities of fingers and toes"	"Osteoporosis without current pathological fracture"	1	2271	506	2777
"M20"	"M86"	"Acquired deformities of fingers and toes"	"Osteomyelitis"	1	276	146	422
"M20"	"N13"	"Acquired deformities of fingers and toes"	"Obstructive and reflux uropathy"	1	292	91	383
"M20"	"N18"	"Acquired deformities of fingers and toes"	"Chronic kidney disease (CKD)"	1	693	39	732
"M20"	"N30"	"Acquired deformities of fingers and toes"	"Cystitis"	1	2455	807	3262
"M20"	"N39"	"Acquired deformities of fingers and toes"	"Other disorders of urinary system"	1	2472	769	3241
"M21"	"A46"	"Other acquired deformities of limbs"	"Erysipelas"	1	427	235	662
"M21"	"C61"	"Other acquired deformities of limbs"	"Malignant neoplasm of prostate"	1	172	52	224
"M21"	"C79"	"Other acquired deformities of limbs"	"Secondary malignant neoplasm of other and unspecified sites"	1	224	9	233
"M21"	"D12"	"Other acquired deformities of limbs"	"Benign neoplasm of colon, rectum, anus and anal canal"	1	617	218	835
"M21"	"D50"	"Other acquired deformities of limbs"	"Iron deficiency anemia"	1	234	82	316
"M21"	"D64"	"Other acquired deformities of limbs"	"Other anemias"	1	724	153	877
"M21"	"E55"	"Other acquired deformities of limbs"	"Vitamin D deficiency"	1	167	76	243
"M21"	"F17"	"Other acquired deformities of limbs"	"Nicotine dependence"	1	197	79	276
"M21"	"G62"	"Other acquired deformities of limbs"	"Other and unspecified polyneuropathies"	1	448	298	746
"M21"	"I44"	"Other acquired deformities of limbs"	"Atrioventricular and left bundle-branch block"	1	146	34	180
"M21"	"I46"	"Other acquired deformities of limbs"	"Cardiac arrest"	1	170	0	170
"M21"	"J15"	"Other acquired deformities of limbs"	"Bacterial pneumonia, not elsewhere classified"	1	607	100	707
"M21"	"J18"	"Other acquired deformities of limbs"	"Pneumonia, unspecified organism"	1	1284	646	1930
"M21"	"J44"	"Other acquired deformities of limbs"	"Other chronic obstructive pulmonary disease"	1	742	337	1079
"M21"	"J84"	"Other acquired deformities of limbs"	"Other interstitial pulmonary diseases"	1	82	19	101
"M21"	"K52"	"Other acquired deformities of limbs"	"Other and unsp noninfective gastroenteritis and colitis"	1	343	203	546
"M21"	"K59"	"Other acquired deformities of limbs"	"Other functional intestinal disorders"	1	1188	519	1707
"M21"	"L89"	"Other acquired deformities of limbs"	"Pressure ulcer"	1	223	59	282
"M21"	"L97"	"Other acquired deformities of limbs"	"Non-pressure chronic ulcer of lower limb, NEC"	1	411	146	557
"M21"	"N18"	"Other acquired deformities of limbs"	"Chronic kidney disease (CKD)"	1	377	54	431
"M21"	"N19"	"Other acquired deformities of limbs"	"Unspecified kidney failure"	1	163	39	202
"M21"	"O72"	"Other acquired deformities of limbs"	"Postpartum hemorrhage"	1	480	28	508
"M21"	"O92"	"Other acquired deformities of limbs"	"Oth disord of brst/lactatn assoc w pregnancy and the puerp"	1	45	8	53
"M22"	"A04"	"Disorder of patella"	"Other bacterial intestinal infections"	1	119	13	132
"M22"	"A46"	"Disorder of patella"	"Erysipelas"	1	305	11	316
"M22"	"A49"	"Disorder of patella"	"Bacterial infection of unspecified site"	1	227	17	244
"M22"	"A63"	"Disorder of patella"	"Oth predominantly sexually transmitted diseases, NEC"	1	543	219	762
"M22"	"B02"	"Disorder of patella"	"Zoster [herpes zoster]"	1	48	5	53
"M22"	"B37"	"Disorder of patella"	"Candidiasis"	1	135	26	161
"M22"	"C53"	"Disorder of patella"	"Malignant neoplasm of cervix uteri"	1	46	2	48
"M22"	"C61"	"Disorder of patella"	"Malignant neoplasm of prostate"	1	48	0	48
"M22"	"C64"	"Disorder of patella"	"Malignant neoplasm of kidney, except renal pelvis"	1	28	0	28
"M22"	"C73"	"Disorder of patella"	"Malignant neoplasm of thyroid gland"	1	30	1	31
"M22"	"D10"	"Disorder of patella"	"Benign neoplasm of mouth and pharynx"	1	83	8	91
"M22"	"D12"	"Disorder of patella"	"Benign neoplasm of colon, rectum, anus and anal canal"	1	436	0	436
"M22"	"D22"	"Disorder of patella"	"Melanocytic nevi"	1	381	49	430
"M22"	"D24"	"Disorder of patella"	"Benign neoplasm of breast"	1	408	112	520
"M22"	"D25"	"Disorder of patella"	"Leiomyoma of uterus"	1	553	98	651
"M22"	"D27"	"Disorder of patella"	"Benign neoplasm of ovary"	1	316	100	416
"M22"	"D30"	"Disorder of patella"	"Benign neoplasm of urinary organs"	1	37	2	39
"M22"	"D35"	"Disorder of patella"	"Benign neoplasm of other and unspecified endocrine glands"	1	55	0	55
"M22"	"D63"	"Disorder of patella"	"Anemia in chronic diseases classified elsewhere"	1	26	0	26
"M22"	"D68"	"Disorder of patella"	"Other coagulation defects"	1	272	4	276
"M22"	"E03"	"Disorder of patella"	"Other hypothyroidism"	1	461	0	461
"M22"	"E06"	"Disorder of patella"	"Thyroiditis"	1	121	8	129
"M22"	"E13"	"Disorder of patella"	"Other specified diabetes mellitus"	1	37	0	37
"M22"	"E27"	"Disorder of patella"	"Other disorders of adrenal gland"	1	41	3	44
"M22"	"E28"	"Disorder of patella"	"Ovarian dysfunction"	1	332	9	341
"M22"	"E64"	"Disorder of patella"	"Sequelae of malnutrition and other nutritional deficiencies"	1	43	0	43
"M22"	"E65"	"Disorder of patella"	"Localized adiposity"	1	187	22	209
"M22"	"E66"	"Disorder of patella"	"Overweight and obesity"	1	2811	0	2811
"M22"	"E73"	"Disorder of patella"	"Lactose intolerance"	1	90	21	111
"M22"	"E83"	"Disorder of patella"	"Disorders of mineral metabolism"	1	72	0	72
"M22"	"E86"	"Disorder of patella"	"Volume depletion"	1	246	19	265
"M22"	"E89"	"Disorder of patella"	"Postproc endocrine and metabolic comp and disorders, NEC"	1	74	0	74
"M22"	"F11"	"Disorder of patella"	"Opioid related disorders"	1	44	6	50
"M22"	"F12"	"Disorder of patella"	"Cannabis related disorders"	1	45	9	54
"M22"	"F17"	"Disorder of patella"	"Nicotine dependence"	1	597	0	597
"M22"	"F33"	"Disorder of patella"	"Major depressive disorder, recurrent"	1	226	0	226
"M22"	"F40"	"Disorder of patella"	"Phobic anxiety disorders"	1	32	2	34
"M22"	"G44"	"Disorder of patella"	"Other headache syndromes"	1	729	138	867
"M22"	"G45"	"Disorder of patella"	"Transient cerebral ischemic attacks and related syndromes"	1	243	0	243
"M22"	"G47"	"Disorder of patella"	"Sleep disorders"	1	701	0	701
"M22"	"G62"	"Disorder of patella"	"Other and unspecified polyneuropathies"	1	123	0	123
"M22"	"G82"	"Disorder of patella"	"Paraplegia (paraparesis) and quadriplegia (quadriparesis)"	1	46	8	54
"M22"	"G93"	"Disorder of patella"	"Other disorders of brain"	1	95	5	100
"M22"	"H02"	"Disorder of patella"	"Other disorders of eyelid"	1	275	11	286
"M22"	"H20"	"Disorder of patella"	"Iridocyclitis"	1	106	11	117
"M22"	"H25"	"Disorder of patella"	"Age-related cataract"	1	325	0	325
"M22"	"H36"	"Disorder of patella"	"Retinal disorders in diseases classified elsewhere"	1	140	0	140
"M22"	"H40"	"Disorder of patella"	"Glaucoma"	1	79	0	79
"M22"	"H43"	"Disorder of patella"	"Disorders of vitreous body"	1	84	0	84
"M22"	"H44"	"Disorder of patella"	"Disorders of globe"	1	81	11	92
"M22"	"H47"	"Disorder of patella"	"Other disorders of optic [2nd] nerve and visual pathways"	1	53	11	64
"M22"	"H52"	"Disorder of patella"	"Disorders of refraction and accommodation"	1	427	153	580
"M22"	"H53"	"Disorder of patella"	"Visual disturbances"	1	279	41	320
"M22"	"H54"	"Disorder of patella"	"Blindness and low vision"	1	73	3	76
"M22"	"H60"	"Disorder of patella"	"Otitis externa"	1	147	58	205
"M22"	"H93"	"Disorder of patella"	"Other disorders of ear, not elsewhere classified"	1	408	57	465
"M22"	"I20"	"Disorder of patella"	"Angina pectoris"	1	799	26	825
"M22"	"I25"	"Disorder of patella"	"Chronic ischemic heart disease"	1	470	0	470
"M22"	"I26"	"Disorder of patella"	"Pulmonary embolism"	1	209	0	209
"M22"	"I27"	"Disorder of patella"	"Other pulmonary heart diseases"	1	30	0	30
"M22"	"I34"	"Disorder of patella"	"Nonrheumatic mitral valve disorders"	1	57	0	57
"M22"	"I42"	"Disorder of patella"	"Cardiomyopathy"	1	73	0	73
"M22"	"I47"	"Disorder of patella"	"Paroxysmal tachycardia"	1	395	65	460
"M22"	"I63"	"Disorder of patella"	"Cerebral infarction"	1	202	0	202
"M22"	"I70"	"Disorder of patella"	"Atherosclerosis"	1	132	0	132
"M22"	"I71"	"Disorder of patella"	"Aortic aneurysm and dissection"	1	66	0	66
"M22"	"I73"	"Disorder of patella"	"Other peripheral vascular diseases"	1	218	0	218
"M22"	"I83"	"Disorder of patella"	"Varicose veins of lower extremities"	1	690	110	800
"M22"	"I86"	"Disorder of patella"	"Varicose veins of other sites"	1	72	21	93
"M22"	"I89"	"Disorder of patella"	"Oth noninfective disorders of lymphatic vessels and nodes"	1	80	1	81
"M22"	"J15"	"Disorder of patella"	"Bacterial pneumonia, not elsewhere classified"	1	297	0	297
"M22"	"J33"	"Disorder of patella"	"Nasal polyp"	1	71	16	87
"M22"	"J34"	"Disorder of patella"	"Other and unspecified disorders of nose and nasal sinuses"	1	557	195	752
"M22"	"J38"	"Disorder of patella"	"Diseases of vocal cords and larynx, not elsewhere classified"	1	167	36	203
"M22"	"J42"	"Disorder of patella"	"Unspecified chronic bronchitis"	1	70	11	81
"M22"	"J90"	"Disorder of patella"	"Pleural effusion, not elsewhere classified"	1	58	0	58
"M22"	"K05"	"Disorder of patella"	"Gingivitis and periodontal diseases"	1	120	0	120
"M22"	"K22"	"Disorder of patella"	"Other diseases of esophagus"	1	171	5	176
"M22"	"K31"	"Disorder of patella"	"Other diseases of stomach and duodenum"	1	40	0	40
"M22"	"K40"	"Disorder of patella"	"Inguinal hernia"	1	475	281	756
"M22"	"K42"	"Disorder of patella"	"Umbilical hernia"	1	292	13	305
"M22"	"K44"	"Disorder of patella"	"Diaphragmatic hernia"	1	562	39	601
"M22"	"K50"	"Disorder of patella"	"Crohn's disease [regional enteritis]"	1	217	30	247
"M22"	"K52"	"Disorder of patella"	"Other and unsp noninfective gastroenteritis and colitis"	1	526	69	595
"M22"	"K59"	"Disorder of patella"	"Other functional intestinal disorders"	1	1483	200	1683
"M22"	"K60"	"Disorder of patella"	"Fissure and fistula of anal and rectal regions"	1	367	75	442
"M22"	"K80"	"Disorder of patella"	"Cholelithiasis"	1	1426	0	1426
"M22"	"K90"	"Disorder of patella"	"Intestinal malabsorption"	1	101	14	115
"M22"	"K92"	"Disorder of patella"	"Other diseases of digestive system"	1	316	27	343
"M22"	"L21"	"Disorder of patella"	"Seborrheic dermatitis"	1	60	16	76
"M22"	"L23"	"Disorder of patella"	"Allergic contact dermatitis"	1	150	45	195
"M22"	"L40"	"Disorder of patella"	"Psoriasis"	1	225	12	237
"M22"	"L70"	"Disorder of patella"	"Acne"	1	83	25	108
"M22"	"L81"	"Disorder of patella"	"Other disorders of pigmentation"	1	64	8	72
"M22"	"L89"	"Disorder of patella"	"Pressure ulcer"	1	35	0	35
"M22"	"L97"	"Disorder of patella"	"Non-pressure chronic ulcer of lower limb, NEC"	1	47	0	47
"M22"	"M05"	"Disorder of patella"	"Rheumatoid arthritis with rheumatoid factor"	1	145	0	145
"M22"	"M06"	"Disorder of patella"	"Other rheumatoid arthritis"	1	223	9	232
"M22"	"M07"	"Disorder of patella"	"Enteropathic arthropathies"	1	193	0	193
"M22"	"M31"	"Disorder of patella"	"Other necrotizing vasculopathies"	1	37	0	37
"M22"	"M46"	"Disorder of patella"	"Other inflammatory spondylopathies"	1	103	0	103
"M22"	"M47"	"Disorder of patella"	"Spondylosis"	1	568	0	568
"M22"	"M50"	"Disorder of patella"	"Cervical disc disorders"	1	606	14	620
"M22"	"M67"	"Disorder of patella"	"Other disorders of synovium and tendon"	1	3465	2443	5908
"M22"	"M77"	"Disorder of patella"	"Other enthesopathies"	1	1044	226	1270
"M22"	"M79"	"Disorder of patella"	"Oth and unsp soft tissue disorders, not elsewhere classified"	1	3675	1591	5266
"M22"	"M81"	"Disorder of patella"	"Osteoporosis without current pathological fracture"	1	320	0	320
"M22"	"M84"	"Disorder of patella"	"Disorder of continuity of bone"	1	116	26	142
"M22"	"M85"	"Disorder of patella"	"Other disorders of bone density and structure"	1	252	0	252
"M22"	"M95"	"Disorder of patella"	"Oth acquired deformities of ms sys and connective tissue"	1	228	88	316
"M22"	"N19"	"Disorder of patella"	"Unspecified kidney failure"	1	38	0	38
"M22"	"N20"	"Disorder of patella"	"Calculus of kidney and ureter"	1	622	71	693
"M22"	"N30"	"Disorder of patella"	"Cystitis"	1	1403	392	1795
"M22"	"N31"	"Disorder of patella"	"Neuromuscular dysfunction of bladder, NEC"	1	87	21	108
"M22"	"N39"	"Disorder of patella"	"Other disorders of urinary system"	1	966	77	1043
"M22"	"N46"	"Disorder of patella"	"Male infertility"	1	407	31	438
"M22"	"N48"	"Disorder of patella"	"Other disorders of penis"	1	127	17	144
"M22"	"N49"	"Disorder of patella"	"Inflammatory disorders of male genital organs, NEC"	1	37	3	40
"M22"	"N62"	"Disorder of patella"	"Hypertrophy of breast"	1	493	196	689
"M22"	"N64"	"Disorder of patella"	"Other disorders of breast"	1	516	71	587
"M22"	"N71"	"Disorder of patella"	"Inflammatory disease of uterus, except cervix"	1	264	86	350
"M22"	"N83"	"Disorder of patella"	"Noninflammatory disord of ovary, fallop and broad ligament"	1	979	189	1168
"M22"	"N89"	"Disorder of patella"	"Other noninflammatory disorders of vagina"	1	81	24	105
"M22"	"N92"	"Disorder of patella"	"Excessive, frequent and irregular menstruation"	1	1816	303	2119
"M22"	"N96"	"Disorder of patella"	"Recurrent pregnancy loss"	1	78	1	79
"M22"	"N97"	"Disorder of patella"	"Female infertility"	1	1123	74	1197
"M22"	"O02"	"Disorder of patella"	"Other abnormal products of conception"	1	1017	145	1162
"M22"	"O03"	"Disorder of patella"	"Spontaneous abortion"	1	958	326	1284
"M22"	"O04"	"Disorder of patella"	"Complications following (induced) termination of pregnancy"	1	1873	1248	3121
"M22"	"O08"	"Disorder of patella"	"Complications following ectopic and molar pregnancy"	1	421	36	457
"M22"	"O12"	"Disorder of patella"	"Gestational edema and proteinuria without hypertension"	1	120	14	134
"M22"	"O13"	"Disorder of patella"	"Gestational hypertension without significant proteinuria"	1	190	2	192
"M22"	"O14"	"Disorder of patella"	"Pre-eclampsia"	1	442	38	480
"M22"	"O20"	"Disorder of patella"	"Hemorrhage in early pregnancy"	1	1070	295	1365
"M22"	"O21"	"Disorder of patella"	"Excessive vomiting in pregnancy"	1	378	9	387
"M22"	"O23"	"Disorder of patella"	"Infections of genitourinary tract in pregnancy"	1	576	40	616
"M22"	"O24"	"Disorder of patella"	"Diabetes in pregnancy, childbirth, and the puerperium"	1	326	0	326
"M22"	"O30"	"Disorder of patella"	"Multiple gestation"	1	255	30	285
"M22"	"O36"	"Disorder of patella"	"Maternal care for other fetal problems"	1	921	45	966
"M22"	"O46"	"Disorder of patella"	"Antepartum hemorrhage, not elsewhere classified"	1	244	38	282
"M22"	"O47"	"Disorder of patella"	"False labor"	1	933	54	987
"M22"	"O62"	"Disorder of patella"	"Abnormalities of forces of labor"	1	2569	633	3202
"M22"	"O63"	"Disorder of patella"	"Long labor"	1	441	29	470
"M22"	"O71"	"Disorder of patella"	"Other obstetric trauma"	1	609	132	741
"M22"	"O75"	"Disorder of patella"	"Oth complications of labor and delivery, NEC"	1	486	19	505
"M22"	"O80"	"Disorder of patella"	"Encounter for full-term uncomplicated delivery"	1	6126	0	6126
"M22"	"O82"	"Disorder of patella"	"Encounter for cesarean delivery without indication"	1	1918	0	1918
"M22"	"O90"	"Disorder of patella"	"Complications of the puerperium, not elsewhere classified"	1	291	0	291
"M22"	"O92"	"Disorder of patella"	"Oth disord of brst/lactatn assoc w pregnancy and the puerp"	1	320	0	320
"M23"	"A41"	"Internal derangement of knee"	"Other sepsis"	1	2439	0	2439
"M23"	"A46"	"Internal derangement of knee"	"Erysipelas"	1	1858	688	2546
"M23"	"A49"	"Internal derangement of knee"	"Bacterial infection of unspecified site"	1	1623	191	1814
"M23"	"B02"	"Internal derangement of knee"	"Zoster [herpes zoster]"	1	293	118	411
"M23"	"B36"	"Internal derangement of knee"	"Other superficial mycoses"	1	147	63	210
"M23"	"C01"	"Internal derangement of knee"	"Malignant neoplasm of base of tongue"	1	35	3	38
"M23"	"C04"	"Internal derangement of knee"	"Malignant neoplasm of floor of mouth"	1	35	0	35
"M23"	"C06"	"Internal derangement of knee"	"Malignant neoplasm of other and unspecified parts of mouth"	1	73	0	73
"M23"	"C09"	"Internal derangement of knee"	"Malignant neoplasm of tonsil"	1	71	5	76
"M23"	"C10"	"Internal derangement of knee"	"Malignant neoplasm of oropharynx"	1	86	1	87
"M23"	"C17"	"Internal derangement of knee"	"Malignant neoplasm of small intestine"	1	57	0	57
"M23"	"C18"	"Internal derangement of knee"	"Malignant neoplasm of colon"	1	890	90	980
"M23"	"C20"	"Internal derangement of knee"	"Malignant neoplasm of rectum"	1	436	65	501
"M23"	"C21"	"Internal derangement of knee"	"Malignant neoplasm of anus and anal canal"	1	46	8	54
"M23"	"C25"	"Internal derangement of knee"	"Malignant neoplasm of pancreas"	1	379	0	379
"M23"	"C32"	"Internal derangement of knee"	"Malignant neoplasm of larynx"	1	71	20	91
"M23"	"C38"	"Internal derangement of knee"	"Malignant neoplasm of heart, mediastinum and pleura"	1	33	1	34
"M23"	"C44"	"Internal derangement of knee"	"Other and unspecified malignant neoplasm of skin"	1	1729	262	1991
"M23"	"C48"	"Internal derangement of knee"	"Malignant neoplasm of retroperitoneum and peritoneum"	1	45	0	45
"M23"	"C49"	"Internal derangement of knee"	"Malignant neoplasm of other connective and soft tissue"	1	184	45	229
"M23"	"C56"	"Internal derangement of knee"	"Malignant neoplasm of ovary"	1	223	58	281
"M23"	"C61"	"Internal derangement of knee"	"Malignant neoplasm of prostate"	1	1591	0	1591
"M23"	"C71"	"Internal derangement of knee"	"Malignant neoplasm of brain"	1	275	10	285
"M23"	"C77"	"Internal derangement of knee"	"Secondary and unspecified malignant neoplasm of lymph nodes"	1	829	21	850
"M23"	"C90"	"Internal derangement of knee"	"Multiple myeloma and malignant plasma cell neoplasms"	1	157	1	158
"M23"	"D05"	"Internal derangement of knee"	"Carcinoma in situ of breast"	1	201	74	275
"M23"	"D09"	"Internal derangement of knee"	"Carcinoma in situ of other and unspecified sites"	1	166	0	166
"M23"	"D10"	"Internal derangement of knee"	"Benign neoplasm of mouth and pharynx"	1	390	188	578
"M23"	"D14"	"Internal derangement of knee"	"Benign neoplasm of middle ear and respiratory system"	1	413	217	630
"M23"	"D17"	"Internal derangement of knee"	"Benign lipomatous neoplasm"	1	2044	1396	3440
"M23"	"D22"	"Internal derangement of knee"	"Melanocytic nevi"	1	1373	555	1928
"M23"	"D32"	"Internal derangement of knee"	"Benign neoplasm of meninges"	1	235	51	286
"M23"	"D35"	"Internal derangement of knee"	"Benign neoplasm of other and unspecified endocrine glands"	1	372	65	437
"M23"	"D43"	"Internal derangement of knee"	"Neoplasm of uncertain behavior of brain and cnsl"	1	188	31	219
"M23"	"D45"	"Internal derangement of knee"	"Polycythemia vera"	1	72	15	87
"M23"	"D47"	"Internal derangement of knee"	"Oth neoplm of uncrt behav of lymphoid, hematpoetc & rel tiss"	1	334	11	345
"M23"	"D50"	"Internal derangement of knee"	"Iron deficiency anemia"	1	973	185	1158
"M23"	"D51"	"Internal derangement of knee"	"Vitamin B12 deficiency anemia"	1	146	61	207
"M23"	"D63"	"Internal derangement of knee"	"Anemia in chronic diseases classified elsewhere"	1	426	0	426
"M23"	"D65"	"Internal derangement of knee"	"Disseminated intravascular coagulation"	1	42	7	49
"M23"	"D69"	"Internal derangement of knee"	"Purpura and other hemorrhagic conditions"	1	418	238	656
"M23"	"D72"	"Internal derangement of knee"	"Other disorders of white blood cells"	1	198	30	228
"M23"	"E21"	"Internal derangement of knee"	"Hyperparathyroidism and other disorders of parathyroid gland"	1	467	82	549
"M23"	"E23"	"Internal derangement of knee"	"Hypofunction and other disorders of the pituitary gland"	1	240	74	314
"M23"	"E26"	"Internal derangement of knee"	"Hyperaldosteronism"	1	42	8	50
"M23"	"E27"	"Internal derangement of knee"	"Other disorders of adrenal gland"	1	242	39	281
"M23"	"E61"	"Internal derangement of knee"	"Deficiency of other nutrient elements"	1	83	8	91
"M23"	"E64"	"Internal derangement of knee"	"Sequelae of malnutrition and other nutritional deficiencies"	1	302	28	330
"M23"	"E83"	"Internal derangement of knee"	"Disorders of mineral metabolism"	1	487	14	501
"M23"	"E85"	"Internal derangement of knee"	"Amyloidosis"	1	49	1	50
"M23"	"E87"	"Internal derangement of knee"	"Other disorders of fluid, electrolyte and acid-base balance"	1	1857	0	1857
"M23"	"F01"	"Internal derangement of knee"	"Vascular dementia"	1	108	0	108
"M23"	"F02"	"Internal derangement of knee"	"Dementia in other diseases classified elsewhere"	1	58	1	59
"M23"	"F05"	"Internal derangement of knee"	"Delirium due to known physiological condition"	1	350	0	350
"M23"	"F06"	"Internal derangement of knee"	"Other mental disorders due to known physiological condition"	1	220	4	224
"M23"	"F32"	"Internal derangement of knee"	"Depressive episode"	1	1281	531	1812
"M23"	"F33"	"Internal derangement of knee"	"Major depressive disorder, recurrent"	1	1112	173	1285
"M23"	"F34"	"Internal derangement of knee"	"Persistent mood [affective] disorders"	1	132	53	185
"M23"	"F43"	"Internal derangement of knee"	"Reaction to severe stress, and adjustment disorders"	1	1204	523	1727
"M23"	"G12"	"Internal derangement of knee"	"Spinal muscular atrophy and related syndromes"	1	125	9	134
"M23"	"G20"	"Internal derangement of knee"	"Parkinson's disease"	1	365	17	382
"M23"	"G23"	"Internal derangement of knee"	"Other degenerative diseases of basal ganglia"	1	43	0	43
"M23"	"G30"	"Internal derangement of knee"	"Alzheimer's disease"	1	243	0	243
"M23"	"G44"	"Internal derangement of knee"	"Other headache syndromes"	1	1712	1090	2802
"M23"	"G45"	"Internal derangement of knee"	"Transient cerebral ischemic attacks and related syndromes"	1	1912	642	2554
"M23"	"G47"	"Internal derangement of knee"	"Sleep disorders"	1	5014	0	5014
"M23"	"G50"	"Internal derangement of knee"	"Disorders of trigeminal nerve"	1	318	162	480
"M23"	"G56"	"Internal derangement of knee"	"Mononeuropathies of upper limb"	1	4577	3196	7773
"M23"	"G61"	"Internal derangement of knee"	"Inflammatory polyneuropathy"	1	106	43	149
"M23"	"G62"	"Internal derangement of knee"	"Other and unspecified polyneuropathies"	1	1177	217	1394
"M23"	"G91"	"Internal derangement of knee"	"Hydrocephalus"	1	176	39	215
"M23"	"H02"	"Internal derangement of knee"	"Other disorders of eyelid"	1	1672	663	2335
"M23"	"H04"	"Internal derangement of knee"	"Disorders of lacrimal system"	1	296	156	452
"M23"	"H18"	"Internal derangement of knee"	"Other disorders of cornea"	1	434	163	597
"M23"	"H26"	"Internal derangement of knee"	"Other cataract"	1	1926	496	2422
"M23"	"H34"	"Internal derangement of knee"	"Retinal vascular occlusions"	1	395	86	481
"M23"	"H43"	"Internal derangement of knee"	"Disorders of vitreous body"	1	1009	291	1300
"M23"	"H47"	"Internal derangement of knee"	"Other disorders of optic [2nd] nerve and visual pathways"	1	162	66	228
"M23"	"H57"	"Internal derangement of knee"	"Other disorders of eye and adnexa"	1	1041	335	1376
"M23"	"H81"	"Internal derangement of knee"	"Disorders of vestibular function"	1	1251	890	2141
"M23"	"H93"	"Internal derangement of knee"	"Other disorders of ear, not elsewhere classified"	1	1888	1281	3169
"M23"	"I10"	"Internal derangement of knee"	"Essential (primary) hypertension"	1	18940	0	18940
"M23"	"I11"	"Internal derangement of knee"	"Hypertensive heart disease"	1	437	78	515
"M23"	"I21"	"Internal derangement of knee"	"Acute myocardial infarction"	1	2374	915	3289
"M23"	"I24"	"Internal derangement of knee"	"Other acute ischemic heart diseases"	1	215	95	310
"M23"	"I25"	"Internal derangement of knee"	"Chronic ischemic heart disease"	1	4057	1466	5523
"M23"	"I31"	"Internal derangement of knee"	"Other diseases of pericardium"	1	172	18	190
"M23"	"I42"	"Internal derangement of knee"	"Cardiomyopathy"	1	576	74	650
"M23"	"I44"	"Internal derangement of knee"	"Atrioventricular and left bundle-branch block"	1	659	88	747
"M23"	"I45"	"Internal derangement of knee"	"Other conduction disorders"	1	431	203	634
"M23"	"I46"	"Internal derangement of knee"	"Cardiac arrest"	1	612	0	612
"M23"	"I49"	"Internal derangement of knee"	"Other cardiac arrhythmias"	1	1899	687	2586
"M23"	"I50"	"Internal derangement of knee"	"Heart failure"	1	2938	0	2938
"M23"	"I67"	"Internal derangement of knee"	"Other cerebrovascular diseases"	1	364	58	422
"M23"	"I70"	"Internal derangement of knee"	"Atherosclerosis"	1	1093	454	1547
"M23"	"I71"	"Internal derangement of knee"	"Aortic aneurysm and dissection"	1	925	7	932
"M23"	"I72"	"Internal derangement of knee"	"Other aneurysm"	1	255	29	284
"M23"	"I85"	"Internal derangement of knee"	"Esophageal varices"	1	197	10	207
"M23"	"I87"	"Internal derangement of knee"	"Other disorders of veins"	1	392	121	513
"M23"	"I89"	"Internal derangement of knee"	"Oth noninfective disorders of lymphatic vessels and nodes"	1	387	126	513
"M23"	"I97"	"Internal derangement of knee"	"Intraop and postproc comp and disorders of circ sys, NEC"	1	97	20	117
"M23"	"J06"	"Internal derangement of knee"	"Acute upper resp infections of multiple and unsp sites"	1	910	137	1047
"M23"	"J09"	"Internal derangement of knee"	"Influenza due to certain identified influenza viruses"	1	139	0	139
"M23"	"J10"	"Internal derangement of knee"	"Influenza due to other identified influenza virus"	1	174	11	185
"M23"	"J18"	"Internal derangement of knee"	"Pneumonia, unspecified organism"	1	7507	0	7507
"M23"	"J44"	"Internal derangement of knee"	"Other chronic obstructive pulmonary disease"	1	4130	0	4130
"M23"	"J47"	"Internal derangement of knee"	"Bronchiectasis"	1	353	30	383
"M23"	"J81"	"Internal derangement of knee"	"Pulmonary edema"	1	205	0	205
"M23"	"J85"	"Internal derangement of knee"	"Abscess of lung and mediastinum"	1	72	6	78
"M23"	"J91"	"Internal derangement of knee"	"Pleural effusion in conditions classified elsewhere"	1	219	12	231
"M23"	"J93"	"Internal derangement of knee"	"Pneumothorax and air leak"	1	332	164	496
"M23"	"J98"	"Internal derangement of knee"	"Other respiratory disorders"	1	474	193	667
"M23"	"K04"	"Internal derangement of knee"	"Diseases of pulp and periapical tissues"	1	661	348	1009
"M23"	"K08"	"Internal derangement of knee"	"Other disorders of teeth and supporting structures"	1	503	248	751
"M23"	"K21"	"Internal derangement of knee"	"Gastro-esophageal reflux disease"	1	3029	2058	5087
"M23"	"K25"	"Internal derangement of knee"	"Gastric ulcer"	1	1040	636	1676
"M23"	"K43"	"Internal derangement of knee"	"Ventral hernia"	1	1088	544	1632
"M23"	"K44"	"Internal derangement of knee"	"Diaphragmatic hernia"	1	1976	1354	3330
"M23"	"K46"	"Internal derangement of knee"	"Unspecified abdominal hernia"	1	125	51	176
"M23"	"K52"	"Internal derangement of knee"	"Other and unsp noninfective gastroenteritis and colitis"	1	1832	765	2597
"M23"	"K55"	"Internal derangement of knee"	"Vascular disorders of intestine"	1	203	4	207
"M23"	"K57"	"Internal derangement of knee"	"Diverticular disease of intestine"	1	5378	0	5378
"M23"	"K62"	"Internal derangement of knee"	"Other diseases of anus and rectum"	1	2832	1161	3993
"M23"	"K64"	"Internal derangement of knee"	"Hemorrhoids and perianal venous thrombosis"	1	2932	0	2932
"M23"	"K65"	"Internal derangement of knee"	"Peritonitis"	1	403	133	536
"M23"	"K70"	"Internal derangement of knee"	"Alcoholic liver disease"	1	520	87	607
"M23"	"K71"	"Internal derangement of knee"	"Toxic liver disease"	1	142	50	192
"M23"	"K72"	"Internal derangement of knee"	"Hepatic failure, not elsewhere classified"	1	242	2	244
"M23"	"K81"	"Internal derangement of knee"	"Cholecystitis"	1	614	252	866
"M23"	"K85"	"Internal derangement of knee"	"Acute pancreatitis"	1	657	293	950
"M23"	"K91"	"Internal derangement of knee"	"Intraop and postproc comp and disorders of dgstv sys, NEC"	1	261	88	349
"M23"	"L08"	"Internal derangement of knee"	"Other local infections of skin and subcutaneous tissue"	1	1694	1098	2792
"M23"	"L28"	"Internal derangement of knee"	"Lichen simplex chronicus and prurigo"	1	197	80	277
"M23"	"L30"	"Internal derangement of knee"	"Other and unspecified dermatitis"	1	1193	529	1722
"M23"	"L57"	"Internal derangement of knee"	"Skin changes due to chronic expsr to nonionizing radiation"	1	658	132	790
"M23"	"L71"	"Internal derangement of knee"	"Rosacea"	1	251	147	398
"M23"	"L72"	"Internal derangement of knee"	"Follicular cysts of skin and subcutaneous tissue"	1	474	310	784
"M23"	"L82"	"Internal derangement of knee"	"Seborrheic keratosis"	1	552	99	651
"M23"	"L90"	"Internal derangement of knee"	"Atrophic disorders of skin"	1	1097	763	1860
"M23"	"L98"	"Internal derangement of knee"	"Oth disorders of skin, subcu, not elsewhere classified"	1	827	281	1108
"M23"	"M00"	"Internal derangement of knee"	"Pyogenic arthritis"	1	906	495	1401
"M23"	"M06"	"Internal derangement of knee"	"Other rheumatoid arthritis"	1	1172	574	1746
"M23"	"M07"	"Internal derangement of knee"	"Enteropathic arthropathies"	1	865	263	1128
"M23"	"M15"	"Internal derangement of knee"	"Polyosteoarthritis"	1	1068	390	1458
"M23"	"M17"	"Internal derangement of knee"	"Osteoarthritis of knee"	1	38866	34498	73364
"M23"	"M18"	"Internal derangement of knee"	"Osteoarthritis of first carpometacarpal joint"	1	1278	364	1642
"M23"	"M31"	"Internal derangement of knee"	"Other necrotizing vasculopathies"	1	332	85	417
"M23"	"M45"	"Internal derangement of knee"	"Ankylosing spondylitis"	1	187	100	287
"M23"	"M46"	"Internal derangement of knee"	"Other inflammatory spondylopathies"	1	516	118	634
"M23"	"M47"	"Internal derangement of knee"	"Spondylosis"	1	3638	1423	5061
"M23"	"M50"	"Internal derangement of knee"	"Cervical disc disorders"	1	2224	1440	3664
"M23"	"M65"	"Internal derangement of knee"	"Synovitis and tenosynovitis"	1	14257	12295	26552
"M23"	"M67"	"Internal derangement of knee"	"Other disorders of synovium and tendon"	1	13486	11864	25350
"M23"	"M70"	"Internal derangement of knee"	"Soft tissue disorders related to use, overuse and pressure"	1	3576	2790	6366
"M23"	"M79"	"Internal derangement of knee"	"Oth and unsp soft tissue disorders, not elsewhere classified"	1	10436	9376	19812
"M23"	"M84"	"Internal derangement of knee"	"Disorder of continuity of bone"	1	382	232	614
"M23"	"N13"	"Internal derangement of knee"	"Obstructive and reflux uropathy"	1	679	227	906
"M23"	"N19"	"Internal derangement of knee"	"Unspecified kidney failure"	1	450	51	501
"M23"	"N28"	"Internal derangement of knee"	"Oth disorders of kidney and ureter, not elsewhere classified"	1	351	71	422
"M23"	"N40"	"Internal derangement of knee"	"Benign prostatic hyperplasia"	1	1689	983	2672
"M23"	"N46"	"Internal derangement of knee"	"Male infertility"	1	1273	612	1885
"M23"	"N49"	"Internal derangement of knee"	"Inflammatory disorders of male genital organs, NEC"	1	183	95	278
"M23"	"N50"	"Internal derangement of knee"	"Other and unspecified disorders of male genital organs"	1	1102	531	1633
"M23"	"N64"	"Internal derangement of knee"	"Other disorders of breast"	1	1013	765	1778
"M23"	"N93"	"Internal derangement of knee"	"Other abnormal uterine and vaginal bleeding"	1	565	379	944
"M23"	"N95"	"Internal derangement of knee"	"Menopausal and other perimenopausal disorders"	1	1459	938	2397
"M23"	"O35"	"Internal derangement of knee"	"Maternal care for known or suspected fetal abnlt and damage"	1	280	69	349
"M23"	"O40"	"Internal derangement of knee"	"Polyhydramnios"	1	157	65	222
"M23"	"O67"	"Internal derangement of knee"	"Labor and delivery comp by intrapartum hemorrhage, NEC"	1	74	19	93
"M23"	"O72"	"Internal derangement of knee"	"Postpartum hemorrhage"	1	6901	0	6901
"M23"	"O92"	"Internal derangement of knee"	"Oth disord of brst/lactatn assoc w pregnancy and the puerp"	1	516	96	612
"M23"	"O99"	"Internal derangement of knee"	"Oth maternal diseases classd elsw but compl preg/chldbrth"	1	3668	1664	5332
"M23"	"Q23"	"Internal derangement of knee"	"Congenital malformations of aortic and mitral valves"	1	96	26	122
"M24"	"A41"	"Other specific joint derangements"	"Other sepsis"	1	451	85	536
"M24"	"A46"	"Other specific joint derangements"	"Erysipelas"	1	341	153	494
"M24"	"A49"	"Other specific joint derangements"	"Bacterial infection of unspecified site"	1	323	85	408
"M24"	"B37"	"Other specific joint derangements"	"Candidiasis"	1	99	40	139
"M24"	"C15"	"Other specific joint derangements"	"Malignant neoplasm of esophagus"	1	26	0	26
"M24"	"C25"	"Other specific joint derangements"	"Malignant neoplasm of pancreas"	1	49	0	49
"M24"	"C78"	"Other specific joint derangements"	"Secondary malignant neoplasm of resp and digestive organs"	1	135	0	135
"M24"	"D17"	"Other specific joint derangements"	"Benign lipomatous neoplasm"	1	289	157	446
"M24"	"D22"	"Other specific joint derangements"	"Melanocytic nevi"	1	205	72	277
"M24"	"D63"	"Other specific joint derangements"	"Anemia in chronic diseases classified elsewhere"	1	63	8	71
"M24"	"E03"	"Other specific joint derangements"	"Other hypothyroidism"	1	284	110	394
"M24"	"E13"	"Other specific joint derangements"	"Other specified diabetes mellitus"	1	42	7	49
"M24"	"E66"	"Other specific joint derangements"	"Overweight and obesity"	1	988	456	1444
"M24"	"E78"	"Other specific joint derangements"	"Disorders of lipoprotein metabolism and other lipidemias"	1	733	221	954
"M24"	"E86"	"Other specific joint derangements"	"Volume depletion"	1	468	180	648
"M24"	"G45"	"Other specific joint derangements"	"Transient cerebral ischemic attacks and related syndromes"	1	207	107	314
"M24"	"G62"	"Other specific joint derangements"	"Other and unspecified polyneuropathies"	1	140	64	204
"M24"	"H25"	"Other specific joint derangements"	"Age-related cataract"	1	603	319	922
"M24"	"H36"	"Other specific joint derangements"	"Retinal disorders in diseases classified elsewhere"	1	102	38	140
"M24"	"I25"	"Other specific joint derangements"	"Chronic ischemic heart disease"	1	568	286	854
"M24"	"I34"	"Other specific joint derangements"	"Nonrheumatic mitral valve disorders"	1	84	19	103
"M24"	"I35"	"Other specific joint derangements"	"Nonrheumatic aortic valve disorders"	1	205	43	248
"M24"	"I46"	"Other specific joint derangements"	"Cardiac arrest"	1	112	0	112
"M24"	"I48"	"Other specific joint derangements"	"Atrial fibrillation and flutter"	1	633	229	862
"M24"	"I49"	"Other specific joint derangements"	"Other cardiac arrhythmias"	1	226	128	354
"M24"	"I50"	"Other specific joint derangements"	"Heart failure"	1	509	153	662
"M24"	"I63"	"Other specific joint derangements"	"Cerebral infarction"	1	323	114	437
"M24"	"I71"	"Other specific joint derangements"	"Aortic aneurysm and dissection"	1	123	21	144
"M24"	"I73"	"Other specific joint derangements"	"Other peripheral vascular diseases"	1	214	67	281
"M24"	"I80"	"Other specific joint derangements"	"Phlebitis and thrombophlebitis"	1	362	206	568
"M24"	"J15"	"Other specific joint derangements"	"Bacterial pneumonia, not elsewhere classified"	1	427	86	513
"M24"	"J18"	"Other specific joint derangements"	"Pneumonia, unspecified organism"	1	1056	612	1668
"M24"	"J43"	"Other specific joint derangements"	"Emphysema"	1	54	14	68
"M24"	"J84"	"Other specific joint derangements"	"Other interstitial pulmonary diseases"	1	79	10	89
"M24"	"J90"	"Other specific joint derangements"	"Pleural effusion, not elsewhere classified"	1	85	15	100
"M24"	"K22"	"Other specific joint derangements"	"Other diseases of esophagus"	1	121	54	175
"M24"	"K43"	"Other specific joint derangements"	"Ventral hernia"	1	161	71	232
"M24"	"K56"	"Other specific joint derangements"	"Paralytic ileus and intestinal obstruction without hernia"	1	191	74	265
"M24"	"K57"	"Other specific joint derangements"	"Diverticular disease of intestine"	1	477	105	582
"M24"	"K62"	"Other specific joint derangements"	"Other diseases of anus and rectum"	1	383	197	580
"M24"	"K63"	"Other specific joint derangements"	"Other diseases of intestine"	1	90	20	110
"M24"	"K83"	"Other specific joint derangements"	"Other diseases of biliary tract"	1	67	17	84
"M24"	"K92"	"Other specific joint derangements"	"Other diseases of digestive system"	1	302	119	421
"M24"	"L30"	"Other specific joint derangements"	"Other and unspecified dermatitis"	1	208	112	320
"M24"	"M50"	"Other specific joint derangements"	"Cervical disc disorders"	1	348	216	564
"M24"	"M51"	"Other specific joint derangements"	"Thoracic, thoracolum, and lumbosacral intvrt disc disorders"	1	939	690	1629
"M24"	"M81"	"Other specific joint derangements"	"Osteoporosis without current pathological fracture"	1	416	130	546
"M24"	"N39"	"Other specific joint derangements"	"Other disorders of urinary system"	1	651	331	982
"M24"	"N46"	"Other specific joint derangements"	"Male infertility"	1	250	81	331
"M24"	"N93"	"Other specific joint derangements"	"Other abnormal uterine and vaginal bleeding"	1	102	38	140
"M24"	"O70"	"Other specific joint derangements"	"Perineal laceration during delivery"	1	700	448	1148
"M24"	"O99"	"Other specific joint derangements"	"Oth maternal diseases classd elsw but compl preg/chldbrth"	1	629	295	924
"M25"	"A41"	"Other joint disorder, not elsewhere classified"	"Other sepsis"	1	1287	383	1670
"M25"	"C10"	"Other joint disorder, not elsewhere classified"	"Malignant neoplasm of oropharynx"	1	31	2	33
"M25"	"C15"	"Other joint disorder, not elsewhere classified"	"Malignant neoplasm of esophagus"	1	57	0	57
"M25"	"C16"	"Other joint disorder, not elsewhere classified"	"Malignant neoplasm of stomach"	1	61	10	71
"M25"	"C25"	"Other joint disorder, not elsewhere classified"	"Malignant neoplasm of pancreas"	1	150	2	152
"M25"	"C34"	"Other joint disorder, not elsewhere classified"	"Malignant neoplasm of bronchus and lung"	1	685	68	753
"M25"	"C61"	"Other joint disorder, not elsewhere classified"	"Malignant neoplasm of prostate"	1	345	126	471
"M25"	"C78"	"Other joint disorder, not elsewhere classified"	"Secondary malignant neoplasm of resp and digestive organs"	1	560	17	577
"M25"	"D47"	"Other joint disorder, not elsewhere classified"	"Oth neoplm of uncrt behav of lymphoid, hematpoetc & rel tiss"	1	282	106	388
"M25"	"D64"	"Other joint disorder, not elsewhere classified"	"Other anemias"	1	1242	698	1940
"M25"	"E86"	"Other joint disorder, not elsewhere classified"	"Volume depletion"	1	1307	420	1727
"M25"	"F17"	"Other joint disorder, not elsewhere classified"	"Nicotine dependence"	1	600	393	993
"M25"	"F41"	"Other joint disorder, not elsewhere classified"	"Other anxiety disorders"	1	438	236	674
"M25"	"G62"	"Other joint disorder, not elsewhere classified"	"Other and unspecified polyneuropathies"	1	661	404	1065
"M25"	"G96"	"Other joint disorder, not elsewhere classified"	"Other disorders of central nervous system"	1	490	158	648
"M25"	"H26"	"Other joint disorder, not elsewhere classified"	"Other cataract"	1	603	428	1031
"M25"	"I48"	"Other joint disorder, not elsewhere classified"	"Atrial fibrillation and flutter"	1	1439	1101	2540
"M25"	"I50"	"Other joint disorder, not elsewhere classified"	"Heart failure"	1	1126	668	1794
"M25"	"I61"	"Other joint disorder, not elsewhere classified"	"Nontraumatic intracerebral hemorrhage"	1	239	72	311
"M25"	"I63"	"Other joint disorder, not elsewhere classified"	"Cerebral infarction"	1	851	400	1251
"M25"	"I85"	"Other joint disorder, not elsewhere classified"	"Esophageal varices"	1	88	30	118
"M25"	"J44"	"Other joint disorder, not elsewhere classified"	"Other chronic obstructive pulmonary disease"	1	1388	905	2293
"M25"	"J96"	"Other joint disorder, not elsewhere classified"	"Respiratory failure, not elsewhere classified"	1	1096	175	1271
"M25"	"K56"	"Other joint disorder, not elsewhere classified"	"Paralytic ileus and intestinal obstruction without hernia"	1	410	262	672
"M25"	"K72"	"Other joint disorder, not elsewhere classified"	"Hepatic failure, not elsewhere classified"	1	115	40	155
"M25"	"L89"	"Other joint disorder, not elsewhere classified"	"Pressure ulcer"	1	229	49	278
"M25"	"L97"	"Other joint disorder, not elsewhere classified"	"Non-pressure chronic ulcer of lower limb, NEC"	1	351	121	472
"M25"	"M06"	"Other joint disorder, not elsewhere classified"	"Other rheumatoid arthritis"	1	1576	1294	2870
"M25"	"M19"	"Other joint disorder, not elsewhere classified"	"Other and unspecified osteoarthritis"	1	2581	2072	4653
"M25"	"M85"	"Other joint disorder, not elsewhere classified"	"Other disorders of bone density and structure"	1	1271	523	1794
"M25"	"O72"	"Other joint disorder, not elsewhere classified"	"Postpartum hemorrhage"	1	1433	872	2305
"M30"	"M85"	"Polyarteritis nodosa and related conditions"	"Other disorders of bone density and structure"	1	62	15	77
"M31"	"A46"	"Other necrotizing vasculopathies"	"Erysipelas"	1	380	156	536
"M31"	"A49"	"Other necrotizing vasculopathies"	"Bacterial infection of unspecified site"	1	458	161	619
"M31"	"C15"	"Other necrotizing vasculopathies"	"Malignant neoplasm of esophagus"	1	34	3	37
"M31"	"C16"	"Other necrotizing vasculopathies"	"Malignant neoplasm of stomach"	1	42	6	48
"M31"	"C18"	"Other necrotizing vasculopathies"	"Malignant neoplasm of colon"	1	179	77	256
"M31"	"C34"	"Other necrotizing vasculopathies"	"Malignant neoplasm of bronchus and lung"	1	355	60	415
"M31"	"C78"	"Other necrotizing vasculopathies"	"Secondary malignant neoplasm of resp and digestive organs"	1	261	20	281
"M31"	"C79"	"Other necrotizing vasculopathies"	"Secondary malignant neoplasm of other and unspecified sites"	1	164	20	184
"M31"	"D63"	"Other necrotizing vasculopathies"	"Anemia in chronic diseases classified elsewhere"	1	219	83	302
"M31"	"D68"	"Other necrotizing vasculopathies"	"Other coagulation defects"	1	160	73	233
"M31"	"G20"	"Other necrotizing vasculopathies"	"Parkinson's disease"	1	84	27	111
"M31"	"H26"	"Other necrotizing vasculopathies"	"Other cataract"	1	551	317	868
"M31"	"H57"	"Other necrotizing vasculopathies"	"Other disorders of eye and adnexa"	1	259	148	407
"M31"	"I35"	"Other necrotizing vasculopathies"	"Nonrheumatic aortic valve disorders"	1	588	152	740
"M31"	"I63"	"Other necrotizing vasculopathies"	"Cerebral infarction"	1	659	387	1046
"M31"	"I71"	"Other necrotizing vasculopathies"	"Aortic aneurysm and dissection"	1	291	55	346
"M31"	"J09"	"Other necrotizing vasculopathies"	"Influenza due to certain identified influenza viruses"	1	42	5	47
"M31"	"J15"	"Other necrotizing vasculopathies"	"Bacterial pneumonia, not elsewhere classified"	1	850	196	1046
"M31"	"J81"	"Other necrotizing vasculopathies"	"Pulmonary edema"	1	206	52	258
"M31"	"K52"	"Other necrotizing vasculopathies"	"Other and unsp noninfective gastroenteritis and colitis"	1	330	155	485
"M31"	"L97"	"Other necrotizing vasculopathies"	"Non-pressure chronic ulcer of lower limb, NEC"	1	313	80	393
"M31"	"L98"	"Other necrotizing vasculopathies"	"Oth disorders of skin, subcu, not elsewhere classified"	1	235	132	367
"M31"	"M35"	"Other necrotizing vasculopathies"	"Other systemic involvement of connective tissue"	1	2334	1891	4225
"M31"	"N30"	"Other necrotizing vasculopathies"	"Cystitis"	1	1360	616	1976
"M31"	"N39"	"Other necrotizing vasculopathies"	"Other disorders of urinary system"	1	1086	343	1429
"M32"	"A09"	"Systemic lupus erythematosus (SLE)"	"Infectious gastroenteritis and colitis, unspecified"	1	114	42	156
"M32"	"A18"	"Systemic lupus erythematosus (SLE)"	"Tuberculosis of other organs"	1	92	11	103
"M32"	"A41"	"Systemic lupus erythematosus (SLE)"	"Other sepsis"	1	219	37	256
"M32"	"B02"	"Systemic lupus erythematosus (SLE)"	"Zoster [herpes zoster]"	1	48	9	57
"M32"	"B07"	"Systemic lupus erythematosus (SLE)"	"Viral warts"	1	34	1	35
"M32"	"C78"	"Systemic lupus erythematosus (SLE)"	"Secondary malignant neoplasm of resp and digestive organs"	1	42	0	42
"M32"	"D64"	"Systemic lupus erythematosus (SLE)"	"Other anemias"	1	162	80	242
"M32"	"D68"	"Systemic lupus erythematosus (SLE)"	"Other coagulation defects"	1	227	87	314
"M32"	"E86"	"Systemic lupus erythematosus (SLE)"	"Volume depletion"	1	129	11	140
"M32"	"H26"	"Systemic lupus erythematosus (SLE)"	"Other cataract"	1	91	17	108
"M32"	"H35"	"Systemic lupus erythematosus (SLE)"	"Other retinal disorders"	1	120	31	151
"M32"	"H53"	"Systemic lupus erythematosus (SLE)"	"Visual disturbances"	1	68	20	88
"M32"	"H57"	"Systemic lupus erythematosus (SLE)"	"Other disorders of eye and adnexa"	1	107	24	131
"M32"	"I21"	"Systemic lupus erythematosus (SLE)"	"Acute myocardial infarction"	1	104	41	145
"M32"	"I34"	"Systemic lupus erythematosus (SLE)"	"Nonrheumatic mitral valve disorders"	1	62	15	77
"M32"	"I35"	"Systemic lupus erythematosus (SLE)"	"Nonrheumatic aortic valve disorders"	1	88	13	101
"M32"	"I46"	"Systemic lupus erythematosus (SLE)"	"Cardiac arrest"	1	37	2	39
"M32"	"I48"	"Systemic lupus erythematosus (SLE)"	"Atrial fibrillation and flutter"	1	165	45	210
"M32"	"I50"	"Systemic lupus erythematosus (SLE)"	"Heart failure"	1	167	43	210
"M32"	"I63"	"Systemic lupus erythematosus (SLE)"	"Cerebral infarction"	1	126	43	169
"M32"	"J15"	"Systemic lupus erythematosus (SLE)"	"Bacterial pneumonia, not elsewhere classified"	1	167	30	197
"M32"	"J44"	"Systemic lupus erythematosus (SLE)"	"Other chronic obstructive pulmonary disease"	1	185	49	234
"M32"	"J96"	"Systemic lupus erythematosus (SLE)"	"Respiratory failure, not elsewhere classified"	1	127	9	136
"M32"	"K62"	"Systemic lupus erythematosus (SLE)"	"Other diseases of anus and rectum"	1	81	27	108
"M32"	"K92"	"Systemic lupus erythematosus (SLE)"	"Other diseases of digestive system"	1	66	12	78
"M32"	"L57"	"Systemic lupus erythematosus (SLE)"	"Skin changes due to chronic expsr to nonionizing radiation"	1	36	1	37
"M32"	"L89"	"Systemic lupus erythematosus (SLE)"	"Pressure ulcer"	1	41	2	43
"M32"	"L97"	"Systemic lupus erythematosus (SLE)"	"Non-pressure chronic ulcer of lower limb, NEC"	1	49	3	52
"M32"	"M80"	"Systemic lupus erythematosus (SLE)"	"Osteoporosis with current pathological fracture"	1	97	21	118
"M32"	"M81"	"Systemic lupus erythematosus (SLE)"	"Osteoporosis without current pathological fracture"	1	325	25	350
"M32"	"M85"	"Systemic lupus erythematosus (SLE)"	"Other disorders of bone density and structure"	1	231	27	258
"M32"	"N08"	"Systemic lupus erythematosus (SLE)"	"Glomerular disorders in diseases classified elsewhere"	1	71	20	91
"M32"	"N30"	"Systemic lupus erythematosus (SLE)"	"Cystitis"	1	241	84	325
"M33"	"A41"	"Dermatopolymyositis"	"Other sepsis"	1	110	29	139
"M33"	"C79"	"Dermatopolymyositis"	"Secondary malignant neoplasm of other and unspecified sites"	1	27	1	28
"M34"	"A41"	"Systemic sclerosis [scleroderma]"	"Other sepsis"	1	103	32	135
"M34"	"A49"	"Systemic sclerosis [scleroderma]"	"Bacterial infection of unspecified site"	1	52	7	59
"M34"	"C78"	"Systemic sclerosis [scleroderma]"	"Secondary malignant neoplasm of resp and digestive organs"	1	33	0	33
"M34"	"E86"	"Systemic sclerosis [scleroderma]"	"Volume depletion"	1	118	23	141
"M34"	"I35"	"Systemic sclerosis [scleroderma]"	"Nonrheumatic aortic valve disorders"	1	108	23	131
"M34"	"J15"	"Systemic sclerosis [scleroderma]"	"Bacterial pneumonia, not elsewhere classified"	1	102	15	117
"M34"	"J96"	"Systemic sclerosis [scleroderma]"	"Respiratory failure, not elsewhere classified"	1	142	22	164
"M34"	"K08"	"Systemic sclerosis [scleroderma]"	"Other disorders of teeth and supporting structures"	1	35	3	38
"M34"	"K59"	"Systemic sclerosis [scleroderma]"	"Other functional intestinal disorders"	1	142	57	199
"M34"	"M80"	"Systemic sclerosis [scleroderma]"	"Osteoporosis with current pathological fracture"	1	74	4	78
"M35"	"A49"	"Other systemic involvement of connective tissue"	"Bacterial infection of unspecified site"	1	905	252	1157
"M35"	"B37"	"Other systemic involvement of connective tissue"	"Candidiasis"	1	456	279	735
"M35"	"C15"	"Other systemic involvement of connective tissue"	"Malignant neoplasm of esophagus"	1	77	14	91
"M35"	"C22"	"Other systemic involvement of connective tissue"	"Malignant neoplasm of liver and intrahepatic bile ducts"	1	62	0	62
"M35"	"C25"	"Other systemic involvement of connective tissue"	"Malignant neoplasm of pancreas"	1	182	15	197
"M35"	"C34"	"Other systemic involvement of connective tissue"	"Malignant neoplasm of bronchus and lung"	1	680	142	822
"M35"	"C71"	"Other systemic involvement of connective tissue"	"Malignant neoplasm of brain"	1	86	19	105
"M35"	"C79"	"Other systemic involvement of connective tissue"	"Secondary malignant neoplasm of other and unspecified sites"	1	411	53	464
"M35"	"D46"	"Other systemic involvement of connective tissue"	"Myelodysplastic syndromes"	1	140	63	203
"M35"	"D50"	"Other systemic involvement of connective tissue"	"Iron deficiency anemia"	1	841	420	1261
"M35"	"D62"	"Other systemic involvement of connective tissue"	"Acute posthemorrhagic anemia"	1	382	117	499
"M35"	"D64"	"Other systemic involvement of connective tissue"	"Other anemias"	1	2403	1247	3650
"M35"	"E46"	"Other systemic involvement of connective tissue"	"Unspecified protein-calorie malnutrition"	1	43	6	49
"M35"	"E86"	"Other systemic involvement of connective tissue"	"Volume depletion"	1	3437	0	3437
"M35"	"E87"	"Other systemic involvement of connective tissue"	"Other disorders of fluid, electrolyte and acid-base balance"	1	1344	295	1639
"M35"	"F17"	"Other systemic involvement of connective tissue"	"Nicotine dependence"	1	289	109	398
"M35"	"F33"	"Other systemic involvement of connective tissue"	"Major depressive disorder, recurrent"	1	562	166	728
"M35"	"F41"	"Other systemic involvement of connective tissue"	"Other anxiety disorders"	1	345	99	444
"M35"	"G62"	"Other systemic involvement of connective tissue"	"Other and unspecified polyneuropathies"	1	619	357	976
"M35"	"G96"	"Other systemic involvement of connective tissue"	"Other disorders of central nervous system"	1	458	101	559
"M35"	"H26"	"Other systemic involvement of connective tissue"	"Other cataract"	1	1031	719	1750
"M35"	"H35"	"Other systemic involvement of connective tissue"	"Other retinal disorders"	1	1162	921	2083
"M35"	"H54"	"Other systemic involvement of connective tissue"	"Blindness and low vision"	1	208	113	321
"M35"	"H57"	"Other systemic involvement of connective tissue"	"Other disorders of eye and adnexa"	1	521	292	813
"M35"	"I11"	"Other systemic involvement of connective tissue"	"Hypertensive heart disease"	1	343	194	537
"M35"	"I26"	"Other systemic involvement of connective tissue"	"Pulmonary embolism"	1	719	380	1099
"M35"	"I27"	"Other systemic involvement of connective tissue"	"Other pulmonary heart diseases"	1	227	91	318
"M35"	"I50"	"Other systemic involvement of connective tissue"	"Heart failure"	1	2627	1356	3983
"M35"	"I95"	"Other systemic involvement of connective tissue"	"Hypotension"	1	550	166	716
"M35"	"J18"	"Other systemic involvement of connective tissue"	"Pneumonia, unspecified organism"	1	4615	2407	7022
"M35"	"J22"	"Other systemic involvement of connective tissue"	"Unspecified acute lower respiratory infection"	1	267	71	338
"M35"	"J84"	"Other systemic involvement of connective tissue"	"Other interstitial pulmonary diseases"	1	434	258	692
"M35"	"J90"	"Other systemic involvement of connective tissue"	"Pleural effusion, not elsewhere classified"	1	261	89	350
"M35"	"J91"	"Other systemic involvement of connective tissue"	"Pleural effusion in conditions classified elsewhere"	1	114	36	150
"M35"	"K56"	"Other systemic involvement of connective tissue"	"Paralytic ileus and intestinal obstruction without hernia"	1	603	239	842
"M35"	"K59"	"Other systemic involvement of connective tissue"	"Other functional intestinal disorders"	1	2561	1182	3743
"M35"	"L30"	"Other systemic involvement of connective tissue"	"Other and unspecified dermatitis"	1	398	266	664
"M35"	"L57"	"Other systemic involvement of connective tissue"	"Skin changes due to chronic expsr to nonionizing radiation"	1	244	85	329
"M35"	"L97"	"Other systemic involvement of connective tissue"	"Non-pressure chronic ulcer of lower limb, NEC"	1	652	123	775
"M35"	"L98"	"Other systemic involvement of connective tissue"	"Oth disorders of skin, subcu, not elsewhere classified"	1	620	234	854
"M35"	"M19"	"Other systemic involvement of connective tissue"	"Other and unspecified osteoarthritis"	1	1313	941	2254
"M35"	"M48"	"Other systemic involvement of connective tissue"	"Other spondylopathies"	1	1334	852	2186
"M35"	"M80"	"Other systemic involvement of connective tissue"	"Osteoporosis with current pathological fracture"	1	1983	797	2780
"M35"	"M81"	"Other systemic involvement of connective tissue"	"Osteoporosis without current pathological fracture"	1	4134	2136	6270
"M35"	"N19"	"Other systemic involvement of connective tissue"	"Unspecified kidney failure"	1	555	161	716
"M35"	"N39"	"Other systemic involvement of connective tissue"	"Other disorders of urinary system"	1	2775	1069	3844
"M40"	"C34"	"Kyphosis and lordosis"	"Malignant neoplasm of bronchus and lung"	1	34	1	35
"M40"	"J96"	"Kyphosis and lordosis"	"Respiratory failure, not elsewhere classified"	1	155	77	232
"M40"	"M23"	"Kyphosis and lordosis"	"Internal derangement of knee"	1	116	40	156
"M40"	"O70"	"Kyphosis and lordosis"	"Perineal laceration during delivery"	1	66	11	77
"M40"	"O72"	"Kyphosis and lordosis"	"Postpartum hemorrhage"	1	54	0	54
"M40"	"O99"	"Kyphosis and lordosis"	"Oth maternal diseases classd elsw but compl preg/chldbrth"	1	58	4	62
"M41"	"A49"	"Scoliosis"	"Bacterial infection of unspecified site"	1	259	71	330
"M41"	"C25"	"Scoliosis"	"Malignant neoplasm of pancreas"	1	43	1	44
"M41"	"C34"	"Scoliosis"	"Malignant neoplasm of bronchus and lung"	1	162	7	169
"M41"	"D12"	"Scoliosis"	"Benign neoplasm of colon, rectum, anus and anal canal"	1	194	102	296
"M41"	"D50"	"Scoliosis"	"Iron deficiency anemia"	1	216	84	300
"M41"	"D63"	"Scoliosis"	"Anemia in chronic diseases classified elsewhere"	1	69	19	88
"M41"	"E28"	"Scoliosis"	"Ovarian dysfunction"	1	59	0	59
"M41"	"E66"	"Scoliosis"	"Overweight and obesity"	1	462	154	616
"M41"	"F41"	"Scoliosis"	"Other anxiety disorders"	1	124	31	155
"M41"	"G47"	"Scoliosis"	"Sleep disorders"	1	211	90	301
"M41"	"I42"	"Scoliosis"	"Cardiomyopathy"	1	90	32	122
"M41"	"I46"	"Scoliosis"	"Cardiac arrest"	1	137	3	140
"M41"	"I48"	"Scoliosis"	"Atrial fibrillation and flutter"	1	524	213	737
"M41"	"I50"	"Scoliosis"	"Heart failure"	1	509	194	703
"M41"	"J22"	"Scoliosis"	"Unspecified acute lower respiratory infection"	1	87	15	102
"M41"	"J95"	"Scoliosis"	"Intraop and postproc comp and disorders of resp sys, NEC"	1	106	16	122
"M41"	"J96"	"Scoliosis"	"Respiratory failure, not elsewhere classified"	1	663	297	960
"M41"	"K80"	"Scoliosis"	"Cholelithiasis"	1	290	166	456
"M41"	"L05"	"Scoliosis"	"Pilonidal cyst and sinus"	1	55	8	63
"M41"	"N18"	"Scoliosis"	"Chronic kidney disease (CKD)"	1	164	16	180
"M41"	"N63"	"Scoliosis"	"Unspecified lump in breast"	1	98	38	136
"M41"	"N80"	"Scoliosis"	"Endometriosis"	1	63	16	79
"M41"	"N83"	"Scoliosis"	"Noninflammatory disord of ovary, fallop and broad ligament"	1	161	76	237
"M41"	"N87"	"Scoliosis"	"Dysplasia of cervix uteri"	1	90	10	100
"M41"	"N93"	"Scoliosis"	"Other abnormal uterine and vaginal bleeding"	1	62	0	62
"M41"	"N94"	"Scoliosis"	"Pain and oth cond assoc w fem gntl org and menstrual cycle"	1	143	37	180
"M41"	"N97"	"Scoliosis"	"Female infertility"	1	130	4	134
"M41"	"O02"	"Scoliosis"	"Other abnormal products of conception"	1	117	3	120
"M41"	"O03"	"Scoliosis"	"Spontaneous abortion"	1	100	26	126
"M41"	"O23"	"Scoliosis"	"Infections of genitourinary tract in pregnancy"	1	63	0	63
"M41"	"O26"	"Scoliosis"	"Maternal care for oth conditions predom related to pregnancy"	1	121	13	134
"M41"	"O32"	"Scoliosis"	"Maternal care for malpresentation of fetus"	1	48	2	50
"M41"	"O48"	"Scoliosis"	"Late pregnancy"	1	54	10	64
"M41"	"O60"	"Scoliosis"	"Preterm labor"	1	25	0	25
"M41"	"O62"	"Scoliosis"	"Abnormalities of forces of labor"	1	298	25	323
"M41"	"O63"	"Scoliosis"	"Long labor"	1	54	0	54
"M41"	"O72"	"Scoliosis"	"Postpartum hemorrhage"	1	408	0	408
"M41"	"O75"	"Scoliosis"	"Oth complications of labor and delivery, NEC"	1	62	0	62
"M41"	"O80"	"Scoliosis"	"Encounter for full-term uncomplicated delivery"	1	605	70	675
"M41"	"O82"	"Scoliosis"	"Encounter for cesarean delivery without indication"	1	228	10	238
"M41"	"O91"	"Scoliosis"	"Infect of breast assoc w pregnancy, the puerp and lactation"	1	25	0	25
"M42"	"E10"	"Spinal osteochondrosis"	"Type 1 diabetes mellitus"	1	70	22	92
"M42"	"G44"	"Spinal osteochondrosis"	"Other headache syndromes"	1	111	29	140
"M42"	"M79"	"Spinal osteochondrosis"	"Oth and unsp soft tissue disorders, not elsewhere classified"	1	463	221	684
"M42"	"O72"	"Spinal osteochondrosis"	"Postpartum hemorrhage"	1	74	0	74
"M43"	"A41"	"Other deforming dorsopathies"	"Other sepsis"	1	791	63	854
"M43"	"A46"	"Other deforming dorsopathies"	"Erysipelas"	1	371	125	496
"M43"	"C15"	"Other deforming dorsopathies"	"Malignant neoplasm of esophagus"	1	37	0	37
"M43"	"C16"	"Other deforming dorsopathies"	"Malignant neoplasm of stomach"	1	57	1	58
"M43"	"C18"	"Other deforming dorsopathies"	"Malignant neoplasm of colon"	1	156	61	217
"M43"	"C25"	"Other deforming dorsopathies"	"Malignant neoplasm of pancreas"	1	92	1	93
"M43"	"C61"	"Other deforming dorsopathies"	"Malignant neoplasm of prostate"	1	169	58	227
"M43"	"C79"	"Other deforming dorsopathies"	"Secondary malignant neoplasm of other and unspecified sites"	1	231	2	233
"M43"	"D46"	"Other deforming dorsopathies"	"Myelodysplastic syndromes"	1	39	4	43
"M43"	"D63"	"Other deforming dorsopathies"	"Anemia in chronic diseases classified elsewhere"	1	124	11	135
"M43"	"D64"	"Other deforming dorsopathies"	"Other anemias"	1	795	145	940
"M43"	"D68"	"Other deforming dorsopathies"	"Other coagulation defects"	1	73	19	92
"M43"	"E64"	"Other deforming dorsopathies"	"Sequelae of malnutrition and other nutritional deficiencies"	1	78	13	91
"M43"	"E78"	"Other deforming dorsopathies"	"Disorders of lipoprotein metabolism and other lipidemias"	1	893	511	1404
"M43"	"E87"	"Other deforming dorsopathies"	"Other disorders of fluid, electrolyte and acid-base balance"	1	542	65	607
"M43"	"F41"	"Other deforming dorsopathies"	"Other anxiety disorders"	1	182	50	232
"M43"	"G47"	"Other deforming dorsopathies"	"Sleep disorders"	1	450	130	580
"M43"	"G95"	"Other deforming dorsopathies"	"Other and unspecified diseases of spinal cord"	1	165	71	236
"M43"	"I21"	"Other deforming dorsopathies"	"Acute myocardial infarction"	1	541	259	800
"M43"	"I25"	"Other deforming dorsopathies"	"Chronic ischemic heart disease"	1	858	539	1397
"M43"	"I26"	"Other deforming dorsopathies"	"Pulmonary embolism"	1	271	58	329
"M43"	"I34"	"Other deforming dorsopathies"	"Nonrheumatic mitral valve disorders"	1	156	33	189
"M43"	"I42"	"Other deforming dorsopathies"	"Cardiomyopathy"	1	101	22	123
"M43"	"I46"	"Other deforming dorsopathies"	"Cardiac arrest"	1	158	0	158
"M43"	"I48"	"Other deforming dorsopathies"	"Atrial fibrillation and flutter"	1	1066	344	1410
"M43"	"I49"	"Other deforming dorsopathies"	"Other cardiac arrhythmias"	1	282	146	428
"M43"	"I61"	"Other deforming dorsopathies"	"Nontraumatic intracerebral hemorrhage"	1	136	16	152
"M43"	"I63"	"Other deforming dorsopathies"	"Cerebral infarction"	1	564	150	714
"M43"	"I69"	"Other deforming dorsopathies"	"Sequelae of cerebrovascular disease"	1	583	150	733
"M43"	"J90"	"Other deforming dorsopathies"	"Pleural effusion, not elsewhere classified"	1	121	6	127
"M43"	"J98"	"Other deforming dorsopathies"	"Other respiratory disorders"	1	135	49	184
"M43"	"K05"	"Other deforming dorsopathies"	"Gingivitis and periodontal diseases"	1	99	40	139
"M43"	"K72"	"Other deforming dorsopathies"	"Hepatic failure, not elsewhere classified"	1	65	6	71
"M43"	"M19"	"Other deforming dorsopathies"	"Other and unspecified osteoarthritis"	1	786	516	1302
"M43"	"M81"	"Other deforming dorsopathies"	"Osteoporosis without current pathological fracture"	1	907	553	1460
"M43"	"M96"	"Other deforming dorsopathies"	"Intraop and postproc comp and disorders of ms sys, NEC"	1	330	122	452
"M43"	"N13"	"Other deforming dorsopathies"	"Obstructive and reflux uropathy"	1	126	49	175
"M43"	"N18"	"Other deforming dorsopathies"	"Chronic kidney disease (CKD)"	1	329	29	358
"M43"	"N19"	"Other deforming dorsopathies"	"Unspecified kidney failure"	1	132	29	161
"M45"	"C34"	"Ankylosing spondylitis"	"Malignant neoplasm of bronchus and lung"	1	42	6	48
"M45"	"C61"	"Ankylosing spondylitis"	"Malignant neoplasm of prostate"	1	49	5	54
"M45"	"D12"	"Ankylosing spondylitis"	"Benign neoplasm of colon, rectum, anus and anal canal"	1	101	25	126
"M45"	"E78"	"Ankylosing spondylitis"	"Disorders of lipoprotein metabolism and other lipidemias"	1	170	62	232
"M45"	"I10"	"Ankylosing spondylitis"	"Essential (primary) hypertension"	1	395	238	633
"M45"	"J18"	"Ankylosing spondylitis"	"Pneumonia, unspecified organism"	1	361	114	475
"M45"	"J96"	"Ankylosing spondylitis"	"Respiratory failure, not elsewhere classified"	1	134	12	146
"M45"	"K59"	"Ankylosing spondylitis"	"Other functional intestinal disorders"	1	255	105	360
"M45"	"L30"	"Ankylosing spondylitis"	"Other and unspecified dermatitis"	1	88	32	120
"M45"	"L89"	"Ankylosing spondylitis"	"Pressure ulcer"	1	48	1	49
"M45"	"M81"	"Ankylosing spondylitis"	"Osteoporosis without current pathological fracture"	1	207	97	304
"M45"	"M85"	"Ankylosing spondylitis"	"Other disorders of bone density and structure"	1	180	62	242
"M46"	"L89"	"Other inflammatory spondylopathies"	"Pressure ulcer"	1	155	73	228
"M47"	"A04"	"Spondylosis"	"Other bacterial intestinal infections"	1	409	47	456
"M47"	"A41"	"Spondylosis"	"Other sepsis"	1	2652	0	2652
"M47"	"A46"	"Spondylosis"	"Erysipelas"	1	1072	429	1501
"M47"	"A49"	"Spondylosis"	"Bacterial infection of unspecified site"	1	1060	142	1202
"M47"	"C44"	"Spondylosis"	"Other and unspecified malignant neoplasm of skin"	1	915	331	1246
"M47"	"C45"	"Spondylosis"	"Mesothelioma"	1	41	2	43
"M47"	"C61"	"Spondylosis"	"Malignant neoplasm of prostate"	1	808	300	1108
"M47"	"C76"	"Spondylosis"	"Malignant neoplasm of other and ill-defined sites"	1	82	23	105
"M47"	"C80"	"Spondylosis"	"Malignant neoplasm without specification of site"	1	173	6	179
"M47"	"D09"	"Spondylosis"	"Carcinoma in situ of other and unspecified sites"	1	116	2	118
"M47"	"D61"	"Spondylosis"	"Oth aplastic anemias and other bone marrow failure syndromes"	1	70	8	78
"M47"	"D63"	"Spondylosis"	"Anemia in chronic diseases classified elsewhere"	1	484	15	499
"M47"	"D64"	"Spondylosis"	"Other anemias"	1	3368	0	3368
"M47"	"D69"	"Spondylosis"	"Purpura and other hemorrhagic conditions"	1	211	101	312
"M47"	"E13"	"Spondylosis"	"Other specified diabetes mellitus"	1	113	27	140
"M47"	"E41"	"Spondylosis"	"Nutritional marasmus"	1	81	0	81
"M47"	"E53"	"Spondylosis"	"Deficiency of other B group vitamins"	1	254	85	339
"M47"	"E83"	"Spondylosis"	"Disorders of mineral metabolism"	1	359	62	421
"M47"	"E87"	"Spondylosis"	"Other disorders of fluid, electrolyte and acid-base balance"	1	1789	221	2010
"M47"	"F33"	"Spondylosis"	"Major depressive disorder, recurrent"	1	874	308	1182
"M47"	"F41"	"Spondylosis"	"Other anxiety disorders"	1	546	209	755
"M47"	"G12"	"Spondylosis"	"Spinal muscular atrophy and related syndromes"	1	186	65	251
"M47"	"G20"	"Spondylosis"	"Parkinson's disease"	1	501	216	717
"M47"	"G25"	"Spondylosis"	"Other extrapyramidal and movement disorders"	1	247	136	383
"M47"	"H26"	"Spondylosis"	"Other cataract"	1	1325	699	2024
"M47"	"I26"	"Spondylosis"	"Pulmonary embolism"	1	806	196	1002
"M47"	"I34"	"Spondylosis"	"Nonrheumatic mitral valve disorders"	1	481	170	651
"M47"	"I35"	"Spondylosis"	"Nonrheumatic aortic valve disorders"	1	1565	258	1823
"M47"	"I42"	"Spondylosis"	"Cardiomyopathy"	1	344	110	454
"M47"	"I44"	"Spondylosis"	"Atrioventricular and left bundle-branch block"	1	541	153	694
"M47"	"I50"	"Spondylosis"	"Heart failure"	1	4202	0	4202
"M47"	"I61"	"Spondylosis"	"Nontraumatic intracerebral hemorrhage"	1	528	73	601
"M47"	"I73"	"Spondylosis"	"Other peripheral vascular diseases"	1	1354	773	2127
"M47"	"I85"	"Spondylosis"	"Esophageal varices"	1	102	25	127
"M47"	"J15"	"Spondylosis"	"Bacterial pneumonia, not elsewhere classified"	1	2368	0	2368
"M47"	"J43"	"Spondylosis"	"Emphysema"	1	284	144	428
"M47"	"J47"	"Spondylosis"	"Bronchiectasis"	1	169	35	204
"M47"	"J69"	"Spondylosis"	"Pneumonitis due to solids and liquids"	1	209	0	209
"M47"	"J81"	"Spondylosis"	"Pulmonary edema"	1	378	13	391
"M47"	"J91"	"Spondylosis"	"Pleural effusion in conditions classified elsewhere"	1	168	17	185
"M47"	"J95"	"Spondylosis"	"Intraop and postproc comp and disorders of resp sys, NEC"	1	128	9	137
"M47"	"K22"	"Spondylosis"	"Other diseases of esophagus"	1	499	261	760
"M47"	"K59"	"Spondylosis"	"Other functional intestinal disorders"	1	3781	1505	5286
"M47"	"K63"	"Spondylosis"	"Other diseases of intestine"	1	385	105	490
"M47"	"K76"	"Spondylosis"	"Other diseases of liver"	1	370	236	606
"M47"	"K83"	"Spondylosis"	"Other diseases of biliary tract"	1	319	96	415
"M47"	"K92"	"Spondylosis"	"Other diseases of digestive system"	1	1086	360	1446
"M47"	"L97"	"Spondylosis"	"Non-pressure chronic ulcer of lower limb, NEC"	1	729	60	789
"M47"	"M80"	"Spondylosis"	"Osteoporosis with current pathological fracture"	1	1660	800	2460
"M47"	"M81"	"Spondylosis"	"Osteoporosis without current pathological fracture"	1	2933	2057	4990
"M47"	"N13"	"Spondylosis"	"Obstructive and reflux uropathy"	1	416	194	610
"M47"	"N17"	"Spondylosis"	"Acute kidney failure"	1	565	33	598
"M47"	"N28"	"Spondylosis"	"Oth disorders of kidney and ureter, not elsewhere classified"	1	283	104	387
"M47"	"N39"	"Spondylosis"	"Other disorders of urinary system"	1	3452	1386	4838
"M48"	"C16"	"Other spondylopathies"	"Malignant neoplasm of stomach"	1	225	35	260
"M48"	"C18"	"Other spondylopathies"	"Malignant neoplasm of colon"	1	644	447	1091
"M48"	"C45"	"Other spondylopathies"	"Mesothelioma"	1	49	3	52
"M48"	"C71"	"Other spondylopathies"	"Malignant neoplasm of brain"	1	136	39	175
"M48"	"C79"	"Other spondylopathies"	"Secondary malignant neoplasm of other and unspecified sites"	1	1006	440	1446
"M48"	"C92"	"Other spondylopathies"	"Myeloid leukemia"	1	117	33	150
"M48"	"D46"	"Other spondylopathies"	"Myelodysplastic syndromes"	1	170	40	210
"M48"	"D63"	"Other spondylopathies"	"Anemia in chronic diseases classified elsewhere"	1	692	127	819
"M48"	"D64"	"Other spondylopathies"	"Other anemias"	1	3849	1287	5136
"M48"	"E53"	"Other spondylopathies"	"Deficiency of other B group vitamins"	1	241	109	350
"M48"	"E55"	"Other spondylopathies"	"Vitamin D deficiency"	1	609	315	924
"M48"	"E64"	"Other spondylopathies"	"Sequelae of malnutrition and other nutritional deficiencies"	1	300	79	379
"M48"	"F03"	"Other spondylopathies"	"Unspecified dementia"	1	1801	0	1801
"M48"	"F32"	"Other spondylopathies"	"Depressive episode"	1	1529	952	2481
"M48"	"F33"	"Other spondylopathies"	"Major depressive disorder, recurrent"	1	1056	423	1479
"M48"	"G12"	"Other spondylopathies"	"Spinal muscular atrophy and related syndromes"	1	204	88	292
"M48"	"G82"	"Other spondylopathies"	"Paraplegia (paraparesis) and quadriplegia (quadriparesis)"	1	687	487	1174
"M48"	"G91"	"Other spondylopathies"	"Hydrocephalus"	1	276	134	410
"M48"	"H54"	"Other spondylopathies"	"Blindness and low vision"	1	338	133	471
"M48"	"I48"	"Other spondylopathies"	"Atrial fibrillation and flutter"	1	4522	2817	7339
"M48"	"I50"	"Other spondylopathies"	"Heart failure"	1	3898	1846	5744
"M48"	"I61"	"Other spondylopathies"	"Nontraumatic intracerebral hemorrhage"	1	613	152	765
"M48"	"I69"	"Other spondylopathies"	"Sequelae of cerebrovascular disease"	1	2624	1360	3984
"M48"	"J15"	"Other spondylopathies"	"Bacterial pneumonia, not elsewhere classified"	1	3931	0	3931
"M48"	"J44"	"Other spondylopathies"	"Other chronic obstructive pulmonary disease"	1	3407	2826	6233
"M48"	"J47"	"Other spondylopathies"	"Bronchiectasis"	1	166	83	249
"M48"	"J90"	"Other spondylopathies"	"Pleural effusion, not elsewhere classified"	1	575	160	735
"M48"	"J93"	"Other spondylopathies"	"Pneumothorax and air leak"	1	251	135	386
"M48"	"J94"	"Other spondylopathies"	"Other pleural conditions"	1	161	53	214
"M48"	"J96"	"Other spondylopathies"	"Respiratory failure, not elsewhere classified"	1	3572	0	3572
"M48"	"K52"	"Other spondylopathies"	"Other and unsp noninfective gastroenteritis and colitis"	1	1165	867	2032
"M48"	"K56"	"Other spondylopathies"	"Paralytic ileus and intestinal obstruction without hernia"	1	924	531	1455
"M48"	"K72"	"Other spondylopathies"	"Hepatic failure, not elsewhere classified"	1	186	58	244
"M48"	"K83"	"Other spondylopathies"	"Other diseases of biliary tract"	1	344	166	510
"M48"	"K92"	"Other spondylopathies"	"Other diseases of digestive system"	1	1305	674	1979
"M48"	"M10"	"Other spondylopathies"	"Gout"	1	782	589	1371
"M48"	"N17"	"Other spondylopathies"	"Acute kidney failure"	1	887	176	1063
"M48"	"N30"	"Other spondylopathies"	"Cystitis"	1	4855	2894	7749
"M48"	"N31"	"Other spondylopathies"	"Neuromuscular dysfunction of bladder, NEC"	1	554	392	946
"M50"	"A04"	"Cervical disc disorders"	"Other bacterial intestinal infections"	1	148	10	158
"M50"	"A46"	"Cervical disc disorders"	"Erysipelas"	1	539	130	669
"M50"	"C06"	"Cervical disc disorders"	"Malignant neoplasm of other and unspecified parts of mouth"	1	44	4	48
"M50"	"C15"	"Cervical disc disorders"	"Malignant neoplasm of esophagus"	1	73	0	73
"M50"	"C25"	"Cervical disc disorders"	"Malignant neoplasm of pancreas"	1	111	0	111
"M50"	"C44"	"Cervical disc disorders"	"Other and unspecified malignant neoplasm of skin"	1	483	59	542
"M50"	"C64"	"Cervical disc disorders"	"Malignant neoplasm of kidney, except renal pelvis"	1	121	18	139
"M50"	"C67"	"Cervical disc disorders"	"Malignant neoplasm of bladder"	1	103	17	120
"M50"	"C79"	"Cervical disc disorders"	"Secondary malignant neoplasm of other and unspecified sites"	1	433	0	433
"M50"	"C80"	"Cervical disc disorders"	"Malignant neoplasm without specification of site"	1	69	0	69
"M50"	"C83"	"Cervical disc disorders"	"Non-follicular lymphoma"	1	73	10	83
"M50"	"C92"	"Cervical disc disorders"	"Myeloid leukemia"	1	38	2	40
"M50"	"D22"	"Cervical disc disorders"	"Melanocytic nevi"	1	233	125	358
"M50"	"D30"	"Cervical disc disorders"	"Benign neoplasm of urinary organs"	1	137	46	183
"M50"	"D35"	"Cervical disc disorders"	"Benign neoplasm of other and unspecified endocrine glands"	1	135	31	166
"M50"	"D62"	"Cervical disc disorders"	"Acute posthemorrhagic anemia"	1	139	29	168
"M50"	"D69"	"Cervical disc disorders"	"Purpura and other hemorrhagic conditions"	1	115	40	155
"M50"	"E05"	"Cervical disc disorders"	"Thyrotoxicosis [hyperthyroidism]"	1	372	238	610
"M50"	"E87"	"Cervical disc disorders"	"Other disorders of fluid, electrolyte and acid-base balance"	1	616	0	616
"M50"	"F05"	"Cervical disc disorders"	"Delirium due to known physiological condition"	1	158	0	158
"M50"	"F06"	"Cervical disc disorders"	"Other mental disorders due to known physiological condition"	1	78	0	78
"M50"	"F41"	"Cervical disc disorders"	"Other anxiety disorders"	1	369	122	491
"M50"	"G12"	"Cervical disc disorders"	"Spinal muscular atrophy and related syndromes"	1	101	33	134
"M50"	"G25"	"Cervical disc disorders"	"Other extrapyramidal and movement disorders"	1	158	31	189
"M50"	"G47"	"Cervical disc disorders"	"Sleep disorders"	1	1211	269	1480
"M50"	"G62"	"Cervical disc disorders"	"Other and unspecified polyneuropathies"	1	630	287	917
"M50"	"G82"	"Cervical disc disorders"	"Paraplegia (paraparesis) and quadriplegia (quadriparesis)"	1	336	217	553
"M50"	"G95"	"Cervical disc disorders"	"Other and unspecified diseases of spinal cord"	1	381	241	622
"M50"	"G96"	"Cervical disc disorders"	"Other disorders of central nervous system"	1	574	150	724
"M50"	"H26"	"Cervical disc disorders"	"Other cataract"	1	576	120	696
"M50"	"H33"	"Cervical disc disorders"	"Retinal detachments and breaks"	1	200	66	266
"M50"	"H90"	"Cervical disc disorders"	"Conductive and sensorineural hearing loss"	1	499	227	726
"M50"	"I10"	"Cervical disc disorders"	"Essential (primary) hypertension"	1	4243	1632	5875
"M50"	"I27"	"Cervical disc disorders"	"Other pulmonary heart diseases"	1	118	9	127
"M50"	"I34"	"Cervical disc disorders"	"Nonrheumatic mitral valve disorders"	1	195	32	227
"M50"	"I35"	"Cervical disc disorders"	"Nonrheumatic aortic valve disorders"	1	568	19	587
"M50"	"I42"	"Cervical disc disorders"	"Cardiomyopathy"	1	204	27	231
"M50"	"I49"	"Cervical disc disorders"	"Other cardiac arrhythmias"	1	528	198	726
"M50"	"I51"	"Cervical disc disorders"	"Complications and ill-defined descriptions of heart disease"	1	184	28	212
"M50"	"I61"	"Cervical disc disorders"	"Nontraumatic intracerebral hemorrhage"	1	185	19	204
"M50"	"I63"	"Cervical disc disorders"	"Cerebral infarction"	1	1037	154	1191
"M50"	"I69"	"Cervical disc disorders"	"Sequelae of cerebrovascular disease"	1	1112	156	1268
"M50"	"I71"	"Cervical disc disorders"	"Aortic aneurysm and dissection"	1	348	0	348
"M50"	"I80"	"Cervical disc disorders"	"Phlebitis and thrombophlebitis"	1	569	260	829
"M50"	"I87"	"Cervical disc disorders"	"Other disorders of veins"	1	97	16	113
"M50"	"I89"	"Cervical disc disorders"	"Oth noninfective disorders of lymphatic vessels and nodes"	1	101	36	137
"M50"	"J38"	"Cervical disc disorders"	"Diseases of vocal cords and larynx, not elsewhere classified"	1	406	228	634
"M50"	"J43"	"Cervical disc disorders"	"Emphysema"	1	153	33	186
"M50"	"J69"	"Cervical disc disorders"	"Pneumonitis due to solids and liquids"	1	77	0	77
"M50"	"J86"	"Cervical disc disorders"	"Pyothorax"	1	87	14	101
"M50"	"J90"	"Cervical disc disorders"	"Pleural effusion, not elsewhere classified"	1	197	0	197
"M50"	"J91"	"Cervical disc disorders"	"Pleural effusion in conditions classified elsewhere"	1	76	3	79
"M50"	"J93"	"Cervical disc disorders"	"Pneumothorax and air leak"	1	119	45	164
"M50"	"K05"	"Cervical disc disorders"	"Gingivitis and periodontal diseases"	1	205	80	285
"M50"	"K31"	"Cervical disc disorders"	"Other diseases of stomach and duodenum"	1	125	22	147
"M50"	"K52"	"Cervical disc disorders"	"Other and unsp noninfective gastroenteritis and colitis"	1	522	230	752
"M50"	"K74"	"Cervical disc disorders"	"Fibrosis and cirrhosis of liver"	1	94	6	100
"M50"	"K76"	"Cervical disc disorders"	"Other diseases of liver"	1	265	98	363
"M50"	"K83"	"Cervical disc disorders"	"Other diseases of biliary tract"	1	139	26	165
"M50"	"K86"	"Cervical disc disorders"	"Other diseases of pancreas"	1	142	55	197
"M50"	"K91"	"Cervical disc disorders"	"Intraop and postproc comp and disorders of dgstv sys, NEC"	1	96	25	121
"M50"	"L89"	"Cervical disc disorders"	"Pressure ulcer"	1	163	0	163
"M50"	"L97"	"Cervical disc disorders"	"Non-pressure chronic ulcer of lower limb, NEC"	1	242	15	257
"M50"	"M10"	"Cervical disc disorders"	"Gout"	1	320	120	440
"M50"	"M47"	"Cervical disc disorders"	"Spondylosis"	1	8201	7301	15502
"M50"	"M72"	"Cervical disc disorders"	"Fibroblastic disorders"	1	445	266	711
"M50"	"N13"	"Cervical disc disorders"	"Obstructive and reflux uropathy"	1	183	68	251
"M50"	"N17"	"Cervical disc disorders"	"Acute kidney failure"	1	195	0	195
"M50"	"N18"	"Cervical disc disorders"	"Chronic kidney disease (CKD)"	1	399	0	399
"M50"	"N19"	"Cervical disc disorders"	"Unspecified kidney failure"	1	197	11	208
"M50"	"N30"	"Cervical disc disorders"	"Cystitis"	1	1556	620	2176
"M50"	"N39"	"Cervical disc disorders"	"Other disorders of urinary system"	1	1561	497	2058
"M51"	"A31"	"Thoracic, thoracolum, and lumbosacral intvrt disc disorders"	"Infection due to other mycobacteria"	1	28	2	30
"M51"	"A40"	"Thoracic, thoracolum, and lumbosacral intvrt disc disorders"	"Streptococcal sepsis"	1	195	15	210
"M51"	"A41"	"Thoracic, thoracolum, and lumbosacral intvrt disc disorders"	"Other sepsis"	1	3525	0	3525
"M51"	"B02"	"Thoracic, thoracolum, and lumbosacral intvrt disc disorders"	"Zoster [herpes zoster]"	1	388	131	519
"M51"	"B34"	"Thoracic, thoracolum, and lumbosacral intvrt disc disorders"	"Viral infection of unspecified site"	1	593	365	958
"M51"	"B37"	"Thoracic, thoracolum, and lumbosacral intvrt disc disorders"	"Candidiasis"	1	717	162	879
"M51"	"B96"	"Thoracic, thoracolum, and lumbosacral intvrt disc disorders"	"Oth bacterial agents as the cause of diseases classd elswhr"	1	194	4	198
"M51"	"C06"	"Thoracic, thoracolum, and lumbosacral intvrt disc disorders"	"Malignant neoplasm of other and unspecified parts of mouth"	1	95	3	98
"M51"	"C10"	"Thoracic, thoracolum, and lumbosacral intvrt disc disorders"	"Malignant neoplasm of oropharynx"	1	96	0	96
"M51"	"C15"	"Thoracic, thoracolum, and lumbosacral intvrt disc disorders"	"Malignant neoplasm of esophagus"	1	260	0	260
"M51"	"C16"	"Thoracic, thoracolum, and lumbosacral intvrt disc disorders"	"Malignant neoplasm of stomach"	1	289	0	289
"M51"	"C18"	"Thoracic, thoracolum, and lumbosacral intvrt disc disorders"	"Malignant neoplasm of colon"	1	1001	152	1153
"M51"	"C20"	"Thoracic, thoracolum, and lumbosacral intvrt disc disorders"	"Malignant neoplasm of rectum"	1	471	85	556
"M51"	"C32"	"Thoracic, thoracolum, and lumbosacral intvrt disc disorders"	"Malignant neoplasm of larynx"	1	118	14	132
"M51"	"C38"	"Thoracic, thoracolum, and lumbosacral intvrt disc disorders"	"Malignant neoplasm of heart, mediastinum and pleura"	1	52	3	55
"M51"	"C50"	"Thoracic, thoracolum, and lumbosacral intvrt disc disorders"	"Malignant neoplasm of breast"	1	1362	703	2065
"M51"	"C64"	"Thoracic, thoracolum, and lumbosacral intvrt disc disorders"	"Malignant neoplasm of kidney, except renal pelvis"	1	360	47	407
"M51"	"C76"	"Thoracic, thoracolum, and lumbosacral intvrt disc disorders"	"Malignant neoplasm of other and ill-defined sites"	1	110	27	137
"M51"	"C79"	"Thoracic, thoracolum, and lumbosacral intvrt disc disorders"	"Secondary malignant neoplasm of other and unspecified sites"	1	1596	0	1596
"M51"	"C84"	"Thoracic, thoracolum, and lumbosacral intvrt disc disorders"	"Mature T/NK-cell lymphomas"	1	44	3	47
"M51"	"C85"	"Thoracic, thoracolum, and lumbosacral intvrt disc disorders"	"Oth and unspecified types of non-Hodgkin lymphoma"	1	270	69	339
"M51"	"C92"	"Thoracic, thoracolum, and lumbosacral intvrt disc disorders"	"Myeloid leukemia"	1	164	11	175
"M51"	"C95"	"Thoracic, thoracolum, and lumbosacral intvrt disc disorders"	"Leukemia of unspecified cell type"	1	52	0	52
"M51"	"D09"	"Thoracic, thoracolum, and lumbosacral intvrt disc disorders"	"Carcinoma in situ of other and unspecified sites"	1	171	0	171
"M51"	"D13"	"Thoracic, thoracolum, and lumbosacral intvrt disc disorders"	"Benign neoplasm of and ill-defined parts of digestive system"	1	386	94	480
"M51"	"D21"	"Thoracic, thoracolum, and lumbosacral intvrt disc disorders"	"Other benign neoplasms of connective and other soft tissue"	1	317	171	488
"M51"	"D30"	"Thoracic, thoracolum, and lumbosacral intvrt disc disorders"	"Benign neoplasm of urinary organs"	1	426	213	639
"M51"	"D33"	"Thoracic, thoracolum, and lumbosacral intvrt disc disorders"	"Benign neoplasm of brain and oth prt central nervous system"	1	295	155	450
"M51"	"D38"	"Thoracic, thoracolum, and lumbosacral intvrt disc disorders"	"Neoplm of uncrt behav of mid ear & resp and intrathorac org"	1	104	16	120
"M51"	"D43"	"Thoracic, thoracolum, and lumbosacral intvrt disc disorders"	"Neoplasm of uncertain behavior of brain and cnsl"	1	205	46	251
"M51"	"D46"	"Thoracic, thoracolum, and lumbosacral intvrt disc disorders"	"Myelodysplastic syndromes"	1	177	8	185
"M51"	"D47"	"Thoracic, thoracolum, and lumbosacral intvrt disc disorders"	"Oth neoplm of uncrt behav of lymphoid, hematpoetc & rel tiss"	1	437	32	469
"M51"	"D61"	"Thoracic, thoracolum, and lumbosacral intvrt disc disorders"	"Oth aplastic anemias and other bone marrow failure syndromes"	1	132	9	141
"M51"	"D62"	"Thoracic, thoracolum, and lumbosacral intvrt disc disorders"	"Acute posthemorrhagic anemia"	1	618	56	674
"M51"	"D63"	"Thoracic, thoracolum, and lumbosacral intvrt disc disorders"	"Anemia in chronic diseases classified elsewhere"	1	736	0	736
"M51"	"D65"	"Thoracic, thoracolum, and lumbosacral intvrt disc disorders"	"Disseminated intravascular coagulation"	1	48	2	50
"M51"	"D69"	"Thoracic, thoracolum, and lumbosacral intvrt disc disorders"	"Purpura and other hemorrhagic conditions"	1	469	123	592
"M51"	"D70"	"Thoracic, thoracolum, and lumbosacral intvrt disc disorders"	"Neutropenia"	1	81	16	97
"M51"	"D84"	"Thoracic, thoracolum, and lumbosacral intvrt disc disorders"	"Other immunodeficiencies"	1	68	1	69
"M51"	"E05"	"Thoracic, thoracolum, and lumbosacral intvrt disc disorders"	"Thyrotoxicosis [hyperthyroidism]"	1	1272	807	2079
"M51"	"E06"	"Thoracic, thoracolum, and lumbosacral intvrt disc disorders"	"Thyroiditis"	1	293	154	447
"M51"	"E13"	"Thoracic, thoracolum, and lumbosacral intvrt disc disorders"	"Other specified diabetes mellitus"	1	255	23	278
"M51"	"E21"	"Thoracic, thoracolum, and lumbosacral intvrt disc disorders"	"Hyperparathyroidism and other disorders of parathyroid gland"	1	546	109	655
"M51"	"E23"	"Thoracic, thoracolum, and lumbosacral intvrt disc disorders"	"Hypofunction and other disorders of the pituitary gland"	1	236	69	305
"M51"	"E29"	"Thoracic, thoracolum, and lumbosacral intvrt disc disorders"	"Testicular dysfunction"	1	119	23	142
"M51"	"E41"	"Thoracic, thoracolum, and lumbosacral intvrt disc disorders"	"Nutritional marasmus"	1	82	0	82
"M51"	"E46"	"Thoracic, thoracolum, and lumbosacral intvrt disc disorders"	"Unspecified protein-calorie malnutrition"	1	67	0	67
"M51"	"E55"	"Thoracic, thoracolum, and lumbosacral intvrt disc disorders"	"Vitamin D deficiency"	1	847	223	1070
"M51"	"E61"	"Thoracic, thoracolum, and lumbosacral intvrt disc disorders"	"Deficiency of other nutrient elements"	1	92	10	102
"M51"	"E64"	"Thoracic, thoracolum, and lumbosacral intvrt disc disorders"	"Sequelae of malnutrition and other nutritional deficiencies"	1	403	7	410
"M51"	"E86"	"Thoracic, thoracolum, and lumbosacral intvrt disc disorders"	"Volume depletion"	1	3801	0	3801
"M51"	"E89"	"Thoracic, thoracolum, and lumbosacral intvrt disc disorders"	"Postproc endocrine and metabolic comp and disorders, NEC"	1	275	100	375
"M51"	"F01"	"Thoracic, thoracolum, and lumbosacral intvrt disc disorders"	"Vascular dementia"	1	310	0	310
"M51"	"F11"	"Thoracic, thoracolum, and lumbosacral intvrt disc disorders"	"Opioid related disorders"	1	240	84	324
"M51"	"F41"	"Thoracic, thoracolum, and lumbosacral intvrt disc disorders"	"Other anxiety disorders"	1	1164	228	1392
"M51"	"G30"	"Thoracic, thoracolum, and lumbosacral intvrt disc disorders"	"Alzheimer's disease"	1	344	0	344
"M51"	"G51"	"Thoracic, thoracolum, and lumbosacral intvrt disc disorders"	"Facial nerve disorders"	1	377	218	595
"M51"	"G55"	"Thoracic, thoracolum, and lumbosacral intvrt disc disorders"	"Nerve root and plexus compressions in diseases classd elswhr"	1	909	621	1530
"M51"	"G62"	"Thoracic, thoracolum, and lumbosacral intvrt disc disorders"	"Other and unspecified polyneuropathies"	1	2126	728	2854
"M51"	"G81"	"Thoracic, thoracolum, and lumbosacral intvrt disc disorders"	"Hemiplegia and hemiparesis"	1	85	30	115
"M51"	"G94"	"Thoracic, thoracolum, and lumbosacral intvrt disc disorders"	"Other disorders of brain in diseases classified elsewhere"	1	49	4	53
"M51"	"H02"	"Thoracic, thoracolum, and lumbosacral intvrt disc disorders"	"Other disorders of eyelid"	1	1486	583	2069
"M51"	"H18"	"Thoracic, thoracolum, and lumbosacral intvrt disc disorders"	"Other disorders of cornea"	1	364	129	493
"M51"	"H33"	"Thoracic, thoracolum, and lumbosacral intvrt disc disorders"	"Retinal detachments and breaks"	1	562	238	800
"M51"	"H35"	"Thoracic, thoracolum, and lumbosacral intvrt disc disorders"	"Other retinal disorders"	1	3310	0	3310
"M51"	"H36"	"Thoracic, thoracolum, and lumbosacral intvrt disc disorders"	"Retinal disorders in diseases classified elsewhere"	1	722	228	950
"M51"	"H43"	"Thoracic, thoracolum, and lumbosacral intvrt disc disorders"	"Disorders of vitreous body"	1	840	217	1057
"M51"	"H47"	"Thoracic, thoracolum, and lumbosacral intvrt disc disorders"	"Other disorders of optic [2nd] nerve and visual pathways"	1	157	61	218
"M51"	"H49"	"Thoracic, thoracolum, and lumbosacral intvrt disc disorders"	"Paralytic strabismus"	1	182	65	247
"M51"	"H53"	"Thoracic, thoracolum, and lumbosacral intvrt disc disorders"	"Visual disturbances"	1	984	282	1266
"M51"	"H57"	"Thoracic, thoracolum, and lumbosacral intvrt disc disorders"	"Other disorders of eye and adnexa"	1	700	198	898
"M51"	"H90"	"Thoracic, thoracolum, and lumbosacral intvrt disc disorders"	"Conductive and sensorineural hearing loss"	1	1665	767	2432
"M51"	"I11"	"Thoracic, thoracolum, and lumbosacral intvrt disc disorders"	"Hypertensive heart disease"	1	675	101	776
"M51"	"I12"	"Thoracic, thoracolum, and lumbosacral intvrt disc disorders"	"Hypertensive chronic kidney disease"	1	122	37	159
"M51"	"I13"	"Thoracic, thoracolum, and lumbosacral intvrt disc disorders"	"Hypertensive heart and chronic kidney disease"	1	49	10	59
"M51"	"I15"	"Thoracic, thoracolum, and lumbosacral intvrt disc disorders"	"Secondary hypertension"	1	590	201	791
"M51"	"I24"	"Thoracic, thoracolum, and lumbosacral intvrt disc disorders"	"Other acute ischemic heart diseases"	1	292	118	410
"M51"	"I25"	"Thoracic, thoracolum, and lumbosacral intvrt disc disorders"	"Chronic ischemic heart disease"	1	8419	0	8419
"M51"	"I33"	"Thoracic, thoracolum, and lumbosacral intvrt disc disorders"	"Acute and subacute endocarditis"	1	182	21	203
"M51"	"I34"	"Thoracic, thoracolum, and lumbosacral intvrt disc disorders"	"Nonrheumatic mitral valve disorders"	1	741	135	876
"M51"	"I35"	"Thoracic, thoracolum, and lumbosacral intvrt disc disorders"	"Nonrheumatic aortic valve disorders"	1	2454	0	2454
"M51"	"I42"	"Thoracic, thoracolum, and lumbosacral intvrt disc disorders"	"Cardiomyopathy"	1	640	78	718
"M51"	"I45"	"Thoracic, thoracolum, and lumbosacral intvrt disc disorders"	"Other conduction disorders"	1	416	169	585
"M51"	"I46"	"Thoracic, thoracolum, and lumbosacral intvrt disc disorders"	"Cardiac arrest"	1	842	0	842
"M51"	"I49"	"Thoracic, thoracolum, and lumbosacral intvrt disc disorders"	"Other cardiac arrhythmias"	1	1796	551	2347
"M51"	"I50"	"Thoracic, thoracolum, and lumbosacral intvrt disc disorders"	"Heart failure"	1	5229	0	5229
"M51"	"I61"	"Thoracic, thoracolum, and lumbosacral intvrt disc disorders"	"Nontraumatic intracerebral hemorrhage"	1	775	24	799
"M51"	"I62"	"Thoracic, thoracolum, and lumbosacral intvrt disc disorders"	"Other and unspecified nontraumatic intracranial hemorrhage"	1	76	2	78
"M51"	"I63"	"Thoracic, thoracolum, and lumbosacral intvrt disc disorders"	"Cerebral infarction"	1	3869	0	3869
"M51"	"I69"	"Thoracic, thoracolum, and lumbosacral intvrt disc disorders"	"Sequelae of cerebrovascular disease"	1	3921	0	3921
"M51"	"I70"	"Thoracic, thoracolum, and lumbosacral intvrt disc disorders"	"Atherosclerosis"	1	2659	1273	3932
"M51"	"I71"	"Thoracic, thoracolum, and lumbosacral intvrt disc disorders"	"Aortic aneurysm and dissection"	1	1317	112	1429
"M51"	"I80"	"Thoracic, thoracolum, and lumbosacral intvrt disc disorders"	"Phlebitis and thrombophlebitis"	1	2116	937	3053
"M51"	"I85"	"Thoracic, thoracolum, and lumbosacral intvrt disc disorders"	"Esophageal varices"	1	267	23	290
"M51"	"I87"	"Thoracic, thoracolum, and lumbosacral intvrt disc disorders"	"Other disorders of veins"	1	375	74	449
"M51"	"I89"	"Thoracic, thoracolum, and lumbosacral intvrt disc disorders"	"Oth noninfective disorders of lymphatic vessels and nodes"	1	341	75	416
"M51"	"J15"	"Thoracic, thoracolum, and lumbosacral intvrt disc disorders"	"Bacterial pneumonia, not elsewhere classified"	1	3233	0	3233
"M51"	"J17"	"Thoracic, thoracolum, and lumbosacral intvrt disc disorders"	"Pneumonia in diseases classified elsewhere"	1	55	9	64
"M51"	"J22"	"Thoracic, thoracolum, and lumbosacral intvrt disc disorders"	"Unspecified acute lower respiratory infection"	1	436	0	436
"M51"	"J38"	"Thoracic, thoracolum, and lumbosacral intvrt disc disorders"	"Diseases of vocal cords and larynx, not elsewhere classified"	1	532	340	872
"M51"	"J43"	"Thoracic, thoracolum, and lumbosacral intvrt disc disorders"	"Emphysema"	1	469	77	546
"M51"	"J44"	"Thoracic, thoracolum, and lumbosacral intvrt disc disorders"	"Other chronic obstructive pulmonary disease"	1	6699	0	6699
"M51"	"J47"	"Thoracic, thoracolum, and lumbosacral intvrt disc disorders"	"Bronchiectasis"	1	357	24	381
"M51"	"J70"	"Thoracic, thoracolum, and lumbosacral intvrt disc disorders"	"Respiratory conditions due to other external agents"	1	42	3	45
"M51"	"J90"	"Thoracic, thoracolum, and lumbosacral intvrt disc disorders"	"Pleural effusion, not elsewhere classified"	1	630	0	630
"M51"	"J94"	"Thoracic, thoracolum, and lumbosacral intvrt disc disorders"	"Other pleural conditions"	1	226	16	242
"M51"	"J95"	"Thoracic, thoracolum, and lumbosacral intvrt disc disorders"	"Intraop and postproc comp and disorders of resp sys, NEC"	1	169	0	169
"M51"	"J98"	"Thoracic, thoracolum, and lumbosacral intvrt disc disorders"	"Other respiratory disorders"	1	626	160	786
"M51"	"K21"	"Thoracic, thoracolum, and lumbosacral intvrt disc disorders"	"Gastro-esophageal reflux disease"	1	2669	1899	4568
"M51"	"K22"	"Thoracic, thoracolum, and lumbosacral intvrt disc disorders"	"Other diseases of esophagus"	1	984	265	1249
"M51"	"K31"	"Thoracic, thoracolum, and lumbosacral intvrt disc disorders"	"Other diseases of stomach and duodenum"	1	340	51	391
"M51"	"K45"	"Thoracic, thoracolum, and lumbosacral intvrt disc disorders"	"Other abdominal hernia"	1	224	120	344
"M51"	"K52"	"Thoracic, thoracolum, and lumbosacral intvrt disc disorders"	"Other and unsp noninfective gastroenteritis and colitis"	1	2093	765	2858
"M51"	"K55"	"Thoracic, thoracolum, and lumbosacral intvrt disc disorders"	"Vascular disorders of intestine"	1	359	4	363
"M51"	"K59"	"Thoracic, thoracolum, and lumbosacral intvrt disc disorders"	"Other functional intestinal disorders"	1	8306	0	8306
"M51"	"K62"	"Thoracic, thoracolum, and lumbosacral intvrt disc disorders"	"Other diseases of anus and rectum"	1	2835	1134	3969
"M51"	"K65"	"Thoracic, thoracolum, and lumbosacral intvrt disc disorders"	"Peritonitis"	1	538	127	665
"M51"	"K71"	"Thoracic, thoracolum, and lumbosacral intvrt disc disorders"	"Toxic liver disease"	1	160	59	219
"M51"	"K72"	"Thoracic, thoracolum, and lumbosacral intvrt disc disorders"	"Hepatic failure, not elsewhere classified"	1	350	3	353
"M51"	"K74"	"Thoracic, thoracolum, and lumbosacral intvrt disc disorders"	"Fibrosis and cirrhosis of liver"	1	394	41	435
"M51"	"K76"	"Thoracic, thoracolum, and lumbosacral intvrt disc disorders"	"Other diseases of liver"	1	793	250	1043
"M51"	"K81"	"Thoracic, thoracolum, and lumbosacral intvrt disc disorders"	"Cholecystitis"	1	676	230	906
"M51"	"K91"	"Thoracic, thoracolum, and lumbosacral intvrt disc disorders"	"Intraop and postproc comp and disorders of dgstv sys, NEC"	1	328	73	401
"M51"	"K92"	"Thoracic, thoracolum, and lumbosacral intvrt disc disorders"	"Other diseases of digestive system"	1	1835	395	2230
"M51"	"L90"	"Thoracic, thoracolum, and lumbosacral intvrt disc disorders"	"Atrophic disorders of skin"	1	716	463	1179
"M51"	"L95"	"Thoracic, thoracolum, and lumbosacral intvrt disc disorders"	"Vasculitis limited to skin, not elsewhere classified"	1	91	24	115
"M51"	"L97"	"Thoracic, thoracolum, and lumbosacral intvrt disc disorders"	"Non-pressure chronic ulcer of lower limb, NEC"	1	984	3	987
"M51"	"L98"	"Thoracic, thoracolum, and lumbosacral intvrt disc disorders"	"Oth disorders of skin, subcu, not elsewhere classified"	1	849	199	1048
"M51"	"M00"	"Thoracic, thoracolum, and lumbosacral intvrt disc disorders"	"Pyogenic arthritis"	1	266	112	378
"M51"	"M05"	"Thoracic, thoracolum, and lumbosacral intvrt disc disorders"	"Rheumatoid arthritis with rheumatoid factor"	1	599	391	990
"M51"	"M14"	"Thoracic, thoracolum, and lumbosacral intvrt disc disorders"	"Arthropathies in other diseases classified elsewhere"	1	84	23	107
"M51"	"M15"	"Thoracic, thoracolum, and lumbosacral intvrt disc disorders"	"Polyosteoarthritis"	1	1246	834	2080
"M51"	"M72"	"Thoracic, thoracolum, and lumbosacral intvrt disc disorders"	"Fibroblastic disorders"	1	1227	678	1905
"M51"	"M80"	"Thoracic, thoracolum, and lumbosacral intvrt disc disorders"	"Osteoporosis with current pathological fracture"	1	2404	691	3095
"M51"	"M90"	"Thoracic, thoracolum, and lumbosacral intvrt disc disorders"	"Osteopathies in diseases classified elsewhere"	1	75	13	88
"M51"	"N13"	"Thoracic, thoracolum, and lumbosacral intvrt disc disorders"	"Obstructive and reflux uropathy"	1	793	263	1056
"M51"	"N18"	"Thoracic, thoracolum, and lumbosacral intvrt disc disorders"	"Chronic kidney disease (CKD)"	1	1749	0	1749
"M51"	"N28"	"Thoracic, thoracolum, and lumbosacral intvrt disc disorders"	"Oth disorders of kidney and ureter, not elsewhere classified"	1	447	77	524
"M51"	"N30"	"Thoracic, thoracolum, and lumbosacral intvrt disc disorders"	"Cystitis"	1	8146	0	8146
"M51"	"N48"	"Thoracic, thoracolum, and lumbosacral intvrt disc disorders"	"Other disorders of penis"	1	802	337	1139
"M51"	"N95"	"Thoracic, thoracolum, and lumbosacral intvrt disc disorders"	"Menopausal and other perimenopausal disorders"	1	1308	774	2082
"M51"	"Q61"	"Thoracic, thoracolum, and lumbosacral intvrt disc disorders"	"Cystic kidney disease"	1	403	86	489
"M53"	"A41"	"Other and unspecified dorsopathies, not elsewhere classified"	"Other sepsis"	1	632	123	755
"M53"	"C15"	"Other and unspecified dorsopathies, not elsewhere classified"	"Malignant neoplasm of esophagus"	1	33	2	35
"M53"	"C25"	"Other and unspecified dorsopathies, not elsewhere classified"	"Malignant neoplasm of pancreas"	1	65	1	66
"M53"	"C78"	"Other and unspecified dorsopathies, not elsewhere classified"	"Secondary malignant neoplasm of resp and digestive organs"	1	311	25	336
"M53"	"D63"	"Other and unspecified dorsopathies, not elsewhere classified"	"Anemia in chronic diseases classified elsewhere"	1	132	18	150
"M53"	"D64"	"Other and unspecified dorsopathies, not elsewhere classified"	"Other anemias"	1	618	224	842
"M53"	"E86"	"Other and unspecified dorsopathies, not elsewhere classified"	"Volume depletion"	1	591	111	702
"M53"	"G62"	"Other and unspecified dorsopathies, not elsewhere classified"	"Other and unspecified polyneuropathies"	1	323	191	514
"M53"	"J18"	"Other and unspecified dorsopathies, not elsewhere classified"	"Pneumonia, unspecified organism"	1	1232	595	1827
"M53"	"J44"	"Other and unspecified dorsopathies, not elsewhere classified"	"Other chronic obstructive pulmonary disease"	1	694	380	1074
"M53"	"J90"	"Other and unspecified dorsopathies, not elsewhere classified"	"Pleural effusion, not elsewhere classified"	1	104	23	127
"M53"	"K59"	"Other and unspecified dorsopathies, not elsewhere classified"	"Other functional intestinal disorders"	1	1252	686	1938
"M53"	"M81"	"Other and unspecified dorsopathies, not elsewhere classified"	"Osteoporosis without current pathological fracture"	1	777	454	1231
"M53"	"N19"	"Other and unspecified dorsopathies, not elsewhere classified"	"Unspecified kidney failure"	1	92	33	125
"M54"	"B44"	"Dorsalgia"	"Aspergillosis"	1	61	15	76
"M54"	"C04"	"Dorsalgia"	"Malignant neoplasm of floor of mouth"	1	66	6	72
"M54"	"C06"	"Dorsalgia"	"Malignant neoplasm of other and unspecified parts of mouth"	1	138	23	161
"M54"	"C10"	"Dorsalgia"	"Malignant neoplasm of oropharynx"	1	123	2	125
"M54"	"C17"	"Dorsalgia"	"Malignant neoplasm of small intestine"	1	81	10	91
"M54"	"C20"	"Dorsalgia"	"Malignant neoplasm of rectum"	1	478	301	779
"M54"	"C22"	"Dorsalgia"	"Malignant neoplasm of liver and intrahepatic bile ducts"	1	371	11	382
"M54"	"C23"	"Dorsalgia"	"Malignant neoplasm of gallbladder"	1	36	4	40
"M54"	"C24"	"Dorsalgia"	"Malignant neoplasm of other and unsp parts of biliary tract"	1	162	8	170
"M54"	"C32"	"Dorsalgia"	"Malignant neoplasm of larynx"	1	134	61	195
"M54"	"C44"	"Dorsalgia"	"Other and unspecified malignant neoplasm of skin"	1	2080	851	2931
"M54"	"C48"	"Dorsalgia"	"Malignant neoplasm of retroperitoneum and peritoneum"	1	70	9	79
"M54"	"C71"	"Dorsalgia"	"Malignant neoplasm of brain"	1	356	81	437
"M54"	"C77"	"Dorsalgia"	"Secondary and unspecified malignant neoplasm of lymph nodes"	1	1001	229	1230
"M54"	"C78"	"Dorsalgia"	"Secondary malignant neoplasm of resp and digestive organs"	1	3369	0	3369
"M54"	"C83"	"Dorsalgia"	"Non-follicular lymphoma"	1	533	183	716
"M54"	"C85"	"Dorsalgia"	"Oth and unspecified types of non-Hodgkin lymphoma"	1	399	227	626
"M54"	"C92"	"Dorsalgia"	"Myeloid leukemia"	1	265	68	333
"M54"	"D12"	"Dorsalgia"	"Benign neoplasm of colon, rectum, anus and anal canal"	1	6432	0	6432
"M54"	"D13"	"Dorsalgia"	"Benign neoplasm of and ill-defined parts of digestive system"	1	504	198	702
"M54"	"D17"	"Dorsalgia"	"Benign lipomatous neoplasm"	1	1855	1344	3199
"M54"	"D22"	"Dorsalgia"	"Melanocytic nevi"	1	1111	492	1603
"M54"	"D35"	"Dorsalgia"	"Benign neoplasm of other and unspecified endocrine glands"	1	569	169	738
"M54"	"D51"	"Dorsalgia"	"Vitamin B12 deficiency anemia"	1	542	373	915
"M54"	"D61"	"Dorsalgia"	"Oth aplastic anemias and other bone marrow failure syndromes"	1	231	79	310
"M54"	"D63"	"Dorsalgia"	"Anemia in chronic diseases classified elsewhere"	1	1682	326	2008
"M54"	"D64"	"Dorsalgia"	"Other anemias"	1	10181	0	10181
"M54"	"D69"	"Dorsalgia"	"Purpura and other hemorrhagic conditions"	1	744	408	1152
"M54"	"D70"	"Dorsalgia"	"Neutropenia"	1	126	55	181
"M54"	"E13"	"Dorsalgia"	"Other specified diabetes mellitus"	1	394	92	486
"M54"	"E86"	"Dorsalgia"	"Volume depletion"	1	12304	0	12304
"M54"	"F20"	"Dorsalgia"	"Schizophrenia"	1	416	228	644
"M54"	"F34"	"Dorsalgia"	"Persistent mood [affective] disorders"	1	374	213	587
"M54"	"F41"	"Dorsalgia"	"Other anxiety disorders"	1	3043	935	3978
"M54"	"F45"	"Dorsalgia"	"Somatoform disorders"	1	736	458	1194
"M54"	"G12"	"Dorsalgia"	"Spinal muscular atrophy and related syndromes"	1	212	48	260
"M54"	"G25"	"Dorsalgia"	"Other extrapyramidal and movement disorders"	1	610	249	859
"M54"	"G44"	"Dorsalgia"	"Other headache syndromes"	1	2871	2069	4940
"M54"	"G50"	"Dorsalgia"	"Disorders of trigeminal nerve"	1	535	331	866
"M54"	"G54"	"Dorsalgia"	"Nerve root and plexus disorders"	1	976	754	1730
"M54"	"G56"	"Dorsalgia"	"Mononeuropathies of upper limb"	1	5083	4332	9415
"M54"	"G62"	"Dorsalgia"	"Other and unspecified polyneuropathies"	1	2664	1130	3794
"M54"	"G93"	"Dorsalgia"	"Other disorders of brain"	1	605	190	795
"M54"	"G98"	"Dorsalgia"	"Other disorders of nervous system not elsewhere classified"	1	1044	198	1242
"M54"	"H18"	"Dorsalgia"	"Other disorders of cornea"	1	466	279	745
"M54"	"H25"	"Dorsalgia"	"Age-related cataract"	1	8244	5843	14087
"M54"	"H26"	"Dorsalgia"	"Other cataract"	1	2479	1665	4144
"M54"	"H33"	"Dorsalgia"	"Retinal detachments and breaks"	1	607	422	1029
"M54"	"H35"	"Dorsalgia"	"Other retinal disorders"	1	2970	1858	4828
"M54"	"H43"	"Dorsalgia"	"Disorders of vitreous body"	1	950	457	1407
"M54"	"H47"	"Dorsalgia"	"Other disorders of optic [2nd] nerve and visual pathways"	1	255	139	394
"M54"	"I10"	"Dorsalgia"	"Essential (primary) hypertension"	1	17724	12765	30489
"M54"	"I15"	"Dorsalgia"	"Secondary hypertension"	1	892	439	1331
"M54"	"I26"	"Dorsalgia"	"Pulmonary embolism"	1	2407	996	3403
"M54"	"I33"	"Dorsalgia"	"Acute and subacute endocarditis"	1	334	145	479
"M54"	"I46"	"Dorsalgia"	"Cardiac arrest"	1	1605	0	1605
"M54"	"I48"	"Dorsalgia"	"Atrial fibrillation and flutter"	1	8246	4407	12653
"M54"	"I50"	"Dorsalgia"	"Heart failure"	1	11136	0	11136
"M54"	"I51"	"Dorsalgia"	"Complications and ill-defined descriptions of heart disease"	1	935	326	1261
"M54"	"I61"	"Dorsalgia"	"Nontraumatic intracerebral hemorrhage"	1	1442	327	1769
"M54"	"I63"	"Dorsalgia"	"Cerebral infarction"	1	4690	1732	6422
"M54"	"I69"	"Dorsalgia"	"Sequelae of cerebrovascular disease"	1	7794	0	7794
"M54"	"I70"	"Dorsalgia"	"Atherosclerosis"	1	3153	2387	5540
"M54"	"I71"	"Dorsalgia"	"Aortic aneurysm and dissection"	1	1754	637	2391
"M54"	"I74"	"Dorsalgia"	"Arterial embolism and thrombosis"	1	581	252	833
"M54"	"I85"	"Dorsalgia"	"Esophageal varices"	1	388	131	519
"M54"	"J43"	"Dorsalgia"	"Emphysema"	1	723	367	1090
"M54"	"J47"	"Dorsalgia"	"Bronchiectasis"	1	416	69	485
"M54"	"J69"	"Dorsalgia"	"Pneumonitis due to solids and liquids"	1	762	19	781
"M54"	"J81"	"Dorsalgia"	"Pulmonary edema"	1	1101	202	1303
"M54"	"J91"	"Dorsalgia"	"Pleural effusion in conditions classified elsewhere"	1	509	108	617
"M54"	"J94"	"Dorsalgia"	"Other pleural conditions"	1	373	142	515
"M54"	"J95"	"Dorsalgia"	"Intraop and postproc comp and disorders of resp sys, NEC"	1	285	38	323
"M54"	"J96"	"Dorsalgia"	"Respiratory failure, not elsewhere classified"	1	7055	0	7055
"M54"	"K05"	"Dorsalgia"	"Gingivitis and periodontal diseases"	1	896	443	1339
"M54"	"K12"	"Dorsalgia"	"Stomatitis and related lesions"	1	419	277	696
"M54"	"K21"	"Dorsalgia"	"Gastro-esophageal reflux disease"	1	4294	3348	7642
"M54"	"K25"	"Dorsalgia"	"Gastric ulcer"	1	2915	2359	5274
"M54"	"K43"	"Dorsalgia"	"Ventral hernia"	1	1624	1028	2652
"M54"	"K52"	"Dorsalgia"	"Other and unsp noninfective gastroenteritis and colitis"	1	3344	1843	5187
"M54"	"K56"	"Dorsalgia"	"Paralytic ileus and intestinal obstruction without hernia"	1	2347	915	3262
"M54"	"K57"	"Dorsalgia"	"Diverticular disease of intestine"	1	5621	2347	7968
"M54"	"K59"	"Dorsalgia"	"Other functional intestinal disorders"	1	18591	0	18591
"M54"	"K65"	"Dorsalgia"	"Peritonitis"	1	857	406	1263
"M54"	"K70"	"Dorsalgia"	"Alcoholic liver disease"	1	1114	499	1613
"M54"	"K72"	"Dorsalgia"	"Hepatic failure, not elsewhere classified"	1	641	91	732
"M54"	"K80"	"Dorsalgia"	"Cholelithiasis"	1	5331	4696	10027
"M54"	"K83"	"Dorsalgia"	"Other diseases of biliary tract"	1	929	352	1281
"M54"	"K85"	"Dorsalgia"	"Acute pancreatitis"	1	1116	790	1906
"M54"	"K86"	"Dorsalgia"	"Other diseases of pancreas"	1	798	410	1208
"M54"	"K91"	"Dorsalgia"	"Intraop and postproc comp and disorders of dgstv sys, NEC"	1	478	210	688
"M54"	"L98"	"Dorsalgia"	"Oth disorders of skin, subcu, not elsewhere classified"	1	1467	564	2031
"M54"	"M15"	"Dorsalgia"	"Polyosteoarthritis"	1	1453	1102	2555
"M54"	"M19"	"Dorsalgia"	"Other and unspecified osteoarthritis"	1	9033	0	9033
"M54"	"M45"	"Dorsalgia"	"Ankylosing spondylitis"	1	892	539	1431
"M54"	"M46"	"Dorsalgia"	"Other inflammatory spondylopathies"	1	2415	1499	3914
"M54"	"M48"	"Dorsalgia"	"Other spondylopathies"	1	14117	9351	23468
"M54"	"M49"	"Dorsalgia"	"Spondylopathies in diseases classified elsewhere"	1	258	153	411
"M54"	"M53"	"Dorsalgia"	"Other and unspecified dorsopathies, not elsewhere classified"	1	5584	4767	10351
"M54"	"M70"	"Dorsalgia"	"Soft tissue disorders related to use, overuse and pressure"	1	3972	3477	7449
"M54"	"M80"	"Dorsalgia"	"Osteoporosis with current pathological fracture"	1	7419	3968	11387
"M54"	"M86"	"Dorsalgia"	"Osteomyelitis"	1	410	259	669
"M54"	"N19"	"Dorsalgia"	"Unspecified kidney failure"	1	1533	428	1961
"M54"	"N30"	"Dorsalgia"	"Cystitis"	1	11402	7671	19073
"M54"	"N31"	"Dorsalgia"	"Neuromuscular dysfunction of bladder, NEC"	1	1034	666	1700
"M54"	"N46"	"Dorsalgia"	"Male infertility"	1	755	534	1289
"M54"	"O72"	"Dorsalgia"	"Postpartum hemorrhage"	1	5308	2440	7748
"M54"	"Q23"	"Dorsalgia"	"Congenital malformations of aortic and mitral valves"	1	103	34	137
"M62"	"A41"	"Other disorders of muscle"	"Other sepsis"	1	3011	0	3011
"M62"	"C09"	"Other disorders of muscle"	"Malignant neoplasm of tonsil"	1	42	6	48
"M62"	"C10"	"Other disorders of muscle"	"Malignant neoplasm of oropharynx"	1	52	8	60
"M62"	"C16"	"Other disorders of muscle"	"Malignant neoplasm of stomach"	1	189	1	190
"M62"	"C17"	"Other disorders of muscle"	"Malignant neoplasm of small intestine"	1	29	0	29
"M62"	"C20"	"Other disorders of muscle"	"Malignant neoplasm of rectum"	1	290	44	334
"M62"	"C21"	"Other disorders of muscle"	"Malignant neoplasm of anus and anal canal"	1	43	0	43
"M62"	"C25"	"Other disorders of muscle"	"Malignant neoplasm of pancreas"	1	328	0	328
"M62"	"C32"	"Other disorders of muscle"	"Malignant neoplasm of larynx"	1	81	21	102
"M62"	"C49"	"Other disorders of muscle"	"Malignant neoplasm of other connective and soft tissue"	1	119	13	132
"M62"	"C50"	"Other disorders of muscle"	"Malignant neoplasm of breast"	1	1274	440	1714
"M62"	"C61"	"Other disorders of muscle"	"Malignant neoplasm of prostate"	1	774	48	822
"M62"	"C71"	"Other disorders of muscle"	"Malignant neoplasm of brain"	1	230	8	238
"M62"	"C77"	"Other disorders of muscle"	"Secondary and unspecified malignant neoplasm of lymph nodes"	1	459	16	475
"M62"	"C78"	"Other disorders of muscle"	"Secondary malignant neoplasm of resp and digestive organs"	1	1121	0	1121
"M62"	"C79"	"Other disorders of muscle"	"Secondary malignant neoplasm of other and unspecified sites"	1	1058	0	1058
"M62"	"C80"	"Other disorders of muscle"	"Malignant neoplasm without specification of site"	1	207	0	207
"M62"	"C92"	"Other disorders of muscle"	"Myeloid leukemia"	1	121	15	136
"M62"	"D23"	"Other disorders of muscle"	"Other benign neoplasms of skin"	1	801	420	1221
"M62"	"D30"	"Other disorders of muscle"	"Benign neoplasm of urinary organs"	1	310	108	418
"M62"	"D46"	"Other disorders of muscle"	"Myelodysplastic syndromes"	1	121	2	123
"M62"	"D61"	"Other disorders of muscle"	"Oth aplastic anemias and other bone marrow failure syndromes"	1	100	8	108
"M62"	"D63"	"Other disorders of muscle"	"Anemia in chronic diseases classified elsewhere"	1	612	0	612
"M62"	"D64"	"Other disorders of muscle"	"Other anemias"	1	3743	0	3743
"M62"	"E03"	"Other disorders of muscle"	"Other hypothyroidism"	1	2134	444	2578
"M62"	"E16"	"Other disorders of muscle"	"Other disorders of pancreatic internal secretion"	1	519	178	697
"M62"	"E68"	"Other disorders of muscle"	"Sequelae of hyperalimentation"	1	396	119	515
"M62"	"E73"	"Other disorders of muscle"	"Lactose intolerance"	1	259	96	355
"M62"	"E83"	"Other disorders of muscle"	"Disorders of mineral metabolism"	1	447	5	452
"M62"	"F32"	"Other disorders of muscle"	"Depressive episode"	1	3304	0	3304
"M62"	"G24"	"Other disorders of muscle"	"Dystonia"	1	328	46	374
"M62"	"G56"	"Other disorders of muscle"	"Mononeuropathies of upper limb"	1	3346	1437	4783
"M62"	"H26"	"Other disorders of muscle"	"Other cataract"	1	1740	305	2045
"M62"	"H33"	"Other disorders of muscle"	"Retinal detachments and breaks"	1	405	120	525
"M62"	"H36"	"Other disorders of muscle"	"Retinal disorders in diseases classified elsewhere"	1	652	110	762
"M62"	"H43"	"Other disorders of muscle"	"Disorders of vitreous body"	1	667	70	737
"M62"	"H81"	"Other disorders of muscle"	"Disorders of vestibular function"	1	1936	936	2872
"M62"	"H91"	"Other disorders of muscle"	"Other and unspecified hearing loss"	1	4743	1801	6544
"M62"	"H92"	"Other disorders of muscle"	"Otalgia and effusion of ear"	1	195	63	258
"M62"	"I10"	"Other disorders of muscle"	"Essential (primary) hypertension"	1	14965	0	14965
"M62"	"I21"	"Other disorders of muscle"	"Acute myocardial infarction"	1	2966	1818	4784
"M62"	"I24"	"Other disorders of muscle"	"Other acute ischemic heart diseases"	1	622	186	808
"M62"	"I70"	"Other disorders of muscle"	"Atherosclerosis"	1	2005	681	2686
"M62"	"I95"	"Other disorders of muscle"	"Hypotension"	1	1068	121	1189
"M62"	"J15"	"Other disorders of muscle"	"Bacterial pneumonia, not elsewhere classified"	1	3034	0	3034
"M62"	"J40"	"Other disorders of muscle"	"Bronchitis, not specified as acute or chronic"	1	239	120	359
"M62"	"J85"	"Other disorders of muscle"	"Abscess of lung and mediastinum"	1	80	12	92
"M62"	"J96"	"Other disorders of muscle"	"Respiratory failure, not elsewhere classified"	1	2984	0	2984
"M62"	"K05"	"Other disorders of muscle"	"Gingivitis and periodontal diseases"	1	709	514	1223
"M62"	"K25"	"Other disorders of muscle"	"Gastric ulcer"	1	1982	779	2761
"M62"	"K51"	"Other disorders of muscle"	"Ulcerative colitis"	1	579	395	974
"M62"	"K58"	"Other disorders of muscle"	"Irritable bowel syndrome"	1	2032	1228	3260
"M62"	"K65"	"Other disorders of muscle"	"Peritonitis"	1	448	81	529
"M62"	"K86"	"Other disorders of muscle"	"Other diseases of pancreas"	1	488	166	654
"M62"	"L29"	"Other disorders of muscle"	"Pruritus"	1	366	72	438
"M62"	"L50"	"Other disorders of muscle"	"Urticaria"	1	905	535	1440
"M62"	"L89"	"Other disorders of muscle"	"Pressure ulcer"	1	605	16	621
"M62"	"L97"	"Other disorders of muscle"	"Non-pressure chronic ulcer of lower limb, NEC"	1	825	14	839
"M62"	"L98"	"Other disorders of muscle"	"Oth disorders of skin, subcu, not elsewhere classified"	1	794	181	975
"M62"	"M05"	"Other disorders of muscle"	"Rheumatoid arthritis with rheumatoid factor"	1	630	209	839
"M62"	"M15"	"Other disorders of muscle"	"Polyosteoarthritis"	1	999	524	1523
"M62"	"M21"	"Other disorders of muscle"	"Other acquired deformities of limbs"	1	914	618	1532
"M62"	"M25"	"Other disorders of muscle"	"Other joint disorder, not elsewhere classified"	1	3111	1711	4822
"M62"	"M48"	"Other disorders of muscle"	"Other spondylopathies"	1	4150	0	4150
"M62"	"M79"	"Other disorders of muscle"	"Oth and unsp soft tissue disorders, not elsewhere classified"	1	9510	5051	14561
"M62"	"M80"	"Other disorders of muscle"	"Osteoporosis with current pathological fracture"	1	1969	0	1969
"M62"	"N13"	"Other disorders of muscle"	"Obstructive and reflux uropathy"	1	694	202	896
"M62"	"N18"	"Other disorders of muscle"	"Chronic kidney disease (CKD)"	1	1535	0	1535
"M62"	"N46"	"Other disorders of muscle"	"Male infertility"	1	377	126	503
"M62"	"N93"	"Other disorders of muscle"	"Other abnormal uterine and vaginal bleeding"	1	784	525	1309
"M62"	"Q40"	"Other disorders of muscle"	"Other congenital malformations of upper alimentary tract"	1	217	40	257
"M65"	"A04"	"Synovitis and tenosynovitis"	"Other bacterial intestinal infections"	1	290	64	354
"M65"	"B37"	"Synovitis and tenosynovitis"	"Candidiasis"	1	296	96	392
"M65"	"B96"	"Synovitis and tenosynovitis"	"Oth bacterial agents as the cause of diseases classd elswhr"	1	76	10	86
"M65"	"C09"	"Synovitis and tenosynovitis"	"Malignant neoplasm of tonsil"	1	35	3	38
"M65"	"C15"	"Synovitis and tenosynovitis"	"Malignant neoplasm of esophagus"	1	113	0	113
"M65"	"C18"	"Synovitis and tenosynovitis"	"Malignant neoplasm of colon"	1	499	103	602
"M65"	"C24"	"Synovitis and tenosynovitis"	"Malignant neoplasm of other and unsp parts of biliary tract"	1	47	0	47
"M65"	"C48"	"Synovitis and tenosynovitis"	"Malignant neoplasm of retroperitoneum and peritoneum"	1	28	0	28
"M65"	"C61"	"Synovitis and tenosynovitis"	"Malignant neoplasm of prostate"	1	506	129	635
"M65"	"C71"	"Synovitis and tenosynovitis"	"Malignant neoplasm of brain"	1	142	2	144
"M65"	"C77"	"Synovitis and tenosynovitis"	"Secondary and unspecified malignant neoplasm of lymph nodes"	1	400	26	426
"M65"	"C79"	"Synovitis and tenosynovitis"	"Secondary malignant neoplasm of other and unspecified sites"	1	606	0	606
"M65"	"C82"	"Synovitis and tenosynovitis"	"Follicular lymphoma"	1	50	12	62
"M65"	"C83"	"Synovitis and tenosynovitis"	"Non-follicular lymphoma"	1	133	17	150
"M65"	"C85"	"Synovitis and tenosynovitis"	"Oth and unspecified types of non-Hodgkin lymphoma"	1	101	28	129
"M65"	"C90"	"Synovitis and tenosynovitis"	"Multiple myeloma and malignant plasma cell neoplasms"	1	96	12	108
"M65"	"D05"	"Synovitis and tenosynovitis"	"Carcinoma in situ of breast"	1	103	41	144
"M65"	"D12"	"Synovitis and tenosynovitis"	"Benign neoplasm of colon, rectum, anus and anal canal"	1	2317	527	2844
"M65"	"D13"	"Synovitis and tenosynovitis"	"Benign neoplasm of and ill-defined parts of digestive system"	1	175	74	249
"M65"	"D22"	"Synovitis and tenosynovitis"	"Melanocytic nevi"	1	430	200	630
"M65"	"D30"	"Synovitis and tenosynovitis"	"Benign neoplasm of urinary organs"	1	207	108	315
"M65"	"D35"	"Synovitis and tenosynovitis"	"Benign neoplasm of other and unspecified endocrine glands"	1	189	55	244
"M65"	"D46"	"Synovitis and tenosynovitis"	"Myelodysplastic syndromes"	1	49	1	50
"M65"	"D47"	"Synovitis and tenosynovitis"	"Oth neoplm of uncrt behav of lymphoid, hematpoetc & rel tiss"	1	234	21	255
"M65"	"D50"	"Synovitis and tenosynovitis"	"Iron deficiency anemia"	1	634	132	766
"M65"	"D61"	"Synovitis and tenosynovitis"	"Oth aplastic anemias and other bone marrow failure syndromes"	1	54	3	57
"M65"	"D62"	"Synovitis and tenosynovitis"	"Acute posthemorrhagic anemia"	1	219	33	252
"M65"	"D63"	"Synovitis and tenosynovitis"	"Anemia in chronic diseases classified elsewhere"	1	340	0	340
"M65"	"E13"	"Synovitis and tenosynovitis"	"Other specified diabetes mellitus"	1	157	29	186
"M65"	"E21"	"Synovitis and tenosynovitis"	"Hyperparathyroidism and other disorders of parathyroid gland"	1	210	75	285
"M65"	"E27"	"Synovitis and tenosynovitis"	"Other disorders of adrenal gland"	1	143	31	174
"M65"	"E34"	"Synovitis and tenosynovitis"	"Other endocrine disorders"	1	142	43	185
"M65"	"E55"	"Synovitis and tenosynovitis"	"Vitamin D deficiency"	1	266	38	304
"M65"	"E64"	"Synovitis and tenosynovitis"	"Sequelae of malnutrition and other nutritional deficiencies"	1	145	15	160
"M65"	"E78"	"Synovitis and tenosynovitis"	"Disorders of lipoprotein metabolism and other lipidemias"	1	3093	1288	4381
"M65"	"F01"	"Synovitis and tenosynovitis"	"Vascular dementia"	1	103	0	103
"M65"	"F02"	"Synovitis and tenosynovitis"	"Dementia in other diseases classified elsewhere"	1	44	1	45
"M65"	"F33"	"Synovitis and tenosynovitis"	"Major depressive disorder, recurrent"	1	499	87	586
"M65"	"F41"	"Synovitis and tenosynovitis"	"Other anxiety disorders"	1	555	78	633
"M65"	"G12"	"Synovitis and tenosynovitis"	"Spinal muscular atrophy and related syndromes"	1	49	3	52
"M65"	"G30"	"Synovitis and tenosynovitis"	"Alzheimer's disease"	1	185	0	185
"M65"	"G44"	"Synovitis and tenosynovitis"	"Other headache syndromes"	1	684	429	1113
"M65"	"G45"	"Synovitis and tenosynovitis"	"Transient cerebral ischemic attacks and related syndromes"	1	955	478	1433
"M65"	"G47"	"Synovitis and tenosynovitis"	"Sleep disorders"	1	1695	347	2042
"M65"	"G91"	"Synovitis and tenosynovitis"	"Hydrocephalus"	1	96	16	112
"M65"	"G93"	"Synovitis and tenosynovitis"	"Other disorders of brain"	1	130	35	165
"M65"	"H25"	"Synovitis and tenosynovitis"	"Age-related cataract"	1	5295	0	5295
"M65"	"H40"	"Synovitis and tenosynovitis"	"Glaucoma"	1	429	209	638
"M65"	"I15"	"Synovitis and tenosynovitis"	"Secondary hypertension"	1	292	101	393
"M65"	"I26"	"Synovitis and tenosynovitis"	"Pulmonary embolism"	1	655	111	766
"M65"	"I31"	"Synovitis and tenosynovitis"	"Other diseases of pericardium"	1	87	14	101
"M65"	"I34"	"Synovitis and tenosynovitis"	"Nonrheumatic mitral valve disorders"	1	366	66	432
"M65"	"I35"	"Synovitis and tenosynovitis"	"Nonrheumatic aortic valve disorders"	1	1209	75	1284
"M65"	"I38"	"Synovitis and tenosynovitis"	"Endocarditis, valve unspecified"	1	49	4	53
"M65"	"I46"	"Synovitis and tenosynovitis"	"Cardiac arrest"	1	315	0	315
"M65"	"I49"	"Synovitis and tenosynovitis"	"Other cardiac arrhythmias"	1	853	379	1232
"M65"	"I51"	"Synovitis and tenosynovitis"	"Complications and ill-defined descriptions of heart disease"	1	258	62	320
"M65"	"I60"	"Synovitis and tenosynovitis"	"Nontraumatic subarachnoid hemorrhage"	1	150	63	213
"M65"	"I67"	"Synovitis and tenosynovitis"	"Other cerebrovascular diseases"	1	176	32	208
"M65"	"I69"	"Synovitis and tenosynovitis"	"Sequelae of cerebrovascular disease"	1	1282	193	1475
"M65"	"I70"	"Synovitis and tenosynovitis"	"Atherosclerosis"	1	775	432	1207
"M65"	"I71"	"Synovitis and tenosynovitis"	"Aortic aneurysm and dissection"	1	433	39	472
"M65"	"I80"	"Synovitis and tenosynovitis"	"Phlebitis and thrombophlebitis"	1	1081	620	1701
"M65"	"I82"	"Synovitis and tenosynovitis"	"Other venous embolism and thrombosis"	1	250	74	324
"M65"	"I87"	"Synovitis and tenosynovitis"	"Other disorders of veins"	1	150	53	203
"M65"	"J18"	"Synovitis and tenosynovitis"	"Pneumonia, unspecified organism"	1	4459	0	4459
"M65"	"J22"	"Synovitis and tenosynovitis"	"Unspecified acute lower respiratory infection"	1	171	5	176
"M65"	"J47"	"Synovitis and tenosynovitis"	"Bronchiectasis"	1	186	31	217
"M65"	"J93"	"Synovitis and tenosynovitis"	"Pneumothorax and air leak"	1	189	66	255
"M65"	"J98"	"Synovitis and tenosynovitis"	"Other respiratory disorders"	1	252	97	349
"M65"	"K05"	"Synovitis and tenosynovitis"	"Gingivitis and periodontal diseases"	1	258	126	384
"M65"	"K22"	"Synovitis and tenosynovitis"	"Other diseases of esophagus"	1	407	122	529
"M65"	"K25"	"Synovitis and tenosynovitis"	"Gastric ulcer"	1	584	358	942
"M65"	"K31"	"Synovitis and tenosynovitis"	"Other diseases of stomach and duodenum"	1	167	41	208
"M65"	"K43"	"Synovitis and tenosynovitis"	"Ventral hernia"	1	518	335	853
"M65"	"K44"	"Synovitis and tenosynovitis"	"Diaphragmatic hernia"	1	1018	760	1778
"M65"	"K52"	"Synovitis and tenosynovitis"	"Other and unsp noninfective gastroenteritis and colitis"	1	946	424	1370
"M65"	"K56"	"Synovitis and tenosynovitis"	"Paralytic ileus and intestinal obstruction without hernia"	1	567	174	741
"M65"	"K57"	"Synovitis and tenosynovitis"	"Diverticular disease of intestine"	1	2227	583	2810
"M65"	"K59"	"Synovitis and tenosynovitis"	"Other functional intestinal disorders"	1	2990	908	3898
"M65"	"K63"	"Synovitis and tenosynovitis"	"Other diseases of intestine"	1	332	37	369
"M65"	"K70"	"Synovitis and tenosynovitis"	"Alcoholic liver disease"	1	238	47	285
"M65"	"K74"	"Synovitis and tenosynovitis"	"Fibrosis and cirrhosis of liver"	1	167	28	195
"M65"	"K86"	"Synovitis and tenosynovitis"	"Other diseases of pancreas"	1	177	67	244
"M65"	"K90"	"Synovitis and tenosynovitis"	"Intestinal malabsorption"	1	126	57	183
"M65"	"L30"	"Synovitis and tenosynovitis"	"Other and unspecified dermatitis"	1	511	253	764
"M65"	"L90"	"Synovitis and tenosynovitis"	"Atrophic disorders of skin"	1	551	352	903
"M65"	"M07"	"Synovitis and tenosynovitis"	"Enteropathic arthropathies"	1	575	200	775
"M65"	"M13"	"Synovitis and tenosynovitis"	"Other arthritis"	1	1380	884	2264
"M65"	"M15"	"Synovitis and tenosynovitis"	"Polyosteoarthritis"	1	750	457	1207
"M65"	"M19"	"Synovitis and tenosynovitis"	"Other and unspecified osteoarthritis"	1	3773	2215	5988
"M65"	"M31"	"Synovitis and tenosynovitis"	"Other necrotizing vasculopathies"	1	174	82	256
"M65"	"M70"	"Synovitis and tenosynovitis"	"Soft tissue disorders related to use, overuse and pressure"	1	1927	1418	3345
"M65"	"M75"	"Synovitis and tenosynovitis"	"Shoulder lesions"	1	4894	4086	8980
"M65"	"M99"	"Synovitis and tenosynovitis"	"Biomechanical lesions, not elsewhere classified"	1	523	251	774
"M65"	"N18"	"Synovitis and tenosynovitis"	"Chronic kidney disease (CKD)"	1	830	58	888
"M65"	"N39"	"Synovitis and tenosynovitis"	"Other disorders of urinary system"	1	2333	852	3185
"M65"	"N46"	"Synovitis and tenosynovitis"	"Male infertility"	1	323	177	500
"M65"	"N50"	"Synovitis and tenosynovitis"	"Other and unspecified disorders of male genital organs"	1	299	163	462
"M65"	"O92"	"Synovitis and tenosynovitis"	"Oth disord of brst/lactatn assoc w pregnancy and the puerp"	1	204	102	306
"M65"	"O99"	"Synovitis and tenosynovitis"	"Oth maternal diseases classd elsw but compl preg/chldbrth"	1	1402	895	2297
"M66"	"C79"	"Spontaneous rupture of synovium and tendon"	"Secondary malignant neoplasm of other and unspecified sites"	1	41	1	42
"M66"	"D64"	"Spontaneous rupture of synovium and tendon"	"Other anemias"	1	218	81	299
"M66"	"E87"	"Spontaneous rupture of synovium and tendon"	"Other disorders of fluid, electrolyte and acid-base balance"	1	141	44	185
"M66"	"I48"	"Spontaneous rupture of synovium and tendon"	"Atrial fibrillation and flutter"	1	322	176	498
"M66"	"I50"	"Spontaneous rupture of synovium and tendon"	"Heart failure"	1	233	108	341
"M66"	"I69"	"Spontaneous rupture of synovium and tendon"	"Sequelae of cerebrovascular disease"	1	148	69	217
"M66"	"J15"	"Spontaneous rupture of synovium and tendon"	"Bacterial pneumonia, not elsewhere classified"	1	199	43	242
"M66"	"J90"	"Spontaneous rupture of synovium and tendon"	"Pleural effusion, not elsewhere classified"	1	46	4	50
"M66"	"J96"	"Spontaneous rupture of synovium and tendon"	"Respiratory failure, not elsewhere classified"	1	213	29	242
"M66"	"N17"	"Spontaneous rupture of synovium and tendon"	"Acute kidney failure"	1	50	3	53
"M66"	"N39"	"Spontaneous rupture of synovium and tendon"	"Other disorders of urinary system"	1	254	127	381
"M67"	"A04"	"Other disorders of synovium and tendon"	"Other bacterial intestinal infections"	1	125	55	180
"M67"	"A46"	"Other disorders of synovium and tendon"	"Erysipelas"	1	469	218	687
"M67"	"C15"	"Other disorders of synovium and tendon"	"Malignant neoplasm of esophagus"	1	71	0	71
"M67"	"C16"	"Other disorders of synovium and tendon"	"Malignant neoplasm of stomach"	1	89	0	89
"M67"	"C18"	"Other disorders of synovium and tendon"	"Malignant neoplasm of colon"	1	298	35	333
"M67"	"C20"	"Other disorders of synovium and tendon"	"Malignant neoplasm of rectum"	1	131	15	146
"M67"	"C24"	"Other disorders of synovium and tendon"	"Malignant neoplasm of other and unsp parts of biliary tract"	1	35	0	35
"M67"	"C25"	"Other disorders of synovium and tendon"	"Malignant neoplasm of pancreas"	1	122	0	122
"M67"	"C49"	"Other disorders of synovium and tendon"	"Malignant neoplasm of other connective and soft tissue"	1	100	34	134
"M67"	"C50"	"Other disorders of synovium and tendon"	"Malignant neoplasm of breast"	1	495	290	785
"M67"	"C56"	"Other disorders of synovium and tendon"	"Malignant neoplasm of ovary"	1	76	16	92
"M67"	"C67"	"Other disorders of synovium and tendon"	"Malignant neoplasm of bladder"	1	58	15	73
"M67"	"C71"	"Other disorders of synovium and tendon"	"Malignant neoplasm of brain"	1	86	2	88
"M67"	"C78"	"Other disorders of synovium and tendon"	"Secondary malignant neoplasm of resp and digestive organs"	1	437	0	437
"M67"	"C79"	"Other disorders of synovium and tendon"	"Secondary malignant neoplasm of other and unspecified sites"	1	314	0	314
"M67"	"C80"	"Other disorders of synovium and tendon"	"Malignant neoplasm without specification of site"	1	38	0	38
"M67"	"C90"	"Other disorders of synovium and tendon"	"Multiple myeloma and malignant plasma cell neoplasms"	1	47	3	50
"M67"	"C91"	"Other disorders of synovium and tendon"	"Lymphoid leukemia"	1	60	14	74
"M67"	"D12"	"Other disorders of synovium and tendon"	"Benign neoplasm of colon, rectum, anus and anal canal"	1	1508	231	1739
"M67"	"D22"	"Other disorders of synovium and tendon"	"Melanocytic nevi"	1	441	227	668
"M67"	"D46"	"Other disorders of synovium and tendon"	"Myelodysplastic syndromes"	1	31	2	33
"M67"	"D50"	"Other disorders of synovium and tendon"	"Iron deficiency anemia"	1	416	87	503
"M67"	"D63"	"Other disorders of synovium and tendon"	"Anemia in chronic diseases classified elsewhere"	1	159	0	159
"M67"	"D64"	"Other disorders of synovium and tendon"	"Other anemias"	1	847	113	960
"M67"	"D75"	"Other disorders of synovium and tendon"	"Other and unsp diseases of blood and blood-forming organs"	1	91	26	117
"M67"	"E03"	"Other disorders of synovium and tendon"	"Other hypothyroidism"	1	703	246	949
"M67"	"E06"	"Other disorders of synovium and tendon"	"Thyroiditis"	1	151	64	215
"M67"	"E13"	"Other disorders of synovium and tendon"	"Other specified diabetes mellitus"	1	69	17	86
"M67"	"E23"	"Other disorders of synovium and tendon"	"Hypofunction and other disorders of the pituitary gland"	1	77	23	100
"M67"	"E64"	"Other disorders of synovium and tendon"	"Sequelae of malnutrition and other nutritional deficiencies"	1	77	21	98
"M67"	"E66"	"Other disorders of synovium and tendon"	"Overweight and obesity"	1	2605	1191	3796
"M67"	"E78"	"Other disorders of synovium and tendon"	"Disorders of lipoprotein metabolism and other lipidemias"	1	1908	593	2501
"M67"	"E83"	"Other disorders of synovium and tendon"	"Disorders of mineral metabolism"	1	185	12	197
"M67"	"E86"	"Other disorders of synovium and tendon"	"Volume depletion"	1	707	98	805
"M67"	"F01"	"Other disorders of synovium and tendon"	"Vascular dementia"	1	34	0	34
"M67"	"F05"	"Other disorders of synovium and tendon"	"Delirium due to known physiological condition"	1	110	0	110
"M67"	"F17"	"Other disorders of synovium and tendon"	"Nicotine dependence"	1	680	178	858
"M67"	"F31"	"Other disorders of synovium and tendon"	"Bipolar disorder"	1	65	17	82
"M67"	"F32"	"Other disorders of synovium and tendon"	"Depressive episode"	1	423	172	595
"M67"	"F41"	"Other disorders of synovium and tendon"	"Other anxiety disorders"	1	389	78	467
"M67"	"G45"	"Other disorders of synovium and tendon"	"Transient cerebral ischemic attacks and related syndromes"	1	582	203	785
"M67"	"G47"	"Other disorders of synovium and tendon"	"Sleep disorders"	1	1184	245	1429
"M67"	"G62"	"Other disorders of synovium and tendon"	"Other and unspecified polyneuropathies"	1	373	107	480
"M67"	"H02"	"Other disorders of synovium and tendon"	"Other disorders of eyelid"	1	539	266	805
"M67"	"H18"	"Other disorders of synovium and tendon"	"Other disorders of cornea"	1	144	51	195
"M67"	"H33"	"Other disorders of synovium and tendon"	"Retinal detachments and breaks"	1	185	99	284
"M67"	"H40"	"Other disorders of synovium and tendon"	"Glaucoma"	1	211	95	306
"M67"	"H43"	"Other disorders of synovium and tendon"	"Disorders of vitreous body"	1	300	113	413
"M67"	"H53"	"Other disorders of synovium and tendon"	"Visual disturbances"	1	329	176	505
"M67"	"H57"	"Other disorders of synovium and tendon"	"Other disorders of eye and adnexa"	1	292	130	422
"M67"	"H91"	"Other disorders of synovium and tendon"	"Other and unspecified hearing loss"	1	1324	781	2105
"M67"	"I10"	"Other disorders of synovium and tendon"	"Essential (primary) hypertension"	1	3957	1619	5576
"M67"	"I27"	"Other disorders of synovium and tendon"	"Other pulmonary heart diseases"	1	83	8	91
"M67"	"I34"	"Other disorders of synovium and tendon"	"Nonrheumatic mitral valve disorders"	1	199	49	248
"M67"	"I35"	"Other disorders of synovium and tendon"	"Nonrheumatic aortic valve disorders"	1	621	41	662
"M67"	"I46"	"Other disorders of synovium and tendon"	"Cardiac arrest"	1	238	0	238
"M67"	"I49"	"Other disorders of synovium and tendon"	"Other cardiac arrhythmias"	1	589	265	854
"M67"	"I50"	"Other disorders of synovium and tendon"	"Heart failure"	1	769	105	874
"M67"	"I61"	"Other disorders of synovium and tendon"	"Nontraumatic intracerebral hemorrhage"	1	193	30	223
"M67"	"I69"	"Other disorders of synovium and tendon"	"Sequelae of cerebrovascular disease"	1	674	100	774
"M67"	"I70"	"Other disorders of synovium and tendon"	"Atherosclerosis"	1	413	189	602
"M67"	"I73"	"Other disorders of synovium and tendon"	"Other peripheral vascular diseases"	1	601	147	748
"M67"	"I80"	"Other disorders of synovium and tendon"	"Phlebitis and thrombophlebitis"	1	641	415	1056
"M67"	"I85"	"Other disorders of synovium and tendon"	"Esophageal varices"	1	63	0	63
"M67"	"I95"	"Other disorders of synovium and tendon"	"Hypotension"	1	193	31	224
"M67"	"J06"	"Other disorders of synovium and tendon"	"Acute upper resp infections of multiple and unsp sites"	1	249	109	358
"M67"	"J09"	"Other disorders of synovium and tendon"	"Influenza due to certain identified influenza viruses"	1	53	1	54
"M67"	"J18"	"Other disorders of synovium and tendon"	"Pneumonia, unspecified organism"	1	1790	756	2546
"M67"	"J43"	"Other disorders of synovium and tendon"	"Emphysema"	1	106	23	129
"M67"	"J44"	"Other disorders of synovium and tendon"	"Other chronic obstructive pulmonary disease"	1	1129	325	1454
"M67"	"J81"	"Other disorders of synovium and tendon"	"Pulmonary edema"	1	67	1	68
"M67"	"J84"	"Other disorders of synovium and tendon"	"Other interstitial pulmonary diseases"	1	120	16	136
"M67"	"J90"	"Other disorders of synovium and tendon"	"Pleural effusion, not elsewhere classified"	1	171	19	190
"M67"	"J95"	"Other disorders of synovium and tendon"	"Intraop and postproc comp and disorders of resp sys, NEC"	1	45	2	47
"M67"	"J96"	"Other disorders of synovium and tendon"	"Respiratory failure, not elsewhere classified"	1	655	5	660
"M67"	"K22"	"Other disorders of synovium and tendon"	"Other diseases of esophagus"	1	258	102	360
"M67"	"K25"	"Other disorders of synovium and tendon"	"Gastric ulcer"	1	324	186	510
"M67"	"K44"	"Other disorders of synovium and tendon"	"Diaphragmatic hernia"	1	656	433	1089
"M67"	"K55"	"Other disorders of synovium and tendon"	"Vascular disorders of intestine"	1	65	1	66
"M67"	"K56"	"Other disorders of synovium and tendon"	"Paralytic ileus and intestinal obstruction without hernia"	1	333	111	444
"M67"	"K57"	"Other disorders of synovium and tendon"	"Diverticular disease of intestine"	1	1370	284	1654
"M67"	"K59"	"Other disorders of synovium and tendon"	"Other functional intestinal disorders"	1	1887	778	2665
"M67"	"K63"	"Other disorders of synovium and tendon"	"Other diseases of intestine"	1	182	16	198
"M67"	"K70"	"Other disorders of synovium and tendon"	"Alcoholic liver disease"	1	178	27	205
"M67"	"K72"	"Other disorders of synovium and tendon"	"Hepatic failure, not elsewhere classified"	1	75	1	76
"M67"	"K76"	"Other disorders of synovium and tendon"	"Other diseases of liver"	1	242	91	333
"M67"	"K83"	"Other disorders of synovium and tendon"	"Other diseases of biliary tract"	1	160	37	197
"M67"	"L97"	"Other disorders of synovium and tendon"	"Non-pressure chronic ulcer of lower limb, NEC"	1	189	40	229
"M67"	"L98"	"Other disorders of synovium and tendon"	"Oth disorders of skin, subcu, not elsewhere classified"	1	308	151	459
"M67"	"M05"	"Other disorders of synovium and tendon"	"Rheumatoid arthritis with rheumatoid factor"	1	380	247	627
"M67"	"M13"	"Other disorders of synovium and tendon"	"Other arthritis"	1	659	485	1144
"M67"	"M15"	"Other disorders of synovium and tendon"	"Polyosteoarthritis"	1	405	229	634
"M67"	"M19"	"Other disorders of synovium and tendon"	"Other and unspecified osteoarthritis"	1	2558	1458	4016
"M67"	"M25"	"Other disorders of synovium and tendon"	"Other joint disorder, not elsewhere classified"	1	1783	1341	3124
"M67"	"M47"	"Other disorders of synovium and tendon"	"Spondylosis"	1	1108	505	1613
"M67"	"M48"	"Other disorders of synovium and tendon"	"Other spondylopathies"	1	920	287	1207
"M67"	"M75"	"Other disorders of synovium and tendon"	"Shoulder lesions"	1	3579	2342	5921
"M67"	"M80"	"Other disorders of synovium and tendon"	"Osteoporosis with current pathological fracture"	1	370	24	394
"M67"	"N13"	"Other disorders of synovium and tendon"	"Obstructive and reflux uropathy"	1	233	110	343
"M67"	"N17"	"Other disorders of synovium and tendon"	"Acute kidney failure"	1	173	8	181
"M67"	"N18"	"Other disorders of synovium and tendon"	"Chronic kidney disease (CKD)"	1	408	25	433
"M67"	"N81"	"Other disorders of synovium and tendon"	"Female genital prolapse"	1	634	440	1074
"M67"	"O35"	"Other disorders of synovium and tendon"	"Maternal care for known or suspected fetal abnlt and damage"	1	109	42	151
"M67"	"O72"	"Other disorders of synovium and tendon"	"Postpartum hemorrhage"	1	3699	0	3699
"M70"	"A41"	"Soft tissue disorders related to use, overuse and pressure"	"Other sepsis"	1	1740	224	1964
"M70"	"A46"	"Soft tissue disorders related to use, overuse and pressure"	"Erysipelas"	1	1270	843	2113
"M70"	"C16"	"Soft tissue disorders related to use, overuse and pressure"	"Malignant neoplasm of stomach"	1	122	5	127
"M70"	"C18"	"Soft tissue disorders related to use, overuse and pressure"	"Malignant neoplasm of colon"	1	362	121	483
"M70"	"C20"	"Soft tissue disorders related to use, overuse and pressure"	"Malignant neoplasm of rectum"	1	140	52	192
"M70"	"C24"	"Soft tissue disorders related to use, overuse and pressure"	"Malignant neoplasm of other and unsp parts of biliary tract"	1	35	0	35
"M70"	"C25"	"Soft tissue disorders related to use, overuse and pressure"	"Malignant neoplasm of pancreas"	1	174	0	174
"M70"	"C34"	"Soft tissue disorders related to use, overuse and pressure"	"Malignant neoplasm of bronchus and lung"	1	964	30	994
"M70"	"C44"	"Soft tissue disorders related to use, overuse and pressure"	"Other and unspecified malignant neoplasm of skin"	1	628	219	847
"M70"	"C61"	"Soft tissue disorders related to use, overuse and pressure"	"Malignant neoplasm of prostate"	1	509	100	609
"M70"	"C71"	"Soft tissue disorders related to use, overuse and pressure"	"Malignant neoplasm of brain"	1	81	12	93
"M70"	"C79"	"Soft tissue disorders related to use, overuse and pressure"	"Secondary malignant neoplasm of other and unspecified sites"	1	542	12	554
"M70"	"C92"	"Soft tissue disorders related to use, overuse and pressure"	"Myeloid leukemia"	1	65	11	76
"M70"	"D62"	"Soft tissue disorders related to use, overuse and pressure"	"Acute posthemorrhagic anemia"	1	264	62	326
"M70"	"E11"	"Soft tissue disorders related to use, overuse and pressure"	"Type 2 diabetes mellitus"	1	1548	1126	2674
"M70"	"E13"	"Soft tissue disorders related to use, overuse and pressure"	"Other specified diabetes mellitus"	1	104	17	121
"M70"	"F03"	"Soft tissue disorders related to use, overuse and pressure"	"Unspecified dementia"	1	620	57	677
"M70"	"F17"	"Soft tissue disorders related to use, overuse and pressure"	"Nicotine dependence"	1	643	177	820
"M70"	"F33"	"Soft tissue disorders related to use, overuse and pressure"	"Major depressive disorder, recurrent"	1	440	140	580
"M70"	"G30"	"Soft tissue disorders related to use, overuse and pressure"	"Alzheimer's disease"	1	176	0	176
"M70"	"G31"	"Soft tissue disorders related to use, overuse and pressure"	"Oth degenerative diseases of nervous system, NEC"	1	93	8	101
"M70"	"G96"	"Soft tissue disorders related to use, overuse and pressure"	"Other disorders of central nervous system"	1	447	54	501
"M70"	"H43"	"Soft tissue disorders related to use, overuse and pressure"	"Disorders of vitreous body"	1	277	156	433
"M70"	"H57"	"Soft tissue disorders related to use, overuse and pressure"	"Other disorders of eye and adnexa"	1	240	76	316
"M70"	"I21"	"Soft tissue disorders related to use, overuse and pressure"	"Acute myocardial infarction"	1	1066	760	1826
"M70"	"I26"	"Soft tissue disorders related to use, overuse and pressure"	"Pulmonary embolism"	1	559	197	756
"M70"	"I34"	"Soft tissue disorders related to use, overuse and pressure"	"Nonrheumatic mitral valve disorders"	1	239	119	358
"M70"	"I48"	"Soft tissue disorders related to use, overuse and pressure"	"Atrial fibrillation and flutter"	1	2412	1059	3471
"M70"	"I49"	"Soft tissue disorders related to use, overuse and pressure"	"Other cardiac arrhythmias"	1	610	408	1018
"M70"	"I85"	"Soft tissue disorders related to use, overuse and pressure"	"Esophageal varices"	1	119	30	149
"M70"	"J06"	"Soft tissue disorders related to use, overuse and pressure"	"Acute upper resp infections of multiple and unsp sites"	1	227	43	270
"M70"	"J18"	"Soft tissue disorders related to use, overuse and pressure"	"Pneumonia, unspecified organism"	1	3312	1308	4620
"M70"	"J81"	"Soft tissue disorders related to use, overuse and pressure"	"Pulmonary edema"	1	234	31	265
"M70"	"J84"	"Soft tissue disorders related to use, overuse and pressure"	"Other interstitial pulmonary diseases"	1	181	60	241
"M70"	"J90"	"Soft tissue disorders related to use, overuse and pressure"	"Pleural effusion, not elsewhere classified"	1	281	45	326
"M70"	"J91"	"Soft tissue disorders related to use, overuse and pressure"	"Pleural effusion in conditions classified elsewhere"	1	111	18	129
"M70"	"J98"	"Soft tissue disorders related to use, overuse and pressure"	"Other respiratory disorders"	1	220	124	344
"M70"	"K31"	"Soft tissue disorders related to use, overuse and pressure"	"Other diseases of stomach and duodenum"	1	114	49	163
"M70"	"K59"	"Soft tissue disorders related to use, overuse and pressure"	"Other functional intestinal disorders"	1	2113	963	3076
"M70"	"K63"	"Soft tissue disorders related to use, overuse and pressure"	"Other diseases of intestine"	1	257	54	311
"M70"	"K70"	"Soft tissue disorders related to use, overuse and pressure"	"Alcoholic liver disease"	1	332	105	437
"M70"	"K72"	"Soft tissue disorders related to use, overuse and pressure"	"Hepatic failure, not elsewhere classified"	1	156	18	174
"M70"	"K74"	"Soft tissue disorders related to use, overuse and pressure"	"Fibrosis and cirrhosis of liver"	1	165	38	203
"M70"	"K76"	"Soft tissue disorders related to use, overuse and pressure"	"Other diseases of liver"	1	254	137	391
"M70"	"K83"	"Soft tissue disorders related to use, overuse and pressure"	"Other diseases of biliary tract"	1	185	70	255
"M70"	"L98"	"Soft tissue disorders related to use, overuse and pressure"	"Oth disorders of skin, subcu, not elsewhere classified"	1	501	227	728
"M70"	"M19"	"Soft tissue disorders related to use, overuse and pressure"	"Other and unspecified osteoarthritis"	1	1771	1218	2989
"M70"	"M48"	"Soft tissue disorders related to use, overuse and pressure"	"Other spondylopathies"	1	1884	1131	3015
"M70"	"M85"	"Soft tissue disorders related to use, overuse and pressure"	"Other disorders of bone density and structure"	1	844	446	1290
"M70"	"N13"	"Soft tissue disorders related to use, overuse and pressure"	"Obstructive and reflux uropathy"	1	263	125	388
"M70"	"N19"	"Soft tissue disorders related to use, overuse and pressure"	"Unspecified kidney failure"	1	375	108	483
"M70"	"N30"	"Soft tissue disorders related to use, overuse and pressure"	"Cystitis"	1	1991	1077	3068
"M71"	"C18"	"Other bursopathies"	"Malignant neoplasm of colon"	1	114	38	152
"M71"	"C20"	"Other bursopathies"	"Malignant neoplasm of rectum"	1	60	13	73
"M71"	"C44"	"Other bursopathies"	"Other and unspecified malignant neoplasm of skin"	1	231	42	273
"M71"	"C78"	"Other bursopathies"	"Secondary malignant neoplasm of resp and digestive organs"	1	227	0	227
"M71"	"C79"	"Other bursopathies"	"Secondary malignant neoplasm of other and unspecified sites"	1	159	0	159
"M71"	"D12"	"Other bursopathies"	"Benign neoplasm of colon, rectum, anus and anal canal"	1	497	104	601
"M71"	"D50"	"Other bursopathies"	"Iron deficiency anemia"	1	195	29	224
"M71"	"E11"	"Other bursopathies"	"Type 2 diabetes mellitus"	1	537	307	844
"M71"	"E78"	"Other bursopathies"	"Disorders of lipoprotein metabolism and other lipidemias"	1	728	264	992
"M71"	"E83"	"Other bursopathies"	"Disorders of mineral metabolism"	1	70	12	82
"M71"	"E86"	"Other bursopathies"	"Volume depletion"	1	639	30	669
"M71"	"G47"	"Other bursopathies"	"Sleep disorders"	1	356	69	425
"M71"	"I10"	"Other bursopathies"	"Essential (primary) hypertension"	1	1841	908	2749
"M71"	"I42"	"Other bursopathies"	"Cardiomyopathy"	1	79	22	101
"M71"	"I70"	"Other bursopathies"	"Atherosclerosis"	1	269	128	397
"M71"	"I73"	"Other bursopathies"	"Other peripheral vascular diseases"	1	278	66	344
"M71"	"J69"	"Other bursopathies"	"Pneumonitis due to solids and liquids"	1	49	0	49
"M71"	"J90"	"Other bursopathies"	"Pleural effusion, not elsewhere classified"	1	104	2	106
"M71"	"J91"	"Other bursopathies"	"Pleural effusion in conditions classified elsewhere"	1	36	4	40
"M71"	"K62"	"Other bursopathies"	"Other diseases of anus and rectum"	1	338	150	488
"M71"	"K92"	"Other bursopathies"	"Other diseases of digestive system"	1	238	69	307
"M71"	"M13"	"Other bursopathies"	"Other arthritis"	1	406	261	667
"M71"	"M15"	"Other bursopathies"	"Polyosteoarthritis"	1	192	97	289
"M71"	"M81"	"Other bursopathies"	"Osteoporosis without current pathological fracture"	1	571	117	688
"M71"	"N18"	"Other bursopathies"	"Chronic kidney disease (CKD)"	1	247	29	276
"M72"	"A41"	"Fibroblastic disorders"	"Other sepsis"	1	1655	235	1890
"M72"	"A46"	"Fibroblastic disorders"	"Erysipelas"	1	610	312	922
"M72"	"A49"	"Fibroblastic disorders"	"Bacterial infection of unspecified site"	1	613	75	688
"M72"	"B02"	"Fibroblastic disorders"	"Zoster [herpes zoster]"	1	100	22	122
"M72"	"B96"	"Fibroblastic disorders"	"Oth bacterial agents as the cause of diseases classd elswhr"	1	72	0	72
"M72"	"C10"	"Fibroblastic disorders"	"Malignant neoplasm of oropharynx"	1	48	0	48
"M72"	"C13"	"Fibroblastic disorders"	"Malignant neoplasm of hypopharynx"	1	40	0	40
"M72"	"C18"	"Fibroblastic disorders"	"Malignant neoplasm of colon"	1	580	88	668
"M72"	"C22"	"Fibroblastic disorders"	"Malignant neoplasm of liver and intrahepatic bile ducts"	1	103	0	103
"M72"	"C24"	"Fibroblastic disorders"	"Malignant neoplasm of other and unsp parts of biliary tract"	1	47	0	47
"M72"	"C45"	"Fibroblastic disorders"	"Mesothelioma"	1	29	0	29
"M72"	"C67"	"Fibroblastic disorders"	"Malignant neoplasm of bladder"	1	207	46	253
"M72"	"C71"	"Fibroblastic disorders"	"Malignant neoplasm of brain"	1	100	1	101
"M72"	"C80"	"Fibroblastic disorders"	"Malignant neoplasm without specification of site"	1	111	0	111
"M72"	"C91"	"Fibroblastic disorders"	"Lymphoid leukemia"	1	91	20	111
"M72"	"C92"	"Fibroblastic disorders"	"Myeloid leukemia"	1	57	6	63
"M72"	"D12"	"Fibroblastic disorders"	"Benign neoplasm of colon, rectum, anus and anal canal"	1	1738	443	2181
"M72"	"D35"	"Fibroblastic disorders"	"Benign neoplasm of other and unspecified endocrine glands"	1	82	28	110
"M72"	"D38"	"Fibroblastic disorders"	"Neoplm of uncrt behav of mid ear & resp and intrathorac org"	1	49	10	59
"M72"	"D46"	"Fibroblastic disorders"	"Myelodysplastic syndromes"	1	66	5	71
"M72"	"D62"	"Fibroblastic disorders"	"Acute posthemorrhagic anemia"	1	208	19	227
"M72"	"D68"	"Fibroblastic disorders"	"Other coagulation defects"	1	142	65	207
"M72"	"D72"	"Fibroblastic disorders"	"Other disorders of white blood cells"	1	47	8	55
"M72"	"E11"	"Fibroblastic disorders"	"Type 2 diabetes mellitus"	1	1402	1040	2442
"M72"	"E27"	"Fibroblastic disorders"	"Other disorders of adrenal gland"	1	69	17	86
"M72"	"E64"	"Fibroblastic disorders"	"Sequelae of malnutrition and other nutritional deficiencies"	1	108	12	120
"M72"	"E78"	"Fibroblastic disorders"	"Disorders of lipoprotein metabolism and other lipidemias"	1	1893	987	2880
"M72"	"F03"	"Fibroblastic disorders"	"Unspecified dementia"	1	408	0	408
"M72"	"F17"	"Fibroblastic disorders"	"Nicotine dependence"	1	403	161	564
"M72"	"F32"	"Fibroblastic disorders"	"Depressive episode"	1	385	127	512
"M72"	"G12"	"Fibroblastic disorders"	"Spinal muscular atrophy and related syndromes"	1	38	5	43
"M72"	"G20"	"Fibroblastic disorders"	"Parkinson's disease"	1	173	0	173
"M72"	"G25"	"Fibroblastic disorders"	"Other extrapyramidal and movement disorders"	1	82	19	101
"M72"	"G30"	"Fibroblastic disorders"	"Alzheimer's disease"	1	137	0	137
"M72"	"G31"	"Fibroblastic disorders"	"Oth degenerative diseases of nervous system, NEC"	1	116	2	118
"M72"	"G45"	"Fibroblastic disorders"	"Transient cerebral ischemic attacks and related syndromes"	1	730	395	1125
"M72"	"G47"	"Fibroblastic disorders"	"Sleep disorders"	1	723	206	929
"M72"	"G91"	"Fibroblastic disorders"	"Hydrocephalus"	1	72	11	83
"M72"	"G93"	"Fibroblastic disorders"	"Other disorders of brain"	1	94	31	125
"M72"	"G95"	"Fibroblastic disorders"	"Other and unspecified diseases of spinal cord"	1	151	8	159
"M72"	"H34"	"Fibroblastic disorders"	"Retinal vascular occlusions"	1	154	50	204
"M72"	"H43"	"Fibroblastic disorders"	"Disorders of vitreous body"	1	300	165	465
"M72"	"H54"	"Fibroblastic disorders"	"Blindness and low vision"	1	96	16	112
"M72"	"H91"	"Fibroblastic disorders"	"Other and unspecified hearing loss"	1	2002	1365	3367
"M72"	"I11"	"Fibroblastic disorders"	"Hypertensive heart disease"	1	194	34	228
"M72"	"I21"	"Fibroblastic disorders"	"Acute myocardial infarction"	1	1036	579	1615
"M72"	"I27"	"Fibroblastic disorders"	"Other pulmonary heart diseases"	1	127	12	139
"M72"	"I34"	"Fibroblastic disorders"	"Nonrheumatic mitral valve disorders"	1	271	77	348
"M72"	"I35"	"Fibroblastic disorders"	"Nonrheumatic aortic valve disorders"	1	944	79	1023
"M72"	"I38"	"Fibroblastic disorders"	"Endocarditis, valve unspecified"	1	44	3	47
"M72"	"I42"	"Fibroblastic disorders"	"Cardiomyopathy"	1	212	78	290
"M72"	"I45"	"Fibroblastic disorders"	"Other conduction disorders"	1	150	58	208
"M72"	"I46"	"Fibroblastic disorders"	"Cardiac arrest"	1	383	0	383
"M72"	"I49"	"Fibroblastic disorders"	"Other cardiac arrhythmias"	1	627	268	895
"M72"	"I70"	"Fibroblastic disorders"	"Atherosclerosis"	1	774	357	1131
"M72"	"I71"	"Fibroblastic disorders"	"Aortic aneurysm and dissection"	1	515	51	566
"M72"	"I80"	"Fibroblastic disorders"	"Phlebitis and thrombophlebitis"	1	575	378	953
"M72"	"I82"	"Fibroblastic disorders"	"Other venous embolism and thrombosis"	1	134	39	173
"M72"	"I85"	"Fibroblastic disorders"	"Esophageal varices"	1	130	25	155
"M72"	"I95"	"Fibroblastic disorders"	"Hypotension"	1	355	15	370
"M72"	"J09"	"Fibroblastic disorders"	"Influenza due to certain identified influenza viruses"	1	30	0	30
"M72"	"J14"	"Fibroblastic disorders"	"Pneumonia due to Hemophilus influenzae"	1	43	7	50
"M72"	"J81"	"Fibroblastic disorders"	"Pulmonary edema"	1	184	5	189
"M72"	"J91"	"Fibroblastic disorders"	"Pleural effusion in conditions classified elsewhere"	1	123	0	123
"M72"	"J92"	"Fibroblastic disorders"	"Pleural plaque"	1	63	15	78
"M72"	"J94"	"Fibroblastic disorders"	"Other pleural conditions"	1	116	18	134
"M72"	"J95"	"Fibroblastic disorders"	"Intraop and postproc comp and disorders of resp sys, NEC"	1	85	11	96
"M72"	"K22"	"Fibroblastic disorders"	"Other diseases of esophagus"	1	306	121	427
"M72"	"K31"	"Fibroblastic disorders"	"Other diseases of stomach and duodenum"	1	80	28	108
"M72"	"K55"	"Fibroblastic disorders"	"Vascular disorders of intestine"	1	99	9	108
"M72"	"K63"	"Fibroblastic disorders"	"Other diseases of intestine"	1	238	37	275
"M72"	"K64"	"Fibroblastic disorders"	"Hemorrhoids and perianal venous thrombosis"	1	619	55	674
"M72"	"K65"	"Fibroblastic disorders"	"Peritonitis"	1	196	76	272
"M72"	"K70"	"Fibroblastic disorders"	"Alcoholic liver disease"	1	391	108	499
"M72"	"K72"	"Fibroblastic disorders"	"Hepatic failure, not elsewhere classified"	1	161	17	178
"M72"	"K74"	"Fibroblastic disorders"	"Fibrosis and cirrhosis of liver"	1	203	25	228
"M72"	"K76"	"Fibroblastic disorders"	"Other diseases of liver"	1	256	101	357
"M72"	"K83"	"Fibroblastic disorders"	"Other diseases of biliary tract"	1	165	50	215
"M72"	"K91"	"Fibroblastic disorders"	"Intraop and postproc comp and disorders of dgstv sys, NEC"	1	102	40	142
"M72"	"K92"	"Fibroblastic disorders"	"Other diseases of digestive system"	1	604	123	727
"M72"	"L89"	"Fibroblastic disorders"	"Pressure ulcer"	1	241	22	263
"M72"	"L97"	"Fibroblastic disorders"	"Non-pressure chronic ulcer of lower limb, NEC"	1	367	61	428
"M72"	"M19"	"Fibroblastic disorders"	"Other and unspecified osteoarthritis"	1	1176	875	2051
"M72"	"M31"	"Fibroblastic disorders"	"Other necrotizing vasculopathies"	1	125	55	180
"M72"	"M81"	"Fibroblastic disorders"	"Osteoporosis without current pathological fracture"	1	963	245	1208
"M72"	"M99"	"Fibroblastic disorders"	"Biomechanical lesions, not elsewhere classified"	1	166	85	251
"M72"	"N13"	"Fibroblastic disorders"	"Obstructive and reflux uropathy"	1	240	113	353
"M72"	"N17"	"Fibroblastic disorders"	"Acute kidney failure"	1	508	103	611
"M72"	"N28"	"Fibroblastic disorders"	"Oth disorders of kidney and ureter, not elsewhere classified"	1	148	27	175
"M72"	"N39"	"Fibroblastic disorders"	"Other disorders of urinary system"	1	1312	289	1601
"M72"	"N40"	"Fibroblastic disorders"	"Benign prostatic hyperplasia"	1	1068	797	1865
"M75"	"A31"	"Shoulder lesions"	"Infection due to other mycobacteria"	1	41	6	47
"M75"	"A46"	"Shoulder lesions"	"Erysipelas"	1	1530	932	2462
"M75"	"A49"	"Shoulder lesions"	"Bacterial infection of unspecified site"	1	1691	333	2024
"M75"	"B02"	"Shoulder lesions"	"Zoster [herpes zoster]"	1	320	164	484
"M75"	"B95"	"Shoulder lesions"	"Strep as the cause of diseases classified elsewhere"	1	142	42	184
"M75"	"B96"	"Shoulder lesions"	"Oth bacterial agents as the cause of diseases classd elswhr"	1	155	38	193
"M75"	"C06"	"Shoulder lesions"	"Malignant neoplasm of other and unspecified parts of mouth"	1	73	20	93
"M75"	"C10"	"Shoulder lesions"	"Malignant neoplasm of oropharynx"	1	107	19	126
"M75"	"C15"	"Shoulder lesions"	"Malignant neoplasm of esophagus"	1	281	0	281
"M75"	"C22"	"Shoulder lesions"	"Malignant neoplasm of liver and intrahepatic bile ducts"	1	237	0	237
"M75"	"C45"	"Shoulder lesions"	"Mesothelioma"	1	73	4	77
"M75"	"C61"	"Shoulder lesions"	"Malignant neoplasm of prostate"	1	1825	381	2206
"M75"	"C71"	"Shoulder lesions"	"Malignant neoplasm of brain"	1	278	32	310
"M75"	"C79"	"Shoulder lesions"	"Secondary malignant neoplasm of other and unspecified sites"	1	1480	0	1480
"M75"	"C83"	"Shoulder lesions"	"Non-follicular lymphoma"	1	288	94	382
"M75"	"C91"	"Shoulder lesions"	"Lymphoid leukemia"	1	199	77	276
"M75"	"C92"	"Shoulder lesions"	"Myeloid leukemia"	1	186	29	215
"M75"	"D13"	"Shoulder lesions"	"Benign neoplasm of and ill-defined parts of digestive system"	1	397	208	605
"M75"	"D32"	"Shoulder lesions"	"Benign neoplasm of meninges"	1	205	82	287
"M75"	"D35"	"Shoulder lesions"	"Benign neoplasm of other and unspecified endocrine glands"	1	387	136	523
"M75"	"D43"	"Shoulder lesions"	"Neoplasm of uncertain behavior of brain and cnsl"	1	160	44	204
"M75"	"D46"	"Shoulder lesions"	"Myelodysplastic syndromes"	1	162	11	173
"M75"	"D61"	"Shoulder lesions"	"Oth aplastic anemias and other bone marrow failure syndromes"	1	94	29	123
"M75"	"D62"	"Shoulder lesions"	"Acute posthemorrhagic anemia"	1	443	202	645
"M75"	"E03"	"Shoulder lesions"	"Other hypothyroidism"	1	1653	1086	2739
"M75"	"E13"	"Shoulder lesions"	"Other specified diabetes mellitus"	1	256	96	352
"M75"	"E21"	"Shoulder lesions"	"Hyperparathyroidism and other disorders of parathyroid gland"	1	514	180	694
"M75"	"E23"	"Shoulder lesions"	"Hypofunction and other disorders of the pituitary gland"	1	222	85	307
"M75"	"E25"	"Shoulder lesions"	"Adrenogenital disorders"	1	63	13	76
"M75"	"E34"	"Shoulder lesions"	"Other endocrine disorders"	1	272	134	406
"M75"	"E46"	"Shoulder lesions"	"Unspecified protein-calorie malnutrition"	1	65	1	66
"M75"	"E51"	"Shoulder lesions"	"Thiamine deficiency"	1	55	8	63
"M75"	"E55"	"Shoulder lesions"	"Vitamin D deficiency"	1	566	214	780
"M75"	"E61"	"Shoulder lesions"	"Deficiency of other nutrient elements"	1	102	14	116
"M75"	"E64"	"Shoulder lesions"	"Sequelae of malnutrition and other nutritional deficiencies"	1	315	64	379
"M75"	"E78"	"Shoulder lesions"	"Disorders of lipoprotein metabolism and other lipidemias"	1	6313	3980	10293
"M75"	"E83"	"Shoulder lesions"	"Disorders of mineral metabolism"	1	578	96	674
"M75"	"F01"	"Shoulder lesions"	"Vascular dementia"	1	252	0	252
"M75"	"F02"	"Shoulder lesions"	"Dementia in other diseases classified elsewhere"	1	99	2	101
"M75"	"F05"	"Shoulder lesions"	"Delirium due to known physiological condition"	1	620	0	620
"M75"	"G23"	"Shoulder lesions"	"Other degenerative diseases of basal ganglia"	1	84	10	94
"M75"	"G47"	"Shoulder lesions"	"Sleep disorders"	1	4133	1493	5626
"M75"	"G91"	"Shoulder lesions"	"Hydrocephalus"	1	191	56	247
"M75"	"G93"	"Shoulder lesions"	"Other disorders of brain"	1	283	140	423
"M75"	"H26"	"Shoulder lesions"	"Other cataract"	1	2291	1051	3342
"M75"	"H43"	"Shoulder lesions"	"Disorders of vitreous body"	1	957	501	1458
"M75"	"H57"	"Shoulder lesions"	"Other disorders of eye and adnexa"	1	747	396	1143
"M75"	"I10"	"Shoulder lesions"	"Essential (primary) hypertension"	1	12527	9057	21584
"M75"	"I11"	"Shoulder lesions"	"Hypertensive heart disease"	1	482	191	673
"M75"	"I15"	"Shoulder lesions"	"Secondary hypertension"	1	561	376	937
"M75"	"I21"	"Shoulder lesions"	"Acute myocardial infarction"	1	2516	2062	4578
"M75"	"I34"	"Shoulder lesions"	"Nonrheumatic mitral valve disorders"	1	664	257	921
"M75"	"I38"	"Shoulder lesions"	"Endocarditis, valve unspecified"	1	105	24	129
"M75"	"I44"	"Shoulder lesions"	"Atrioventricular and left bundle-branch block"	1	828	246	1074
"M75"	"I48"	"Shoulder lesions"	"Atrial fibrillation and flutter"	1	7782	0	7782
"M75"	"I69"	"Shoulder lesions"	"Sequelae of cerebrovascular disease"	1	2910	928	3838
"M75"	"I71"	"Shoulder lesions"	"Aortic aneurysm and dissection"	1	1219	170	1389
"M75"	"I72"	"Shoulder lesions"	"Other aneurysm"	1	249	100	349
"M75"	"I73"	"Shoulder lesions"	"Other peripheral vascular diseases"	1	2049	894	2943
"M75"	"I74"	"Shoulder lesions"	"Arterial embolism and thrombosis"	1	262	156	418
"M75"	"I87"	"Shoulder lesions"	"Other disorders of veins"	1	344	159	503
"M75"	"I89"	"Shoulder lesions"	"Oth noninfective disorders of lymphatic vessels and nodes"	1	376	196	572
"M75"	"J14"	"Shoulder lesions"	"Pneumonia due to Hemophilus influenzae"	1	100	31	131
"M75"	"J86"	"Shoulder lesions"	"Pyothorax"	1	183	88	271
"M75"	"J90"	"Shoulder lesions"	"Pleural effusion, not elsewhere classified"	1	707	79	786
"M75"	"J91"	"Shoulder lesions"	"Pleural effusion in conditions classified elsewhere"	1	323	58	381
"M75"	"J94"	"Shoulder lesions"	"Other pleural conditions"	1	190	72	262
"M75"	"J95"	"Shoulder lesions"	"Intraop and postproc comp and disorders of resp sys, NEC"	1	173	15	188
"M75"	"J96"	"Shoulder lesions"	"Respiratory failure, not elsewhere classified"	1	2683	0	2683
"M75"	"K31"	"Shoulder lesions"	"Other diseases of stomach and duodenum"	1	314	119	433
"M75"	"K59"	"Shoulder lesions"	"Other functional intestinal disorders"	1	5803	2451	8254
"M75"	"K62"	"Shoulder lesions"	"Other diseases of anus and rectum"	1	2479	2044	4523
"M75"	"K72"	"Shoulder lesions"	"Hepatic failure, not elsewhere classified"	1	290	40	330
"M75"	"K76"	"Shoulder lesions"	"Other diseases of liver"	1	743	448	1191
"M75"	"K83"	"Shoulder lesions"	"Other diseases of biliary tract"	1	461	208	669
"M75"	"K91"	"Shoulder lesions"	"Intraop and postproc comp and disorders of dgstv sys, NEC"	1	268	158	426
"M75"	"K92"	"Shoulder lesions"	"Other diseases of digestive system"	1	1253	713	1966
"M75"	"L30"	"Shoulder lesions"	"Other and unspecified dermatitis"	1	954	713	1667
"M75"	"L82"	"Shoulder lesions"	"Seborrheic keratosis"	1	527	181	708
"M75"	"L98"	"Shoulder lesions"	"Oth disorders of skin, subcu, not elsewhere classified"	1	805	504	1309
"M75"	"M05"	"Shoulder lesions"	"Rheumatoid arthritis with rheumatoid factor"	1	944	589	1533
"M75"	"M06"	"Shoulder lesions"	"Other rheumatoid arthritis"	1	1016	767	1783
"M75"	"M07"	"Shoulder lesions"	"Enteropathic arthropathies"	1	534	369	903
"M75"	"M15"	"Shoulder lesions"	"Polyosteoarthritis"	1	1374	1048	2422
"M75"	"M18"	"Shoulder lesions"	"Osteoarthritis of first carpometacarpal joint"	1	1328	781	2109
"M75"	"M19"	"Shoulder lesions"	"Other and unspecified osteoarthritis"	1	17311	16105	33416
"M75"	"M47"	"Shoulder lesions"	"Spondylosis"	1	4871	4031	8902
"M75"	"M48"	"Shoulder lesions"	"Other spondylopathies"	1	3884	1834	5718
"M75"	"M85"	"Shoulder lesions"	"Other disorders of bone density and structure"	1	2967	890	3857
"M75"	"N12"	"Shoulder lesions"	"Tubulo-interstitial nephritis, not spcf as acute or chronic"	1	210	99	309
"M75"	"N13"	"Shoulder lesions"	"Obstructive and reflux uropathy"	1	683	385	1068
"M75"	"N18"	"Shoulder lesions"	"Chronic kidney disease (CKD)"	1	1764	204	1968
"M75"	"O72"	"Shoulder lesions"	"Postpartum hemorrhage"	1	1889	1534	3423
"M76"	"A04"	"Enthesopathies, lower limb, excluding foot"	"Other bacterial intestinal infections"	1	109	40	149
"M76"	"A41"	"Enthesopathies, lower limb, excluding foot"	"Other sepsis"	1	533	44	577
"M76"	"A49"	"Enthesopathies, lower limb, excluding foot"	"Bacterial infection of unspecified site"	1	327	91	418
"M76"	"C16"	"Enthesopathies, lower limb, excluding foot"	"Malignant neoplasm of stomach"	1	51	1	52
"M76"	"C25"	"Enthesopathies, lower limb, excluding foot"	"Malignant neoplasm of pancreas"	1	57	0	57
"M76"	"C61"	"Enthesopathies, lower limb, excluding foot"	"Malignant neoplasm of prostate"	1	223	45	268
"M76"	"C64"	"Enthesopathies, lower limb, excluding foot"	"Malignant neoplasm of kidney, except renal pelvis"	1	54	8	62
"M76"	"C71"	"Enthesopathies, lower limb, excluding foot"	"Malignant neoplasm of brain"	1	55	3	58
"M76"	"C79"	"Enthesopathies, lower limb, excluding foot"	"Secondary malignant neoplasm of other and unspecified sites"	1	190	2	192
"M76"	"C80"	"Enthesopathies, lower limb, excluding foot"	"Malignant neoplasm without specification of site"	1	34	0	34
"M76"	"D12"	"Enthesopathies, lower limb, excluding foot"	"Benign neoplasm of colon, rectum, anus and anal canal"	1	804	225	1029
"M76"	"D62"	"Enthesopathies, lower limb, excluding foot"	"Acute posthemorrhagic anemia"	1	80	27	107
"M76"	"E03"	"Enthesopathies, lower limb, excluding foot"	"Other hypothyroidism"	1	389	207	596
"M76"	"E11"	"Enthesopathies, lower limb, excluding foot"	"Type 2 diabetes mellitus"	1	699	443	1142
"M76"	"E13"	"Enthesopathies, lower limb, excluding foot"	"Other specified diabetes mellitus"	1	43	4	47
"M76"	"E21"	"Enthesopathies, lower limb, excluding foot"	"Hyperparathyroidism and other disorders of parathyroid gland"	1	96	35	131
"M76"	"E66"	"Enthesopathies, lower limb, excluding foot"	"Overweight and obesity"	1	1251	1003	2254
"M76"	"E87"	"Enthesopathies, lower limb, excluding foot"	"Other disorders of fluid, electrolyte and acid-base balance"	1	372	26	398
"M76"	"E89"	"Enthesopathies, lower limb, excluding foot"	"Postproc endocrine and metabolic comp and disorders, NEC"	1	63	15	78
"M76"	"F06"	"Enthesopathies, lower limb, excluding foot"	"Other mental disorders due to known physiological condition"	1	50	0	50
"M76"	"G47"	"Enthesopathies, lower limb, excluding foot"	"Sleep disorders"	1	754	217	971
"M76"	"G93"	"Enthesopathies, lower limb, excluding foot"	"Other disorders of brain"	1	68	20	88
"M76"	"G95"	"Enthesopathies, lower limb, excluding foot"	"Other and unspecified diseases of spinal cord"	1	88	10	98
"M76"	"H25"	"Enthesopathies, lower limb, excluding foot"	"Age-related cataract"	1	1194	496	1690
"M76"	"H26"	"Enthesopathies, lower limb, excluding foot"	"Other cataract"	1	336	176	512
"M76"	"I35"	"Enthesopathies, lower limb, excluding foot"	"Nonrheumatic aortic valve disorders"	1	368	47	415
"M76"	"I42"	"Enthesopathies, lower limb, excluding foot"	"Cardiomyopathy"	1	102	38	140
"M76"	"I44"	"Enthesopathies, lower limb, excluding foot"	"Atrioventricular and left bundle-branch block"	1	120	30	150
"M76"	"I71"	"Enthesopathies, lower limb, excluding foot"	"Aortic aneurysm and dissection"	1	197	22	219
"M76"	"I95"	"Enthesopathies, lower limb, excluding foot"	"Hypotension"	1	151	18	169
"M76"	"J44"	"Enthesopathies, lower limb, excluding foot"	"Other chronic obstructive pulmonary disease"	1	557	270	827
"M76"	"J47"	"Enthesopathies, lower limb, excluding foot"	"Bronchiectasis"	1	56	12	68
"M76"	"J69"	"Enthesopathies, lower limb, excluding foot"	"Pneumonitis due to solids and liquids"	1	51	1	52
"M76"	"J90"	"Enthesopathies, lower limb, excluding foot"	"Pleural effusion, not elsewhere classified"	1	93	5	98
"M76"	"K22"	"Enthesopathies, lower limb, excluding foot"	"Other diseases of esophagus"	1	176	72	248
"M76"	"K70"	"Enthesopathies, lower limb, excluding foot"	"Alcoholic liver disease"	1	90	28	118
"M76"	"K72"	"Enthesopathies, lower limb, excluding foot"	"Hepatic failure, not elsewhere classified"	1	45	5	50
"M76"	"K92"	"Enthesopathies, lower limb, excluding foot"	"Other diseases of digestive system"	1	285	118	403
"M76"	"L89"	"Enthesopathies, lower limb, excluding foot"	"Pressure ulcer"	1	112	3	115
"M76"	"L97"	"Enthesopathies, lower limb, excluding foot"	"Non-pressure chronic ulcer of lower limb, NEC"	1	236	44	280
"M76"	"M80"	"Enthesopathies, lower limb, excluding foot"	"Osteoporosis with current pathological fracture"	1	226	56	282
"M76"	"M81"	"Enthesopathies, lower limb, excluding foot"	"Osteoporosis without current pathological fracture"	1	596	261	857
"M76"	"N17"	"Enthesopathies, lower limb, excluding foot"	"Acute kidney failure"	1	138	2	140
"M76"	"N19"	"Enthesopathies, lower limb, excluding foot"	"Unspecified kidney failure"	1	104	21	125
"M76"	"N28"	"Enthesopathies, lower limb, excluding foot"	"Oth disorders of kidney and ureter, not elsewhere classified"	1	89	18	107
"M76"	"N39"	"Enthesopathies, lower limb, excluding foot"	"Other disorders of urinary system"	1	887	523	1410
"M76"	"N46"	"Enthesopathies, lower limb, excluding foot"	"Male infertility"	1	284	163	447
"M76"	"O72"	"Enthesopathies, lower limb, excluding foot"	"Postpartum hemorrhage"	1	1577	220	1797
"M77"	"A41"	"Other enthesopathies"	"Other sepsis"	1	697	21	718
"M77"	"A46"	"Other enthesopathies"	"Erysipelas"	1	472	226	698
"M77"	"B37"	"Other enthesopathies"	"Candidiasis"	1	177	80	257
"M77"	"C16"	"Other enthesopathies"	"Malignant neoplasm of stomach"	1	45	0	45
"M77"	"C20"	"Other enthesopathies"	"Malignant neoplasm of rectum"	1	94	12	106
"M77"	"C22"	"Other enthesopathies"	"Malignant neoplasm of liver and intrahepatic bile ducts"	1	43	0	43
"M77"	"C34"	"Other enthesopathies"	"Malignant neoplasm of bronchus and lung"	1	403	0	403
"M77"	"C44"	"Other enthesopathies"	"Other and unspecified malignant neoplasm of skin"	1	442	105	547
"M77"	"C64"	"Other enthesopathies"	"Malignant neoplasm of kidney, except renal pelvis"	1	75	11	86
"M77"	"C67"	"Other enthesopathies"	"Malignant neoplasm of bladder"	1	56	8	64
"M77"	"C77"	"Other enthesopathies"	"Secondary and unspecified malignant neoplasm of lymph nodes"	1	222	14	236
"M77"	"C78"	"Other enthesopathies"	"Secondary malignant neoplasm of resp and digestive organs"	1	330	0	330
"M77"	"C79"	"Other enthesopathies"	"Secondary malignant neoplasm of other and unspecified sites"	1	232	0	232
"M77"	"C91"	"Other enthesopathies"	"Lymphoid leukemia"	1	60	8	68
"M77"	"D12"	"Other enthesopathies"	"Benign neoplasm of colon, rectum, anus and anal canal"	1	1258	220	1478
"M77"	"D50"	"Other enthesopathies"	"Iron deficiency anemia"	1	282	72	354
"M77"	"D63"	"Other enthesopathies"	"Anemia in chronic diseases classified elsewhere"	1	112	0	112
"M77"	"D64"	"Other enthesopathies"	"Other anemias"	1	700	106	806
"M77"	"E11"	"Other enthesopathies"	"Type 2 diabetes mellitus"	1	1208	503	1711
"M77"	"E13"	"Other enthesopathies"	"Other specified diabetes mellitus"	1	51	7	58
"M77"	"E21"	"Other enthesopathies"	"Hyperparathyroidism and other disorders of parathyroid gland"	1	136	42	178
"M77"	"E27"	"Other enthesopathies"	"Other disorders of adrenal gland"	1	80	11	91
"M77"	"E64"	"Other enthesopathies"	"Sequelae of malnutrition and other nutritional deficiencies"	1	89	11	100
"M77"	"E78"	"Other enthesopathies"	"Disorders of lipoprotein metabolism and other lipidemias"	1	1751	518	2269
"M77"	"E86"	"Other enthesopathies"	"Volume depletion"	1	642	23	665
"M77"	"E89"	"Other enthesopathies"	"Postproc endocrine and metabolic comp and disorders, NEC"	1	81	27	108
"M77"	"F17"	"Other enthesopathies"	"Nicotine dependence"	1	569	143	712
"M77"	"H26"	"Other enthesopathies"	"Other cataract"	1	482	162	644
"M77"	"H36"	"Other enthesopathies"	"Retinal disorders in diseases classified elsewhere"	1	183	92	275
"M77"	"H43"	"Other enthesopathies"	"Disorders of vitreous body"	1	273	89	362
"M77"	"H53"	"Other enthesopathies"	"Visual disturbances"	1	308	146	454
"M77"	"H91"	"Other enthesopathies"	"Other and unspecified hearing loss"	1	1143	645	1788
"M77"	"I10"	"Other enthesopathies"	"Essential (primary) hypertension"	1	3417	1307	4724
"M77"	"I20"	"Other enthesopathies"	"Angina pectoris"	1	1101	810	1911
"M77"	"I25"	"Other enthesopathies"	"Chronic ischemic heart disease"	1	1072	439	1511
"M77"	"I34"	"Other enthesopathies"	"Nonrheumatic mitral valve disorders"	1	151	30	181
"M77"	"I50"	"Other enthesopathies"	"Heart failure"	1	673	126	799
"M77"	"I51"	"Other enthesopathies"	"Complications and ill-defined descriptions of heart disease"	1	124	34	158
"M77"	"I61"	"Other enthesopathies"	"Nontraumatic intracerebral hemorrhage"	1	114	25	139
"M77"	"I63"	"Other enthesopathies"	"Cerebral infarction"	1	677	119	796
"M77"	"I70"	"Other enthesopathies"	"Atherosclerosis"	1	428	207	635
"M77"	"I71"	"Other enthesopathies"	"Aortic aneurysm and dissection"	1	217	11	228
"M77"	"I80"	"Other enthesopathies"	"Phlebitis and thrombophlebitis"	1	550	391	941
"M77"	"I89"	"Other enthesopathies"	"Oth noninfective disorders of lymphatic vessels and nodes"	1	142	52	194
"M77"	"J10"	"Other enthesopathies"	"Influenza due to other identified influenza virus"	1	38	2	40
"M77"	"J15"	"Other enthesopathies"	"Bacterial pneumonia, not elsewhere classified"	1	674	59	733
"M77"	"J44"	"Other enthesopathies"	"Other chronic obstructive pulmonary disease"	1	1049	231	1280
"M77"	"J47"	"Other enthesopathies"	"Bronchiectasis"	1	89	3	92
"M77"	"J69"	"Other enthesopathies"	"Pneumonitis due to solids and liquids"	1	62	0	62
"M77"	"J81"	"Other enthesopathies"	"Pulmonary edema"	1	68	5	73
"M77"	"J91"	"Other enthesopathies"	"Pleural effusion in conditions classified elsewhere"	1	68	6	74
"M77"	"J94"	"Other enthesopathies"	"Other pleural conditions"	1	48	9	57
"M77"	"J96"	"Other enthesopathies"	"Respiratory failure, not elsewhere classified"	1	598	0	598
"M77"	"K05"	"Other enthesopathies"	"Gingivitis and periodontal diseases"	1	131	57	188
"M77"	"K22"	"Other enthesopathies"	"Other diseases of esophagus"	1	200	90	290
"M77"	"K43"	"Other enthesopathies"	"Ventral hernia"	1	310	188	498
"M77"	"K52"	"Other enthesopathies"	"Other and unsp noninfective gastroenteritis and colitis"	1	508	283	791
"M77"	"K55"	"Other enthesopathies"	"Vascular disorders of intestine"	1	63	0	63
"M77"	"K59"	"Other enthesopathies"	"Other functional intestinal disorders"	1	1478	578	2056
"M77"	"K64"	"Other enthesopathies"	"Hemorrhoids and perianal venous thrombosis"	1	834	45	879
"M77"	"K70"	"Other enthesopathies"	"Alcoholic liver disease"	1	160	24	184
"M77"	"K76"	"Other enthesopathies"	"Other diseases of liver"	1	228	90	318
"M77"	"M07"	"Other enthesopathies"	"Enteropathic arthropathies"	1	307	162	469
"M77"	"M47"	"Other enthesopathies"	"Spondylosis"	1	1451	807	2258
"M77"	"M81"	"Other enthesopathies"	"Osteoporosis without current pathological fracture"	1	1082	272	1354
"M77"	"N18"	"Other enthesopathies"	"Chronic kidney disease (CKD)"	1	334	39	373
"M77"	"N39"	"Other enthesopathies"	"Other disorders of urinary system"	1	1295	582	1877
"M77"	"N95"	"Other enthesopathies"	"Menopausal and other perimenopausal disorders"	1	521	261	782
"M77"	"O72"	"Other enthesopathies"	"Postpartum hemorrhage"	1	864	557	1421
"M77"	"Q61"	"Other enthesopathies"	"Cystic kidney disease"	1	92	35	127
"M79"	"A41"	"Oth and unsp soft tissue disorders, not elsewhere classified"	"Other sepsis"	1	6478	0	6478
"M79"	"A49"	"Oth and unsp soft tissue disorders, not elsewhere classified"	"Bacterial infection of unspecified site"	1	2873	899	3772
"M79"	"B37"	"Oth and unsp soft tissue disorders, not elsewhere classified"	"Candidiasis"	1	949	583	1532
"M79"	"C14"	"Oth and unsp soft tissue disorders, not elsewhere classified"	"Malig neoplasm of sites in the lip, oral cavity and pharynx"	1	45	7	52
"M79"	"C15"	"Oth and unsp soft tissue disorders, not elsewhere classified"	"Malignant neoplasm of esophagus"	1	291	13	304
"M79"	"C16"	"Oth and unsp soft tissue disorders, not elsewhere classified"	"Malignant neoplasm of stomach"	1	291	28	319
"M79"	"C17"	"Oth and unsp soft tissue disorders, not elsewhere classified"	"Malignant neoplasm of small intestine"	1	64	8	72
"M79"	"C44"	"Oth and unsp soft tissue disorders, not elsewhere classified"	"Other and unspecified malignant neoplasm of skin"	1	1734	790	2524
"M79"	"C64"	"Oth and unsp soft tissue disorders, not elsewhere classified"	"Malignant neoplasm of kidney, except renal pelvis"	1	347	154	501
"M79"	"C79"	"Oth and unsp soft tissue disorders, not elsewhere classified"	"Secondary malignant neoplasm of other and unspecified sites"	1	1855	344	2199
"M79"	"C80"	"Oth and unsp soft tissue disorders, not elsewhere classified"	"Malignant neoplasm without specification of site"	1	362	49	411
"M79"	"D63"	"Oth and unsp soft tissue disorders, not elsewhere classified"	"Anemia in chronic diseases classified elsewhere"	1	1045	206	1251
"M79"	"D64"	"Oth and unsp soft tissue disorders, not elsewhere classified"	"Other anemias"	1	5049	2254	7303
"M79"	"E23"	"Oth and unsp soft tissue disorders, not elsewhere classified"	"Hypofunction and other disorders of the pituitary gland"	1	329	156	485
"M79"	"E27"	"Oth and unsp soft tissue disorders, not elsewhere classified"	"Other disorders of adrenal gland"	1	346	126	472
"M79"	"E34"	"Oth and unsp soft tissue disorders, not elsewhere classified"	"Other endocrine disorders"	1	395	225	620
"M79"	"E53"	"Oth and unsp soft tissue disorders, not elsewhere classified"	"Deficiency of other B group vitamins"	1	388	146	534
"M79"	"E55"	"Oth and unsp soft tissue disorders, not elsewhere classified"	"Vitamin D deficiency"	1	1340	680	2020
"M79"	"E64"	"Oth and unsp soft tissue disorders, not elsewhere classified"	"Sequelae of malnutrition and other nutritional deficiencies"	1	555	193	748
"M79"	"E89"	"Oth and unsp soft tissue disorders, not elsewhere classified"	"Postproc endocrine and metabolic comp and disorders, NEC"	1	340	153	493
"M79"	"F32"	"Oth and unsp soft tissue disorders, not elsewhere classified"	"Depressive episode"	1	2672	1791	4463
"M79"	"G12"	"Oth and unsp soft tissue disorders, not elsewhere classified"	"Spinal muscular atrophy and related syndromes"	1	154	45	199
"M79"	"G31"	"Oth and unsp soft tissue disorders, not elsewhere classified"	"Oth degenerative diseases of nervous system, NEC"	1	337	80	417
"M79"	"G62"	"Oth and unsp soft tissue disorders, not elsewhere classified"	"Other and unspecified polyneuropathies"	1	2001	1249	3250
"M79"	"G63"	"Oth and unsp soft tissue disorders, not elsewhere classified"	"Polyneuropathy in diseases classified elsewhere"	1	322	190	512
"M79"	"H25"	"Oth and unsp soft tissue disorders, not elsewhere classified"	"Age-related cataract"	1	6476	5111	11587
"M79"	"H26"	"Oth and unsp soft tissue disorders, not elsewhere classified"	"Other cataract"	1	1966	1539	3505
"M79"	"H35"	"Oth and unsp soft tissue disorders, not elsewhere classified"	"Other retinal disorders"	1	2234	1711	3945
"M79"	"H43"	"Oth and unsp soft tissue disorders, not elsewhere classified"	"Disorders of vitreous body"	1	828	508	1336
"M79"	"I42"	"Oth and unsp soft tissue disorders, not elsewhere classified"	"Cardiomyopathy"	1	676	372	1048
"M79"	"I46"	"Oth and unsp soft tissue disorders, not elsewhere classified"	"Cardiac arrest"	1	1360	0	1360
"M79"	"I48"	"Oth and unsp soft tissue disorders, not elsewhere classified"	"Atrial fibrillation and flutter"	1	6125	3806	9931
"M79"	"I50"	"Oth and unsp soft tissue disorders, not elsewhere classified"	"Heart failure"	1	5045	2748	7793
"M79"	"I61"	"Oth and unsp soft tissue disorders, not elsewhere classified"	"Nontraumatic intracerebral hemorrhage"	1	923	350	1273
"M79"	"I63"	"Oth and unsp soft tissue disorders, not elsewhere classified"	"Cerebral infarction"	1	3318	1737	5055
"M79"	"I67"	"Oth and unsp soft tissue disorders, not elsewhere classified"	"Other cerebrovascular diseases"	1	427	219	646
"M79"	"J09"	"Oth and unsp soft tissue disorders, not elsewhere classified"	"Influenza due to certain identified influenza viruses"	1	257	11	268
"M79"	"J15"	"Oth and unsp soft tissue disorders, not elsewhere classified"	"Bacterial pneumonia, not elsewhere classified"	1	6103	0	6103
"M79"	"J22"	"Oth and unsp soft tissue disorders, not elsewhere classified"	"Unspecified acute lower respiratory infection"	1	611	112	723
"M79"	"J43"	"Oth and unsp soft tissue disorders, not elsewhere classified"	"Emphysema"	1	479	254	733
"M79"	"J44"	"Oth and unsp soft tissue disorders, not elsewhere classified"	"Other chronic obstructive pulmonary disease"	1	5172	3325	8497
"M79"	"J69"	"Oth and unsp soft tissue disorders, not elsewhere classified"	"Pneumonitis due to solids and liquids"	1	609	68	677
"M79"	"J85"	"Oth and unsp soft tissue disorders, not elsewhere classified"	"Abscess of lung and mediastinum"	1	130	53	183
"M79"	"J91"	"Oth and unsp soft tissue disorders, not elsewhere classified"	"Pleural effusion in conditions classified elsewhere"	1	389	99	488
"M79"	"J94"	"Oth and unsp soft tissue disorders, not elsewhere classified"	"Other pleural conditions"	1	272	117	389
"M79"	"J95"	"Oth and unsp soft tissue disorders, not elsewhere classified"	"Intraop and postproc comp and disorders of resp sys, NEC"	1	203	38	241
"M79"	"K22"	"Oth and unsp soft tissue disorders, not elsewhere classified"	"Other diseases of esophagus"	1	1060	573	1633
"M79"	"K63"	"Oth and unsp soft tissue disorders, not elsewhere classified"	"Other diseases of intestine"	1	857	259	1116
"M79"	"K70"	"Oth and unsp soft tissue disorders, not elsewhere classified"	"Alcoholic liver disease"	1	759	418	1177
"M79"	"K72"	"Oth and unsp soft tissue disorders, not elsewhere classified"	"Hepatic failure, not elsewhere classified"	1	487	67	554
"M79"	"K76"	"Oth and unsp soft tissue disorders, not elsewhere classified"	"Other diseases of liver"	1	961	545	1506
"M79"	"K92"	"Oth and unsp soft tissue disorders, not elsewhere classified"	"Other diseases of digestive system"	1	2446	1408	3854
"M79"	"M07"	"Oth and unsp soft tissue disorders, not elsewhere classified"	"Enteropathic arthropathies"	1	874	414	1288
"M79"	"M25"	"Oth and unsp soft tissue disorders, not elsewhere classified"	"Other joint disorder, not elsewhere classified"	1	6002	5434	11436
"M79"	"M46"	"Oth and unsp soft tissue disorders, not elsewhere classified"	"Other inflammatory spondylopathies"	1	744	356	1100
"M79"	"M47"	"Oth and unsp soft tissue disorders, not elsewhere classified"	"Spondylosis"	1	4533	3782	8315
"M79"	"M48"	"Oth and unsp soft tissue disorders, not elsewhere classified"	"Other spondylopathies"	1	4784	2728	7512
"M79"	"M66"	"Oth and unsp soft tissue disorders, not elsewhere classified"	"Spontaneous rupture of synovium and tendon"	1	510	346	856
"M79"	"M75"	"Oth and unsp soft tissue disorders, not elsewhere classified"	"Shoulder lesions"	1	9719	8205	17924
"M79"	"M80"	"Oth and unsp soft tissue disorders, not elsewhere classified"	"Osteoporosis with current pathological fracture"	1	2537	1036	3573
"M79"	"M81"	"Oth and unsp soft tissue disorders, not elsewhere classified"	"Osteoporosis without current pathological fracture"	1	5094	2513	7607
"M79"	"N19"	"Oth and unsp soft tissue disorders, not elsewhere classified"	"Unspecified kidney failure"	1	1069	417	1486
"M79"	"N30"	"Oth and unsp soft tissue disorders, not elsewhere classified"	"Cystitis"	1	7789	5639	13428
"M79"	"O72"	"Oth and unsp soft tissue disorders, not elsewhere classified"	"Postpartum hemorrhage"	1	6872	0	6872
"M79"	"Q61"	"Oth and unsp soft tissue disorders, not elsewhere classified"	"Cystic kidney disease"	1	356	147	503
"M80"	"A04"	"Osteoporosis with current pathological fracture"	"Other bacterial intestinal infections"	1	748	475	1223
"M80"	"A41"	"Osteoporosis with current pathological fracture"	"Other sepsis"	1	3446	1917	5363
"M80"	"C25"	"Osteoporosis with current pathological fracture"	"Malignant neoplasm of pancreas"	1	228	74	302
"M80"	"C34"	"Osteoporosis with current pathological fracture"	"Malignant neoplasm of bronchus and lung"	1	1039	623	1662
"M80"	"C78"	"Osteoporosis with current pathological fracture"	"Secondary malignant neoplasm of resp and digestive organs"	1	699	265	964
"M80"	"C79"	"Osteoporosis with current pathological fracture"	"Secondary malignant neoplasm of other and unspecified sites"	1	591	294	885
"M80"	"E41"	"Osteoporosis with current pathological fracture"	"Nutritional marasmus"	1	262	120	382
"M80"	"E86"	"Osteoporosis with current pathological fracture"	"Volume depletion"	1	5699	4338	10037
"M80"	"F03"	"Osteoporosis with current pathological fracture"	"Unspecified dementia"	1	2724	2127	4851
"M80"	"G30"	"Osteoporosis with current pathological fracture"	"Alzheimer's disease"	1	655	300	955
"M80"	"L89"	"Osteoporosis with current pathological fracture"	"Pressure ulcer"	1	961	453	1414
"M81"	"A41"	"Osteoporosis without current pathological fracture"	"Other sepsis"	1	5659	2890	8549
"M81"	"B96"	"Osteoporosis without current pathological fracture"	"Oth bacterial agents as the cause of diseases classd elswhr"	1	328	197	525
"M81"	"C77"	"Osteoporosis without current pathological fracture"	"Secondary and unspecified malignant neoplasm of lymph nodes"	1	598	429	1027
"M81"	"D47"	"Osteoporosis without current pathological fracture"	"Oth neoplm of uncrt behav of lymphoid, hematpoetc & rel tiss"	1	649	448	1097
"M81"	"E41"	"Osteoporosis without current pathological fracture"	"Nutritional marasmus"	1	493	179	672
"M81"	"F03"	"Osteoporosis without current pathological fracture"	"Unspecified dementia"	1	4279	2265	6544
"M81"	"F05"	"Osteoporosis without current pathological fracture"	"Delirium due to known physiological condition"	1	2081	957	3038
"M81"	"G30"	"Osteoporosis without current pathological fracture"	"Alzheimer's disease"	1	1226	339	1565
"M81"	"G47"	"Osteoporosis without current pathological fracture"	"Sleep disorders"	1	1169	686	1855
"M81"	"J09"	"Osteoporosis without current pathological fracture"	"Influenza due to certain identified influenza viruses"	1	260	55	315
"M81"	"J15"	"Osteoporosis without current pathological fracture"	"Bacterial pneumonia, not elsewhere classified"	1	5716	3511	9227
"M81"	"J90"	"Osteoporosis without current pathological fracture"	"Pleural effusion, not elsewhere classified"	1	1014	550	1564
"M81"	"J91"	"Osteoporosis without current pathological fracture"	"Pleural effusion in conditions classified elsewhere"	1	344	222	566
"M81"	"J96"	"Osteoporosis without current pathological fracture"	"Respiratory failure, not elsewhere classified"	1	6337	3431	9768
"M81"	"K64"	"Osteoporosis without current pathological fracture"	"Hemorrhoids and perianal venous thrombosis"	1	1144	281	1425
"M81"	"L57"	"Osteoporosis without current pathological fracture"	"Skin changes due to chronic expsr to nonionizing radiation"	1	679	389	1068
"M81"	"L97"	"Osteoporosis without current pathological fracture"	"Non-pressure chronic ulcer of lower limb, NEC"	1	1528	881	2409
"M81"	"N18"	"Osteoporosis without current pathological fracture"	"Chronic kidney disease (CKD)"	1	2082	1408	3490
"M83"	"J22"	"Adult osteomalacia"	"Unspecified acute lower respiratory infection"	1	46	6	52
"M84"	"D12"	"Disorder of continuity of bone"	"Benign neoplasm of colon, rectum, anus and anal canal"	1	171	78	249
"M84"	"G47"	"Disorder of continuity of bone"	"Sleep disorders"	1	171	49	220
"M84"	"L97"	"Disorder of continuity of bone"	"Non-pressure chronic ulcer of lower limb, NEC"	1	128	41	169
"M85"	"A41"	"Other disorders of bone density and structure"	"Other sepsis"	1	1411	600	2011
"M85"	"C15"	"Other disorders of bone density and structure"	"Malignant neoplasm of esophagus"	1	78	14	92
"M85"	"C22"	"Other disorders of bone density and structure"	"Malignant neoplasm of liver and intrahepatic bile ducts"	1	82	14	96
"M85"	"C25"	"Other disorders of bone density and structure"	"Malignant neoplasm of pancreas"	1	204	15	219
"M85"	"C34"	"Other disorders of bone density and structure"	"Malignant neoplasm of bronchus and lung"	1	855	232	1087
"M85"	"C78"	"Other disorders of bone density and structure"	"Secondary malignant neoplasm of resp and digestive organs"	1	813	123	936
"M85"	"C79"	"Other disorders of bone density and structure"	"Secondary malignant neoplasm of other and unspecified sites"	1	650	105	755
"M85"	"C80"	"Other disorders of bone density and structure"	"Malignant neoplasm without specification of site"	1	96	9	105
"M85"	"C90"	"Other disorders of bone density and structure"	"Multiple myeloma and malignant plasma cell neoplasms"	1	108	44	152
"M85"	"D09"	"Other disorders of bone density and structure"	"Carcinoma in situ of other and unspecified sites"	1	75	21	96
"M85"	"D64"	"Other disorders of bone density and structure"	"Other anemias"	1	1296	1010	2306
"M85"	"E86"	"Other disorders of bone density and structure"	"Volume depletion"	1	1582	609	2191
"M85"	"E87"	"Other disorders of bone density and structure"	"Other disorders of fluid, electrolyte and acid-base balance"	1	1142	579	1721
"M85"	"F03"	"Other disorders of bone density and structure"	"Unspecified dementia"	1	479	96	575
"M85"	"G30"	"Other disorders of bone density and structure"	"Alzheimer's disease"	1	277	10	287
"M85"	"G47"	"Other disorders of bone density and structure"	"Sleep disorders"	1	744	453	1197
"M85"	"I95"	"Other disorders of bone density and structure"	"Hypotension"	1	525	260	785
"M85"	"J22"	"Other disorders of bone density and structure"	"Unspecified acute lower respiratory infection"	1	410	277	687
"M85"	"J69"	"Other disorders of bone density and structure"	"Pneumonitis due to solids and liquids"	1	142	22	164
"M85"	"J96"	"Other disorders of bone density and structure"	"Respiratory failure, not elsewhere classified"	1	1249	707	1956
"M85"	"L89"	"Other disorders of bone density and structure"	"Pressure ulcer"	1	221	66	287
"M85"	"N17"	"Other disorders of bone density and structure"	"Acute kidney failure"	1	327	139	466
"M86"	"C34"	"Osteomyelitis"	"Malignant neoplasm of bronchus and lung"	1	149	24	173
"M86"	"C78"	"Osteomyelitis"	"Secondary malignant neoplasm of resp and digestive organs"	1	93	10	103
"M86"	"E87"	"Osteomyelitis"	"Other disorders of fluid, electrolyte and acid-base balance"	1	316	192	508
"M86"	"G47"	"Osteomyelitis"	"Sleep disorders"	1	113	46	159
"M86"	"O72"	"Osteomyelitis"	"Postpartum hemorrhage"	1	55	0	55
"M87"	"E86"	"Osteonecrosis"	"Volume depletion"	1	261	127	388
"M89"	"C61"	"Other disorders of bone"	"Malignant neoplasm of prostate"	1	220	124	344
"M89"	"G95"	"Other disorders of bone"	"Other and unspecified diseases of spinal cord"	1	100	30	130
"M89"	"I21"	"Other disorders of bone"	"Acute myocardial infarction"	1	321	165	486
"M89"	"I25"	"Other disorders of bone"	"Chronic ischemic heart disease"	1	499	320	819
"M89"	"I48"	"Other disorders of bone"	"Atrial fibrillation and flutter"	1	706	282	988
"M89"	"J18"	"Other disorders of bone"	"Pneumonia, unspecified organism"	1	1181	489	1670
"M89"	"M13"	"Other disorders of bone"	"Other arthritis"	1	212	119	331
"M89"	"M16"	"Other disorders of bone"	"Osteoarthritis of hip"	1	574	360	934
"M89"	"M25"	"Other disorders of bone"	"Other joint disorder, not elsewhere classified"	1	499	317	816
"M89"	"M75"	"Other disorders of bone"	"Shoulder lesions"	1	804	398	1202
"M89"	"M81"	"Other disorders of bone"	"Osteoporosis without current pathological fracture"	1	1103	573	1676
"M89"	"M85"	"Other disorders of bone"	"Other disorders of bone density and structure"	1	536	42	578
"M89"	"M99"	"Other disorders of bone"	"Biomechanical lesions, not elsewhere classified"	1	173	49	222
"M89"	"O72"	"Other disorders of bone"	"Postpartum hemorrhage"	1	203	14	217
"M89"	"O99"	"Other disorders of bone"	"Oth maternal diseases classd elsw but compl preg/chldbrth"	1	123	55	178
"M91"	"M23"	"Juvenile osteochondrosis of hip and pelvis"	"Internal derangement of knee"	1	59	8	67
"M91"	"M70"	"Juvenile osteochondrosis of hip and pelvis"	"Soft tissue disorders related to use, overuse and pressure"	1	74	20	94
"M91"	"M95"	"Juvenile osteochondrosis of hip and pelvis"	"Oth acquired deformities of ms sys and connective tissue"	1	45	5	50
"M92"	"L05"	"Other juvenile osteochondrosis"	"Pilonidal cyst and sinus"	1	47	0	47
"M92"	"M23"	"Other juvenile osteochondrosis"	"Internal derangement of knee"	1	535	346	881
"M92"	"N20"	"Other juvenile osteochondrosis"	"Calculus of kidney and ureter"	1	36	2	38
"M92"	"O36"	"Other juvenile osteochondrosis"	"Maternal care for other fetal problems"	1	25	0	25
"M92"	"O62"	"Other juvenile osteochondrosis"	"Abnormalities of forces of labor"	1	81	7	88
"M92"	"O68"	"Other juvenile osteochondrosis"	"Labor and delivery comp by abnlt of fetal acid-base balance"	1	50	0	50
"M93"	"E11"	"Other osteochondropathies"	"Type 2 diabetes mellitus"	1	135	9	144
"M93"	"H36"	"Other osteochondropathies"	"Retinal disorders in diseases classified elsewhere"	1	30	1	31
"M93"	"H91"	"Other osteochondropathies"	"Other and unspecified hearing loss"	1	87	20	107
"M93"	"I20"	"Other osteochondropathies"	"Angina pectoris"	1	133	19	152
"M93"	"I25"	"Other osteochondropathies"	"Chronic ischemic heart disease"	1	115	12	127
"M93"	"J18"	"Other osteochondropathies"	"Pneumonia, unspecified organism"	1	144	35	179
"M93"	"J96"	"Other osteochondropathies"	"Respiratory failure, not elsewhere classified"	1	53	0	53
"M93"	"K43"	"Other osteochondropathies"	"Ventral hernia"	1	28	0	28
"M93"	"K59"	"Other osteochondropathies"	"Other functional intestinal disorders"	1	149	19	168
"M93"	"L02"	"Other osteochondropathies"	"Cutaneous abscess, furuncle and carbuncle"	1	116	35	151
"M93"	"M17"	"Other osteochondropathies"	"Osteoarthritis of knee"	1	881	345	1226
"M93"	"M70"	"Other osteochondropathies"	"Soft tissue disorders related to use, overuse and pressure"	1	183	61	244
"M93"	"M79"	"Other osteochondropathies"	"Oth and unsp soft tissue disorders, not elsewhere classified"	1	451	287	738
"M93"	"M95"	"Other osteochondropathies"	"Oth acquired deformities of ms sys and connective tissue"	1	94	17	111
"M93"	"N30"	"Other osteochondropathies"	"Cystitis"	1	134	30	164
"M93"	"N39"	"Other osteochondropathies"	"Other disorders of urinary system"	1	95	15	110
"M93"	"O70"	"Other osteochondropathies"	"Perineal laceration during delivery"	1	143	35	178
"M94"	"J96"	"Other disorders of cartilage"	"Respiratory failure, not elsewhere classified"	1	57	1	58
"M94"	"M17"	"Other disorders of cartilage"	"Osteoarthritis of knee"	1	495	347	842
"M94"	"N18"	"Other disorders of cartilage"	"Chronic kidney disease (CKD)"	1	31	2	33
"M94"	"O72"	"Other disorders of cartilage"	"Postpartum hemorrhage"	1	165	54	219
"M95"	"A41"	"Oth acquired deformities of ms sys and connective tissue"	"Other sepsis"	1	172	14	186
"M95"	"C78"	"Oth acquired deformities of ms sys and connective tissue"	"Secondary malignant neoplasm of resp and digestive organs"	1	31	0	31
"M95"	"C79"	"Oth acquired deformities of ms sys and connective tissue"	"Secondary malignant neoplasm of other and unspecified sites"	1	42	5	47
"M95"	"D12"	"Oth acquired deformities of ms sys and connective tissue"	"Benign neoplasm of colon, rectum, anus and anal canal"	1	134	16	150
"M95"	"E11"	"Oth acquired deformities of ms sys and connective tissue"	"Type 2 diabetes mellitus"	1	167	67	234
"M95"	"E78"	"Oth acquired deformities of ms sys and connective tissue"	"Disorders of lipoprotein metabolism and other lipidemias"	1	242	57	299
"M95"	"E86"	"Oth acquired deformities of ms sys and connective tissue"	"Volume depletion"	1	258	41	299
"M95"	"G62"	"Oth acquired deformities of ms sys and connective tissue"	"Other and unspecified polyneuropathies"	1	61	15	76
"M95"	"I21"	"Oth acquired deformities of ms sys and connective tissue"	"Acute myocardial infarction"	1	140	50	190
"M95"	"I25"	"Oth acquired deformities of ms sys and connective tissue"	"Chronic ischemic heart disease"	1	197	76	273
"M95"	"I48"	"Oth acquired deformities of ms sys and connective tissue"	"Atrial fibrillation and flutter"	1	200	56	256
"M95"	"J15"	"Oth acquired deformities of ms sys and connective tissue"	"Bacterial pneumonia, not elsewhere classified"	1	171	17	188
"M95"	"J18"	"Oth acquired deformities of ms sys and connective tissue"	"Pneumonia, unspecified organism"	1	435	192	627
"M95"	"J44"	"Oth acquired deformities of ms sys and connective tissue"	"Other chronic obstructive pulmonary disease"	1	223	63	286
"M95"	"J96"	"Oth acquired deformities of ms sys and connective tissue"	"Respiratory failure, not elsewhere classified"	1	202	12	214
"M95"	"K22"	"Oth acquired deformities of ms sys and connective tissue"	"Other diseases of esophagus"	1	51	12	63
"M95"	"K59"	"Oth acquired deformities of ms sys and connective tissue"	"Other functional intestinal disorders"	1	444	199	643
"M95"	"N17"	"Oth acquired deformities of ms sys and connective tissue"	"Acute kidney failure"	1	41	1	42
"M95"	"N18"	"Oth acquired deformities of ms sys and connective tissue"	"Chronic kidney disease (CKD)"	1	84	2	86
"M95"	"N19"	"Oth acquired deformities of ms sys and connective tissue"	"Unspecified kidney failure"	1	37	2	39
"M95"	"N20"	"Oth acquired deformities of ms sys and connective tissue"	"Calculus of kidney and ureter"	1	159	80	239
"M95"	"N30"	"Oth acquired deformities of ms sys and connective tissue"	"Cystitis"	1	385	174	559
"M95"	"N39"	"Oth acquired deformities of ms sys and connective tissue"	"Other disorders of urinary system"	1	281	93	374
"M95"	"N46"	"Oth acquired deformities of ms sys and connective tissue"	"Male infertility"	1	104	36	140
"M96"	"E86"	"Intraop and postproc comp and disorders of ms sys, NEC"	"Volume depletion"	1	191	43	234
"M96"	"I50"	"Intraop and postproc comp and disorders of ms sys, NEC"	"Heart failure"	1	180	76	256
"M96"	"J18"	"Intraop and postproc comp and disorders of ms sys, NEC"	"Pneumonia, unspecified organism"	1	382	188	570
"M96"	"J96"	"Intraop and postproc comp and disorders of ms sys, NEC"	"Respiratory failure, not elsewhere classified"	1	170	20	190
"M96"	"N18"	"Intraop and postproc comp and disorders of ms sys, NEC"	"Chronic kidney disease (CKD)"	1	75	11	86
"M99"	"C18"	"Biomechanical lesions, not elsewhere classified"	"Malignant neoplasm of colon"	1	114	40	154
"M99"	"C79"	"Biomechanical lesions, not elsewhere classified"	"Secondary malignant neoplasm of other and unspecified sites"	1	175	59	234
"M99"	"J22"	"Biomechanical lesions, not elsewhere classified"	"Unspecified acute lower respiratory infection"	1	29	1	30
"M99"	"J44"	"Biomechanical lesions, not elsewhere classified"	"Other chronic obstructive pulmonary disease"	1	569	332	901
"M99"	"J90"	"Biomechanical lesions, not elsewhere classified"	"Pleural effusion, not elsewhere classified"	1	74	10	84
"M99"	"J96"	"Biomechanical lesions, not elsewhere classified"	"Respiratory failure, not elsewhere classified"	1	408	18	426
"M99"	"N19"	"Biomechanical lesions, not elsewhere classified"	"Unspecified kidney failure"	1	103	43	146
"N00"	"H57"	"Acute nephritic syndrome"	"Other disorders of eye and adnexa"	1	50	7	57
"N00"	"N05"	"Acute nephritic syndrome"	"Unspecified nephritic syndrome"	1	341	201	542
"N00"	"N18"	"Acute nephritic syndrome"	"Chronic kidney disease (CKD)"	1	988	640	1628
"N00"	"N28"	"Acute nephritic syndrome"	"Oth disorders of kidney and ureter, not elsewhere classified"	1	123	50	173
"N00"	"O72"	"Acute nephritic syndrome"	"Postpartum hemorrhage"	1	38	0	38
"N03"	"A08"	"Chronic nephritic syndrome"	"Viral and other specified intestinal infections"	1	67	19	86
"N03"	"B02"	"Chronic nephritic syndrome"	"Zoster [herpes zoster]"	1	66	15	81
"N03"	"B07"	"Chronic nephritic syndrome"	"Viral warts"	1	97	0	97
"N03"	"B25"	"Chronic nephritic syndrome"	"Cytomegaloviral disease"	1	72	10	82
"N03"	"B37"	"Chronic nephritic syndrome"	"Candidiasis"	1	56	12	68
"N03"	"C34"	"Chronic nephritic syndrome"	"Malignant neoplasm of bronchus and lung"	1	51	8	59
"N03"	"C78"	"Chronic nephritic syndrome"	"Secondary malignant neoplasm of resp and digestive organs"	1	49	0	49
"N03"	"C79"	"Chronic nephritic syndrome"	"Secondary malignant neoplasm of other and unspecified sites"	1	28	1	29
"N03"	"D68"	"Chronic nephritic syndrome"	"Other coagulation defects"	1	52	11	63
"N03"	"E21"	"Chronic nephritic syndrome"	"Hyperparathyroidism and other disorders of parathyroid gland"	1	134	12	146
"N03"	"E83"	"Chronic nephritic syndrome"	"Disorders of mineral metabolism"	1	61	7	68
"N03"	"E86"	"Chronic nephritic syndrome"	"Volume depletion"	1	256	92	348
"N03"	"I21"	"Chronic nephritic syndrome"	"Acute myocardial infarction"	1	200	110	310
"N03"	"I50"	"Chronic nephritic syndrome"	"Heart failure"	1	293	173	466
"N03"	"I51"	"Chronic nephritic syndrome"	"Complications and ill-defined descriptions of heart disease"	1	51	11	62
"N03"	"I70"	"Chronic nephritic syndrome"	"Atherosclerosis"	1	199	59	258
"N03"	"I73"	"Chronic nephritic syndrome"	"Other peripheral vascular diseases"	1	91	21	112
"N03"	"I95"	"Chronic nephritic syndrome"	"Hypotension"	1	92	23	115
"N03"	"J06"	"Chronic nephritic syndrome"	"Acute upper resp infections of multiple and unsp sites"	1	41	7	48
"N03"	"J18"	"Chronic nephritic syndrome"	"Pneumonia, unspecified organism"	1	635	318	953
"N03"	"J81"	"Chronic nephritic syndrome"	"Pulmonary edema"	1	128	45	173
"N03"	"K62"	"Chronic nephritic syndrome"	"Other diseases of anus and rectum"	1	133	31	164
"N03"	"K63"	"Chronic nephritic syndrome"	"Other diseases of intestine"	1	40	4	44
"N03"	"K92"	"Chronic nephritic syndrome"	"Other diseases of digestive system"	1	143	37	180
"N03"	"L08"	"Chronic nephritic syndrome"	"Other local infections of skin and subcutaneous tissue"	1	72	22	94
"N03"	"L30"	"Chronic nephritic syndrome"	"Other and unspecified dermatitis"	1	69	19	88
"N03"	"L57"	"Chronic nephritic syndrome"	"Skin changes due to chronic expsr to nonionizing radiation"	1	63	0	63
"N03"	"L97"	"Chronic nephritic syndrome"	"Non-pressure chronic ulcer of lower limb, NEC"	1	81	7	88
"N03"	"L98"	"Chronic nephritic syndrome"	"Oth disorders of skin, subcu, not elsewhere classified"	1	106	17	123
"N03"	"M10"	"Chronic nephritic syndrome"	"Gout"	1	217	80	297
"N03"	"O72"	"Chronic nephritic syndrome"	"Postpartum hemorrhage"	1	61	16	77
"N04"	"A41"	"Nephrotic syndrome"	"Other sepsis"	1	368	122	490
"N04"	"A49"	"Nephrotic syndrome"	"Bacterial infection of unspecified site"	1	161	31	192
"N04"	"D22"	"Nephrotic syndrome"	"Melanocytic nevi"	1	37	3	40
"N04"	"E83"	"Nephrotic syndrome"	"Disorders of mineral metabolism"	1	60	13	73
"N04"	"E86"	"Nephrotic syndrome"	"Volume depletion"	1	211	115	326
"N04"	"E87"	"Nephrotic syndrome"	"Other disorders of fluid, electrolyte and acid-base balance"	1	247	105	352
"N04"	"J18"	"Nephrotic syndrome"	"Pneumonia, unspecified organism"	1	425	282	707
"N04"	"K04"	"Nephrotic syndrome"	"Diseases of pulp and periapical tissues"	1	64	17	81
"N04"	"K65"	"Nephrotic syndrome"	"Peritonitis"	1	155	38	193
"N04"	"N19"	"Nephrotic syndrome"	"Unspecified kidney failure"	1	493	255	748
"N04"	"N28"	"Nephrotic syndrome"	"Oth disorders of kidney and ureter, not elsewhere classified"	1	149	68	217
"N05"	"A41"	"Unspecified nephritic syndrome"	"Other sepsis"	1	223	113	336
"N05"	"A49"	"Unspecified nephritic syndrome"	"Bacterial infection of unspecified site"	1	113	27	140
"N06"	"A41"	"Isolated proteinuria with specified morphological lesion"	"Other sepsis"	1	172	33	205
"N06"	"N18"	"Isolated proteinuria with specified morphological lesion"	"Chronic kidney disease (CKD)"	1	436	142	578
"N06"	"N19"	"Isolated proteinuria with specified morphological lesion"	"Unspecified kidney failure"	1	157	51	208
"N08"	"I46"	"Glomerular disorders in diseases classified elsewhere"	"Cardiac arrest"	1	90	33	123
"N10"	"A04"	"Acute pyelonephritis"	"Other bacterial intestinal infections"	1	352	230	582
"N10"	"C22"	"Acute pyelonephritis"	"Malignant neoplasm of liver and intrahepatic bile ducts"	1	46	4	50
"N10"	"C34"	"Acute pyelonephritis"	"Malignant neoplasm of bronchus and lung"	1	316	72	388
"N10"	"C78"	"Acute pyelonephritis"	"Secondary malignant neoplasm of resp and digestive organs"	1	387	143	530
"N10"	"C79"	"Acute pyelonephritis"	"Secondary malignant neoplasm of other and unspecified sites"	1	354	135	489
"N10"	"F41"	"Acute pyelonephritis"	"Other anxiety disorders"	1	338	111	449
"N10"	"G47"	"Acute pyelonephritis"	"Sleep disorders"	1	448	149	597
"N10"	"H57"	"Acute pyelonephritis"	"Other disorders of eye and adnexa"	1	241	60	301
"N10"	"J06"	"Acute pyelonephritis"	"Acute upper resp infections of multiple and unsp sites"	1	986	381	1367
"N10"	"J96"	"Acute pyelonephritis"	"Respiratory failure, not elsewhere classified"	1	1048	589	1637
"N10"	"L89"	"Acute pyelonephritis"	"Pressure ulcer"	1	304	174	478
"N10"	"N28"	"Acute pyelonephritis"	"Oth disorders of kidney and ureter, not elsewhere classified"	1	425	289	714
"N10"	"O23"	"Acute pyelonephritis"	"Infections of genitourinary tract in pregnancy"	1	432	290	722
"N10"	"O34"	"Acute pyelonephritis"	"Maternal care for abnormality of pelvic organs"	1	164	72	236
"N10"	"O36"	"Acute pyelonephritis"	"Maternal care for other fetal problems"	1	249	143	392
"N10"	"O70"	"Acute pyelonephritis"	"Perineal laceration during delivery"	1	903	414	1317
"N10"	"O92"	"Acute pyelonephritis"	"Oth disord of brst/lactatn assoc w pregnancy and the puerp"	1	110	37	147
"N10"	"O99"	"Acute pyelonephritis"	"Oth maternal diseases classd elsw but compl preg/chldbrth"	1	921	420	1341
"N13"	"A04"	"Obstructive and reflux uropathy"	"Other bacterial intestinal infections"	1	386	185	571
"N13"	"C22"	"Obstructive and reflux uropathy"	"Malignant neoplasm of liver and intrahepatic bile ducts"	1	71	17	88
"N13"	"C65"	"Obstructive and reflux uropathy"	"Malignant neoplasm of renal pelvis"	1	266	138	404
"N13"	"C66"	"Obstructive and reflux uropathy"	"Malignant neoplasm of ureter"	1	288	138	426
"N13"	"C79"	"Obstructive and reflux uropathy"	"Secondary malignant neoplasm of other and unspecified sites"	1	1496	1025	2521
"N13"	"E86"	"Obstructive and reflux uropathy"	"Volume depletion"	1	2344	1570	3914
"N13"	"E87"	"Obstructive and reflux uropathy"	"Other disorders of fluid, electrolyte and acid-base balance"	1	1167	927	2094
"N13"	"F01"	"Obstructive and reflux uropathy"	"Vascular dementia"	1	98	39	137
"N13"	"F03"	"Obstructive and reflux uropathy"	"Unspecified dementia"	1	465	239	704
"N13"	"F05"	"Obstructive and reflux uropathy"	"Delirium due to known physiological condition"	1	352	143	495
"N13"	"G96"	"Obstructive and reflux uropathy"	"Other disorders of central nervous system"	1	176	85	261
"N13"	"J69"	"Obstructive and reflux uropathy"	"Pneumonitis due to solids and liquids"	1	154	41	195
"N13"	"K64"	"Obstructive and reflux uropathy"	"Hemorrhoids and perianal venous thrombosis"	1	226	35	261
"N13"	"N11"	"Obstructive and reflux uropathy"	"Chronic tubulo-interstitial nephritis"	1	567	320	887
"N13"	"N26"	"Obstructive and reflux uropathy"	"Unspecified contracted kidney"	1	299	147	446
"N13"	"N28"	"Obstructive and reflux uropathy"	"Oth disorders of kidney and ureter, not elsewhere classified"	1	721	479	1200
"N18"	"A04"	"Chronic kidney disease (CKD)"	"Other bacterial intestinal infections"	1	1433	875	2308
"N18"	"B07"	"Chronic kidney disease (CKD)"	"Viral warts"	1	286	74	360
"N18"	"B59"	"Chronic kidney disease (CKD)"	"Pneumocystosis"	1	108	37	145
"N18"	"B95"	"Chronic kidney disease (CKD)"	"Strep as the cause of diseases classified elsewhere"	1	204	112	316
"N18"	"I77"	"Chronic kidney disease (CKD)"	"Other disorders of arteries and arterioles"	1	346	167	513
"N18"	"J09"	"Chronic kidney disease (CKD)"	"Influenza due to certain identified influenza viruses"	1	245	55	300
"N18"	"L82"	"Chronic kidney disease (CKD)"	"Seborrheic keratosis"	1	231	108	339
"N18"	"L89"	"Chronic kidney disease (CKD)"	"Pressure ulcer"	1	1020	723	1743
"N18"	"N08"	"Chronic kidney disease (CKD)"	"Glomerular disorders in diseases classified elsewhere"	1	647	464	1111
"N19"	"B25"	"Unspecified kidney failure"	"Cytomegaloviral disease"	1	155	63	218
"N19"	"J09"	"Unspecified kidney failure"	"Influenza due to certain identified influenza viruses"	1	121	25	146
"N19"	"L57"	"Unspecified kidney failure"	"Skin changes due to chronic expsr to nonionizing radiation"	1	238	57	295
"N19"	"L82"	"Unspecified kidney failure"	"Seborrheic keratosis"	1	112	37	149
"N19"	"N28"	"Unspecified kidney failure"	"Oth disorders of kidney and ureter, not elsewhere classified"	1	1354	992	2346
"N20"	"A46"	"Calculus of kidney and ureter"	"Erysipelas"	1	648	301	949
"N20"	"A49"	"Calculus of kidney and ureter"	"Bacterial infection of unspecified site"	1	913	221	1134
"N20"	"B37"	"Calculus of kidney and ureter"	"Candidiasis"	1	350	157	507
"N20"	"C18"	"Calculus of kidney and ureter"	"Malignant neoplasm of colon"	1	543	158	701
"N20"	"C22"	"Calculus of kidney and ureter"	"Malignant neoplasm of liver and intrahepatic bile ducts"	1	108	2	110
"N20"	"C24"	"Calculus of kidney and ureter"	"Malignant neoplasm of other and unsp parts of biliary tract"	1	47	1	48
"N20"	"C34"	"Calculus of kidney and ureter"	"Malignant neoplasm of bronchus and lung"	1	854	25	879
"N20"	"C43"	"Calculus of kidney and ureter"	"Malignant melanoma of skin"	1	202	112	314
"N20"	"C61"	"Calculus of kidney and ureter"	"Malignant neoplasm of prostate"	1	938	279	1217
"N20"	"C67"	"Calculus of kidney and ureter"	"Malignant neoplasm of bladder"	1	386	240	626
"N20"	"C71"	"Calculus of kidney and ureter"	"Malignant neoplasm of brain"	1	112	17	129
"N20"	"C78"	"Calculus of kidney and ureter"	"Secondary malignant neoplasm of resp and digestive organs"	1	959	40	999
"N20"	"C83"	"Calculus of kidney and ureter"	"Non-follicular lymphoma"	1	147	47	194
"N20"	"D04"	"Calculus of kidney and ureter"	"Carcinoma in situ of skin"	1	41	3	44
"N20"	"D12"	"Calculus of kidney and ureter"	"Benign neoplasm of colon, rectum, anus and anal canal"	1	1916	452	2368
"N20"	"D22"	"Calculus of kidney and ureter"	"Melanocytic nevi"	1	225	124	349
"N20"	"D35"	"Calculus of kidney and ureter"	"Benign neoplasm of other and unspecified endocrine glands"	1	450	116	566
"N20"	"D46"	"Calculus of kidney and ureter"	"Myelodysplastic syndromes"	1	66	16	82
"N20"	"D50"	"Calculus of kidney and ureter"	"Iron deficiency anemia"	1	633	171	804
"N20"	"D62"	"Calculus of kidney and ureter"	"Acute posthemorrhagic anemia"	1	262	64	326
"N20"	"D64"	"Calculus of kidney and ureter"	"Other anemias"	1	1719	481	2200
"N20"	"D69"	"Calculus of kidney and ureter"	"Purpura and other hemorrhagic conditions"	1	202	112	314
"N20"	"E13"	"Calculus of kidney and ureter"	"Other specified diabetes mellitus"	1	173	46	219
"N20"	"E21"	"Calculus of kidney and ureter"	"Hyperparathyroidism and other disorders of parathyroid gland"	1	1034	264	1298
"N20"	"E23"	"Calculus of kidney and ureter"	"Hypofunction and other disorders of the pituitary gland"	1	95	37	132
"N20"	"E64"	"Calculus of kidney and ureter"	"Sequelae of malnutrition and other nutritional deficiencies"	1	178	51	229
"N20"	"E79"	"Calculus of kidney and ureter"	"Disorders of purine and pyrimidine metabolism"	1	147	27	174
"N20"	"E83"	"Calculus of kidney and ureter"	"Disorders of mineral metabolism"	1	434	105	539
"N20"	"E86"	"Calculus of kidney and ureter"	"Volume depletion"	1	2025	441	2466
"N20"	"F02"	"Calculus of kidney and ureter"	"Dementia in other diseases classified elsewhere"	1	50	7	57
"N20"	"F03"	"Calculus of kidney and ureter"	"Unspecified dementia"	1	642	75	717
"N20"	"F06"	"Calculus of kidney and ureter"	"Other mental disorders due to known physiological condition"	1	137	26	163
"N20"	"F17"	"Calculus of kidney and ureter"	"Nicotine dependence"	1	1048	514	1562
"N20"	"F33"	"Calculus of kidney and ureter"	"Major depressive disorder, recurrent"	1	561	136	697
"N20"	"F43"	"Calculus of kidney and ureter"	"Reaction to severe stress, and adjustment disorders"	1	365	171	536
"N20"	"G20"	"Calculus of kidney and ureter"	"Parkinson's disease"	1	226	65	291
"N20"	"G31"	"Calculus of kidney and ureter"	"Oth degenerative diseases of nervous system, NEC"	1	98	8	106
"N20"	"G56"	"Calculus of kidney and ureter"	"Mononeuropathies of upper limb"	1	986	694	1680
"N20"	"G62"	"Calculus of kidney and ureter"	"Other and unspecified polyneuropathies"	1	412	131	543
"N20"	"G63"	"Calculus of kidney and ureter"	"Polyneuropathy in diseases classified elsewhere"	1	84	19	103
"N20"	"G90"	"Calculus of kidney and ureter"	"Disorders of autonomic nervous system"	1	70	21	91
"N20"	"H02"	"Calculus of kidney and ureter"	"Other disorders of eyelid"	1	457	173	630
"N20"	"H26"	"Calculus of kidney and ureter"	"Other cataract"	1	751	262	1013
"N20"	"H35"	"Calculus of kidney and ureter"	"Other retinal disorders"	1	931	306	1237
"N20"	"H43"	"Calculus of kidney and ureter"	"Disorders of vitreous body"	1	311	115	426
"N20"	"H53"	"Calculus of kidney and ureter"	"Visual disturbances"	1	387	161	548
"N20"	"H81"	"Calculus of kidney and ureter"	"Disorders of vestibular function"	1	531	361	892
"N20"	"H90"	"Calculus of kidney and ureter"	"Conductive and sensorineural hearing loss"	1	623	395	1018
"N20"	"H91"	"Calculus of kidney and ureter"	"Other and unspecified hearing loss"	1	2116	1294	3410
"N20"	"I15"	"Calculus of kidney and ureter"	"Secondary hypertension"	1	387	133	520
"N20"	"I21"	"Calculus of kidney and ureter"	"Acute myocardial infarction"	1	1591	848	2439
"N20"	"I24"	"Calculus of kidney and ureter"	"Other acute ischemic heart diseases"	1	175	58	233
"N20"	"I25"	"Calculus of kidney and ureter"	"Chronic ischemic heart disease"	1	2469	1311	3780
"N20"	"I26"	"Calculus of kidney and ureter"	"Pulmonary embolism"	1	665	179	844
"N20"	"I27"	"Calculus of kidney and ureter"	"Other pulmonary heart diseases"	1	175	43	218
"N20"	"I34"	"Calculus of kidney and ureter"	"Nonrheumatic mitral valve disorders"	1	276	88	364
"N20"	"I35"	"Calculus of kidney and ureter"	"Nonrheumatic aortic valve disorders"	1	938	130	1068
"N20"	"I38"	"Calculus of kidney and ureter"	"Endocarditis, valve unspecified"	1	65	14	79
"N20"	"I42"	"Calculus of kidney and ureter"	"Cardiomyopathy"	1	293	99	392
"N20"	"I44"	"Calculus of kidney and ureter"	"Atrioventricular and left bundle-branch block"	1	408	92	500
"N20"	"I46"	"Calculus of kidney and ureter"	"Cardiac arrest"	1	466	0	466
"N20"	"I50"	"Calculus of kidney and ureter"	"Heart failure"	1	2150	564	2714
"N20"	"I51"	"Calculus of kidney and ureter"	"Complications and ill-defined descriptions of heart disease"	1	321	76	397
"N20"	"I67"	"Calculus of kidney and ureter"	"Other cerebrovascular diseases"	1	155	59	214
"N20"	"I70"	"Calculus of kidney and ureter"	"Atherosclerosis"	1	763	434	1197
"N20"	"I72"	"Calculus of kidney and ureter"	"Other aneurysm"	1	167	41	208
"N20"	"I73"	"Calculus of kidney and ureter"	"Other peripheral vascular diseases"	1	647	167	814
"N20"	"I74"	"Calculus of kidney and ureter"	"Arterial embolism and thrombosis"	1	181	66	247
"N20"	"I80"	"Calculus of kidney and ureter"	"Phlebitis and thrombophlebitis"	1	897	524	1421
"N20"	"I82"	"Calculus of kidney and ureter"	"Other venous embolism and thrombosis"	1	218	72	290
"N20"	"I89"	"Calculus of kidney and ureter"	"Oth noninfective disorders of lymphatic vessels and nodes"	1	124	49	173
"N20"	"I95"	"Calculus of kidney and ureter"	"Hypotension"	1	424	76	500
"N20"	"J10"	"Calculus of kidney and ureter"	"Influenza due to other identified influenza virus"	1	84	0	84
"N20"	"J18"	"Calculus of kidney and ureter"	"Pneumonia, unspecified organism"	1	3901	1464	5365
"N20"	"J22"	"Calculus of kidney and ureter"	"Unspecified acute lower respiratory infection"	1	195	28	223
"N20"	"J44"	"Calculus of kidney and ureter"	"Other chronic obstructive pulmonary disease"	1	1815	700	2515
"N20"	"J47"	"Calculus of kidney and ureter"	"Bronchiectasis"	1	115	15	130
"N20"	"J90"	"Calculus of kidney and ureter"	"Pleural effusion, not elsewhere classified"	1	382	68	450
"N20"	"J91"	"Calculus of kidney and ureter"	"Pleural effusion in conditions classified elsewhere"	1	125	26	151
"N20"	"J96"	"Calculus of kidney and ureter"	"Respiratory failure, not elsewhere classified"	1	1430	136	1566
"N20"	"J98"	"Calculus of kidney and ureter"	"Other respiratory disorders"	1	244	131	375
"N20"	"K22"	"Calculus of kidney and ureter"	"Other diseases of esophagus"	1	346	181	527
"N20"	"K25"	"Calculus of kidney and ureter"	"Gastric ulcer"	1	769	487	1256
"N20"	"K42"	"Calculus of kidney and ureter"	"Umbilical hernia"	1	477	312	789
"N20"	"K43"	"Calculus of kidney and ureter"	"Ventral hernia"	1	632	351	983
"N20"	"K55"	"Calculus of kidney and ureter"	"Vascular disorders of intestine"	1	166	29	195
"N20"	"K59"	"Calculus of kidney and ureter"	"Other functional intestinal disorders"	1	2796	1303	4099
"N20"	"K62"	"Calculus of kidney and ureter"	"Other diseases of anus and rectum"	1	1243	614	1857
"N20"	"K63"	"Calculus of kidney and ureter"	"Other diseases of intestine"	1	331	113	444
"N20"	"K74"	"Calculus of kidney and ureter"	"Fibrosis and cirrhosis of liver"	1	175	48	223
"N20"	"K92"	"Calculus of kidney and ureter"	"Other diseases of digestive system"	1	933	395	1328
"N20"	"L08"	"Calculus of kidney and ureter"	"Other local infections of skin and subcutaneous tissue"	1	532	356	888
"N20"	"L30"	"Calculus of kidney and ureter"	"Other and unspecified dermatitis"	1	370	187	557
"N20"	"L57"	"Calculus of kidney and ureter"	"Skin changes due to chronic expsr to nonionizing radiation"	1	204	18	222
"N20"	"L89"	"Calculus of kidney and ureter"	"Pressure ulcer"	1	294	98	392
"N20"	"L98"	"Calculus of kidney and ureter"	"Oth disorders of skin, subcu, not elsewhere classified"	1	329	135	464
"N20"	"M16"	"Calculus of kidney and ureter"	"Osteoarthritis of hip"	1	1074	531	1605
"N20"	"M19"	"Calculus of kidney and ureter"	"Other and unspecified osteoarthritis"	1	1185	433	1618
"N20"	"M48"	"Calculus of kidney and ureter"	"Other spondylopathies"	1	1043	332	1375
"N20"	"M75"	"Calculus of kidney and ureter"	"Shoulder lesions"	1	1907	1237	3144
"N20"	"M80"	"Calculus of kidney and ureter"	"Osteoporosis with current pathological fracture"	1	611	102	713
"N20"	"M99"	"Calculus of kidney and ureter"	"Biomechanical lesions, not elsewhere classified"	1	201	100	301
"N20"	"N23"	"Calculus of kidney and ureter"	"Unspecified renal colic"	1	425	284	709
"N20"	"N26"	"Calculus of kidney and ureter"	"Unspecified contracted kidney"	1	167	71	238
"N20"	"N28"	"Calculus of kidney and ureter"	"Oth disorders of kidney and ureter, not elsewhere classified"	1	938	449	1387
"N20"	"N39"	"Calculus of kidney and ureter"	"Other disorders of urinary system"	1	3678	2042	5720
"N20"	"O72"	"Calculus of kidney and ureter"	"Postpartum hemorrhage"	1	1247	761	2008
"N21"	"A41"	"Calculus of lower urinary tract"	"Other sepsis"	1	853	454	1307
"N21"	"C34"	"Calculus of lower urinary tract"	"Malignant neoplasm of bronchus and lung"	1	171	19	190
"N21"	"C77"	"Calculus of lower urinary tract"	"Secondary and unspecified malignant neoplasm of lymph nodes"	1	69	17	86
"N21"	"C78"	"Calculus of lower urinary tract"	"Secondary malignant neoplasm of resp and digestive organs"	1	196	19	215
"N21"	"C79"	"Calculus of lower urinary tract"	"Secondary malignant neoplasm of other and unspecified sites"	1	198	28	226
"N21"	"D12"	"Calculus of lower urinary tract"	"Benign neoplasm of colon, rectum, anus and anal canal"	1	228	129	357
"N21"	"D50"	"Calculus of lower urinary tract"	"Iron deficiency anemia"	1	133	37	170
"N21"	"E16"	"Calculus of lower urinary tract"	"Other disorders of pancreatic internal secretion"	1	53	13	66
"N21"	"E86"	"Calculus of lower urinary tract"	"Volume depletion"	1	557	144	701
"N21"	"F41"	"Calculus of lower urinary tract"	"Other anxiety disorders"	1	97	8	105
"N21"	"I48"	"Calculus of lower urinary tract"	"Atrial fibrillation and flutter"	1	599	338	937
"N21"	"I73"	"Calculus of lower urinary tract"	"Other peripheral vascular diseases"	1	117	47	164
"N21"	"J18"	"Calculus of lower urinary tract"	"Pneumonia, unspecified organism"	1	921	403	1324
"N21"	"M10"	"Calculus of lower urinary tract"	"Gout"	1	102	37	139
"N21"	"M85"	"Calculus of lower urinary tract"	"Other disorders of bone density and structure"	1	73	14	87
"N21"	"N18"	"Calculus of lower urinary tract"	"Chronic kidney disease (CKD)"	1	341	58	399
"N25"	"A49"	"Disorders resulting from impaired renal tubular function"	"Bacterial infection of unspecified site"	1	133	40	173
"N25"	"L57"	"Disorders resulting from impaired renal tubular function"	"Skin changes due to chronic expsr to nonionizing radiation"	1	39	4	43
"N28"	"C78"	"Oth disorders of kidney and ureter, not elsewhere classified"	"Secondary malignant neoplasm of resp and digestive organs"	1	217	93	310
"N28"	"C79"	"Oth disorders of kidney and ureter, not elsewhere classified"	"Secondary malignant neoplasm of other and unspecified sites"	1	178	66	244
"N30"	"A04"	"Cystitis"	"Other bacterial intestinal infections"	1	3072	1908	4980
"N30"	"A41"	"Cystitis"	"Other sepsis"	1	17919	13958	31877
"N30"	"A54"	"Cystitis"	"Gonococcal infection"	1	160	42	202
"N30"	"C25"	"Cystitis"	"Malignant neoplasm of pancreas"	1	799	311	1110
"N30"	"C79"	"Cystitis"	"Secondary malignant neoplasm of other and unspecified sites"	1	2488	1737	4225
"N30"	"C80"	"Cystitis"	"Malignant neoplasm without specification of site"	1	474	209	683
"N30"	"E41"	"Cystitis"	"Nutritional marasmus"	1	655	275	930
"N30"	"E46"	"Cystitis"	"Unspecified protein-calorie malnutrition"	1	300	186	486
"N30"	"G30"	"Cystitis"	"Alzheimer's disease"	1	1882	1179	3061
"N30"	"G47"	"Cystitis"	"Sleep disorders"	1	2448	1159	3607
"N30"	"J06"	"Cystitis"	"Acute upper resp infections of multiple and unsp sites"	1	1237	753	1990
"N30"	"J09"	"Cystitis"	"Influenza due to certain identified influenza viruses"	1	438	113	551
"N30"	"J15"	"Cystitis"	"Bacterial pneumonia, not elsewhere classified"	1	10929	7653	18582
"N30"	"J22"	"Cystitis"	"Unspecified acute lower respiratory infection"	1	1509	1093	2602
"N30"	"J69"	"Cystitis"	"Pneumonitis due to solids and liquids"	1	2304	660	2964
"N30"	"J91"	"Cystitis"	"Pleural effusion in conditions classified elsewhere"	1	662	448	1110
"N30"	"K72"	"Cystitis"	"Hepatic failure, not elsewhere classified"	1	696	512	1208
"N30"	"N17"	"Cystitis"	"Acute kidney failure"	1	2699	2218	4917
"N30"	"N18"	"Cystitis"	"Chronic kidney disease (CKD)"	1	6188	4832	11020
"N30"	"N93"	"Cystitis"	"Other abnormal uterine and vaginal bleeding"	1	729	525	1254
"N30"	"O13"	"Cystitis"	"Gestational hypertension without significant proteinuria"	1	276	162	438
"N30"	"O23"	"Cystitis"	"Infections of genitourinary tract in pregnancy"	1	1712	1093	2805
"N30"	"O24"	"Cystitis"	"Diabetes in pregnancy, childbirth, and the puerperium"	1	523	307	830
"N30"	"O36"	"Cystitis"	"Maternal care for other fetal problems"	1	1141	779	1920
"N30"	"O42"	"Cystitis"	"Premature rupture of membranes"	1	1043	784	1827
"N30"	"O72"	"Cystitis"	"Postpartum hemorrhage"	1	7663	0	7663
"N30"	"O90"	"Cystitis"	"Complications of the puerperium, not elsewhere classified"	1	479	238	717
"N31"	"A41"	"Neuromuscular dysfunction of bladder, NEC"	"Other sepsis"	1	1193	329	1522
"N31"	"A46"	"Neuromuscular dysfunction of bladder, NEC"	"Erysipelas"	1	309	143	452
"N31"	"A49"	"Neuromuscular dysfunction of bladder, NEC"	"Bacterial infection of unspecified site"	1	399	58	457
"N31"	"B37"	"Neuromuscular dysfunction of bladder, NEC"	"Candidiasis"	1	132	49	181
"N31"	"C15"	"Neuromuscular dysfunction of bladder, NEC"	"Malignant neoplasm of esophagus"	1	42	2	44
"N31"	"C16"	"Neuromuscular dysfunction of bladder, NEC"	"Malignant neoplasm of stomach"	1	45	2	47
"N31"	"C25"	"Neuromuscular dysfunction of bladder, NEC"	"Malignant neoplasm of pancreas"	1	48	4	52
"N31"	"C34"	"Neuromuscular dysfunction of bladder, NEC"	"Malignant neoplasm of bronchus and lung"	1	243	12	255
"N31"	"C79"	"Neuromuscular dysfunction of bladder, NEC"	"Secondary malignant neoplasm of other and unspecified sites"	1	149	16	165
"N31"	"F01"	"Neuromuscular dysfunction of bladder, NEC"	"Vascular dementia"	1	138	23	161
"N31"	"F32"	"Neuromuscular dysfunction of bladder, NEC"	"Depressive episode"	1	299	184	483
"N31"	"F41"	"Neuromuscular dysfunction of bladder, NEC"	"Other anxiety disorders"	1	120	31	151
"N31"	"G47"	"Neuromuscular dysfunction of bladder, NEC"	"Sleep disorders"	1	358	89	447
"N31"	"I48"	"Neuromuscular dysfunction of bladder, NEC"	"Atrial fibrillation and flutter"	1	616	357	973
"N31"	"I50"	"Neuromuscular dysfunction of bladder, NEC"	"Heart failure"	1	704	346	1050
"N31"	"I73"	"Neuromuscular dysfunction of bladder, NEC"	"Other peripheral vascular diseases"	1	179	92	271
"N31"	"J18"	"Neuromuscular dysfunction of bladder, NEC"	"Pneumonia, unspecified organism"	1	1762	652	2414
"N31"	"J22"	"Neuromuscular dysfunction of bladder, NEC"	"Unspecified acute lower respiratory infection"	1	136	5	141
"N31"	"J69"	"Neuromuscular dysfunction of bladder, NEC"	"Pneumonitis due to solids and liquids"	1	184	5	189
"N31"	"K43"	"Neuromuscular dysfunction of bladder, NEC"	"Ventral hernia"	1	215	108	323
"N31"	"K59"	"Neuromuscular dysfunction of bladder, NEC"	"Other functional intestinal disorders"	1	1318	626	1944
"N31"	"L89"	"Neuromuscular dysfunction of bladder, NEC"	"Pressure ulcer"	1	482	178	660
"N31"	"N18"	"Neuromuscular dysfunction of bladder, NEC"	"Chronic kidney disease (CKD)"	1	465	146	611
"N31"	"N21"	"Neuromuscular dysfunction of bladder, NEC"	"Calculus of lower urinary tract"	1	248	126	374
"N31"	"N28"	"Neuromuscular dysfunction of bladder, NEC"	"Oth disorders of kidney and ureter, not elsewhere classified"	1	147	62	209
"N31"	"O72"	"Neuromuscular dysfunction of bladder, NEC"	"Postpartum hemorrhage"	1	107	32	139
"N32"	"C25"	"Other disorders of bladder"	"Malignant neoplasm of pancreas"	1	46	7	53
"N32"	"I35"	"Other disorders of bladder"	"Nonrheumatic aortic valve disorders"	1	194	83	277
"N32"	"J18"	"Other disorders of bladder"	"Pneumonia, unspecified organism"	1	950	568	1518
"N32"	"J90"	"Other disorders of bladder"	"Pleural effusion, not elsewhere classified"	1	80	25	105
"N32"	"K59"	"Other disorders of bladder"	"Other functional intestinal disorders"	1	764	490	1254
"N35"	"A46"	"Urethral stricture"	"Erysipelas"	1	167	81	248
"N35"	"C22"	"Urethral stricture"	"Malignant neoplasm of liver and intrahepatic bile ducts"	1	31	0	31
"N35"	"C77"	"Urethral stricture"	"Secondary and unspecified malignant neoplasm of lymph nodes"	1	81	21	102
"N35"	"C78"	"Urethral stricture"	"Secondary malignant neoplasm of resp and digestive organs"	1	249	21	270
"N35"	"E86"	"Urethral stricture"	"Volume depletion"	1	649	83	732
"N35"	"I26"	"Urethral stricture"	"Pulmonary embolism"	1	137	39	176
"N35"	"I46"	"Urethral stricture"	"Cardiac arrest"	1	159	4	163
"N35"	"I63"	"Urethral stricture"	"Cerebral infarction"	1	337	141	478
"N35"	"I69"	"Urethral stricture"	"Sequelae of cerebrovascular disease"	1	382	179	561
"N35"	"I71"	"Urethral stricture"	"Aortic aneurysm and dissection"	1	139	63	202
"N35"	"J15"	"Urethral stricture"	"Bacterial pneumonia, not elsewhere classified"	1	397	57	454
"N35"	"J18"	"Urethral stricture"	"Pneumonia, unspecified organism"	1	1133	369	1502
"N35"	"J44"	"Urethral stricture"	"Other chronic obstructive pulmonary disease"	1	543	279	822
"N35"	"J96"	"Urethral stricture"	"Respiratory failure, not elsewhere classified"	1	366	26	392
"N35"	"K92"	"Urethral stricture"	"Other diseases of digestive system"	1	261	96	357
"N35"	"L97"	"Urethral stricture"	"Non-pressure chronic ulcer of lower limb, NEC"	1	119	30	149
"N35"	"M81"	"Urethral stricture"	"Osteoporosis without current pathological fracture"	1	174	39	213
"N36"	"C34"	"Other disorders of urethra"	"Malignant neoplasm of bronchus and lung"	1	40	4	44
"N39"	"A49"	"Other disorders of urinary system"	"Bacterial infection of unspecified site"	1	5016	3672	8688
"N39"	"C15"	"Other disorders of urinary system"	"Malignant neoplasm of esophagus"	1	221	117	338
"N39"	"C22"	"Other disorders of urinary system"	"Malignant neoplasm of liver and intrahepatic bile ducts"	1	258	121	379
"N39"	"C80"	"Other disorders of urinary system"	"Malignant neoplasm without specification of site"	1	323	165	488
"N39"	"D63"	"Other disorders of urinary system"	"Anemia in chronic diseases classified elsewhere"	1	1903	1556	3459
"N39"	"J15"	"Other disorders of urinary system"	"Bacterial pneumonia, not elsewhere classified"	1	8300	7353	15653
"N39"	"J69"	"Other disorders of urinary system"	"Pneumonitis due to solids and liquids"	1	1963	766	2729
"N39"	"L89"	"Other disorders of urinary system"	"Pressure ulcer"	1	2547	1806	4353
"N40"	"A04"	"Benign prostatic hyperplasia"	"Other bacterial intestinal infections"	1	813	53	866
"N40"	"A40"	"Benign prostatic hyperplasia"	"Streptococcal sepsis"	1	367	88	455
"N40"	"C06"	"Benign prostatic hyperplasia"	"Malignant neoplasm of other and unspecified parts of mouth"	1	99	37	136
"N40"	"C16"	"Benign prostatic hyperplasia"	"Malignant neoplasm of stomach"	1	578	76	654
"N40"	"C17"	"Benign prostatic hyperplasia"	"Malignant neoplasm of small intestine"	1	83	20	103
"N40"	"C24"	"Benign prostatic hyperplasia"	"Malignant neoplasm of other and unsp parts of biliary tract"	1	151	13	164
"N40"	"C34"	"Benign prostatic hyperplasia"	"Malignant neoplasm of bronchus and lung"	1	3294	0	3294
"N40"	"C38"	"Benign prostatic hyperplasia"	"Malignant neoplasm of heart, mediastinum and pleura"	1	78	11	89
"N40"	"C41"	"Benign prostatic hyperplasia"	"Malignant neoplasm of bone/artic cartl of and unsp sites"	1	147	19	166
"N40"	"C43"	"Benign prostatic hyperplasia"	"Malignant melanoma of skin"	1	548	228	776
"N40"	"C45"	"Benign prostatic hyperplasia"	"Mesothelioma"	1	157	1	158
"N40"	"C71"	"Benign prostatic hyperplasia"	"Malignant neoplasm of brain"	1	361	35	396
"N40"	"C76"	"Benign prostatic hyperplasia"	"Malignant neoplasm of other and ill-defined sites"	1	238	53	291
"N40"	"C77"	"Benign prostatic hyperplasia"	"Secondary and unspecified malignant neoplasm of lymph nodes"	1	845	96	941
"N40"	"C80"	"Benign prostatic hyperplasia"	"Malignant neoplasm without specification of site"	1	325	11	336
"N40"	"C90"	"Benign prostatic hyperplasia"	"Multiple myeloma and malignant plasma cell neoplasms"	1	388	67	455
"N40"	"C91"	"Benign prostatic hyperplasia"	"Lymphoid leukemia"	1	408	149	557
"N40"	"D07"	"Benign prostatic hyperplasia"	"Carcinoma in situ of other and unspecified genital organs"	1	163	50	213
"N40"	"D46"	"Benign prostatic hyperplasia"	"Myelodysplastic syndromes"	1	358	34	392
"N40"	"D50"	"Benign prostatic hyperplasia"	"Iron deficiency anemia"	1	1809	400	2209
"N40"	"D59"	"Benign prostatic hyperplasia"	"Acquired hemolytic anemia"	1	95	30	125
"N40"	"D61"	"Benign prostatic hyperplasia"	"Oth aplastic anemias and other bone marrow failure syndromes"	1	186	28	214
"N40"	"D65"	"Benign prostatic hyperplasia"	"Disseminated intravascular coagulation"	1	53	6	59
"N40"	"E10"	"Benign prostatic hyperplasia"	"Type 1 diabetes mellitus"	1	2101	1567	3668
"N40"	"E13"	"Benign prostatic hyperplasia"	"Other specified diabetes mellitus"	1	254	61	315
"N40"	"E16"	"Benign prostatic hyperplasia"	"Other disorders of pancreatic internal secretion"	1	763	261	1024
"N40"	"E34"	"Benign prostatic hyperplasia"	"Other endocrine disorders"	1	124	16	140
"N40"	"E85"	"Benign prostatic hyperplasia"	"Amyloidosis"	1	65	13	78
"N40"	"F03"	"Benign prostatic hyperplasia"	"Unspecified dementia"	1	4905	0	4905
"N40"	"F33"	"Benign prostatic hyperplasia"	"Major depressive disorder, recurrent"	1	983	219	1202
"N40"	"F34"	"Benign prostatic hyperplasia"	"Persistent mood [affective] disorders"	1	181	53	234
"N40"	"G12"	"Benign prostatic hyperplasia"	"Spinal muscular atrophy and related syndromes"	1	103	24	127
"N40"	"G20"	"Benign prostatic hyperplasia"	"Parkinson's disease"	1	1663	511	2174
"N40"	"G21"	"Benign prostatic hyperplasia"	"Secondary parkinsonism"	1	375	65	440
"N40"	"G40"	"Benign prostatic hyperplasia"	"Epilepsy and recurrent seizures"	1	1216	787	2003
"N40"	"G47"	"Benign prostatic hyperplasia"	"Sleep disorders"	1	1730	539	2269
"N40"	"G62"	"Benign prostatic hyperplasia"	"Other and unspecified polyneuropathies"	1	1144	461	1605
"N40"	"G63"	"Benign prostatic hyperplasia"	"Polyneuropathy in diseases classified elsewhere"	1	231	71	302
"N40"	"G82"	"Benign prostatic hyperplasia"	"Paraplegia (paraparesis) and quadriplegia (quadriparesis)"	1	245	104	349
"N40"	"G95"	"Benign prostatic hyperplasia"	"Other and unspecified diseases of spinal cord"	1	734	59	793
"N40"	"G96"	"Benign prostatic hyperplasia"	"Other disorders of central nervous system"	1	818	64	882
"N40"	"H18"	"Benign prostatic hyperplasia"	"Other disorders of cornea"	1	328	117	445
"N40"	"H25"	"Benign prostatic hyperplasia"	"Age-related cataract"	1	13934	0	13934
"N40"	"H26"	"Benign prostatic hyperplasia"	"Other cataract"	1	2140	881	3021
"N40"	"H40"	"Benign prostatic hyperplasia"	"Glaucoma"	1	1002	729	1731
"N40"	"I21"	"Benign prostatic hyperplasia"	"Acute myocardial infarction"	1	5052	3445	8497
"N40"	"I31"	"Benign prostatic hyperplasia"	"Other diseases of pericardium"	1	156	49	205
"N40"	"I34"	"Benign prostatic hyperplasia"	"Nonrheumatic mitral valve disorders"	1	896	383	1279
"N40"	"I35"	"Benign prostatic hyperplasia"	"Nonrheumatic aortic valve disorders"	1	3902	0	3902
"N40"	"I42"	"Benign prostatic hyperplasia"	"Cardiomyopathy"	1	766	286	1052
"N40"	"I44"	"Benign prostatic hyperplasia"	"Atrioventricular and left bundle-branch block"	1	1964	480	2444
"N40"	"I50"	"Benign prostatic hyperplasia"	"Heart failure"	1	14118	0	14118
"N40"	"I60"	"Benign prostatic hyperplasia"	"Nontraumatic subarachnoid hemorrhage"	1	189	93	282
"N40"	"I63"	"Benign prostatic hyperplasia"	"Cerebral infarction"	1	4654	1986	6640
"N40"	"I70"	"Benign prostatic hyperplasia"	"Atherosclerosis"	1	3033	2107	5140
"N40"	"I71"	"Benign prostatic hyperplasia"	"Aortic aneurysm and dissection"	1	2477	562	3039
"N40"	"I72"	"Benign prostatic hyperplasia"	"Other aneurysm"	1	427	126	553
"N40"	"I73"	"Benign prostatic hyperplasia"	"Other peripheral vascular diseases"	1	1952	679	2631
"N40"	"I74"	"Benign prostatic hyperplasia"	"Arterial embolism and thrombosis"	1	453	193	646
"N40"	"I80"	"Benign prostatic hyperplasia"	"Phlebitis and thrombophlebitis"	1	1874	1176	3050
"N40"	"I82"	"Benign prostatic hyperplasia"	"Other venous embolism and thrombosis"	1	393	97	490
"N40"	"I87"	"Benign prostatic hyperplasia"	"Other disorders of veins"	1	274	112	386
"N40"	"I89"	"Benign prostatic hyperplasia"	"Oth noninfective disorders of lymphatic vessels and nodes"	1	212	46	258
"N40"	"I97"	"Benign prostatic hyperplasia"	"Intraop and postproc comp and disorders of circ sys, NEC"	1	94	14	108
"N40"	"J10"	"Benign prostatic hyperplasia"	"Influenza due to other identified influenza virus"	1	89	0	89
"N40"	"J14"	"Benign prostatic hyperplasia"	"Pneumonia due to Hemophilus influenzae"	1	153	45	198
"N40"	"J17"	"Benign prostatic hyperplasia"	"Pneumonia in diseases classified elsewhere"	1	94	16	110
"N40"	"J22"	"Benign prostatic hyperplasia"	"Unspecified acute lower respiratory infection"	1	670	36	706
"N40"	"J47"	"Benign prostatic hyperplasia"	"Bronchiectasis"	1	200	36	236
"N40"	"J81"	"Benign prostatic hyperplasia"	"Pulmonary edema"	1	1447	223	1670
"N40"	"J85"	"Benign prostatic hyperplasia"	"Abscess of lung and mediastinum"	1	137	32	169
"N40"	"J91"	"Benign prostatic hyperplasia"	"Pleural effusion in conditions classified elsewhere"	1	484	40	524
"N40"	"J92"	"Benign prostatic hyperplasia"	"Pleural plaque"	1	250	123	373
"N40"	"J94"	"Benign prostatic hyperplasia"	"Other pleural conditions"	1	449	102	551
"N40"	"J95"	"Benign prostatic hyperplasia"	"Intraop and postproc comp and disorders of resp sys, NEC"	1	222	25	247
"N40"	"K02"	"Benign prostatic hyperplasia"	"Dental caries"	1	315	144	459
"N40"	"K08"	"Benign prostatic hyperplasia"	"Other disorders of teeth and supporting structures"	1	370	174	544
"N40"	"K22"	"Benign prostatic hyperplasia"	"Other diseases of esophagus"	1	983	446	1429
"N40"	"K25"	"Benign prostatic hyperplasia"	"Gastric ulcer"	1	2088	1390	3478
"N40"	"K27"	"Benign prostatic hyperplasia"	"Peptic ulcer, site unspecified"	1	513	282	795
"N40"	"K56"	"Benign prostatic hyperplasia"	"Paralytic ileus and intestinal obstruction without hernia"	1	1997	499	2496
"N40"	"K62"	"Benign prostatic hyperplasia"	"Other diseases of anus and rectum"	1	2662	1466	4128
"N40"	"K65"	"Benign prostatic hyperplasia"	"Peritonitis"	1	711	172	883
"N40"	"K74"	"Benign prostatic hyperplasia"	"Fibrosis and cirrhosis of liver"	1	259	77	336
"N40"	"K76"	"Benign prostatic hyperplasia"	"Other diseases of liver"	1	401	190	591
"N40"	"K91"	"Benign prostatic hyperplasia"	"Intraop and postproc comp and disorders of dgstv sys, NEC"	1	305	117	422
"N40"	"L08"	"Benign prostatic hyperplasia"	"Other local infections of skin and subcutaneous tissue"	1	662	341	1003
"N40"	"L89"	"Benign prostatic hyperplasia"	"Pressure ulcer"	1	1129	76	1205
"N40"	"M00"	"Benign prostatic hyperplasia"	"Pyogenic arthritis"	1	268	113	381
"N40"	"M10"	"Benign prostatic hyperplasia"	"Gout"	1	1440	727	2167
"N40"	"M13"	"Benign prostatic hyperplasia"	"Other arthritis"	1	563	246	809
"N40"	"M75"	"Benign prostatic hyperplasia"	"Shoulder lesions"	1	2032	1716	3748
"N40"	"M79"	"Benign prostatic hyperplasia"	"Oth and unsp soft tissue disorders, not elsewhere classified"	1	2309	1417	3726
"N40"	"M86"	"Benign prostatic hyperplasia"	"Osteomyelitis"	1	244	104	348
"N40"	"N02"	"Benign prostatic hyperplasia"	"Recurrent and persistent hematuria"	1	544	291	835
"N40"	"N08"	"Benign prostatic hyperplasia"	"Glomerular disorders in diseases classified elsewhere"	1	94	18	112
"N40"	"N13"	"Benign prostatic hyperplasia"	"Obstructive and reflux uropathy"	1	2728	1404	4132
"N40"	"N17"	"Benign prostatic hyperplasia"	"Acute kidney failure"	1	1682	396	2078
"N40"	"N18"	"Benign prostatic hyperplasia"	"Chronic kidney disease (CKD)"	1	5843	0	5843
"N40"	"N28"	"Benign prostatic hyperplasia"	"Oth disorders of kidney and ureter, not elsewhere classified"	1	1008	263	1271
"N40"	"N31"	"Benign prostatic hyperplasia"	"Neuromuscular dysfunction of bladder, NEC"	1	1985	1391	3376
"N40"	"N32"	"Benign prostatic hyperplasia"	"Other disorders of bladder"	1	2113	1153	3266
"N40"	"N36"	"Benign prostatic hyperplasia"	"Other disorders of urethra"	1	206	72	278
"N40"	"N42"	"Benign prostatic hyperplasia"	"Other and unspecified disorders of prostate"	1	305	131	436
"N40"	"N45"	"Benign prostatic hyperplasia"	"Orchitis and epididymitis"	1	2790	1426	4216
"N40"	"N49"	"Benign prostatic hyperplasia"	"Inflammatory disorders of male genital organs, NEC"	1	451	156	607
"N40"	"N99"	"Benign prostatic hyperplasia"	"Intraop and postproc comp and disorders of GU sys, NEC"	1	2826	746	3572
"N41"	"C34"	"Inflammatory diseases of prostate"	"Malignant neoplasm of bronchus and lung"	1	82	2	84
"N41"	"C61"	"Inflammatory diseases of prostate"	"Malignant neoplasm of prostate"	1	476	154	630
"N41"	"D64"	"Inflammatory diseases of prostate"	"Other anemias"	1	150	38	188
"N41"	"I35"	"Inflammatory diseases of prostate"	"Nonrheumatic aortic valve disorders"	1	90	15	105
"N41"	"I48"	"Inflammatory diseases of prostate"	"Atrial fibrillation and flutter"	1	237	116	353
"N41"	"I50"	"Inflammatory diseases of prostate"	"Heart failure"	1	174	79	253
"N41"	"J18"	"Inflammatory diseases of prostate"	"Pneumonia, unspecified organism"	1	301	132	433
"N41"	"J96"	"Inflammatory diseases of prostate"	"Respiratory failure, not elsewhere classified"	1	119	12	131
"N41"	"K57"	"Inflammatory diseases of prostate"	"Diverticular disease of intestine"	1	225	79	304
"N43"	"A41"	"Hydrocele and spermatocele"	"Other sepsis"	1	830	73	903
"N43"	"C15"	"Hydrocele and spermatocele"	"Malignant neoplasm of esophagus"	1	91	0	91
"N43"	"C16"	"Hydrocele and spermatocele"	"Malignant neoplasm of stomach"	1	97	1	98
"N43"	"C18"	"Hydrocele and spermatocele"	"Malignant neoplasm of colon"	1	251	74	325
"N43"	"C22"	"Hydrocele and spermatocele"	"Malignant neoplasm of liver and intrahepatic bile ducts"	1	58	0	58
"N43"	"C34"	"Hydrocele and spermatocele"	"Malignant neoplasm of bronchus and lung"	1	454	0	454
"N43"	"C43"	"Hydrocele and spermatocele"	"Malignant melanoma of skin"	1	95	28	123
"N43"	"C44"	"Hydrocele and spermatocele"	"Other and unspecified malignant neoplasm of skin"	1	416	58	474
"N43"	"C61"	"Hydrocele and spermatocele"	"Malignant neoplasm of prostate"	1	787	120	907
"N43"	"C80"	"Hydrocele and spermatocele"	"Malignant neoplasm without specification of site"	1	47	2	49
"N43"	"C83"	"Hydrocele and spermatocele"	"Non-follicular lymphoma"	1	80	7	87
"N43"	"C90"	"Hydrocele and spermatocele"	"Multiple myeloma and malignant plasma cell neoplasms"	1	53	0	53
"N43"	"D12"	"Hydrocele and spermatocele"	"Benign neoplasm of colon, rectum, anus and anal canal"	1	934	180	1114
"N43"	"D35"	"Hydrocele and spermatocele"	"Benign neoplasm of other and unspecified endocrine glands"	1	57	3	60
"N43"	"D47"	"Hydrocele and spermatocele"	"Oth neoplm of uncrt behav of lymphoid, hematpoetc & rel tiss"	1	72	0	72
"N43"	"D62"	"Hydrocele and spermatocele"	"Acute posthemorrhagic anemia"	1	104	22	126
"N43"	"E10"	"Hydrocele and spermatocele"	"Type 1 diabetes mellitus"	1	263	136	399
"N43"	"E11"	"Hydrocele and spermatocele"	"Type 2 diabetes mellitus"	1	727	320	1047
"N43"	"E21"	"Hydrocele and spermatocele"	"Hyperparathyroidism and other disorders of parathyroid gland"	1	45	8	53
"N43"	"E27"	"Hydrocele and spermatocele"	"Other disorders of adrenal gland"	1	44	4	48
"N43"	"E78"	"Hydrocele and spermatocele"	"Disorders of lipoprotein metabolism and other lipidemias"	1	902	340	1242
"N43"	"E83"	"Hydrocele and spermatocele"	"Disorders of mineral metabolism"	1	84	10	94
"N43"	"F05"	"Hydrocele and spermatocele"	"Delirium due to known physiological condition"	1	147	0	147
"N43"	"F06"	"Hydrocele and spermatocele"	"Other mental disorders due to known physiological condition"	1	39	3	42
"N43"	"F32"	"Hydrocele and spermatocele"	"Depressive episode"	1	230	45	275
"N43"	"F41"	"Hydrocele and spermatocele"	"Other anxiety disorders"	1	134	7	141
"N43"	"F90"	"Hydrocele and spermatocele"	"Attention-deficit hyperactivity disorders"	1	29	0	29
"N43"	"G31"	"Hydrocele and spermatocele"	"Oth degenerative diseases of nervous system, NEC"	1	60	2	62
"N43"	"G45"	"Hydrocele and spermatocele"	"Transient cerebral ischemic attacks and related syndromes"	1	426	193	619
"N43"	"G93"	"Hydrocele and spermatocele"	"Other disorders of brain"	1	49	9	58
"N43"	"H26"	"Hydrocele and spermatocele"	"Other cataract"	1	336	97	433
"N43"	"H35"	"Hydrocele and spermatocele"	"Other retinal disorders"	1	442	115	557
"N43"	"H43"	"Hydrocele and spermatocele"	"Disorders of vitreous body"	1	140	45	185
"N43"	"H90"	"Hydrocele and spermatocele"	"Conductive and sensorineural hearing loss"	1	305	169	474
"N43"	"H91"	"Hydrocele and spermatocele"	"Other and unspecified hearing loss"	1	1153	659	1812
"N43"	"I10"	"Hydrocele and spermatocele"	"Essential (primary) hypertension"	1	2247	962	3209
"N43"	"I11"	"Hydrocele and spermatocele"	"Hypertensive heart disease"	1	112	24	136
"N43"	"I21"	"Hydrocele and spermatocele"	"Acute myocardial infarction"	1	678	353	1031
"N43"	"I25"	"Hydrocele and spermatocele"	"Chronic ischemic heart disease"	1	1111	611	1722
"N43"	"I27"	"Hydrocele and spermatocele"	"Other pulmonary heart diseases"	1	75	16	91
"N43"	"I45"	"Hydrocele and spermatocele"	"Other conduction disorders"	1	89	33	122
"N43"	"I48"	"Hydrocele and spermatocele"	"Atrial fibrillation and flutter"	1	1603	390	1993
"N43"	"I49"	"Hydrocele and spermatocele"	"Other cardiac arrhythmias"	1	325	111	436
"N43"	"I61"	"Hydrocele and spermatocele"	"Nontraumatic intracerebral hemorrhage"	1	153	21	174
"N43"	"I63"	"Hydrocele and spermatocele"	"Cerebral infarction"	1	619	127	746
"N43"	"I80"	"Hydrocele and spermatocele"	"Phlebitis and thrombophlebitis"	1	317	118	435
"N43"	"I95"	"Hydrocele and spermatocele"	"Hypotension"	1	203	7	210
"N43"	"J06"	"Hydrocele and spermatocele"	"Acute upper resp infections of multiple and unsp sites"	1	199	93	292
"N43"	"J18"	"Hydrocele and spermatocele"	"Pneumonia, unspecified organism"	1	1875	414	2289
"N43"	"J22"	"Hydrocele and spermatocele"	"Unspecified acute lower respiratory infection"	1	92	1	93
"N43"	"J69"	"Hydrocele and spermatocele"	"Pneumonitis due to solids and liquids"	1	87	1	88
"N43"	"J81"	"Hydrocele and spermatocele"	"Pulmonary edema"	1	127	8	135
"N43"	"J91"	"Hydrocele and spermatocele"	"Pleural effusion in conditions classified elsewhere"	1	62	5	67
"N43"	"J93"	"Hydrocele and spermatocele"	"Pneumothorax and air leak"	1	93	28	121
"N43"	"J94"	"Hydrocele and spermatocele"	"Other pleural conditions"	1	62	9	71
"N43"	"J96"	"Hydrocele and spermatocele"	"Respiratory failure, not elsewhere classified"	1	601	10	611
"N43"	"J98"	"Hydrocele and spermatocele"	"Other respiratory disorders"	1	121	43	164
"N43"	"K04"	"Hydrocele and spermatocele"	"Diseases of pulp and periapical tissues"	1	115	44	159
"N43"	"K05"	"Hydrocele and spermatocele"	"Gingivitis and periodontal diseases"	1	102	38	140
"N43"	"K22"	"Hydrocele and spermatocele"	"Other diseases of esophagus"	1	188	58	246
"N43"	"K25"	"Hydrocele and spermatocele"	"Gastric ulcer"	1	246	135	381
"N43"	"K43"	"Hydrocele and spermatocele"	"Ventral hernia"	1	248	134	382
"N43"	"K56"	"Hydrocele and spermatocele"	"Paralytic ileus and intestinal obstruction without hernia"	1	255	69	324
"N43"	"K57"	"Hydrocele and spermatocele"	"Diverticular disease of intestine"	1	760	148	908
"N43"	"K59"	"Hydrocele and spermatocele"	"Other functional intestinal disorders"	1	1041	238	1279
"N43"	"K63"	"Hydrocele and spermatocele"	"Other diseases of intestine"	1	112	22	134
"N43"	"M10"	"Hydrocele and spermatocele"	"Gout"	1	239	72	311
"N43"	"M17"	"Hydrocele and spermatocele"	"Osteoarthritis of knee"	1	714	419	1133
"N43"	"M19"	"Hydrocele and spermatocele"	"Other and unspecified osteoarthritis"	1	431	161	592
"N43"	"M35"	"Hydrocele and spermatocele"	"Other systemic involvement of connective tissue"	1	142	42	184
"N43"	"M47"	"Hydrocele and spermatocele"	"Spondylosis"	1	298	151	449
"N43"	"M48"	"Hydrocele and spermatocele"	"Other spondylopathies"	1	405	110	515
"N43"	"M72"	"Hydrocele and spermatocele"	"Fibroblastic disorders"	1	254	142	396
"N43"	"M85"	"Hydrocele and spermatocele"	"Other disorders of bone density and structure"	1	169	9	178
"N43"	"N13"	"Hydrocele and spermatocele"	"Obstructive and reflux uropathy"	1	241	107	348
"N43"	"N17"	"Hydrocele and spermatocele"	"Acute kidney failure"	1	212	10	222
"N43"	"N18"	"Hydrocele and spermatocele"	"Chronic kidney disease (CKD)"	1	454	44	498
"N43"	"N28"	"Hydrocele and spermatocele"	"Oth disorders of kidney and ureter, not elsewhere classified"	1	110	20	130
"N43"	"N39"	"Hydrocele and spermatocele"	"Other disorders of urinary system"	1	752	109	861
"N43"	"N49"	"Hydrocele and spermatocele"	"Inflammatory disorders of male genital organs, NEC"	1	570	239	809
"N44"	"E11"	"Noninflammatory disorders of testis"	"Type 2 diabetes mellitus"	1	35	0	35
"N44"	"F52"	"Noninflammatory disorders of testis"	"Sexual dysfnct not due to a substance or known physiol cond"	1	60	13	73
"N44"	"H57"	"Noninflammatory disorders of testis"	"Other disorders of eye and adnexa"	1	33	4	37
"N44"	"K21"	"Noninflammatory disorders of testis"	"Gastro-esophageal reflux disease"	1	63	15	78
"N44"	"K80"	"Noninflammatory disorders of testis"	"Cholelithiasis"	1	47	0	47
"N44"	"L02"	"Noninflammatory disorders of testis"	"Cutaneous abscess, furuncle and carbuncle"	1	97	26	123
"N44"	"L05"	"Noninflammatory disorders of testis"	"Pilonidal cyst and sinus"	1	49	6	55
"N44"	"M67"	"Noninflammatory disorders of testis"	"Other disorders of synovium and tendon"	1	80	22	102
"N45"	"A41"	"Orchitis and epididymitis"	"Other sepsis"	1	1120	600	1720
"N45"	"C22"	"Orchitis and epididymitis"	"Malignant neoplasm of liver and intrahepatic bile ducts"	1	59	0	59
"N45"	"C78"	"Orchitis and epididymitis"	"Secondary malignant neoplasm of resp and digestive organs"	1	371	25	396
"N45"	"C79"	"Orchitis and epididymitis"	"Secondary malignant neoplasm of other and unspecified sites"	1	296	20	316
"N45"	"C83"	"Orchitis and epididymitis"	"Non-follicular lymphoma"	1	68	15	83
"N45"	"D50"	"Orchitis and epididymitis"	"Iron deficiency anemia"	1	205	65	270
"N45"	"D63"	"Orchitis and epididymitis"	"Anemia in chronic diseases classified elsewhere"	1	221	44	265
"N45"	"E64"	"Orchitis and epididymitis"	"Sequelae of malnutrition and other nutritional deficiencies"	1	55	13	68
"N45"	"F32"	"Orchitis and epididymitis"	"Depressive episode"	1	216	118	334
"N45"	"G96"	"Orchitis and epididymitis"	"Other disorders of central nervous system"	1	175	22	197
"N45"	"I10"	"Orchitis and epididymitis"	"Essential (primary) hypertension"	1	1432	1109	2541
"N45"	"I35"	"Orchitis and epididymitis"	"Nonrheumatic aortic valve disorders"	1	287	77	364
"N45"	"I44"	"Orchitis and epididymitis"	"Atrioventricular and left bundle-branch block"	1	148	60	208
"N45"	"I46"	"Orchitis and epididymitis"	"Cardiac arrest"	1	255	2	257
"N45"	"I73"	"Orchitis and epididymitis"	"Other peripheral vascular diseases"	1	278	109	387
"N45"	"J91"	"Orchitis and epididymitis"	"Pleural effusion in conditions classified elsewhere"	1	55	11	66
"N45"	"J95"	"Orchitis and epididymitis"	"Intraop and postproc comp and disorders of resp sys, NEC"	1	32	2	34
"N45"	"K59"	"Orchitis and epididymitis"	"Other functional intestinal disorders"	1	936	377	1313
"N45"	"K72"	"Orchitis and epididymitis"	"Hepatic failure, not elsewhere classified"	1	88	14	102
"N45"	"K74"	"Orchitis and epididymitis"	"Fibrosis and cirrhosis of liver"	1	85	18	103
"N45"	"K92"	"Orchitis and epididymitis"	"Other diseases of digestive system"	1	365	187	552
"N45"	"L97"	"Orchitis and epididymitis"	"Non-pressure chronic ulcer of lower limb, NEC"	1	165	50	215
"N45"	"M19"	"Orchitis and epididymitis"	"Other and unspecified osteoarthritis"	1	325	155	480
"N45"	"M75"	"Orchitis and epididymitis"	"Shoulder lesions"	1	648	412	1060
"N45"	"M81"	"Orchitis and epididymitis"	"Osteoporosis without current pathological fracture"	1	292	39	331
"N45"	"N18"	"Orchitis and epididymitis"	"Chronic kidney disease (CKD)"	1	466	144	610
"N45"	"N49"	"Orchitis and epididymitis"	"Inflammatory disorders of male genital organs, NEC"	1	768	530	1298
"N45"	"N50"	"Orchitis and epididymitis"	"Other and unspecified disorders of male genital organs"	1	1606	1043	2649
"N46"	"D12"	"Male infertility"	"Benign neoplasm of colon, rectum, anus and anal canal"	1	180	0	180
"N46"	"E11"	"Male infertility"	"Type 2 diabetes mellitus"	1	286	40	326
"N46"	"E29"	"Male infertility"	"Testicular dysfunction"	1	284	122	406
"N46"	"E87"	"Male infertility"	"Other disorders of fluid, electrolyte and acid-base balance"	1	53	4	57
"N46"	"F33"	"Male infertility"	"Major depressive disorder, recurrent"	1	54	5	59
"N46"	"G47"	"Male infertility"	"Sleep disorders"	1	605	58	663
"N46"	"H93"	"Male infertility"	"Other disorders of ear, not elsewhere classified"	1	151	47	198
"N46"	"I20"	"Male infertility"	"Angina pectoris"	1	251	24	275
"N46"	"I26"	"Male infertility"	"Pulmonary embolism"	1	44	4	48
"N46"	"I46"	"Male infertility"	"Cardiac arrest"	1	26	0	26
"N46"	"I50"	"Male infertility"	"Heart failure"	1	87	0	87
"N46"	"I69"	"Male infertility"	"Sequelae of cerebrovascular disease"	1	71	0	71
"N46"	"I83"	"Male infertility"	"Varicose veins of lower extremities"	1	191	103	294
"N46"	"J15"	"Male infertility"	"Bacterial pneumonia, not elsewhere classified"	1	107	34	141
"N46"	"J44"	"Male infertility"	"Other chronic obstructive pulmonary disease"	1	77	0	77
"N46"	"J96"	"Male infertility"	"Respiratory failure, not elsewhere classified"	1	79	17	96
"N46"	"L97"	"Male infertility"	"Non-pressure chronic ulcer of lower limb, NEC"	1	36	1	37
"N46"	"M16"	"Male infertility"	"Osteoarthritis of hip"	1	110	16	126
"N46"	"M47"	"Male infertility"	"Spondylosis"	1	199	28	227
"N46"	"M75"	"Male infertility"	"Shoulder lesions"	1	731	324	1055
"N46"	"M77"	"Male infertility"	"Other enthesopathies"	1	220	120	340
"N46"	"M81"	"Male infertility"	"Osteoporosis without current pathological fracture"	1	80	3	83
"N46"	"M85"	"Male infertility"	"Other disorders of bone density and structure"	1	94	4	98
"N46"	"N40"	"Male infertility"	"Benign prostatic hyperplasia"	1	84	17	101
"N47"	"A04"	"Disorders of prepuce"	"Other bacterial intestinal infections"	1	130	53	183
"N47"	"A46"	"Disorders of prepuce"	"Erysipelas"	1	377	208	585
"N47"	"A63"	"Disorders of prepuce"	"Oth predominantly sexually transmitted diseases, NEC"	1	279	161	440
"N47"	"C34"	"Disorders of prepuce"	"Malignant neoplasm of bronchus and lung"	1	266	26	292
"N47"	"C44"	"Disorders of prepuce"	"Other and unspecified malignant neoplasm of skin"	1	216	110	326
"N47"	"C60"	"Disorders of prepuce"	"Malignant neoplasm of penis"	1	148	30	178
"N47"	"C71"	"Disorders of prepuce"	"Malignant neoplasm of brain"	1	40	5	45
"N47"	"C77"	"Disorders of prepuce"	"Secondary and unspecified malignant neoplasm of lymph nodes"	1	112	23	135
"N47"	"C79"	"Disorders of prepuce"	"Secondary malignant neoplasm of other and unspecified sites"	1	232	36	268
"N47"	"D22"	"Disorders of prepuce"	"Melanocytic nevi"	1	200	37	237
"N47"	"D50"	"Disorders of prepuce"	"Iron deficiency anemia"	1	195	86	281
"N47"	"F41"	"Disorders of prepuce"	"Other anxiety disorders"	1	174	30	204
"N47"	"G95"	"Disorders of prepuce"	"Other and unspecified diseases of spinal cord"	1	78	24	102
"N47"	"G96"	"Disorders of prepuce"	"Other disorders of central nervous system"	1	165	40	205
"N47"	"I35"	"Disorders of prepuce"	"Nonrheumatic aortic valve disorders"	1	364	119	483
"N47"	"I71"	"Disorders of prepuce"	"Aortic aneurysm and dissection"	1	228	115	343
"N47"	"I95"	"Disorders of prepuce"	"Hypotension"	1	187	68	255
"N47"	"J22"	"Disorders of prepuce"	"Unspecified acute lower respiratory infection"	1	73	23	96
"N47"	"J30"	"Disorders of prepuce"	"Vasomotor and allergic rhinitis"	1	402	210	612
"N47"	"J36"	"Disorders of prepuce"	"Peritonsillar abscess"	1	143	61	204
"N47"	"J84"	"Disorders of prepuce"	"Other interstitial pulmonary diseases"	1	100	32	132
"N47"	"J93"	"Disorders of prepuce"	"Pneumothorax and air leak"	1	91	34	125
"N47"	"J96"	"Disorders of prepuce"	"Respiratory failure, not elsewhere classified"	1	597	159	756
"N47"	"K08"	"Disorders of prepuce"	"Other disorders of teeth and supporting structures"	1	114	41	155
"N47"	"K50"	"Disorders of prepuce"	"Crohn's disease [regional enteritis]"	1	97	37	134
"N47"	"K51"	"Disorders of prepuce"	"Ulcerative colitis"	1	145	62	207
"N47"	"L05"	"Disorders of prepuce"	"Pilonidal cyst and sinus"	1	237	77	314
"N47"	"L89"	"Disorders of prepuce"	"Pressure ulcer"	1	179	41	220
"N47"	"M19"	"Disorders of prepuce"	"Other and unspecified osteoarthritis"	1	318	182	500
"N47"	"M22"	"Disorders of prepuce"	"Disorder of patella"	1	259	139	398
"N47"	"M24"	"Disorders of prepuce"	"Other specific joint derangements"	1	245	108	353
"N47"	"M54"	"Disorders of prepuce"	"Dorsalgia"	1	831	534	1365
"N47"	"M67"	"Disorders of prepuce"	"Other disorders of synovium and tendon"	1	392	145	537
"N47"	"M75"	"Disorders of prepuce"	"Shoulder lesions"	1	832	378	1210
"N47"	"M76"	"Disorders of prepuce"	"Enthesopathies, lower limb, excluding foot"	1	279	93	372
"N47"	"M79"	"Disorders of prepuce"	"Oth and unsp soft tissue disorders, not elsewhere classified"	1	1131	667	1798
"N47"	"M81"	"Disorders of prepuce"	"Osteoporosis without current pathological fracture"	1	244	101	345
"N47"	"N17"	"Disorders of prepuce"	"Acute kidney failure"	1	256	55	311
"N47"	"N19"	"Disorders of prepuce"	"Unspecified kidney failure"	1	272	83	355
"N47"	"N28"	"Disorders of prepuce"	"Oth disorders of kidney and ureter, not elsewhere classified"	1	116	36	152
"N47"	"N62"	"Disorders of prepuce"	"Hypertrophy of breast"	1	284	84	368
"N47"	"Q61"	"Disorders of prepuce"	"Cystic kidney disease"	1	66	18	84
"N48"	"A49"	"Other disorders of penis"	"Bacterial infection of unspecified site"	1	298	89	387
"N48"	"C15"	"Other disorders of penis"	"Malignant neoplasm of esophagus"	1	54	3	57
"N48"	"C16"	"Other disorders of penis"	"Malignant neoplasm of stomach"	1	61	2	63
"N48"	"C18"	"Other disorders of penis"	"Malignant neoplasm of colon"	1	188	65	253
"N48"	"C25"	"Other disorders of penis"	"Malignant neoplasm of pancreas"	1	53	0	53
"N48"	"C34"	"Other disorders of penis"	"Malignant neoplasm of bronchus and lung"	1	287	0	287
"N48"	"E87"	"Other disorders of penis"	"Other disorders of fluid, electrolyte and acid-base balance"	1	312	32	344
"N48"	"F41"	"Other disorders of penis"	"Other anxiety disorders"	1	105	27	132
"N48"	"G63"	"Other disorders of penis"	"Polyneuropathy in diseases classified elsewhere"	1	107	27	134
"N48"	"G96"	"Other disorders of penis"	"Other disorders of central nervous system"	1	142	43	185
"N48"	"H36"	"Other disorders of penis"	"Retinal disorders in diseases classified elsewhere"	1	381	240	621
"N48"	"I46"	"Other disorders of penis"	"Cardiac arrest"	1	180	0	180
"N48"	"I50"	"Other disorders of penis"	"Heart failure"	1	740	200	940
"N48"	"I69"	"Other disorders of penis"	"Sequelae of cerebrovascular disease"	1	481	116	597
"N48"	"J15"	"Other disorders of penis"	"Bacterial pneumonia, not elsewhere classified"	1	467	74	541
"N48"	"J44"	"Other disorders of penis"	"Other chronic obstructive pulmonary disease"	1	636	207	843
"N48"	"J69"	"Other disorders of penis"	"Pneumonitis due to solids and liquids"	1	62	1	63
"N48"	"J91"	"Other disorders of penis"	"Pleural effusion in conditions classified elsewhere"	1	47	7	54
"N48"	"J96"	"Other disorders of penis"	"Respiratory failure, not elsewhere classified"	1	382	19	401
"N48"	"K59"	"Other disorders of penis"	"Other functional intestinal disorders"	1	775	354	1129
"N48"	"K74"	"Other disorders of penis"	"Fibrosis and cirrhosis of liver"	1	70	18	88
"N48"	"M81"	"Other disorders of penis"	"Osteoporosis without current pathological fracture"	1	215	40	255
"N49"	"C34"	"Inflammatory disorders of male genital organs, NEC"	"Malignant neoplasm of bronchus and lung"	1	133	2	135
"N49"	"C78"	"Inflammatory disorders of male genital organs, NEC"	"Secondary malignant neoplasm of resp and digestive organs"	1	86	8	94
"N49"	"E78"	"Inflammatory disorders of male genital organs, NEC"	"Disorders of lipoprotein metabolism and other lipidemias"	1	243	130	373
"N49"	"F17"	"Inflammatory disorders of male genital organs, NEC"	"Nicotine dependence"	1	162	80	242
"N49"	"G47"	"Inflammatory disorders of male genital organs, NEC"	"Sleep disorders"	1	143	41	184
"N49"	"J15"	"Inflammatory disorders of male genital organs, NEC"	"Bacterial pneumonia, not elsewhere classified"	1	172	59	231
"N50"	"A41"	"Other and unspecified disorders of male genital organs"	"Other sepsis"	1	420	134	554
"N50"	"A49"	"Other and unspecified disorders of male genital organs"	"Bacterial infection of unspecified site"	1	208	76	284
"N50"	"C25"	"Other and unspecified disorders of male genital organs"	"Malignant neoplasm of pancreas"	1	50	2	52
"N50"	"C34"	"Other and unspecified disorders of male genital organs"	"Malignant neoplasm of bronchus and lung"	1	157	16	173
"N50"	"C77"	"Other and unspecified disorders of male genital organs"	"Secondary and unspecified malignant neoplasm of lymph nodes"	1	85	31	116
"N50"	"C78"	"Other and unspecified disorders of male genital organs"	"Secondary malignant neoplasm of resp and digestive organs"	1	214	32	246
"N50"	"C79"	"Other and unspecified disorders of male genital organs"	"Secondary malignant neoplasm of other and unspecified sites"	1	157	23	180
"N50"	"D64"	"Other and unspecified disorders of male genital organs"	"Other anemias"	1	293	125	418
"N50"	"E87"	"Other and unspecified disorders of male genital organs"	"Other disorders of fluid, electrolyte and acid-base balance"	1	209	40	249
"N50"	"F05"	"Other and unspecified disorders of male genital organs"	"Delirium due to known physiological condition"	1	58	2	60
"N50"	"G96"	"Other and unspecified disorders of male genital organs"	"Other disorders of central nervous system"	1	143	33	176
"N50"	"H25"	"Other and unspecified disorders of male genital organs"	"Age-related cataract"	1	530	258	788
"N50"	"J69"	"Other and unspecified disorders of male genital organs"	"Pneumonitis due to solids and liquids"	1	39	6	45
"N50"	"J90"	"Other and unspecified disorders of male genital organs"	"Pleural effusion, not elsewhere classified"	1	78	20	98
"N50"	"J96"	"Other and unspecified disorders of male genital organs"	"Respiratory failure, not elsewhere classified"	1	270	49	319
"N50"	"M81"	"Other and unspecified disorders of male genital organs"	"Osteoporosis without current pathological fracture"	1	126	50	176
"N50"	"M85"	"Other and unspecified disorders of male genital organs"	"Other disorders of bone density and structure"	1	96	36	132
"N60"	"A46"	"Benign mammary dysplasia"	"Erysipelas"	1	234	5	239
"N60"	"C18"	"Benign mammary dysplasia"	"Malignant neoplasm of colon"	1	197	5	202
"N60"	"C25"	"Benign mammary dysplasia"	"Malignant neoplasm of pancreas"	1	66	0	66
"N60"	"C43"	"Benign mammary dysplasia"	"Malignant melanoma of skin"	1	139	45	184
"N60"	"C50"	"Benign mammary dysplasia"	"Malignant neoplasm of breast"	1	2042	623	2665
"N60"	"C56"	"Benign mammary dysplasia"	"Malignant neoplasm of ovary"	1	116	20	136
"N60"	"C77"	"Benign mammary dysplasia"	"Secondary and unspecified malignant neoplasm of lymph nodes"	1	202	17	219
"N60"	"C78"	"Benign mammary dysplasia"	"Secondary malignant neoplasm of resp and digestive organs"	1	353	0	353
"N60"	"C83"	"Benign mammary dysplasia"	"Non-follicular lymphoma"	1	51	1	52
"N60"	"C90"	"Benign mammary dysplasia"	"Multiple myeloma and malignant plasma cell neoplasms"	1	25	0	25
"N60"	"C92"	"Benign mammary dysplasia"	"Myeloid leukemia"	1	27	1	28
"N60"	"D30"	"Benign mammary dysplasia"	"Benign neoplasm of urinary organs"	1	66	13	79
"N60"	"D50"	"Benign mammary dysplasia"	"Iron deficiency anemia"	1	228	35	263
"N60"	"D62"	"Benign mammary dysplasia"	"Acute posthemorrhagic anemia"	1	83	18	101
"N60"	"D63"	"Benign mammary dysplasia"	"Anemia in chronic diseases classified elsewhere"	1	94	0	94
"N60"	"E03"	"Benign mammary dysplasia"	"Other hypothyroidism"	1	576	60	636
"N60"	"E04"	"Benign mammary dysplasia"	"Other nontoxic goiter"	1	551	276	827
"N60"	"E23"	"Benign mammary dysplasia"	"Hypofunction and other disorders of the pituitary gland"	1	52	5	57
"N60"	"E66"	"Benign mammary dysplasia"	"Overweight and obesity"	1	1053	361	1414
"N60"	"E86"	"Benign mammary dysplasia"	"Volume depletion"	1	391	0	391
"N60"	"F32"	"Benign mammary dysplasia"	"Depressive episode"	1	327	72	399
"N60"	"G91"	"Benign mammary dysplasia"	"Hydrocephalus"	1	36	2	38
"N60"	"G93"	"Benign mammary dysplasia"	"Other disorders of brain"	1	52	8	60
"N60"	"H18"	"Benign mammary dysplasia"	"Other disorders of cornea"	1	55	7	62
"N60"	"H25"	"Benign mammary dysplasia"	"Age-related cataract"	1	1409	0	1409
"N60"	"H26"	"Benign mammary dysplasia"	"Other cataract"	1	370	33	403
"N60"	"H35"	"Benign mammary dysplasia"	"Other retinal disorders"	1	480	10	490
"N60"	"H40"	"Benign mammary dysplasia"	"Glaucoma"	1	169	21	190
"N60"	"H91"	"Benign mammary dysplasia"	"Other and unspecified hearing loss"	1	969	178	1147
"N60"	"H93"	"Benign mammary dysplasia"	"Other disorders of ear, not elsewhere classified"	1	363	135	498
"N60"	"I10"	"Benign mammary dysplasia"	"Essential (primary) hypertension"	1	2718	0	2718
"N60"	"I15"	"Benign mammary dysplasia"	"Secondary hypertension"	1	100	11	111
"N60"	"I20"	"Benign mammary dysplasia"	"Angina pectoris"	1	843	200	1043
"N60"	"I34"	"Benign mammary dysplasia"	"Nonrheumatic mitral valve disorders"	1	138	13	151
"N60"	"I42"	"Benign mammary dysplasia"	"Cardiomyopathy"	1	74	4	78
"N60"	"I46"	"Benign mammary dysplasia"	"Cardiac arrest"	1	71	0	71
"N60"	"I47"	"Benign mammary dysplasia"	"Paroxysmal tachycardia"	1	300	165	465
"N60"	"I48"	"Benign mammary dysplasia"	"Atrial fibrillation and flutter"	1	783	27	810
"N60"	"I61"	"Benign mammary dysplasia"	"Nontraumatic intracerebral hemorrhage"	1	96	0	96
"N60"	"I71"	"Benign mammary dysplasia"	"Aortic aneurysm and dissection"	1	78	0	78
"N60"	"I73"	"Benign mammary dysplasia"	"Other peripheral vascular diseases"	1	251	14	265
"N60"	"I85"	"Benign mammary dysplasia"	"Esophageal varices"	1	33	2	35
"N60"	"I87"	"Benign mammary dysplasia"	"Other disorders of veins"	1	42	5	47
"N60"	"J13"	"Benign mammary dysplasia"	"Pneumonia due to Streptococcus pneumoniae"	1	34	1	35
"N60"	"J15"	"Benign mammary dysplasia"	"Bacterial pneumonia, not elsewhere classified"	1	384	0	384
"N60"	"J22"	"Benign mammary dysplasia"	"Unspecified acute lower respiratory infection"	1	35	0	35
"N60"	"J43"	"Benign mammary dysplasia"	"Emphysema"	1	93	1	94
"N60"	"J45"	"Benign mammary dysplasia"	"Asthma"	1	581	394	975
"N60"	"J96"	"Benign mammary dysplasia"	"Respiratory failure, not elsewhere classified"	1	345	0	345
"N60"	"J98"	"Benign mammary dysplasia"	"Other respiratory disorders"	1	90	18	108
"N60"	"K05"	"Benign mammary dysplasia"	"Gingivitis and periodontal diseases"	1	88	28	116
"N60"	"K21"	"Benign mammary dysplasia"	"Gastro-esophageal reflux disease"	1	578	169	747
"N60"	"K22"	"Benign mammary dysplasia"	"Other diseases of esophagus"	1	106	15	121
"N60"	"K29"	"Benign mammary dysplasia"	"Gastritis and duodenitis"	1	477	244	721
"N60"	"K30"	"Benign mammary dysplasia"	"Functional dyspepsia"	1	496	303	799
"N60"	"K42"	"Benign mammary dysplasia"	"Umbilical hernia"	1	131	55	186
"N60"	"K43"	"Benign mammary dysplasia"	"Ventral hernia"	1	259	80	339
"N60"	"K44"	"Benign mammary dysplasia"	"Diaphragmatic hernia"	1	348	126	474
"N60"	"K56"	"Benign mammary dysplasia"	"Paralytic ileus and intestinal obstruction without hernia"	1	284	39	323
"N60"	"K58"	"Benign mammary dysplasia"	"Irritable bowel syndrome"	1	416	264	680
"N60"	"K59"	"Benign mammary dysplasia"	"Other functional intestinal disorders"	1	1082	136	1218
"N60"	"K63"	"Benign mammary dysplasia"	"Other diseases of intestine"	1	104	7	111
"N60"	"K70"	"Benign mammary dysplasia"	"Alcoholic liver disease"	1	86	16	102
"N60"	"K74"	"Benign mammary dysplasia"	"Fibrosis and cirrhosis of liver"	1	74	4	78
"N60"	"K80"	"Benign mammary dysplasia"	"Cholelithiasis"	1	740	480	1220
"N60"	"K81"	"Benign mammary dysplasia"	"Cholecystitis"	1	127	32	159
"N60"	"K86"	"Benign mammary dysplasia"	"Other diseases of pancreas"	1	93	17	110
"N60"	"K91"	"Benign mammary dysplasia"	"Intraop and postproc comp and disorders of dgstv sys, NEC"	1	53	10	63
"N60"	"L89"	"Benign mammary dysplasia"	"Pressure ulcer"	1	34	0	34
"N60"	"L98"	"Benign mammary dysplasia"	"Oth disorders of skin, subcu, not elsewhere classified"	1	147	26	173
"N60"	"M06"	"Benign mammary dysplasia"	"Other rheumatoid arthritis"	1	210	61	271
"N60"	"M13"	"Benign mammary dysplasia"	"Other arthritis"	1	195	46	241
"N60"	"M15"	"Benign mammary dysplasia"	"Polyosteoarthritis"	1	187	27	214
"N60"	"M19"	"Benign mammary dysplasia"	"Other and unspecified osteoarthritis"	1	759	31	790
"N60"	"M21"	"Benign mammary dysplasia"	"Other acquired deformities of limbs"	1	200	57	257
"N60"	"M24"	"Benign mammary dysplasia"	"Other specific joint derangements"	1	198	72	270
"N60"	"M43"	"Benign mammary dysplasia"	"Other deforming dorsopathies"	1	158	54	212
"N60"	"M46"	"Benign mammary dysplasia"	"Other inflammatory spondylopathies"	1	67	14	81
"N60"	"M48"	"Benign mammary dysplasia"	"Other spondylopathies"	1	525	26	551
"N60"	"M50"	"Benign mammary dysplasia"	"Cervical disc disorders"	1	391	171	562
"N60"	"M53"	"Benign mammary dysplasia"	"Other and unspecified dorsopathies, not elsewhere classified"	1	183	80	263
"N60"	"M65"	"Benign mammary dysplasia"	"Synovitis and tenosynovitis"	1	640	239	879
"N60"	"M67"	"Benign mammary dysplasia"	"Other disorders of synovium and tendon"	1	467	263	730
"N60"	"M70"	"Benign mammary dysplasia"	"Soft tissue disorders related to use, overuse and pressure"	1	335	100	435
"N60"	"M75"	"Benign mammary dysplasia"	"Shoulder lesions"	1	1520	390	1910
"N60"	"M77"	"Benign mammary dysplasia"	"Other enthesopathies"	1	430	184	614
"N60"	"M79"	"Benign mammary dysplasia"	"Oth and unsp soft tissue disorders, not elsewhere classified"	1	1380	533	1913
"N60"	"M84"	"Benign mammary dysplasia"	"Disorder of continuity of bone"	1	56	7	63
"N60"	"N18"	"Benign mammary dysplasia"	"Chronic kidney disease (CKD)"	1	125	0	125
"N60"	"N19"	"Benign mammary dysplasia"	"Unspecified kidney failure"	1	66	13	79
"N60"	"N20"	"Benign mammary dysplasia"	"Calculus of kidney and ureter"	1	276	142	418
"N60"	"N28"	"Benign mammary dysplasia"	"Oth disorders of kidney and ureter, not elsewhere classified"	1	49	8	57
"N60"	"N39"	"Benign mammary dysplasia"	"Other disorders of urinary system"	1	1226	159	1385
"N60"	"O72"	"Benign mammary dysplasia"	"Postpartum hemorrhage"	1	1002	625	1627
"N61"	"C18"	"Inflammatory disorders of breast"	"Malignant neoplasm of colon"	1	47	5	52
"N61"	"C34"	"Inflammatory disorders of breast"	"Malignant neoplasm of bronchus and lung"	1	101	0	101
"N61"	"C78"	"Inflammatory disorders of breast"	"Secondary malignant neoplasm of resp and digestive organs"	1	137	0	137
"N61"	"J18"	"Inflammatory disorders of breast"	"Pneumonia, unspecified organism"	1	422	156	578
"N61"	"K56"	"Inflammatory disorders of breast"	"Paralytic ileus and intestinal obstruction without hernia"	1	84	24	108
"N61"	"M17"	"Inflammatory disorders of breast"	"Osteoarthritis of knee"	1	252	127	379
"N61"	"M75"	"Inflammatory disorders of breast"	"Shoulder lesions"	1	301	185	486
"N61"	"M80"	"Inflammatory disorders of breast"	"Osteoporosis with current pathological fracture"	1	74	2	76
"N61"	"M85"	"Inflammatory disorders of breast"	"Other disorders of bone density and structure"	1	130	12	142
"N61"	"N18"	"Inflammatory disorders of breast"	"Chronic kidney disease (CKD)"	1	68	10	78
"N61"	"N39"	"Inflammatory disorders of breast"	"Other disorders of urinary system"	1	313	120	433
"N62"	"A49"	"Hypertrophy of breast"	"Bacterial infection of unspecified site"	1	327	56	383
"N62"	"C15"	"Hypertrophy of breast"	"Malignant neoplasm of esophagus"	1	53	1	54
"N62"	"C16"	"Hypertrophy of breast"	"Malignant neoplasm of stomach"	1	36	3	39
"N62"	"C18"	"Hypertrophy of breast"	"Malignant neoplasm of colon"	1	143	43	186
"N62"	"C25"	"Hypertrophy of breast"	"Malignant neoplasm of pancreas"	1	73	1	74
"N62"	"C34"	"Hypertrophy of breast"	"Malignant neoplasm of bronchus and lung"	1	271	26	297
"N62"	"D50"	"Hypertrophy of breast"	"Iron deficiency anemia"	1	284	36	320
"N62"	"D63"	"Hypertrophy of breast"	"Anemia in chronic diseases classified elsewhere"	1	185	9	194
"N62"	"D64"	"Hypertrophy of breast"	"Other anemias"	1	670	145	815
"N62"	"E05"	"Hypertrophy of breast"	"Thyrotoxicosis [hyperthyroidism]"	1	235	83	318
"N62"	"E11"	"Hypertrophy of breast"	"Type 2 diabetes mellitus"	1	779	340	1119
"N62"	"E23"	"Hypertrophy of breast"	"Hypofunction and other disorders of the pituitary gland"	1	182	59	241
"N62"	"E78"	"Hypertrophy of breast"	"Disorders of lipoprotein metabolism and other lipidemias"	1	763	455	1218
"N62"	"E86"	"Hypertrophy of breast"	"Volume depletion"	1	593	56	649
"N62"	"G20"	"Hypertrophy of breast"	"Parkinson's disease"	1	54	9	63
"N62"	"G43"	"Hypertrophy of breast"	"Migraine"	1	270	148	418
"N62"	"G45"	"Hypertrophy of breast"	"Transient cerebral ischemic attacks and related syndromes"	1	292	162	454
"N62"	"G56"	"Hypertrophy of breast"	"Mononeuropathies of upper limb"	1	639	309	948
"N62"	"G93"	"Hypertrophy of breast"	"Other disorders of brain"	1	52	11	63
"N62"	"G96"	"Hypertrophy of breast"	"Other disorders of central nervous system"	1	209	13	222
"N62"	"H53"	"Hypertrophy of breast"	"Visual disturbances"	1	178	77	255
"N62"	"I46"	"Hypertrophy of breast"	"Cardiac arrest"	1	169	0	169
"N62"	"I61"	"Hypertrophy of breast"	"Nontraumatic intracerebral hemorrhage"	1	131	20	151
"N62"	"I63"	"Hypertrophy of breast"	"Cerebral infarction"	1	388	92	480
"N62"	"I69"	"Hypertrophy of breast"	"Sequelae of cerebrovascular disease"	1	403	86	489
"N62"	"I83"	"Hypertrophy of breast"	"Varicose veins of lower extremities"	1	418	272	690
"N62"	"J15"	"Hypertrophy of breast"	"Bacterial pneumonia, not elsewhere classified"	1	523	87	610
"N62"	"J18"	"Hypertrophy of breast"	"Pneumonia, unspecified organism"	1	1225	495	1720
"N62"	"J69"	"Hypertrophy of breast"	"Pneumonitis due to solids and liquids"	1	63	6	69
"N62"	"J84"	"Hypertrophy of breast"	"Other interstitial pulmonary diseases"	1	109	27	136
"N62"	"K59"	"Hypertrophy of breast"	"Other functional intestinal disorders"	1	1053	257	1310
"N62"	"L89"	"Hypertrophy of breast"	"Pressure ulcer"	1	84	10	94
"N62"	"L90"	"Hypertrophy of breast"	"Atrophic disorders of skin"	1	1298	432	1730
"N62"	"L91"	"Hypertrophy of breast"	"Hypertrophic disorders of skin"	1	122	52	174
"N62"	"L97"	"Hypertrophy of breast"	"Non-pressure chronic ulcer of lower limb, NEC"	1	155	24	179
"N62"	"M17"	"Hypertrophy of breast"	"Osteoarthritis of knee"	1	819	373	1192
"N62"	"M20"	"Hypertrophy of breast"	"Acquired deformities of fingers and toes"	1	346	158	504
"N62"	"M46"	"Hypertrophy of breast"	"Other inflammatory spondylopathies"	1	64	18	82
"N62"	"M65"	"Hypertrophy of breast"	"Synovitis and tenosynovitis"	1	492	322	814
"N62"	"M76"	"Hypertrophy of breast"	"Enthesopathies, lower limb, excluding foot"	1	240	141	381
"N62"	"M77"	"Hypertrophy of breast"	"Other enthesopathies"	1	358	151	509
"N62"	"M79"	"Hypertrophy of breast"	"Oth and unsp soft tissue disorders, not elsewhere classified"	1	1054	734	1788
"N62"	"N30"	"Hypertrophy of breast"	"Cystitis"	1	929	364	1293
"N62"	"N39"	"Hypertrophy of breast"	"Other disorders of urinary system"	1	890	165	1055
"N62"	"N87"	"Hypertrophy of breast"	"Dysplasia of cervix uteri"	1	334	128	462
"N62"	"N97"	"Hypertrophy of breast"	"Female infertility"	1	323	136	459
"N62"	"O02"	"Hypertrophy of breast"	"Other abnormal products of conception"	1	292	148	440
"N62"	"O08"	"Hypertrophy of breast"	"Complications following ectopic and molar pregnancy"	1	152	62	214
"N62"	"O24"	"Hypertrophy of breast"	"Diabetes in pregnancy, childbirth, and the puerperium"	1	118	19	137
"N62"	"O42"	"Hypertrophy of breast"	"Premature rupture of membranes"	1	209	85	294
"N62"	"O68"	"Hypertrophy of breast"	"Labor and delivery comp by abnlt of fetal acid-base balance"	1	418	236	654
"N62"	"O72"	"Hypertrophy of breast"	"Postpartum hemorrhage"	1	913	0	913
"N62"	"O92"	"Hypertrophy of breast"	"Oth disord of brst/lactatn assoc w pregnancy and the puerp"	1	307	0	307
"N62"	"O99"	"Hypertrophy of breast"	"Oth maternal diseases classd elsw but compl preg/chldbrth"	1	914	118	1032
"N63"	"A41"	"Unspecified lump in breast"	"Other sepsis"	1	702	0	702
"N63"	"A49"	"Unspecified lump in breast"	"Bacterial infection of unspecified site"	1	353	24	377
"N63"	"B37"	"Unspecified lump in breast"	"Candidiasis"	1	161	63	224
"N63"	"C20"	"Unspecified lump in breast"	"Malignant neoplasm of rectum"	1	87	19	106
"N63"	"C34"	"Unspecified lump in breast"	"Malignant neoplasm of bronchus and lung"	1	478	0	478
"N63"	"C56"	"Unspecified lump in breast"	"Malignant neoplasm of ovary"	1	114	31	145
"N63"	"C71"	"Unspecified lump in breast"	"Malignant neoplasm of brain"	1	77	2	79
"N63"	"D12"	"Unspecified lump in breast"	"Benign neoplasm of colon, rectum, anus and anal canal"	1	789	34	823
"N63"	"D35"	"Unspecified lump in breast"	"Benign neoplasm of other and unspecified endocrine glands"	1	107	13	120
"N63"	"D50"	"Unspecified lump in breast"	"Iron deficiency anemia"	1	302	61	363
"N63"	"D63"	"Unspecified lump in breast"	"Anemia in chronic diseases classified elsewhere"	1	253	0	253
"N63"	"D64"	"Unspecified lump in breast"	"Other anemias"	1	775	91	866
"N63"	"E03"	"Unspecified lump in breast"	"Other hypothyroidism"	1	693	199	892
"N63"	"E21"	"Unspecified lump in breast"	"Hyperparathyroidism and other disorders of parathyroid gland"	1	164	20	184
"N63"	"E23"	"Unspecified lump in breast"	"Hypofunction and other disorders of the pituitary gland"	1	56	13	69
"N63"	"E27"	"Unspecified lump in breast"	"Other disorders of adrenal gland"	1	76	11	87
"N63"	"E78"	"Unspecified lump in breast"	"Disorders of lipoprotein metabolism and other lipidemias"	1	968	199	1167
"N63"	"E83"	"Unspecified lump in breast"	"Disorders of mineral metabolism"	1	155	4	159
"N63"	"E87"	"Unspecified lump in breast"	"Other disorders of fluid, electrolyte and acid-base balance"	1	553	0	553
"N63"	"E89"	"Unspecified lump in breast"	"Postproc endocrine and metabolic comp and disorders, NEC"	1	102	25	127
"N63"	"F32"	"Unspecified lump in breast"	"Depressive episode"	1	445	175	620
"N63"	"G45"	"Unspecified lump in breast"	"Transient cerebral ischemic attacks and related syndromes"	1	332	96	428
"N63"	"G47"	"Unspecified lump in breast"	"Sleep disorders"	1	412	19	431
"N63"	"G56"	"Unspecified lump in breast"	"Mononeuropathies of upper limb"	1	719	347	1066
"N63"	"G98"	"Unspecified lump in breast"	"Other disorders of nervous system not elsewhere classified"	1	68	0	68
"N63"	"H25"	"Unspecified lump in breast"	"Age-related cataract"	1	1592	340	1932
"N63"	"H34"	"Unspecified lump in breast"	"Retinal vascular occlusions"	1	71	17	88
"N63"	"I10"	"Unspecified lump in breast"	"Essential (primary) hypertension"	1	2648	769	3417
"N63"	"I20"	"Unspecified lump in breast"	"Angina pectoris"	1	680	487	1167
"N63"	"I25"	"Unspecified lump in breast"	"Chronic ischemic heart disease"	1	733	299	1032
"N63"	"I44"	"Unspecified lump in breast"	"Atrioventricular and left bundle-branch block"	1	114	25	139
"N63"	"I61"	"Unspecified lump in breast"	"Nontraumatic intracerebral hemorrhage"	1	170	8	178
"N63"	"I67"	"Unspecified lump in breast"	"Other cerebrovascular diseases"	1	69	13	82
"N63"	"I69"	"Unspecified lump in breast"	"Sequelae of cerebrovascular disease"	1	529	44	573
"N63"	"I70"	"Unspecified lump in breast"	"Atherosclerosis"	1	285	130	415
"N63"	"I71"	"Unspecified lump in breast"	"Aortic aneurysm and dissection"	1	114	3	117
"N63"	"I97"	"Unspecified lump in breast"	"Intraop and postproc comp and disorders of circ sys, NEC"	1	358	2	360
"N63"	"J47"	"Unspecified lump in breast"	"Bronchiectasis"	1	88	3	91
"N63"	"J84"	"Unspecified lump in breast"	"Other interstitial pulmonary diseases"	1	89	16	105
"N63"	"J96"	"Unspecified lump in breast"	"Respiratory failure, not elsewhere classified"	1	662	0	662
"N63"	"K21"	"Unspecified lump in breast"	"Gastro-esophageal reflux disease"	1	591	278	869
"N63"	"K31"	"Unspecified lump in breast"	"Other diseases of stomach and duodenum"	1	53	9	62
"N63"	"K44"	"Unspecified lump in breast"	"Diaphragmatic hernia"	1	329	194	523
"N63"	"K52"	"Unspecified lump in breast"	"Other and unsp noninfective gastroenteritis and colitis"	1	396	177	573
"N63"	"K63"	"Unspecified lump in breast"	"Other diseases of intestine"	1	117	12	129
"N63"	"K64"	"Unspecified lump in breast"	"Hemorrhoids and perianal venous thrombosis"	1	300	0	300
"N63"	"K65"	"Unspecified lump in breast"	"Peritonitis"	1	96	33	129
"N63"	"K76"	"Unspecified lump in breast"	"Other diseases of liver"	1	144	58	202
"N63"	"L98"	"Unspecified lump in breast"	"Oth disorders of skin, subcu, not elsewhere classified"	1	221	55	276
"N63"	"M17"	"Unspecified lump in breast"	"Osteoarthritis of knee"	1	1002	414	1416
"N63"	"M19"	"Unspecified lump in breast"	"Other and unspecified osteoarthritis"	1	725	153	878
"N63"	"M25"	"Unspecified lump in breast"	"Other joint disorder, not elsewhere classified"	1	487	227	714
"N63"	"M47"	"Unspecified lump in breast"	"Spondylosis"	1	452	183	635
"N63"	"M80"	"Unspecified lump in breast"	"Osteoporosis with current pathological fracture"	1	428	0	428
"N63"	"M96"	"Unspecified lump in breast"	"Intraop and postproc comp and disorders of ms sys, NEC"	1	45	7	52
"N63"	"M99"	"Unspecified lump in breast"	"Biomechanical lesions, not elsewhere classified"	1	94	16	110
"N63"	"N13"	"Unspecified lump in breast"	"Obstructive and reflux uropathy"	1	153	65	218
"N63"	"N18"	"Unspecified lump in breast"	"Chronic kidney disease (CKD)"	1	265	16	281
"N63"	"N81"	"Unspecified lump in breast"	"Female genital prolapse"	1	624	317	941
"N64"	"A41"	"Other disorders of breast"	"Other sepsis"	1	260	55	315
"N64"	"E86"	"Other disorders of breast"	"Volume depletion"	1	316	58	374
"N64"	"E87"	"Other disorders of breast"	"Other disorders of fluid, electrolyte and acid-base balance"	1	228	49	277
"N64"	"G47"	"Other disorders of breast"	"Sleep disorders"	1	271	89	360
"N64"	"H25"	"Other disorders of breast"	"Age-related cataract"	1	600	324	924
"N64"	"I50"	"Other disorders of breast"	"Heart failure"	1	200	76	276
"N64"	"J15"	"Other disorders of breast"	"Bacterial pneumonia, not elsewhere classified"	1	268	65	333
"N64"	"J18"	"Other disorders of breast"	"Pneumonia, unspecified organism"	1	613	347	960
"N64"	"J96"	"Other disorders of breast"	"Respiratory failure, not elsewhere classified"	1	246	29	275
"N64"	"K56"	"Other disorders of breast"	"Paralytic ileus and intestinal obstruction without hernia"	1	174	77	251
"N64"	"M47"	"Other disorders of breast"	"Spondylosis"	1	314	194	508
"N64"	"M48"	"Other disorders of breast"	"Other spondylopathies"	1	263	94	357
"N64"	"N18"	"Other disorders of breast"	"Chronic kidney disease (CKD)"	1	118	41	159
"N70"	"A41"	"Salpingitis and oophoritis"	"Other sepsis"	1	231	30	261
"N70"	"A46"	"Salpingitis and oophoritis"	"Erysipelas"	1	115	0	115
"N70"	"C34"	"Salpingitis and oophoritis"	"Malignant neoplasm of bronchus and lung"	1	37	0	37
"N70"	"C44"	"Salpingitis and oophoritis"	"Other and unspecified malignant neoplasm of skin"	1	38	0	38
"N70"	"C77"	"Salpingitis and oophoritis"	"Secondary and unspecified malignant neoplasm of lymph nodes"	1	40	0	40
"N70"	"C79"	"Salpingitis and oophoritis"	"Secondary malignant neoplasm of other and unspecified sites"	1	54	0	54
"N70"	"D25"	"Salpingitis and oophoritis"	"Leiomyoma of uterus"	1	888	630	1518
"N70"	"D63"	"Salpingitis and oophoritis"	"Anemia in chronic diseases classified elsewhere"	1	39	0	39
"N70"	"E04"	"Salpingitis and oophoritis"	"Other nontoxic goiter"	1	239	21	260
"N70"	"E28"	"Salpingitis and oophoritis"	"Ovarian dysfunction"	1	196	99	295
"N70"	"E78"	"Salpingitis and oophoritis"	"Disorders of lipoprotein metabolism and other lipidemias"	1	258	0	258
"N70"	"E83"	"Salpingitis and oophoritis"	"Disorders of mineral metabolism"	1	26	0	26
"N70"	"E86"	"Salpingitis and oophoritis"	"Volume depletion"	1	157	1	158
"N70"	"E87"	"Salpingitis and oophoritis"	"Other disorders of fluid, electrolyte and acid-base balance"	1	82	0	82
"N70"	"F17"	"Salpingitis and oophoritis"	"Nicotine dependence"	1	503	30	533
"N70"	"G35"	"Salpingitis and oophoritis"	"Multiple sclerosis"	1	74	4	78
"N70"	"H25"	"Salpingitis and oophoritis"	"Age-related cataract"	1	151	0	151
"N70"	"H36"	"Salpingitis and oophoritis"	"Retinal disorders in diseases classified elsewhere"	1	47	3	50
"N70"	"H90"	"Salpingitis and oophoritis"	"Conductive and sensorineural hearing loss"	1	108	15	123
"N70"	"I10"	"Salpingitis and oophoritis"	"Essential (primary) hypertension"	1	773	11	784
"N70"	"I20"	"Salpingitis and oophoritis"	"Angina pectoris"	1	236	0	236
"N70"	"I25"	"Salpingitis and oophoritis"	"Chronic ischemic heart disease"	1	140	0	140
"N70"	"I26"	"Salpingitis and oophoritis"	"Pulmonary embolism"	1	94	2	96
"N70"	"I35"	"Salpingitis and oophoritis"	"Nonrheumatic aortic valve disorders"	1	30	0	30
"N70"	"I47"	"Salpingitis and oophoritis"	"Paroxysmal tachycardia"	1	152	26	178
"N70"	"I48"	"Salpingitis and oophoritis"	"Atrial fibrillation and flutter"	1	129	0	129
"N70"	"I49"	"Salpingitis and oophoritis"	"Other cardiac arrhythmias"	1	115	0	115
"N70"	"I70"	"Salpingitis and oophoritis"	"Atherosclerosis"	1	59	1	60
"N70"	"I73"	"Salpingitis and oophoritis"	"Other peripheral vascular diseases"	1	52	0	52
"N70"	"I80"	"Salpingitis and oophoritis"	"Phlebitis and thrombophlebitis"	1	204	18	222
"N70"	"K05"	"Salpingitis and oophoritis"	"Gingivitis and periodontal diseases"	1	35	3	38
"N70"	"K66"	"Salpingitis and oophoritis"	"Other disorders of peritoneum"	1	285	155	440
"N70"	"K70"	"Salpingitis and oophoritis"	"Alcoholic liver disease"	1	48	2	50
"N70"	"K83"	"Salpingitis and oophoritis"	"Other diseases of biliary tract"	1	43	0	43
"N70"	"K85"	"Salpingitis and oophoritis"	"Acute pancreatitis"	1	81	11	92
"N70"	"M17"	"Salpingitis and oophoritis"	"Osteoarthritis of knee"	1	312	0	312
"N70"	"M20"	"Salpingitis and oophoritis"	"Acquired deformities of fingers and toes"	1	229	13	242
"N70"	"M75"	"Salpingitis and oophoritis"	"Shoulder lesions"	1	630	0	630
"N70"	"N76"	"Salpingitis and oophoritis"	"Other inflammation of vagina and vulva"	1	370	144	514
"N70"	"N84"	"Salpingitis and oophoritis"	"Polyp of female genital tract"	1	435	107	542
"N70"	"N92"	"Salpingitis and oophoritis"	"Excessive, frequent and irregular menstruation"	1	1673	639	2312
"N70"	"N99"	"Salpingitis and oophoritis"	"Intraop and postproc comp and disorders of GU sys, NEC"	1	313	147	460
"N70"	"O13"	"Salpingitis and oophoritis"	"Gestational hypertension without significant proteinuria"	1	95	30	125
"N70"	"O20"	"Salpingitis and oophoritis"	"Hemorrhage in early pregnancy"	1	1008	626	1634
"N70"	"O24"	"Salpingitis and oophoritis"	"Diabetes in pregnancy, childbirth, and the puerperium"	1	234	44	278
"N70"	"O34"	"Salpingitis and oophoritis"	"Maternal care for abnormality of pelvic organs"	1	479	55	534
"N70"	"O62"	"Salpingitis and oophoritis"	"Abnormalities of forces of labor"	1	1660	1041	2701
"N70"	"O66"	"Salpingitis and oophoritis"	"Other obstructed labor"	1	127	48	175
"N70"	"O70"	"Salpingitis and oophoritis"	"Perineal laceration during delivery"	1	1766	653	2419
"N70"	"O72"	"Salpingitis and oophoritis"	"Postpartum hemorrhage"	1	1831	0	1831
"N70"	"O75"	"Salpingitis and oophoritis"	"Oth complications of labor and delivery, NEC"	1	318	104	422
"N70"	"O99"	"Salpingitis and oophoritis"	"Oth maternal diseases classd elsw but compl preg/chldbrth"	1	1790	368	2158
"N71"	"C50"	"Inflammatory disease of uterus, except cervix"	"Malignant neoplasm of breast"	1	122	8	130
"N71"	"C56"	"Inflammatory disease of uterus, except cervix"	"Malignant neoplasm of ovary"	1	38	6	44
"N71"	"C79"	"Inflammatory disease of uterus, except cervix"	"Secondary malignant neoplasm of other and unspecified sites"	1	42	2	44
"N71"	"G43"	"Inflammatory disease of uterus, except cervix"	"Migraine"	1	331	100	431
"N71"	"I20"	"Inflammatory disease of uterus, except cervix"	"Angina pectoris"	1	186	18	204
"N71"	"I21"	"Inflammatory disease of uterus, except cervix"	"Acute myocardial infarction"	1	85	13	98
"N71"	"K57"	"Inflammatory disease of uterus, except cervix"	"Diverticular disease of intestine"	1	317	40	357
"N71"	"M17"	"Inflammatory disease of uterus, except cervix"	"Osteoarthritis of knee"	1	206	8	214
"N71"	"N84"	"Inflammatory disease of uterus, except cervix"	"Polyp of female genital tract"	1	233	134	367
"N71"	"N92"	"Inflammatory disease of uterus, except cervix"	"Excessive, frequent and irregular menstruation"	1	1202	814	2016
"N71"	"N94"	"Inflammatory disease of uterus, except cervix"	"Pain and oth cond assoc w fem gntl org and menstrual cycle"	1	684	366	1050
"N71"	"N99"	"Inflammatory disease of uterus, except cervix"	"Intraop and postproc comp and disorders of GU sys, NEC"	1	100	32	132
"N72"	"D25"	"Inflammatory disease of cervix uteri"	"Leiomyoma of uterus"	1	124	52	176
"N72"	"O99"	"Inflammatory disease of cervix uteri"	"Oth maternal diseases classd elsw but compl preg/chldbrth"	1	173	83	256
"N73"	"C34"	"Other female pelvic inflammatory diseases"	"Malignant neoplasm of bronchus and lung"	1	38	0	38
"N73"	"C79"	"Other female pelvic inflammatory diseases"	"Secondary malignant neoplasm of other and unspecified sites"	1	43	1	44
"N73"	"F17"	"Other female pelvic inflammatory diseases"	"Nicotine dependence"	1	160	30	190
"N73"	"I21"	"Other female pelvic inflammatory diseases"	"Acute myocardial infarction"	1	39	1	40
"N73"	"I25"	"Other female pelvic inflammatory diseases"	"Chronic ischemic heart disease"	1	68	5	73
"N73"	"I48"	"Other female pelvic inflammatory diseases"	"Atrial fibrillation and flutter"	1	73	9	82
"N73"	"I63"	"Other female pelvic inflammatory diseases"	"Cerebral infarction"	1	40	0	40
"N73"	"I69"	"Other female pelvic inflammatory diseases"	"Sequelae of cerebrovascular disease"	1	55	0	55
"N73"	"I83"	"Other female pelvic inflammatory diseases"	"Varicose veins of lower extremities"	1	106	30	136
"N73"	"J18"	"Other female pelvic inflammatory diseases"	"Pneumonia, unspecified organism"	1	253	38	291
"N73"	"K43"	"Other female pelvic inflammatory diseases"	"Ventral hernia"	1	183	27	210
"N73"	"K56"	"Other female pelvic inflammatory diseases"	"Paralytic ileus and intestinal obstruction without hernia"	1	177	83	260
"N73"	"K57"	"Other female pelvic inflammatory diseases"	"Diverticular disease of intestine"	1	225	98	323
"N73"	"M81"	"Other female pelvic inflammatory diseases"	"Osteoporosis without current pathological fracture"	1	91	0	91
"N75"	"A41"	"Diseases of Bartholin's gland"	"Other sepsis"	1	91	2	93
"N75"	"C34"	"Diseases of Bartholin's gland"	"Malignant neoplasm of bronchus and lung"	1	57	0	57
"N75"	"C50"	"Diseases of Bartholin's gland"	"Malignant neoplasm of breast"	1	142	10	152
"N75"	"C79"	"Diseases of Bartholin's gland"	"Secondary malignant neoplasm of other and unspecified sites"	1	38	0	38
"N75"	"D50"	"Diseases of Bartholin's gland"	"Iron deficiency anemia"	1	68	13	81
"N75"	"E03"	"Diseases of Bartholin's gland"	"Other hypothyroidism"	1	133	27	160
"N75"	"E78"	"Diseases of Bartholin's gland"	"Disorders of lipoprotein metabolism and other lipidemias"	1	174	9	183
"N75"	"E86"	"Diseases of Bartholin's gland"	"Volume depletion"	1	86	2	88
"N75"	"F41"	"Diseases of Bartholin's gland"	"Other anxiety disorders"	1	69	12	81
"N75"	"F43"	"Diseases of Bartholin's gland"	"Reaction to severe stress, and adjustment disorders"	1	64	19	83
"N75"	"G56"	"Diseases of Bartholin's gland"	"Mononeuropathies of upper limb"	1	182	55	237
"N75"	"G96"	"Diseases of Bartholin's gland"	"Other disorders of central nervous system"	1	47	0	47
"N75"	"I20"	"Diseases of Bartholin's gland"	"Angina pectoris"	1	112	28	140
"N75"	"I25"	"Diseases of Bartholin's gland"	"Chronic ischemic heart disease"	1	86	11	97
"N75"	"I48"	"Diseases of Bartholin's gland"	"Atrial fibrillation and flutter"	1	96	10	106
"N75"	"I50"	"Diseases of Bartholin's gland"	"Heart failure"	1	66	1	67
"N75"	"I69"	"Diseases of Bartholin's gland"	"Sequelae of cerebrovascular disease"	1	64	4	68
"N75"	"J15"	"Diseases of Bartholin's gland"	"Bacterial pneumonia, not elsewhere classified"	1	69	4	73
"N75"	"J18"	"Diseases of Bartholin's gland"	"Pneumonia, unspecified organism"	1	238	53	291
"N75"	"J44"	"Diseases of Bartholin's gland"	"Other chronic obstructive pulmonary disease"	1	167	8	175
"N75"	"K56"	"Diseases of Bartholin's gland"	"Paralytic ileus and intestinal obstruction without hernia"	1	70	9	79
"N75"	"K62"	"Diseases of Bartholin's gland"	"Other diseases of anus and rectum"	1	137	32	169
"N75"	"K70"	"Diseases of Bartholin's gland"	"Alcoholic liver disease"	1	34	0	34
"N75"	"M19"	"Diseases of Bartholin's gland"	"Other and unspecified osteoarthritis"	1	131	14	145
"N75"	"M25"	"Diseases of Bartholin's gland"	"Other joint disorder, not elsewhere classified"	1	157	53	210
"N75"	"M47"	"Diseases of Bartholin's gland"	"Spondylosis"	1	115	20	135
"N75"	"M51"	"Diseases of Bartholin's gland"	"Thoracic, thoracolum, and lumbosacral intvrt disc disorders"	1	222	78	300
"N75"	"M70"	"Diseases of Bartholin's gland"	"Soft tissue disorders related to use, overuse and pressure"	1	83	29	112
"N75"	"M75"	"Diseases of Bartholin's gland"	"Shoulder lesions"	1	354	69	423
"N75"	"M77"	"Diseases of Bartholin's gland"	"Other enthesopathies"	1	95	37	132
"N75"	"M79"	"Diseases of Bartholin's gland"	"Oth and unsp soft tissue disorders, not elsewhere classified"	1	314	157	471
"N75"	"M81"	"Diseases of Bartholin's gland"	"Osteoporosis without current pathological fracture"	1	120	0	120
"N75"	"N18"	"Diseases of Bartholin's gland"	"Chronic kidney disease (CKD)"	1	34	0	34
"N75"	"N82"	"Diseases of Bartholin's gland"	"Fistulae involving female genital tract"	1	101	28	129
"N76"	"A41"	"Other inflammation of vagina and vulva"	"Other sepsis"	1	327	79	406
"N76"	"C78"	"Other inflammation of vagina and vulva"	"Secondary malignant neoplasm of resp and digestive organs"	1	140	2	142
"N76"	"D63"	"Other inflammation of vagina and vulva"	"Anemia in chronic diseases classified elsewhere"	1	65	12	77
"N76"	"E05"	"Other inflammation of vagina and vulva"	"Thyrotoxicosis [hyperthyroidism]"	1	197	107	304
"N76"	"E06"	"Other inflammation of vagina and vulva"	"Thyroiditis"	1	51	12	63
"N76"	"F17"	"Other inflammation of vagina and vulva"	"Nicotine dependence"	1	502	133	635
"N76"	"F41"	"Other inflammation of vagina and vulva"	"Other anxiety disorders"	1	187	40	227
"N76"	"G47"	"Other inflammation of vagina and vulva"	"Sleep disorders"	1	215	16	231
"N76"	"I26"	"Other inflammation of vagina and vulva"	"Pulmonary embolism"	1	103	39	142
"N76"	"I42"	"Other inflammation of vagina and vulva"	"Cardiomyopathy"	1	44	6	50
"N76"	"K70"	"Other inflammation of vagina and vulva"	"Alcoholic liver disease"	1	50	8	58
"N76"	"K76"	"Other inflammation of vagina and vulva"	"Other diseases of liver"	1	73	23	96
"N76"	"L30"	"Other inflammation of vagina and vulva"	"Other and unspecified dermatitis"	1	215	104	319
"N76"	"L72"	"Other inflammation of vagina and vulva"	"Follicular cysts of skin and subcutaneous tissue"	1	103	37	140
"N76"	"L73"	"Other inflammation of vagina and vulva"	"Other follicular disorders"	1	566	287	853
"N76"	"L90"	"Other inflammation of vagina and vulva"	"Atrophic disorders of skin"	1	471	250	721
"N76"	"M51"	"Other inflammation of vagina and vulva"	"Thoracic, thoracolum, and lumbosacral intvrt disc disorders"	1	434	272	706
"N76"	"M81"	"Other inflammation of vagina and vulva"	"Osteoporosis without current pathological fracture"	1	397	94	491
"N76"	"O72"	"Other inflammation of vagina and vulva"	"Postpartum hemorrhage"	1	1523	395	1918
"N80"	"A41"	"Endometriosis"	"Other sepsis"	1	186	23	209
"N80"	"A46"	"Endometriosis"	"Erysipelas"	1	85	6	91
"N80"	"C50"	"Endometriosis"	"Malignant neoplasm of breast"	1	301	11	312
"N80"	"D63"	"Endometriosis"	"Anemia in chronic diseases classified elsewhere"	1	34	4	38
"N80"	"E04"	"Endometriosis"	"Other nontoxic goiter"	1	332	113	445
"N80"	"E05"	"Endometriosis"	"Thyrotoxicosis [hyperthyroidism]"	1	269	100	369
"N80"	"E11"	"Endometriosis"	"Type 2 diabetes mellitus"	1	280	61	341
"N80"	"E78"	"Endometriosis"	"Disorders of lipoprotein metabolism and other lipidemias"	1	388	0	388
"N80"	"E86"	"Endometriosis"	"Volume depletion"	1	161	23	184
"N80"	"F52"	"Endometriosis"	"Sexual dysfnct not due to a substance or known physiol cond"	1	85	26	111
"N80"	"G45"	"Endometriosis"	"Transient cerebral ischemic attacks and related syndromes"	1	125	11	136
"N80"	"G47"	"Endometriosis"	"Sleep disorders"	1	214	0	214
"N80"	"G56"	"Endometriosis"	"Mononeuropathies of upper limb"	1	550	117	667
"N80"	"G62"	"Endometriosis"	"Other and unspecified polyneuropathies"	1	74	0	74
"N80"	"G95"	"Endometriosis"	"Other and unspecified diseases of spinal cord"	1	26	0	26
"N80"	"H26"	"Endometriosis"	"Other cataract"	1	112	10	122
"N80"	"H52"	"Endometriosis"	"Disorders of refraction and accommodation"	1	190	82	272
"N80"	"H57"	"Endometriosis"	"Other disorders of eye and adnexa"	1	105	5	110
"N80"	"H90"	"Endometriosis"	"Conductive and sensorineural hearing loss"	1	114	36	150
"N80"	"H93"	"Endometriosis"	"Other disorders of ear, not elsewhere classified"	1	173	25	198
"N80"	"I20"	"Endometriosis"	"Angina pectoris"	1	291	11	302
"N80"	"I42"	"Endometriosis"	"Cardiomyopathy"	1	29	0	29
"N80"	"I50"	"Endometriosis"	"Heart failure"	1	123	27	150
"N80"	"I61"	"Endometriosis"	"Nontraumatic intracerebral hemorrhage"	1	31	0	31
"N80"	"I83"	"Endometriosis"	"Varicose veins of lower extremities"	1	308	163	471
"N80"	"J18"	"Endometriosis"	"Pneumonia, unspecified organism"	1	470	101	571
"N80"	"J84"	"Endometriosis"	"Other interstitial pulmonary diseases"	1	24	1	25
"N80"	"J96"	"Endometriosis"	"Respiratory failure, not elsewhere classified"	1	129	0	129
"N80"	"K22"	"Endometriosis"	"Other diseases of esophagus"	1	60	13	73
"N80"	"L08"	"Endometriosis"	"Other local infections of skin and subcutaneous tissue"	1	140	64	204
"N80"	"M05"	"Endometriosis"	"Rheumatoid arthritis with rheumatoid factor"	1	83	8	91
"N80"	"M06"	"Endometriosis"	"Other rheumatoid arthritis"	1	113	24	137
"N80"	"M07"	"Endometriosis"	"Enteropathic arthropathies"	1	68	6	74
"N80"	"M13"	"Endometriosis"	"Other arthritis"	1	113	28	141
"N80"	"M17"	"Endometriosis"	"Osteoarthritis of knee"	1	472	0	472
"N80"	"M25"	"Endometriosis"	"Other joint disorder, not elsewhere classified"	1	404	101	505
"N80"	"M46"	"Endometriosis"	"Other inflammatory spondylopathies"	1	63	13	76
"N80"	"M48"	"Endometriosis"	"Other spondylopathies"	1	156	0	156
"N80"	"M50"	"Endometriosis"	"Cervical disc disorders"	1	294	52	346
"N80"	"M51"	"Endometriosis"	"Thoracic, thoracolum, and lumbosacral intvrt disc disorders"	1	639	223	862
"N80"	"M54"	"Endometriosis"	"Dorsalgia"	1	854	624	1478
"N80"	"M70"	"Endometriosis"	"Soft tissue disorders related to use, overuse and pressure"	1	238	42	280
"N80"	"M75"	"Endometriosis"	"Shoulder lesions"	1	988	106	1094
"N80"	"M76"	"Endometriosis"	"Enthesopathies, lower limb, excluding foot"	1	199	78	277
"N80"	"M77"	"Endometriosis"	"Other enthesopathies"	1	266	84	350
"N80"	"M79"	"Endometriosis"	"Oth and unsp soft tissue disorders, not elsewhere classified"	1	839	426	1265
"N80"	"M81"	"Endometriosis"	"Osteoporosis without current pathological fracture"	1	248	0	248
"N80"	"N17"	"Endometriosis"	"Acute kidney failure"	1	35	0	35
"N80"	"N18"	"Endometriosis"	"Chronic kidney disease (CKD)"	1	81	5	86
"N80"	"N32"	"Endometriosis"	"Other disorders of bladder"	1	53	13	66
"N80"	"N64"	"Endometriosis"	"Other disorders of breast"	1	246	128	374
"N80"	"O30"	"Endometriosis"	"Multiple gestation"	1	573	315	888
"N80"	"O70"	"Endometriosis"	"Perineal laceration during delivery"	1	1856	1491	3347
"N80"	"O72"	"Endometriosis"	"Postpartum hemorrhage"	1	2799	710	3509
"N81"	"A04"	"Female genital prolapse"	"Other bacterial intestinal infections"	1	342	11	353
"N81"	"A41"	"Female genital prolapse"	"Other sepsis"	1	1837	0	1837
"N81"	"A49"	"Female genital prolapse"	"Bacterial infection of unspecified site"	1	801	0	801
"N81"	"B02"	"Female genital prolapse"	"Zoster [herpes zoster]"	1	225	60	285
"N81"	"B99"	"Female genital prolapse"	"Other and unspecified infectious diseases"	1	46	6	52
"N81"	"C15"	"Female genital prolapse"	"Malignant neoplasm of esophagus"	1	83	0	83
"N81"	"C17"	"Female genital prolapse"	"Malignant neoplasm of small intestine"	1	33	1	34
"N81"	"C18"	"Female genital prolapse"	"Malignant neoplasm of colon"	1	958	85	1043
"N81"	"C20"	"Female genital prolapse"	"Malignant neoplasm of rectum"	1	312	55	367
"N81"	"C44"	"Female genital prolapse"	"Other and unspecified malignant neoplasm of skin"	1	1057	216	1273
"N81"	"C57"	"Female genital prolapse"	"Malignant neoplasm of other and unsp female genital organs"	1	54	3	57
"N81"	"C71"	"Female genital prolapse"	"Malignant neoplasm of brain"	1	130	2	132
"N81"	"C76"	"Female genital prolapse"	"Malignant neoplasm of other and ill-defined sites"	1	91	16	107
"N81"	"C78"	"Female genital prolapse"	"Secondary malignant neoplasm of resp and digestive organs"	1	1120	0	1120
"N81"	"C79"	"Female genital prolapse"	"Secondary malignant neoplasm of other and unspecified sites"	1	690	0	690
"N81"	"C80"	"Female genital prolapse"	"Malignant neoplasm without specification of site"	1	117	0	117
"N81"	"C88"	"Female genital prolapse"	"Malig immunoproliferative dis and certain oth B-cell lymph"	1	36	2	38
"N81"	"C90"	"Female genital prolapse"	"Multiple myeloma and malignant plasma cell neoplasms"	1	132	29	161
"N81"	"C91"	"Female genital prolapse"	"Lymphoid leukemia"	1	117	28	145
"N81"	"C92"	"Female genital prolapse"	"Myeloid leukemia"	1	104	8	112
"N81"	"D09"	"Female genital prolapse"	"Carcinoma in situ of other and unspecified sites"	1	47	0	47
"N81"	"D13"	"Female genital prolapse"	"Benign neoplasm of and ill-defined parts of digestive system"	1	190	75	265
"N81"	"D32"	"Female genital prolapse"	"Benign neoplasm of meninges"	1	139	51	190
"N81"	"D35"	"Female genital prolapse"	"Benign neoplasm of other and unspecified endocrine glands"	1	125	38	163
"N81"	"D43"	"Female genital prolapse"	"Neoplasm of uncertain behavior of brain and cnsl"	1	77	20	97
"N81"	"D47"	"Female genital prolapse"	"Oth neoplm of uncrt behav of lymphoid, hematpoetc & rel tiss"	1	238	23	261
"N81"	"D51"	"Female genital prolapse"	"Vitamin B12 deficiency anemia"	1	181	86	267
"N81"	"D62"	"Female genital prolapse"	"Acute posthemorrhagic anemia"	1	402	53	455
"N81"	"D64"	"Female genital prolapse"	"Other anemias"	1	2728	0	2728
"N81"	"D69"	"Female genital prolapse"	"Purpura and other hemorrhagic conditions"	1	227	70	297
"N81"	"D72"	"Female genital prolapse"	"Other disorders of white blood cells"	1	78	19	97
"N81"	"E10"	"Female genital prolapse"	"Type 1 diabetes mellitus"	1	963	568	1531
"N81"	"E27"	"Female genital prolapse"	"Other disorders of adrenal gland"	1	109	18	127
"N81"	"E34"	"Female genital prolapse"	"Other endocrine disorders"	1	93	17	110
"N81"	"E61"	"Female genital prolapse"	"Deficiency of other nutrient elements"	1	41	3	44
"N81"	"E64"	"Female genital prolapse"	"Sequelae of malnutrition and other nutritional deficiencies"	1	184	18	202
"N81"	"E83"	"Female genital prolapse"	"Disorders of mineral metabolism"	1	301	11	312
"N81"	"E86"	"Female genital prolapse"	"Volume depletion"	1	2935	0	2935
"N81"	"E89"	"Female genital prolapse"	"Postproc endocrine and metabolic comp and disorders, NEC"	1	169	77	246
"N81"	"F05"	"Female genital prolapse"	"Delirium due to known physiological condition"	1	408	0	408
"N81"	"F06"	"Female genital prolapse"	"Other mental disorders due to known physiological condition"	1	162	9	171
"N81"	"F31"	"Female genital prolapse"	"Bipolar disorder"	1	111	47	158
"N81"	"F32"	"Female genital prolapse"	"Depressive episode"	1	1288	376	1664
"N81"	"G12"	"Female genital prolapse"	"Spinal muscular atrophy and related syndromes"	1	51	2	53
"N81"	"G25"	"Female genital prolapse"	"Other extrapyramidal and movement disorders"	1	178	40	218
"N81"	"G30"	"Female genital prolapse"	"Alzheimer's disease"	1	407	0	407
"N81"	"G31"	"Female genital prolapse"	"Oth degenerative diseases of nervous system, NEC"	1	126	5	131
"N81"	"G45"	"Female genital prolapse"	"Transient cerebral ischemic attacks and related syndromes"	1	1215	512	1727
"N81"	"G47"	"Female genital prolapse"	"Sleep disorders"	1	712	103	815
"N81"	"G90"	"Female genital prolapse"	"Disorders of autonomic nervous system"	1	77	10	87
"N81"	"G91"	"Female genital prolapse"	"Hydrocephalus"	1	128	17	145
"N81"	"G93"	"Female genital prolapse"	"Other disorders of brain"	1	97	34	131
"N81"	"G95"	"Female genital prolapse"	"Other and unspecified diseases of spinal cord"	1	164	26	190
"N81"	"G96"	"Female genital prolapse"	"Other disorders of central nervous system"	1	503	39	542
"N81"	"H18"	"Female genital prolapse"	"Other disorders of cornea"	1	231	87	318
"N81"	"H26"	"Female genital prolapse"	"Other cataract"	1	1856	517	2373
"N81"	"H35"	"Female genital prolapse"	"Other retinal disorders"	1	2171	481	2652
"N81"	"H43"	"Female genital prolapse"	"Disorders of vitreous body"	1	484	237	721
"N81"	"H57"	"Female genital prolapse"	"Other disorders of eye and adnexa"	1	286	63	349
"N81"	"I10"	"Female genital prolapse"	"Essential (primary) hypertension"	1	12526	8914	21440
"N81"	"I26"	"Female genital prolapse"	"Pulmonary embolism"	1	817	70	887
"N81"	"I33"	"Female genital prolapse"	"Acute and subacute endocarditis"	1	45	4	49
"N81"	"I34"	"Female genital prolapse"	"Nonrheumatic mitral valve disorders"	1	519	86	605
"N81"	"I45"	"Female genital prolapse"	"Other conduction disorders"	1	204	80	284
"N81"	"I61"	"Female genital prolapse"	"Nontraumatic intracerebral hemorrhage"	1	473	31	504
"N81"	"I71"	"Female genital prolapse"	"Aortic aneurysm and dissection"	1	476	23	499
"N81"	"I72"	"Female genital prolapse"	"Other aneurysm"	1	79	26	105
"N81"	"I85"	"Female genital prolapse"	"Esophageal varices"	1	53	7	60
"N81"	"I87"	"Female genital prolapse"	"Other disorders of veins"	1	169	34	203
"N81"	"I89"	"Female genital prolapse"	"Oth noninfective disorders of lymphatic vessels and nodes"	1	174	48	222
"N81"	"I95"	"Female genital prolapse"	"Hypotension"	1	573	32	605
"N81"	"I97"	"Female genital prolapse"	"Intraop and postproc comp and disorders of circ sys, NEC"	1	83	22	105
"N81"	"J09"	"Female genital prolapse"	"Influenza due to certain identified influenza viruses"	1	57	0	57
"N81"	"J12"	"Female genital prolapse"	"Viral pneumonia, not elsewhere classified"	1	35	0	35
"N81"	"J13"	"Female genital prolapse"	"Pneumonia due to Streptococcus pneumoniae"	1	99	32	131
"N81"	"J15"	"Female genital prolapse"	"Bacterial pneumonia, not elsewhere classified"	1	1584	0	1584
"N81"	"J18"	"Female genital prolapse"	"Pneumonia, unspecified organism"	1	5258	0	5258
"N81"	"J43"	"Female genital prolapse"	"Emphysema"	1	159	63	222
"N81"	"J44"	"Female genital prolapse"	"Other chronic obstructive pulmonary disease"	1	2541	866	3407
"N81"	"J47"	"Female genital prolapse"	"Bronchiectasis"	1	195	25	220
"N81"	"J90"	"Female genital prolapse"	"Pleural effusion, not elsewhere classified"	1	275	0	275
"N81"	"J91"	"Female genital prolapse"	"Pleural effusion in conditions classified elsewhere"	1	144	0	144
"N81"	"J98"	"Female genital prolapse"	"Other respiratory disorders"	1	264	54	318
"N81"	"K21"	"Female genital prolapse"	"Gastro-esophageal reflux disease"	1	1173	905	2078
"N81"	"K25"	"Female genital prolapse"	"Gastric ulcer"	1	901	457	1358
"N81"	"K28"	"Female genital prolapse"	"Gastrojejunal ulcer"	1	50	4	54
"N81"	"K31"	"Female genital prolapse"	"Other diseases of stomach and duodenum"	1	187	27	214
"N81"	"K43"	"Female genital prolapse"	"Ventral hernia"	1	814	378	1192
"N81"	"K52"	"Female genital prolapse"	"Other and unsp noninfective gastroenteritis and colitis"	1	1068	270	1338
"N81"	"K59"	"Female genital prolapse"	"Other functional intestinal disorders"	1	4838	0	4838
"N81"	"K62"	"Female genital prolapse"	"Other diseases of anus and rectum"	1	2261	1005	3266
"N81"	"K64"	"Female genital prolapse"	"Hemorrhoids and perianal venous thrombosis"	1	1142	45	1187
"N81"	"K65"	"Female genital prolapse"	"Peritonitis"	1	272	63	335
"N81"	"K71"	"Female genital prolapse"	"Toxic liver disease"	1	68	19	87
"N81"	"K76"	"Female genital prolapse"	"Other diseases of liver"	1	315	144	459
"N81"	"K81"	"Female genital prolapse"	"Cholecystitis"	1	331	155	486
"N81"	"K83"	"Female genital prolapse"	"Other diseases of biliary tract"	1	303	69	372
"N81"	"K86"	"Female genital prolapse"	"Other diseases of pancreas"	1	127	48	175
"N81"	"L08"	"Female genital prolapse"	"Other local infections of skin and subcutaneous tissue"	1	329	149	478
"N81"	"L30"	"Female genital prolapse"	"Other and unspecified dermatitis"	1	360	170	530
"N81"	"L82"	"Female genital prolapse"	"Seborrheic keratosis"	1	182	46	228
"N81"	"L90"	"Female genital prolapse"	"Atrophic disorders of skin"	1	888	561	1449
"N81"	"M10"	"Female genital prolapse"	"Gout"	1	334	76	410
"N81"	"M13"	"Female genital prolapse"	"Other arthritis"	1	398	179	577
"N81"	"M17"	"Female genital prolapse"	"Osteoarthritis of knee"	1	3033	2123	5156
"N81"	"M18"	"Female genital prolapse"	"Osteoarthritis of first carpometacarpal joint"	1	425	201	626
"N81"	"M31"	"Female genital prolapse"	"Other necrotizing vasculopathies"	1	246	122	368
"N81"	"M43"	"Female genital prolapse"	"Other deforming dorsopathies"	1	429	261	690
"N81"	"M47"	"Female genital prolapse"	"Spondylosis"	1	1060	724	1784
"N81"	"M72"	"Female genital prolapse"	"Fibroblastic disorders"	1	388	252	640
"N81"	"M75"	"Female genital prolapse"	"Shoulder lesions"	1	2075	1503	3578
"N81"	"M80"	"Female genital prolapse"	"Osteoporosis with current pathological fracture"	1	1909	0	1909
"N81"	"M81"	"Female genital prolapse"	"Osteoporosis without current pathological fracture"	1	4704	0	4704
"N81"	"M85"	"Female genital prolapse"	"Other disorders of bone density and structure"	1	1628	326	1954
"N81"	"M87"	"Female genital prolapse"	"Osteonecrosis"	1	68	11	79
"N81"	"M99"	"Female genital prolapse"	"Biomechanical lesions, not elsewhere classified"	1	266	116	382
"N81"	"N19"	"Female genital prolapse"	"Unspecified kidney failure"	1	405	39	444
"N81"	"N28"	"Female genital prolapse"	"Oth disorders of kidney and ureter, not elsewhere classified"	1	207	54	261
"N81"	"N39"	"Female genital prolapse"	"Other disorders of urinary system"	1	10494	9595	20089
"N81"	"N89"	"Female genital prolapse"	"Other noninflammatory disorders of vagina"	1	701	401	1102
"N81"	"N99"	"Female genital prolapse"	"Intraop and postproc comp and disorders of GU sys, NEC"	1	3041	958	3999
"N81"	"Q51"	"Female genital prolapse"	"Congenital malformations of uterus and cervix"	1	419	254	673
"N82"	"E87"	"Fistulae involving female genital tract"	"Other disorders of fluid, electrolyte and acid-base balance"	1	112	46	158
"N83"	"C15"	"Noninflammatory disord of ovary, fallop and broad ligament"	"Malignant neoplasm of esophagus"	1	25	1	26
"N83"	"C34"	"Noninflammatory disord of ovary, fallop and broad ligament"	"Malignant neoplasm of bronchus and lung"	1	340	14	354
"N83"	"C44"	"Noninflammatory disord of ovary, fallop and broad ligament"	"Other and unspecified malignant neoplasm of skin"	1	346	72	418
"N83"	"C56"	"Noninflammatory disord of ovary, fallop and broad ligament"	"Malignant neoplasm of ovary"	1	1260	359	1619
"N83"	"C57"	"Noninflammatory disord of ovary, fallop and broad ligament"	"Malignant neoplasm of other and unsp female genital organs"	1	108	23	131
"N83"	"C71"	"Noninflammatory disord of ovary, fallop and broad ligament"	"Malignant neoplasm of brain"	1	68	5	73
"N83"	"C78"	"Noninflammatory disord of ovary, fallop and broad ligament"	"Secondary malignant neoplasm of resp and digestive organs"	1	690	45	735
"N83"	"D64"	"Noninflammatory disord of ovary, fallop and broad ligament"	"Other anemias"	1	882	411	1293
"N83"	"E04"	"Noninflammatory disord of ovary, fallop and broad ligament"	"Other nontoxic goiter"	1	692	471	1163
"N83"	"E05"	"Noninflammatory disord of ovary, fallop and broad ligament"	"Thyrotoxicosis [hyperthyroidism]"	1	620	398	1018
"N83"	"E11"	"Noninflammatory disord of ovary, fallop and broad ligament"	"Type 2 diabetes mellitus"	1	882	501	1383
"N83"	"E23"	"Noninflammatory disord of ovary, fallop and broad ligament"	"Hypofunction and other disorders of the pituitary gland"	1	95	20	115
"N83"	"E41"	"Noninflammatory disord of ovary, fallop and broad ligament"	"Nutritional marasmus"	1	30	0	30
"N83"	"F03"	"Noninflammatory disord of ovary, fallop and broad ligament"	"Unspecified dementia"	1	249	28	277
"N83"	"F32"	"Noninflammatory disord of ovary, fallop and broad ligament"	"Depressive episode"	1	592	305	897
"N83"	"G44"	"Noninflammatory disord of ovary, fallop and broad ligament"	"Other headache syndromes"	1	498	327	825
"N83"	"G47"	"Noninflammatory disord of ovary, fallop and broad ligament"	"Sleep disorders"	1	669	67	736
"N83"	"G56"	"Noninflammatory disord of ovary, fallop and broad ligament"	"Mononeuropathies of upper limb"	1	1093	579	1672
"N83"	"G91"	"Noninflammatory disord of ovary, fallop and broad ligament"	"Hydrocephalus"	1	54	13	67
"N83"	"G93"	"Noninflammatory disord of ovary, fallop and broad ligament"	"Other disorders of brain"	1	111	36	147
"N83"	"G95"	"Noninflammatory disord of ovary, fallop and broad ligament"	"Other and unspecified diseases of spinal cord"	1	120	11	131
"N83"	"H25"	"Noninflammatory disord of ovary, fallop and broad ligament"	"Age-related cataract"	1	1175	584	1759
"N83"	"H26"	"Noninflammatory disord of ovary, fallop and broad ligament"	"Other cataract"	1	413	214	627
"N83"	"H35"	"Noninflammatory disord of ovary, fallop and broad ligament"	"Other retinal disorders"	1	431	189	620
"N83"	"H43"	"Noninflammatory disord of ovary, fallop and broad ligament"	"Disorders of vitreous body"	1	197	45	242
"N83"	"H53"	"Noninflammatory disord of ovary, fallop and broad ligament"	"Visual disturbances"	1	272	92	364
"N83"	"H57"	"Noninflammatory disord of ovary, fallop and broad ligament"	"Other disorders of eye and adnexa"	1	262	61	323
"N83"	"H81"	"Noninflammatory disord of ovary, fallop and broad ligament"	"Disorders of vestibular function"	1	400	222	622
"N83"	"I25"	"Noninflammatory disord of ovary, fallop and broad ligament"	"Chronic ischemic heart disease"	1	651	373	1024
"N83"	"I26"	"Noninflammatory disord of ovary, fallop and broad ligament"	"Pulmonary embolism"	1	321	139	460
"N83"	"I48"	"Noninflammatory disord of ovary, fallop and broad ligament"	"Atrial fibrillation and flutter"	1	859	334	1193
"N83"	"I49"	"Noninflammatory disord of ovary, fallop and broad ligament"	"Other cardiac arrhythmias"	1	460	196	656
"N83"	"I61"	"Noninflammatory disord of ovary, fallop and broad ligament"	"Nontraumatic intracerebral hemorrhage"	1	146	20	166
"N83"	"I63"	"Noninflammatory disord of ovary, fallop and broad ligament"	"Cerebral infarction"	1	482	133	615
"N83"	"I73"	"Noninflammatory disord of ovary, fallop and broad ligament"	"Other peripheral vascular diseases"	1	230	127	357
"N83"	"I95"	"Noninflammatory disord of ovary, fallop and broad ligament"	"Hypotension"	1	193	63	256
"N83"	"I97"	"Noninflammatory disord of ovary, fallop and broad ligament"	"Intraop and postproc comp and disorders of circ sys, NEC"	1	48	7	55
"N83"	"J15"	"Noninflammatory disord of ovary, fallop and broad ligament"	"Bacterial pneumonia, not elsewhere classified"	1	654	123	777
"N83"	"J43"	"Noninflammatory disord of ovary, fallop and broad ligament"	"Emphysema"	1	79	21	100
"N83"	"J44"	"Noninflammatory disord of ovary, fallop and broad ligament"	"Other chronic obstructive pulmonary disease"	1	937	360	1297
"N83"	"J47"	"Noninflammatory disord of ovary, fallop and broad ligament"	"Bronchiectasis"	1	109	12	121
"N83"	"J69"	"Noninflammatory disord of ovary, fallop and broad ligament"	"Pneumonitis due to solids and liquids"	1	67	4	71
"N83"	"J81"	"Noninflammatory disord of ovary, fallop and broad ligament"	"Pulmonary edema"	1	76	18	94
"N83"	"J91"	"Noninflammatory disord of ovary, fallop and broad ligament"	"Pleural effusion in conditions classified elsewhere"	1	79	13	92
"N83"	"K21"	"Noninflammatory disord of ovary, fallop and broad ligament"	"Gastro-esophageal reflux disease"	1	822	446	1268
"N83"	"K43"	"Noninflammatory disord of ovary, fallop and broad ligament"	"Ventral hernia"	1	980	296	1276
"N83"	"K52"	"Noninflammatory disord of ovary, fallop and broad ligament"	"Other and unsp noninfective gastroenteritis and colitis"	1	639	324	963
"N83"	"K83"	"Noninflammatory disord of ovary, fallop and broad ligament"	"Other diseases of biliary tract"	1	147	68	215
"N83"	"K86"	"Noninflammatory disord of ovary, fallop and broad ligament"	"Other diseases of pancreas"	1	147	50	197
"N83"	"K92"	"Noninflammatory disord of ovary, fallop and broad ligament"	"Other diseases of digestive system"	1	380	167	547
"N83"	"L30"	"Noninflammatory disord of ovary, fallop and broad ligament"	"Other and unspecified dermatitis"	1	299	114	413
"N83"	"L97"	"Noninflammatory disord of ovary, fallop and broad ligament"	"Non-pressure chronic ulcer of lower limb, NEC"	1	134	29	163
"N83"	"M16"	"Noninflammatory disord of ovary, fallop and broad ligament"	"Osteoarthritis of hip"	1	621	271	892
"N83"	"M17"	"Noninflammatory disord of ovary, fallop and broad ligament"	"Osteoarthritis of knee"	1	1281	417	1698
"N83"	"M18"	"Noninflammatory disord of ovary, fallop and broad ligament"	"Osteoarthritis of first carpometacarpal joint"	1	251	30	281
"N83"	"M19"	"Noninflammatory disord of ovary, fallop and broad ligament"	"Other and unspecified osteoarthritis"	1	858	185	1043
"N83"	"M48"	"Noninflammatory disord of ovary, fallop and broad ligament"	"Other spondylopathies"	1	608	149	757
"N83"	"M70"	"Noninflammatory disord of ovary, fallop and broad ligament"	"Soft tissue disorders related to use, overuse and pressure"	1	524	242	766
"N83"	"M75"	"Noninflammatory disord of ovary, fallop and broad ligament"	"Shoulder lesions"	1	2010	707	2717
"N83"	"M76"	"Noninflammatory disord of ovary, fallop and broad ligament"	"Enthesopathies, lower limb, excluding foot"	1	396	244	640
"N83"	"M77"	"Noninflammatory disord of ovary, fallop and broad ligament"	"Other enthesopathies"	1	597	335	932
"N83"	"M79"	"Noninflammatory disord of ovary, fallop and broad ligament"	"Oth and unsp soft tissue disorders, not elsewhere classified"	1	2003	1390	3393
"N83"	"M81"	"Noninflammatory disord of ovary, fallop and broad ligament"	"Osteoporosis without current pathological fracture"	1	1064	248	1312
"N83"	"M85"	"Noninflammatory disord of ovary, fallop and broad ligament"	"Other disorders of bone density and structure"	1	811	76	887
"N83"	"N17"	"Noninflammatory disord of ovary, fallop and broad ligament"	"Acute kidney failure"	1	160	37	197
"N83"	"O72"	"Noninflammatory disord of ovary, fallop and broad ligament"	"Postpartum hemorrhage"	1	4605	1917	6522
"N84"	"A04"	"Polyp of female genital tract"	"Other bacterial intestinal infections"	1	105	29	134
"N84"	"A41"	"Polyp of female genital tract"	"Other sepsis"	1	529	56	585
"N84"	"A49"	"Polyp of female genital tract"	"Bacterial infection of unspecified site"	1	283	38	321
"N84"	"C16"	"Polyp of female genital tract"	"Malignant neoplasm of stomach"	1	39	0	39
"N84"	"C22"	"Polyp of female genital tract"	"Malignant neoplasm of liver and intrahepatic bile ducts"	1	30	0	30
"N84"	"C34"	"Polyp of female genital tract"	"Malignant neoplasm of bronchus and lung"	1	304	0	304
"N84"	"C44"	"Polyp of female genital tract"	"Other and unspecified malignant neoplasm of skin"	1	350	75	425
"N84"	"C54"	"Polyp of female genital tract"	"Malignant neoplasm of corpus uteri"	1	1319	211	1530
"N84"	"C55"	"Polyp of female genital tract"	"Malignant neoplasm of uterus, part unspecified"	1	81	10	91
"N84"	"C78"	"Polyp of female genital tract"	"Secondary malignant neoplasm of resp and digestive organs"	1	500	0	500
"N84"	"C79"	"Polyp of female genital tract"	"Secondary malignant neoplasm of other and unspecified sites"	1	355	3	358
"N84"	"D07"	"Polyp of female genital tract"	"Carcinoma in situ of other and unspecified genital organs"	1	592	202	794
"N84"	"E55"	"Polyp of female genital tract"	"Vitamin D deficiency"	1	118	36	154
"N84"	"E64"	"Polyp of female genital tract"	"Sequelae of malnutrition and other nutritional deficiencies"	1	66	11	77
"N84"	"E83"	"Polyp of female genital tract"	"Disorders of mineral metabolism"	1	118	8	126
"N84"	"F01"	"Polyp of female genital tract"	"Vascular dementia"	1	32	1	33
"N84"	"F06"	"Polyp of female genital tract"	"Other mental disorders due to known physiological condition"	1	55	7	62
"N84"	"F41"	"Polyp of female genital tract"	"Other anxiety disorders"	1	260	121	381
"N84"	"G31"	"Polyp of female genital tract"	"Oth degenerative diseases of nervous system, NEC"	1	35	4	39
"N84"	"G62"	"Polyp of female genital tract"	"Other and unspecified polyneuropathies"	1	157	33	190
"N84"	"G96"	"Polyp of female genital tract"	"Other disorders of central nervous system"	1	250	45	295
"N84"	"H43"	"Polyp of female genital tract"	"Disorders of vitreous body"	1	210	94	304
"N84"	"H57"	"Polyp of female genital tract"	"Other disorders of eye and adnexa"	1	171	55	226
"N84"	"I21"	"Polyp of female genital tract"	"Acute myocardial infarction"	1	292	165	457
"N84"	"I31"	"Polyp of female genital tract"	"Other diseases of pericardium"	1	38	4	42
"N84"	"I46"	"Polyp of female genital tract"	"Cardiac arrest"	1	91	0	91
"N84"	"I48"	"Polyp of female genital tract"	"Atrial fibrillation and flutter"	1	932	376	1308
"N84"	"I69"	"Polyp of female genital tract"	"Sequelae of cerebrovascular disease"	1	442	133	575
"N84"	"I71"	"Polyp of female genital tract"	"Aortic aneurysm and dissection"	1	103	9	112
"N84"	"J09"	"Polyp of female genital tract"	"Influenza due to certain identified influenza viruses"	1	25	0	25
"N84"	"J15"	"Polyp of female genital tract"	"Bacterial pneumonia, not elsewhere classified"	1	422	49	471
"N84"	"J44"	"Polyp of female genital tract"	"Other chronic obstructive pulmonary disease"	1	653	302	955
"N84"	"J69"	"Polyp of female genital tract"	"Pneumonitis due to solids and liquids"	1	35	0	35
"N84"	"J90"	"Polyp of female genital tract"	"Pleural effusion, not elsewhere classified"	1	132	4	136
"N84"	"J91"	"Polyp of female genital tract"	"Pleural effusion in conditions classified elsewhere"	1	47	3	50
"N84"	"K55"	"Polyp of female genital tract"	"Vascular disorders of intestine"	1	49	10	59
"N84"	"K56"	"Polyp of female genital tract"	"Paralytic ileus and intestinal obstruction without hernia"	1	318	83	401
"N84"	"K62"	"Polyp of female genital tract"	"Other diseases of anus and rectum"	1	524	316	840
"N84"	"K63"	"Polyp of female genital tract"	"Other diseases of intestine"	1	120	29	149
"N84"	"K92"	"Polyp of female genital tract"	"Other diseases of digestive system"	1	212	92	304
"N84"	"L89"	"Polyp of female genital tract"	"Pressure ulcer"	1	69	8	77
"N84"	"L97"	"Polyp of female genital tract"	"Non-pressure chronic ulcer of lower limb, NEC"	1	95	26	121
"N84"	"M15"	"Polyp of female genital tract"	"Polyosteoarthritis"	1	206	89	295
"N84"	"M16"	"Polyp of female genital tract"	"Osteoarthritis of hip"	1	723	329	1052
"N84"	"M17"	"Polyp of female genital tract"	"Osteoarthritis of knee"	1	1409	765	2174
"N84"	"M47"	"Polyp of female genital tract"	"Spondylosis"	1	507	257	764
"N84"	"M48"	"Polyp of female genital tract"	"Other spondylopathies"	1	591	144	735
"N84"	"M80"	"Polyp of female genital tract"	"Osteoporosis with current pathological fracture"	1	289	25	314
"N84"	"M81"	"Polyp of female genital tract"	"Osteoporosis without current pathological fracture"	1	1004	149	1153
"N84"	"M85"	"Polyp of female genital tract"	"Other disorders of bone density and structure"	1	720	74	794
"N84"	"N13"	"Polyp of female genital tract"	"Obstructive and reflux uropathy"	1	173	84	257
"N84"	"N19"	"Polyp of female genital tract"	"Unspecified kidney failure"	1	88	30	118
"N84"	"N28"	"Polyp of female genital tract"	"Oth disorders of kidney and ureter, not elsewhere classified"	1	76	24	100
"N84"	"N30"	"Polyp of female genital tract"	"Cystitis"	1	1220	903	2123
"N84"	"N39"	"Polyp of female genital tract"	"Other disorders of urinary system"	1	1622	1063	2685
"N85"	"C34"	"Other noninflammatory disorders of uterus, except cervix"	"Malignant neoplasm of bronchus and lung"	1	58	0	58
"N85"	"C54"	"Other noninflammatory disorders of uterus, except cervix"	"Malignant neoplasm of corpus uteri"	1	453	105	558
"N85"	"C79"	"Other noninflammatory disorders of uterus, except cervix"	"Secondary malignant neoplasm of other and unspecified sites"	1	60	0	60
"N85"	"E87"	"Other noninflammatory disorders of uterus, except cervix"	"Other disorders of fluid, electrolyte and acid-base balance"	1	89	0	89
"N85"	"I21"	"Other noninflammatory disorders of uterus, except cervix"	"Acute myocardial infarction"	1	101	19	120
"N85"	"I25"	"Other noninflammatory disorders of uterus, except cervix"	"Chronic ischemic heart disease"	1	161	58	219
"N85"	"I63"	"Other noninflammatory disorders of uterus, except cervix"	"Cerebral infarction"	1	105	20	125
"N85"	"I73"	"Other noninflammatory disorders of uterus, except cervix"	"Other peripheral vascular diseases"	1	45	2	47
"N85"	"J15"	"Other noninflammatory disorders of uterus, except cervix"	"Bacterial pneumonia, not elsewhere classified"	1	93	0	93
"N85"	"J18"	"Other noninflammatory disorders of uterus, except cervix"	"Pneumonia, unspecified organism"	1	304	49	353
"N85"	"J90"	"Other noninflammatory disorders of uterus, except cervix"	"Pleural effusion, not elsewhere classified"	1	25	1	26
"N85"	"J96"	"Other noninflammatory disorders of uterus, except cervix"	"Respiratory failure, not elsewhere classified"	1	111	1	112
"N85"	"M16"	"Other noninflammatory disorders of uterus, except cervix"	"Osteoarthritis of hip"	1	147	32	179
"N85"	"M47"	"Other noninflammatory disorders of uterus, except cervix"	"Spondylosis"	1	111	24	135
"N85"	"M75"	"Other noninflammatory disorders of uterus, except cervix"	"Shoulder lesions"	1	305	74	379
"N85"	"M79"	"Other noninflammatory disorders of uterus, except cervix"	"Oth and unsp soft tissue disorders, not elsewhere classified"	1	267	131	398
"N85"	"M80"	"Other noninflammatory disorders of uterus, except cervix"	"Osteoporosis with current pathological fracture"	1	57	0	57
"N85"	"M85"	"Other noninflammatory disorders of uterus, except cervix"	"Other disorders of bone density and structure"	1	102	0	102
"N87"	"A41"	"Dysplasia of cervix uteri"	"Other sepsis"	1	263	5	268
"N87"	"A49"	"Dysplasia of cervix uteri"	"Bacterial infection of unspecified site"	1	183	27	210
"N87"	"C34"	"Dysplasia of cervix uteri"	"Malignant neoplasm of bronchus and lung"	1	161	0	161
"N87"	"C53"	"Dysplasia of cervix uteri"	"Malignant neoplasm of cervix uteri"	1	1019	305	1324
"N87"	"C77"	"Dysplasia of cervix uteri"	"Secondary and unspecified malignant neoplasm of lymph nodes"	1	158	0	158
"N87"	"D12"	"Dysplasia of cervix uteri"	"Benign neoplasm of colon, rectum, anus and anal canal"	1	441	0	441
"N87"	"D13"	"Dysplasia of cervix uteri"	"Benign neoplasm of and ill-defined parts of digestive system"	1	46	1	47
"N87"	"D21"	"Dysplasia of cervix uteri"	"Other benign neoplasms of connective and other soft tissue"	1	83	19	102
"N87"	"D22"	"Dysplasia of cervix uteri"	"Melanocytic nevi"	1	310	94	404
"N87"	"D23"	"Dysplasia of cervix uteri"	"Other benign neoplasms of skin"	1	277	112	389
"N87"	"D24"	"Dysplasia of cervix uteri"	"Benign neoplasm of breast"	1	418	237	655
"N87"	"D35"	"Dysplasia of cervix uteri"	"Benign neoplasm of other and unspecified endocrine glands"	1	58	0	58
"N87"	"D50"	"Dysplasia of cervix uteri"	"Iron deficiency anemia"	1	167	43	210
"N87"	"D68"	"Dysplasia of cervix uteri"	"Other coagulation defects"	1	167	79	246
"N87"	"E04"	"Dysplasia of cervix uteri"	"Other nontoxic goiter"	1	489	99	588
"N87"	"E05"	"Dysplasia of cervix uteri"	"Thyrotoxicosis [hyperthyroidism]"	1	435	106	541
"N87"	"E27"	"Dysplasia of cervix uteri"	"Other disorders of adrenal gland"	1	48	2	50
"N87"	"E64"	"Dysplasia of cervix uteri"	"Sequelae of malnutrition and other nutritional deficiencies"	1	40	0	40
"N87"	"E78"	"Dysplasia of cervix uteri"	"Disorders of lipoprotein metabolism and other lipidemias"	1	577	0	577
"N87"	"E86"	"Dysplasia of cervix uteri"	"Volume depletion"	1	248	0	248
"N87"	"E87"	"Dysplasia of cervix uteri"	"Other disorders of fluid, electrolyte and acid-base balance"	1	193	0	193
"N87"	"E89"	"Dysplasia of cervix uteri"	"Postproc endocrine and metabolic comp and disorders, NEC"	1	66	11	77
"N87"	"F33"	"Dysplasia of cervix uteri"	"Major depressive disorder, recurrent"	1	308	76	384
"N87"	"F41"	"Dysplasia of cervix uteri"	"Other anxiety disorders"	1	306	66	372
"N87"	"G45"	"Dysplasia of cervix uteri"	"Transient cerebral ischemic attacks and related syndromes"	1	184	2	186
"N87"	"G50"	"Dysplasia of cervix uteri"	"Disorders of trigeminal nerve"	1	76	12	88
"N87"	"G54"	"Dysplasia of cervix uteri"	"Nerve root and plexus disorders"	1	52	12	64
"N87"	"G55"	"Dysplasia of cervix uteri"	"Nerve root and plexus compressions in diseases classd elswhr"	1	24	1	25
"N87"	"G57"	"Dysplasia of cervix uteri"	"Mononeuropathies of lower limb"	1	146	33	179
"N87"	"G95"	"Dysplasia of cervix uteri"	"Other and unspecified diseases of spinal cord"	1	40	0	40
"N87"	"G98"	"Dysplasia of cervix uteri"	"Other disorders of nervous system not elsewhere classified"	1	106	5	111
"N87"	"H02"	"Dysplasia of cervix uteri"	"Other disorders of eyelid"	1	267	20	287
"N87"	"H25"	"Dysplasia of cervix uteri"	"Age-related cataract"	1	431	0	431
"N87"	"H35"	"Dysplasia of cervix uteri"	"Other retinal disorders"	1	161	0	161
"N87"	"H36"	"Dysplasia of cervix uteri"	"Retinal disorders in diseases classified elsewhere"	1	79	9	88
"N87"	"H40"	"Dysplasia of cervix uteri"	"Glaucoma"	1	75	9	84
"N87"	"H43"	"Dysplasia of cervix uteri"	"Disorders of vitreous body"	1	100	2	102
"N87"	"H52"	"Dysplasia of cervix uteri"	"Disorders of refraction and accommodation"	1	295	138	433
"N87"	"H53"	"Dysplasia of cervix uteri"	"Visual disturbances"	1	157	35	192
"N87"	"H91"	"Dysplasia of cervix uteri"	"Other and unspecified hearing loss"	1	373	28	401
"N87"	"H93"	"Dysplasia of cervix uteri"	"Other disorders of ear, not elsewhere classified"	1	234	36	270
"N87"	"I15"	"Dysplasia of cervix uteri"	"Secondary hypertension"	1	58	15	73
"N87"	"I20"	"Dysplasia of cervix uteri"	"Angina pectoris"	1	449	13	462
"N87"	"I21"	"Dysplasia of cervix uteri"	"Acute myocardial infarction"	1	200	0	200
"N87"	"I34"	"Dysplasia of cervix uteri"	"Nonrheumatic mitral valve disorders"	1	51	1	52
"N87"	"I46"	"Dysplasia of cervix uteri"	"Cardiac arrest"	1	58	0	58
"N87"	"I47"	"Dysplasia of cervix uteri"	"Paroxysmal tachycardia"	1	228	84	312
"N87"	"I49"	"Dysplasia of cervix uteri"	"Other cardiac arrhythmias"	1	242	28	270
"N87"	"I50"	"Dysplasia of cervix uteri"	"Heart failure"	1	192	0	192
"N87"	"I63"	"Dysplasia of cervix uteri"	"Cerebral infarction"	1	231	0	231
"N87"	"I67"	"Dysplasia of cervix uteri"	"Other cerebrovascular diseases"	1	66	5	71
"N87"	"I69"	"Dysplasia of cervix uteri"	"Sequelae of cerebrovascular disease"	1	208	0	208
"N87"	"I70"	"Dysplasia of cervix uteri"	"Atherosclerosis"	1	146	4	150
"N87"	"I73"	"Dysplasia of cervix uteri"	"Other peripheral vascular diseases"	1	189	4	193
"N87"	"I80"	"Dysplasia of cervix uteri"	"Phlebitis and thrombophlebitis"	1	297	91	388
"N87"	"I85"	"Dysplasia of cervix uteri"	"Esophageal varices"	1	26	0	26
"N87"	"I89"	"Dysplasia of cervix uteri"	"Oth noninfective disorders of lymphatic vessels and nodes"	1	94	7	101
"N87"	"I95"	"Dysplasia of cervix uteri"	"Hypotension"	1	62	4	66
"N87"	"J06"	"Dysplasia of cervix uteri"	"Acute upper resp infections of multiple and unsp sites"	1	130	11	141
"N87"	"J47"	"Dysplasia of cervix uteri"	"Bronchiectasis"	1	36	1	37
"N87"	"J90"	"Dysplasia of cervix uteri"	"Pleural effusion, not elsewhere classified"	1	52	0	52
"N87"	"K21"	"Dysplasia of cervix uteri"	"Gastro-esophageal reflux disease"	1	457	106	563
"N87"	"K25"	"Dysplasia of cervix uteri"	"Gastric ulcer"	1	184	35	219
"N87"	"K26"	"Dysplasia of cervix uteri"	"Duodenal ulcer"	1	85	30	115
"N87"	"K31"	"Dysplasia of cervix uteri"	"Other diseases of stomach and duodenum"	1	33	2	35
"N87"	"K43"	"Dysplasia of cervix uteri"	"Ventral hernia"	1	254	33	287
"N87"	"K59"	"Dysplasia of cervix uteri"	"Other functional intestinal disorders"	1	1016	211	1227
"N87"	"K60"	"Dysplasia of cervix uteri"	"Fissure and fistula of anal and rectal regions"	1	217	122	339
"N87"	"K63"	"Dysplasia of cervix uteri"	"Other diseases of intestine"	1	75	11	86
"N87"	"K64"	"Dysplasia of cervix uteri"	"Hemorrhoids and perianal venous thrombosis"	1	464	0	464
"N87"	"K74"	"Dysplasia of cervix uteri"	"Fibrosis and cirrhosis of liver"	1	61	1	62
"N87"	"K83"	"Dysplasia of cervix uteri"	"Other diseases of biliary tract"	1	59	15	74
"N87"	"K91"	"Dysplasia of cervix uteri"	"Intraop and postproc comp and disorders of dgstv sys, NEC"	1	59	8	67
"N87"	"L08"	"Dysplasia of cervix uteri"	"Other local infections of skin and subcutaneous tissue"	1	220	84	304
"N87"	"L40"	"Dysplasia of cervix uteri"	"Psoriasis"	1	142	57	199
"N87"	"L90"	"Dysplasia of cervix uteri"	"Atrophic disorders of skin"	1	392	186	578
"N87"	"L97"	"Dysplasia of cervix uteri"	"Non-pressure chronic ulcer of lower limb, NEC"	1	44	0	44
"N87"	"L98"	"Dysplasia of cervix uteri"	"Oth disorders of skin, subcu, not elsewhere classified"	1	161	43	204
"N87"	"M05"	"Dysplasia of cervix uteri"	"Rheumatoid arthritis with rheumatoid factor"	1	155	21	176
"N87"	"M07"	"Dysplasia of cervix uteri"	"Enteropathic arthropathies"	1	98	12	110
"N87"	"M15"	"Dysplasia of cervix uteri"	"Polyosteoarthritis"	1	86	0	86
"N87"	"M16"	"Dysplasia of cervix uteri"	"Osteoarthritis of hip"	1	325	0	325
"N87"	"M17"	"Dysplasia of cervix uteri"	"Osteoarthritis of knee"	1	706	0	706
"N87"	"M25"	"Dysplasia of cervix uteri"	"Other joint disorder, not elsewhere classified"	1	595	146	741
"N87"	"M51"	"Dysplasia of cervix uteri"	"Thoracic, thoracolum, and lumbosacral intvrt disc disorders"	1	1030	238	1268
"N87"	"M67"	"Dysplasia of cervix uteri"	"Other disorders of synovium and tendon"	1	545	338	883
"N87"	"M71"	"Dysplasia of cervix uteri"	"Other bursopathies"	1	80	25	105
"N87"	"M75"	"Dysplasia of cervix uteri"	"Shoulder lesions"	1	1430	108	1538
"N87"	"M77"	"Dysplasia of cervix uteri"	"Other enthesopathies"	1	494	96	590
"N87"	"M81"	"Dysplasia of cervix uteri"	"Osteoporosis without current pathological fracture"	1	397	0	397
"N87"	"M85"	"Dysplasia of cervix uteri"	"Other disorders of bone density and structure"	1	353	0	353
"N87"	"M99"	"Dysplasia of cervix uteri"	"Biomechanical lesions, not elsewhere classified"	1	122	18	140
"N87"	"N17"	"Dysplasia of cervix uteri"	"Acute kidney failure"	1	45	0	45
"N87"	"N18"	"Dysplasia of cervix uteri"	"Chronic kidney disease (CKD)"	1	108	18	126
"N87"	"N20"	"Dysplasia of cervix uteri"	"Calculus of kidney and ureter"	1	269	113	382
"N87"	"N60"	"Dysplasia of cervix uteri"	"Benign mammary dysplasia"	1	417	170	587
"N87"	"N61"	"Dysplasia of cervix uteri"	"Inflammatory disorders of breast"	1	150	47	197
"N87"	"N88"	"Dysplasia of cervix uteri"	"Other noninflammatory disorders of cervix uteri"	1	931	155	1086
"N87"	"N92"	"Dysplasia of cervix uteri"	"Excessive, frequent and irregular menstruation"	1	3764	1822	5586
"N87"	"N94"	"Dysplasia of cervix uteri"	"Pain and oth cond assoc w fem gntl org and menstrual cycle"	1	1227	822	2049
"N87"	"N95"	"Dysplasia of cervix uteri"	"Menopausal and other perimenopausal disorders"	1	634	131	765
"N87"	"O24"	"Dysplasia of cervix uteri"	"Diabetes in pregnancy, childbirth, and the puerperium"	1	382	193	575
"N87"	"O34"	"Dysplasia of cervix uteri"	"Maternal care for abnormality of pelvic organs"	1	3226	0	3226
"N87"	"O35"	"Dysplasia of cervix uteri"	"Maternal care for known or suspected fetal abnlt and damage"	1	227	109	336
"N87"	"O72"	"Dysplasia of cervix uteri"	"Postpartum hemorrhage"	1	7332	0	7332
"N87"	"O82"	"Dysplasia of cervix uteri"	"Encounter for cesarean delivery without indication"	1	2021	1574	3595
"N88"	"C34"	"Other noninflammatory disorders of cervix uteri"	"Malignant neoplasm of bronchus and lung"	1	25	0	25
"N88"	"D64"	"Other noninflammatory disorders of cervix uteri"	"Other anemias"	1	50	2	52
"N88"	"E87"	"Other noninflammatory disorders of cervix uteri"	"Other disorders of fluid, electrolyte and acid-base balance"	1	25	0	25
"N88"	"H25"	"Other noninflammatory disorders of cervix uteri"	"Age-related cataract"	1	108	2	110
"N88"	"I48"	"Other noninflammatory disorders of cervix uteri"	"Atrial fibrillation and flutter"	1	76	0	76
"N88"	"I50"	"Other noninflammatory disorders of cervix uteri"	"Heart failure"	1	34	0	34
"N88"	"J44"	"Other noninflammatory disorders of cervix uteri"	"Other chronic obstructive pulmonary disease"	1	60	2	62
"N88"	"K59"	"Other noninflammatory disorders of cervix uteri"	"Other functional intestinal disorders"	1	118	18	136
"N88"	"M19"	"Other noninflammatory disorders of cervix uteri"	"Other and unspecified osteoarthritis"	1	47	1	48
"N88"	"M75"	"Other noninflammatory disorders of cervix uteri"	"Shoulder lesions"	1	145	23	168
"N88"	"M81"	"Other noninflammatory disorders of cervix uteri"	"Osteoporosis without current pathological fracture"	1	94	0	94
"N89"	"C52"	"Other noninflammatory disorders of vagina"	"Malignant neoplasm of vagina"	1	51	9	60
"N89"	"O72"	"Other noninflammatory disorders of vagina"	"Postpartum hemorrhage"	1	353	199	552
"N90"	"C77"	"Other noninflammatory disorders of vulva and perineum"	"Secondary and unspecified malignant neoplasm of lymph nodes"	1	46	7	53
"N90"	"C79"	"Other noninflammatory disorders of vulva and perineum"	"Secondary malignant neoplasm of other and unspecified sites"	1	58	0	58
"N90"	"D50"	"Other noninflammatory disorders of vulva and perineum"	"Iron deficiency anemia"	1	89	22	111
"N90"	"E86"	"Other noninflammatory disorders of vulva and perineum"	"Volume depletion"	1	164	30	194
"N90"	"G47"	"Other noninflammatory disorders of vulva and perineum"	"Sleep disorders"	1	112	18	130
"N90"	"J15"	"Other noninflammatory disorders of vulva and perineum"	"Bacterial pneumonia, not elsewhere classified"	1	113	38	151
"N90"	"J18"	"Other noninflammatory disorders of vulva and perineum"	"Pneumonia, unspecified organism"	1	297	154	451
"N90"	"K59"	"Other noninflammatory disorders of vulva and perineum"	"Other functional intestinal disorders"	1	377	169	546
"N91"	"E11"	"Absent, scanty and rare menstruation"	"Type 2 diabetes mellitus"	1	138	13	151
"N91"	"I10"	"Absent, scanty and rare menstruation"	"Essential (primary) hypertension"	1	177	31	208
"N91"	"N95"	"Absent, scanty and rare menstruation"	"Menopausal and other perimenopausal disorders"	1	126	45	171
"N91"	"O68"	"Absent, scanty and rare menstruation"	"Labor and delivery comp by abnlt of fetal acid-base balance"	1	305	189	494
"N92"	"A40"	"Excessive, frequent and irregular menstruation"	"Streptococcal sepsis"	1	88	6	94
"N92"	"A41"	"Excessive, frequent and irregular menstruation"	"Other sepsis"	1	1029	0	1029
"N92"	"A69"	"Excessive, frequent and irregular menstruation"	"Other spirochetal infections"	1	105	35	140
"N92"	"B34"	"Excessive, frequent and irregular menstruation"	"Viral infection of unspecified site"	1	542	343	885
"N92"	"B37"	"Excessive, frequent and irregular menstruation"	"Candidiasis"	1	468	191	659
"N92"	"B95"	"Excessive, frequent and irregular menstruation"	"Strep as the cause of diseases classified elsewhere"	1	82	14	96
"N92"	"B96"	"Excessive, frequent and irregular menstruation"	"Oth bacterial agents as the cause of diseases classd elswhr"	1	76	3	79
"N92"	"C16"	"Excessive, frequent and irregular menstruation"	"Malignant neoplasm of stomach"	1	55	0	55
"N92"	"C17"	"Excessive, frequent and irregular menstruation"	"Malignant neoplasm of small intestine"	1	28	0	28
"N92"	"C20"	"Excessive, frequent and irregular menstruation"	"Malignant neoplasm of rectum"	1	166	0	166
"N92"	"C21"	"Excessive, frequent and irregular menstruation"	"Malignant neoplasm of anus and anal canal"	1	39	0	39
"N92"	"C24"	"Excessive, frequent and irregular menstruation"	"Malignant neoplasm of other and unsp parts of biliary tract"	1	26	0	26
"N92"	"C34"	"Excessive, frequent and irregular menstruation"	"Malignant neoplasm of bronchus and lung"	1	486	0	486
"N92"	"C44"	"Excessive, frequent and irregular menstruation"	"Other and unspecified malignant neoplasm of skin"	1	727	0	727
"N92"	"C49"	"Excessive, frequent and irregular menstruation"	"Malignant neoplasm of other connective and soft tissue"	1	131	13	144
"N92"	"C50"	"Excessive, frequent and irregular menstruation"	"Malignant neoplasm of breast"	1	2487	0	2487
"N92"	"C53"	"Excessive, frequent and irregular menstruation"	"Malignant neoplasm of cervix uteri"	1	427	178	605
"N92"	"C57"	"Excessive, frequent and irregular menstruation"	"Malignant neoplasm of other and unsp female genital organs"	1	58	0	58
"N92"	"C67"	"Excessive, frequent and irregular menstruation"	"Malignant neoplasm of bladder"	1	79	0	79
"N92"	"C78"	"Excessive, frequent and irregular menstruation"	"Secondary malignant neoplasm of resp and digestive organs"	1	740	0	740
"N92"	"C79"	"Excessive, frequent and irregular menstruation"	"Secondary malignant neoplasm of other and unspecified sites"	1	561	0	561
"N92"	"C80"	"Excessive, frequent and irregular menstruation"	"Malignant neoplasm without specification of site"	1	89	0	89
"N92"	"C83"	"Excessive, frequent and irregular menstruation"	"Non-follicular lymphoma"	1	100	0	100
"N92"	"C90"	"Excessive, frequent and irregular menstruation"	"Multiple myeloma and malignant plasma cell neoplasms"	1	59	0	59
"N92"	"C91"	"Excessive, frequent and irregular menstruation"	"Lymphoid leukemia"	1	64	0	64
"N92"	"C92"	"Excessive, frequent and irregular menstruation"	"Myeloid leukemia"	1	59	9	68
"N92"	"D11"	"Excessive, frequent and irregular menstruation"	"Benign neoplasm of major salivary glands"	1	193	54	247
"N92"	"D12"	"Excessive, frequent and irregular menstruation"	"Benign neoplasm of colon, rectum, anus and anal canal"	1	2151	0	2151
"N92"	"D13"	"Excessive, frequent and irregular menstruation"	"Benign neoplasm of and ill-defined parts of digestive system"	1	311	15	326
"N92"	"D14"	"Excessive, frequent and irregular menstruation"	"Benign neoplasm of middle ear and respiratory system"	1	262	30	292
"N92"	"D17"	"Excessive, frequent and irregular menstruation"	"Benign lipomatous neoplasm"	1	1539	438	1977
"N92"	"D18"	"Excessive, frequent and irregular menstruation"	"Hemangioma and lymphangioma, any site"	1	241	83	324
"N92"	"D23"	"Excessive, frequent and irregular menstruation"	"Other benign neoplasms of skin"	1	1040	516	1556
"N92"	"D35"	"Excessive, frequent and irregular menstruation"	"Benign neoplasm of other and unspecified endocrine glands"	1	316	22	338
"N92"	"D46"	"Excessive, frequent and irregular menstruation"	"Myelodysplastic syndromes"	1	42	1	43
"N92"	"D47"	"Excessive, frequent and irregular menstruation"	"Oth neoplm of uncrt behav of lymphoid, hematpoetc & rel tiss"	1	154	0	154
"N92"	"D61"	"Excessive, frequent and irregular menstruation"	"Oth aplastic anemias and other bone marrow failure syndromes"	1	71	17	88
"N92"	"D64"	"Excessive, frequent and irregular menstruation"	"Other anemias"	1	2194	1547	3741
"N92"	"D72"	"Excessive, frequent and irregular menstruation"	"Other disorders of white blood cells"	1	135	17	152
"N92"	"E03"	"Excessive, frequent and irregular menstruation"	"Other hypothyroidism"	1	2400	502	2902
"N92"	"E05"	"Excessive, frequent and irregular menstruation"	"Thyrotoxicosis [hyperthyroidism]"	1	1378	612	1990
"N92"	"E06"	"Excessive, frequent and irregular menstruation"	"Thyroiditis"	1	491	125	616
"N92"	"E11"	"Excessive, frequent and irregular menstruation"	"Type 2 diabetes mellitus"	1	3508	0	3508
"N92"	"E13"	"Excessive, frequent and irregular menstruation"	"Other specified diabetes mellitus"	1	96	0	96
"N92"	"E20"	"Excessive, frequent and irregular menstruation"	"Hypoparathyroidism"	1	52	7	59
"N92"	"E23"	"Excessive, frequent and irregular menstruation"	"Hypofunction and other disorders of the pituitary gland"	1	191	50	241
"N92"	"E27"	"Excessive, frequent and irregular menstruation"	"Other disorders of adrenal gland"	1	206	16	222
"N92"	"E55"	"Excessive, frequent and irregular menstruation"	"Vitamin D deficiency"	1	420	74	494
"N92"	"E64"	"Excessive, frequent and irregular menstruation"	"Sequelae of malnutrition and other nutritional deficiencies"	1	190	3	193
"N92"	"E68"	"Excessive, frequent and irregular menstruation"	"Sequelae of hyperalimentation"	1	760	271	1031
"N92"	"E83"	"Excessive, frequent and irregular menstruation"	"Disorders of mineral metabolism"	1	258	0	258
"N92"	"E87"	"Excessive, frequent and irregular menstruation"	"Other disorders of fluid, electrolyte and acid-base balance"	1	838	0	838
"N92"	"F05"	"Excessive, frequent and irregular menstruation"	"Delirium due to known physiological condition"	1	49	0	49
"N92"	"F20"	"Excessive, frequent and irregular menstruation"	"Schizophrenia"	1	240	137	377
"N92"	"F22"	"Excessive, frequent and irregular menstruation"	"Delusional disorders"	1	49	9	58
"N92"	"F31"	"Excessive, frequent and irregular menstruation"	"Bipolar disorder"	1	222	49	271
"N92"	"F32"	"Excessive, frequent and irregular menstruation"	"Depressive episode"	1	1237	373	1610
"N92"	"F41"	"Excessive, frequent and irregular menstruation"	"Other anxiety disorders"	1	1033	188	1221
"N92"	"F60"	"Excessive, frequent and irregular menstruation"	"Specific personality disorders"	1	240	114	354
"N92"	"G12"	"Excessive, frequent and irregular menstruation"	"Spinal muscular atrophy and related syndromes"	1	35	2	37
"N92"	"G31"	"Excessive, frequent and irregular menstruation"	"Oth degenerative diseases of nervous system, NEC"	1	63	0	63
"N92"	"G45"	"Excessive, frequent and irregular menstruation"	"Transient cerebral ischemic attacks and related syndromes"	1	956	14	970
"N92"	"G47"	"Excessive, frequent and irregular menstruation"	"Sleep disorders"	1	1598	0	1598
"N92"	"G55"	"Excessive, frequent and irregular menstruation"	"Nerve root and plexus compressions in diseases classd elswhr"	1	94	28	122
"N92"	"G57"	"Excessive, frequent and irregular menstruation"	"Mononeuropathies of lower limb"	1	568	129	697
"N92"	"G60"	"Excessive, frequent and irregular menstruation"	"Hereditary and idiopathic neuropathy"	1	45	9	54
"N92"	"G62"	"Excessive, frequent and irregular menstruation"	"Other and unspecified polyneuropathies"	1	459	0	459
"N92"	"G63"	"Excessive, frequent and irregular menstruation"	"Polyneuropathy in diseases classified elsewhere"	1	96	4	100
"N92"	"G91"	"Excessive, frequent and irregular menstruation"	"Hydrocephalus"	1	121	19	140
"N92"	"G93"	"Excessive, frequent and irregular menstruation"	"Other disorders of brain"	1	208	50	258
"N92"	"G95"	"Excessive, frequent and irregular menstruation"	"Other and unspecified diseases of spinal cord"	1	189	0	189
"N92"	"G96"	"Excessive, frequent and irregular menstruation"	"Other disorders of central nervous system"	1	724	4	728
"N92"	"H02"	"Excessive, frequent and irregular menstruation"	"Other disorders of eyelid"	1	1469	106	1575
"N92"	"H04"	"Excessive, frequent and irregular menstruation"	"Disorders of lacrimal system"	1	198	24	222
"N92"	"H11"	"Excessive, frequent and irregular menstruation"	"Other disorders of conjunctiva"	1	320	48	368
"N92"	"H16"	"Excessive, frequent and irregular menstruation"	"Keratitis"	1	300	127	427
"N92"	"H25"	"Excessive, frequent and irregular menstruation"	"Age-related cataract"	1	1622	0	1622
"N92"	"H26"	"Excessive, frequent and irregular menstruation"	"Other cataract"	1	838	0	838
"N92"	"H35"	"Excessive, frequent and irregular menstruation"	"Other retinal disorders"	1	815	0	815
"N92"	"H36"	"Excessive, frequent and irregular menstruation"	"Retinal disorders in diseases classified elsewhere"	1	454	39	493
"N92"	"H40"	"Excessive, frequent and irregular menstruation"	"Glaucoma"	1	420	0	420
"N92"	"H44"	"Excessive, frequent and irregular menstruation"	"Disorders of globe"	1	192	69	261
"N92"	"H47"	"Excessive, frequent and irregular menstruation"	"Other disorders of optic [2nd] nerve and visual pathways"	1	136	38	174
"N92"	"H54"	"Excessive, frequent and irregular menstruation"	"Blindness and low vision"	1	184	20	204
"N92"	"H83"	"Excessive, frequent and irregular menstruation"	"Other diseases of inner ear"	1	146	38	184
"N92"	"H91"	"Excessive, frequent and irregular menstruation"	"Other and unspecified hearing loss"	1	2186	0	2186
"N92"	"I21"	"Excessive, frequent and irregular menstruation"	"Acute myocardial infarction"	1	860	7	867
"N92"	"I25"	"Excessive, frequent and irregular menstruation"	"Chronic ischemic heart disease"	1	1695	0	1695
"N92"	"I30"	"Excessive, frequent and irregular menstruation"	"Acute pericarditis"	1	107	33	140
"N92"	"I31"	"Excessive, frequent and irregular menstruation"	"Other diseases of pericardium"	1	73	0	73
"N92"	"I42"	"Excessive, frequent and irregular menstruation"	"Cardiomyopathy"	1	208	0	208
"N92"	"I45"	"Excessive, frequent and irregular menstruation"	"Other conduction disorders"	1	161	72	233
"N92"	"I46"	"Excessive, frequent and irregular menstruation"	"Cardiac arrest"	1	200	0	200
"N92"	"I47"	"Excessive, frequent and irregular menstruation"	"Paroxysmal tachycardia"	1	983	377	1360
"N92"	"I48"	"Excessive, frequent and irregular menstruation"	"Atrial fibrillation and flutter"	1	1457	0	1457
"N92"	"I49"	"Excessive, frequent and irregular menstruation"	"Other cardiac arrhythmias"	1	1096	144	1240
"N92"	"I51"	"Excessive, frequent and irregular menstruation"	"Complications and ill-defined descriptions of heart disease"	1	343	20	363
"N92"	"I61"	"Excessive, frequent and irregular menstruation"	"Nontraumatic intracerebral hemorrhage"	1	261	0	261
"N92"	"I70"	"Excessive, frequent and irregular menstruation"	"Atherosclerosis"	1	582	34	616
"N92"	"I71"	"Excessive, frequent and irregular menstruation"	"Aortic aneurysm and dissection"	1	130	0	130
"N92"	"I72"	"Excessive, frequent and irregular menstruation"	"Other aneurysm"	1	79	0	79
"N92"	"I74"	"Excessive, frequent and irregular menstruation"	"Arterial embolism and thrombosis"	1	131	34	165
"N92"	"I82"	"Excessive, frequent and irregular menstruation"	"Other venous embolism and thrombosis"	1	272	57	329
"N92"	"I83"	"Excessive, frequent and irregular menstruation"	"Varicose veins of lower extremities"	1	2542	1644	4186
"N92"	"I85"	"Excessive, frequent and irregular menstruation"	"Esophageal varices"	1	105	0	105
"N92"	"I87"	"Excessive, frequent and irregular menstruation"	"Other disorders of veins"	1	206	33	239
"N92"	"I97"	"Excessive, frequent and irregular menstruation"	"Intraop and postproc comp and disorders of circ sys, NEC"	1	114	1	115
"N92"	"I99"	"Excessive, frequent and irregular menstruation"	"Other and unspecified disorders of circulatory system"	1	105	35	140
"N92"	"J01"	"Excessive, frequent and irregular menstruation"	"Acute sinusitis"	1	445	213	658
"N92"	"J06"	"Excessive, frequent and irregular menstruation"	"Acute upper resp infections of multiple and unsp sites"	1	463	15	478
"N92"	"J09"	"Excessive, frequent and irregular menstruation"	"Influenza due to certain identified influenza viruses"	1	59	0	59
"N92"	"J10"	"Excessive, frequent and irregular menstruation"	"Influenza due to other identified influenza virus"	1	91	0	91
"N92"	"J15"	"Excessive, frequent and irregular menstruation"	"Bacterial pneumonia, not elsewhere classified"	1	900	0	900
"N92"	"J32"	"Excessive, frequent and irregular menstruation"	"Chronic sinusitis"	1	493	266	759
"N92"	"J33"	"Excessive, frequent and irregular menstruation"	"Nasal polyp"	1	145	48	193
"N92"	"J40"	"Excessive, frequent and irregular menstruation"	"Bronchitis, not specified as acute or chronic"	1	101	26	127
"N92"	"J42"	"Excessive, frequent and irregular menstruation"	"Unspecified chronic bronchitis"	1	399	121	520
"N92"	"J47"	"Excessive, frequent and irregular menstruation"	"Bronchiectasis"	1	123	0	123
"N92"	"J69"	"Excessive, frequent and irregular menstruation"	"Pneumonitis due to solids and liquids"	1	67	0	67
"N92"	"J81"	"Excessive, frequent and irregular menstruation"	"Pulmonary edema"	1	87	0	87
"N92"	"J84"	"Excessive, frequent and irregular menstruation"	"Other interstitial pulmonary diseases"	1	165	0	165
"N92"	"J91"	"Excessive, frequent and irregular menstruation"	"Pleural effusion in conditions classified elsewhere"	1	83	0	83
"N92"	"J95"	"Excessive, frequent and irregular menstruation"	"Intraop and postproc comp and disorders of resp sys, NEC"	1	57	0	57
"N92"	"J96"	"Excessive, frequent and irregular menstruation"	"Respiratory failure, not elsewhere classified"	1	752	0	752
"N92"	"K05"	"Excessive, frequent and irregular menstruation"	"Gingivitis and periodontal diseases"	1	378	48	426
"N92"	"K08"	"Excessive, frequent and irregular menstruation"	"Other disorders of teeth and supporting structures"	1	365	67	432
"N92"	"K13"	"Excessive, frequent and irregular menstruation"	"Other diseases of lip and oral mucosa"	1	210	22	232
"N92"	"K22"	"Excessive, frequent and irregular menstruation"	"Other diseases of esophagus"	1	435	29	464
"N92"	"K26"	"Excessive, frequent and irregular menstruation"	"Duodenal ulcer"	1	346	164	510
"N92"	"K28"	"Excessive, frequent and irregular menstruation"	"Gastrojejunal ulcer"	1	68	10	78
"N92"	"K43"	"Excessive, frequent and irregular menstruation"	"Ventral hernia"	1	1353	248	1601
"N92"	"K44"	"Excessive, frequent and irregular menstruation"	"Diaphragmatic hernia"	1	1713	363	2076
"N92"	"K45"	"Excessive, frequent and irregular menstruation"	"Other abdominal hernia"	1	304	103	407
"N92"	"K52"	"Excessive, frequent and irregular menstruation"	"Other and unsp noninfective gastroenteritis and colitis"	1	1366	248	1614
"N92"	"K56"	"Excessive, frequent and irregular menstruation"	"Paralytic ileus and intestinal obstruction without hernia"	1	1152	88	1240
"N92"	"K60"	"Excessive, frequent and irregular menstruation"	"Fissure and fistula of anal and rectal regions"	1	772	522	1294
"N92"	"K65"	"Excessive, frequent and irregular menstruation"	"Peritonitis"	1	457	109	566
"N92"	"K70"	"Excessive, frequent and irregular menstruation"	"Alcoholic liver disease"	1	368	0	368
"N92"	"K71"	"Excessive, frequent and irregular menstruation"	"Toxic liver disease"	1	115	25	140
"N92"	"K73"	"Excessive, frequent and irregular menstruation"	"Chronic hepatitis, not elsewhere classified"	1	75	23	98
"N92"	"K74"	"Excessive, frequent and irregular menstruation"	"Fibrosis and cirrhosis of liver"	1	202	0	202
"N92"	"K80"	"Excessive, frequent and irregular menstruation"	"Cholelithiasis"	1	3612	2150	5762
"N92"	"K83"	"Excessive, frequent and irregular menstruation"	"Other diseases of biliary tract"	1	291	29	320
"N92"	"K86"	"Excessive, frequent and irregular menstruation"	"Other diseases of pancreas"	1	219	13	232
"N92"	"K91"	"Excessive, frequent and irregular menstruation"	"Intraop and postproc comp and disorders of dgstv sys, NEC"	1	276	54	330
"N92"	"K92"	"Excessive, frequent and irregular menstruation"	"Other diseases of digestive system"	1	743	139	882
"N92"	"L08"	"Excessive, frequent and irregular menstruation"	"Other local infections of skin and subcutaneous tissue"	1	827	240	1067
"N92"	"L40"	"Excessive, frequent and irregular menstruation"	"Psoriasis"	1	564	188	752
"N92"	"L50"	"Excessive, frequent and irregular menstruation"	"Urticaria"	1	652	479	1131
"N92"	"L57"	"Excessive, frequent and irregular menstruation"	"Skin changes due to chronic expsr to nonionizing radiation"	1	409	11	420
"N92"	"L59"	"Excessive, frequent and irregular menstruation"	"Oth disorders of skin, subcu related to radiation"	1	33	0	33
"N92"	"L71"	"Excessive, frequent and irregular menstruation"	"Rosacea"	1	255	110	365
"N92"	"L89"	"Excessive, frequent and irregular menstruation"	"Pressure ulcer"	1	159	0	159
"N92"	"L95"	"Excessive, frequent and irregular menstruation"	"Vasculitis limited to skin, not elsewhere classified"	1	75	11	86
"N92"	"L97"	"Excessive, frequent and irregular menstruation"	"Non-pressure chronic ulcer of lower limb, NEC"	1	208	0	208
"N92"	"M00"	"Excessive, frequent and irregular menstruation"	"Pyogenic arthritis"	1	98	17	115
"N92"	"M07"	"Excessive, frequent and irregular menstruation"	"Enteropathic arthropathies"	1	492	59	551
"N92"	"M10"	"Excessive, frequent and irregular menstruation"	"Gout"	1	236	0	236
"N92"	"M13"	"Excessive, frequent and irregular menstruation"	"Other arthritis"	1	746	169	915
"N92"	"M14"	"Excessive, frequent and irregular menstruation"	"Arthropathies in other diseases classified elsewhere"	1	44	6	50
"N92"	"M15"	"Excessive, frequent and irregular menstruation"	"Polyosteoarthritis"	1	619	0	619
"N92"	"M17"	"Excessive, frequent and irregular menstruation"	"Osteoarthritis of knee"	1	4942	0	4942
"N92"	"M19"	"Excessive, frequent and irregular menstruation"	"Other and unspecified osteoarthritis"	1	2621	0	2621
"N92"	"M23"	"Excessive, frequent and irregular menstruation"	"Internal derangement of knee"	1	4786	2304	7090
"N92"	"M25"	"Excessive, frequent and irregular menstruation"	"Other joint disorder, not elsewhere classified"	1	2730	875	3605
"N92"	"M35"	"Excessive, frequent and irregular menstruation"	"Other systemic involvement of connective tissue"	1	883	456	1339
"N92"	"M47"	"Excessive, frequent and irregular menstruation"	"Spondylosis"	1	2569	0	2569
"N92"	"M50"	"Excessive, frequent and irregular menstruation"	"Cervical disc disorders"	1	2037	502	2539
"N92"	"M54"	"Excessive, frequent and irregular menstruation"	"Dorsalgia"	1	5922	3577	9499
"N92"	"M66"	"Excessive, frequent and irregular menstruation"	"Spontaneous rupture of synovium and tendon"	1	144	6	150
"N92"	"M67"	"Excessive, frequent and irregular menstruation"	"Other disorders of synovium and tendon"	1	1894	1038	2932
"N92"	"M70"	"Excessive, frequent and irregular menstruation"	"Soft tissue disorders related to use, overuse and pressure"	1	1627	277	1904
"N92"	"M79"	"Excessive, frequent and irregular menstruation"	"Oth and unsp soft tissue disorders, not elsewhere classified"	1	5518	2295	7813
"N92"	"M84"	"Excessive, frequent and irregular menstruation"	"Disorder of continuity of bone"	1	166	22	188
"N92"	"M86"	"Excessive, frequent and irregular menstruation"	"Osteomyelitis"	1	88	12	100
"N92"	"M89"	"Excessive, frequent and irregular menstruation"	"Other disorders of bone"	1	347	204	551
"N92"	"M99"	"Excessive, frequent and irregular menstruation"	"Biomechanical lesions, not elsewhere classified"	1	545	57	602
"N92"	"N15"	"Excessive, frequent and irregular menstruation"	"Other renal tubulo-interstitial diseases"	1	38	6	44
"N92"	"N17"	"Excessive, frequent and irregular menstruation"	"Acute kidney failure"	1	204	0	204
"N92"	"N28"	"Excessive, frequent and irregular menstruation"	"Oth disorders of kidney and ureter, not elsewhere classified"	1	188	22	210
"N92"	"N31"	"Excessive, frequent and irregular menstruation"	"Neuromuscular dysfunction of bladder, NEC"	1	299	119	418
"N92"	"N63"	"Excessive, frequent and irregular menstruation"	"Unspecified lump in breast"	1	1545	845	2390
"N92"	"N64"	"Excessive, frequent and irregular menstruation"	"Other disorders of breast"	1	1478	805	2283
"N92"	"N81"	"Excessive, frequent and irregular menstruation"	"Female genital prolapse"	1	5000	0	5000
"N92"	"N89"	"Excessive, frequent and irregular menstruation"	"Other noninflammatory disorders of vagina"	1	570	297	867
"N93"	"E87"	"Other abnormal uterine and vaginal bleeding"	"Other disorders of fluid, electrolyte and acid-base balance"	1	115	36	151
"N93"	"M19"	"Other abnormal uterine and vaginal bleeding"	"Other and unspecified osteoarthritis"	1	233	57	290
"N93"	"M48"	"Other abnormal uterine and vaginal bleeding"	"Other spondylopathies"	1	106	19	125
"N93"	"M75"	"Other abnormal uterine and vaginal bleeding"	"Shoulder lesions"	1	519	265	784
"N93"	"M80"	"Other abnormal uterine and vaginal bleeding"	"Osteoporosis with current pathological fracture"	1	52	8	60
"N94"	"A46"	"Pain and oth cond assoc w fem gntl org and menstrual cycle"	"Erysipelas"	1	173	19	192
"N94"	"A49"	"Pain and oth cond assoc w fem gntl org and menstrual cycle"	"Bacterial infection of unspecified site"	1	224	18	242
"N94"	"C18"	"Pain and oth cond assoc w fem gntl org and menstrual cycle"	"Malignant neoplasm of colon"	1	68	5	73
"N94"	"C34"	"Pain and oth cond assoc w fem gntl org and menstrual cycle"	"Malignant neoplasm of bronchus and lung"	1	101	0	101
"N94"	"C43"	"Pain and oth cond assoc w fem gntl org and menstrual cycle"	"Malignant melanoma of skin"	1	89	28	117
"N94"	"C56"	"Pain and oth cond assoc w fem gntl org and menstrual cycle"	"Malignant neoplasm of ovary"	1	73	14	87
"N94"	"C78"	"Pain and oth cond assoc w fem gntl org and menstrual cycle"	"Secondary malignant neoplasm of resp and digestive organs"	1	151	0	151
"N94"	"C83"	"Pain and oth cond assoc w fem gntl org and menstrual cycle"	"Non-follicular lymphoma"	1	31	2	33
"N94"	"E04"	"Pain and oth cond assoc w fem gntl org and menstrual cycle"	"Other nontoxic goiter"	1	515	231	746
"N94"	"E11"	"Pain and oth cond assoc w fem gntl org and menstrual cycle"	"Type 2 diabetes mellitus"	1	514	92	606
"N94"	"E21"	"Pain and oth cond assoc w fem gntl org and menstrual cycle"	"Hyperparathyroidism and other disorders of parathyroid gland"	1	88	0	88
"N94"	"E66"	"Pain and oth cond assoc w fem gntl org and menstrual cycle"	"Overweight and obesity"	1	2453	2086	4539
"N94"	"E83"	"Pain and oth cond assoc w fem gntl org and menstrual cycle"	"Disorders of mineral metabolism"	1	70	3	73
"N94"	"E86"	"Pain and oth cond assoc w fem gntl org and menstrual cycle"	"Volume depletion"	1	237	49	286
"N94"	"E89"	"Pain and oth cond assoc w fem gntl org and menstrual cycle"	"Postproc endocrine and metabolic comp and disorders, NEC"	1	86	14	100
"N94"	"G47"	"Pain and oth cond assoc w fem gntl org and menstrual cycle"	"Sleep disorders"	1	453	4	457
"N94"	"G96"	"Pain and oth cond assoc w fem gntl org and menstrual cycle"	"Other disorders of central nervous system"	1	235	13	248
"N94"	"H26"	"Pain and oth cond assoc w fem gntl org and menstrual cycle"	"Other cataract"	1	205	22	227
"N94"	"H33"	"Pain and oth cond assoc w fem gntl org and menstrual cycle"	"Retinal detachments and breaks"	1	79	8	87
"N94"	"H35"	"Pain and oth cond assoc w fem gntl org and menstrual cycle"	"Other retinal disorders"	1	196	28	224
"N94"	"H36"	"Pain and oth cond assoc w fem gntl org and menstrual cycle"	"Retinal disorders in diseases classified elsewhere"	1	102	27	129
"N94"	"H91"	"Pain and oth cond assoc w fem gntl org and menstrual cycle"	"Other and unspecified hearing loss"	1	410	122	532
"N94"	"I15"	"Pain and oth cond assoc w fem gntl org and menstrual cycle"	"Secondary hypertension"	1	73	20	93
"N94"	"I20"	"Pain and oth cond assoc w fem gntl org and menstrual cycle"	"Angina pectoris"	1	650	72	722
"N94"	"I25"	"Pain and oth cond assoc w fem gntl org and menstrual cycle"	"Chronic ischemic heart disease"	1	342	31	373
"N94"	"I26"	"Pain and oth cond assoc w fem gntl org and menstrual cycle"	"Pulmonary embolism"	1	136	33	169
"N94"	"I34"	"Pain and oth cond assoc w fem gntl org and menstrual cycle"	"Nonrheumatic mitral valve disorders"	1	76	8	84
"N94"	"I46"	"Pain and oth cond assoc w fem gntl org and menstrual cycle"	"Cardiac arrest"	1	37	0	37
"N94"	"I48"	"Pain and oth cond assoc w fem gntl org and menstrual cycle"	"Atrial fibrillation and flutter"	1	293	2	295
"N94"	"I50"	"Pain and oth cond assoc w fem gntl org and menstrual cycle"	"Heart failure"	1	155	0	155
"N94"	"I63"	"Pain and oth cond assoc w fem gntl org and menstrual cycle"	"Cerebral infarction"	1	248	7	255
"N94"	"I70"	"Pain and oth cond assoc w fem gntl org and menstrual cycle"	"Atherosclerosis"	1	126	30	156
"N94"	"I73"	"Pain and oth cond assoc w fem gntl org and menstrual cycle"	"Other peripheral vascular diseases"	1	158	23	181
"N94"	"I80"	"Pain and oth cond assoc w fem gntl org and menstrual cycle"	"Phlebitis and thrombophlebitis"	1	277	127	404
"N94"	"J15"	"Pain and oth cond assoc w fem gntl org and menstrual cycle"	"Bacterial pneumonia, not elsewhere classified"	1	297	13	310
"N94"	"J18"	"Pain and oth cond assoc w fem gntl org and menstrual cycle"	"Pneumonia, unspecified organism"	1	718	206	924
"N94"	"J43"	"Pain and oth cond assoc w fem gntl org and menstrual cycle"	"Emphysema"	1	48	0	48
"N94"	"J84"	"Pain and oth cond assoc w fem gntl org and menstrual cycle"	"Other interstitial pulmonary diseases"	1	48	0	48
"N94"	"J98"	"Pain and oth cond assoc w fem gntl org and menstrual cycle"	"Other respiratory disorders"	1	70	19	89
"N94"	"K65"	"Pain and oth cond assoc w fem gntl org and menstrual cycle"	"Peritonitis"	1	115	39	154
"N94"	"K80"	"Pain and oth cond assoc w fem gntl org and menstrual cycle"	"Cholelithiasis"	1	1131	620	1751
"N94"	"K86"	"Pain and oth cond assoc w fem gntl org and menstrual cycle"	"Other diseases of pancreas"	1	49	3	52
"N94"	"K92"	"Pain and oth cond assoc w fem gntl org and menstrual cycle"	"Other diseases of digestive system"	1	199	74	273
"N94"	"L08"	"Pain and oth cond assoc w fem gntl org and menstrual cycle"	"Other local infections of skin and subcutaneous tissue"	1	228	120	348
"N94"	"L97"	"Pain and oth cond assoc w fem gntl org and menstrual cycle"	"Non-pressure chronic ulcer of lower limb, NEC"	1	55	0	55
"N94"	"L98"	"Pain and oth cond assoc w fem gntl org and menstrual cycle"	"Oth disorders of skin, subcu, not elsewhere classified"	1	175	61	236
"N94"	"M05"	"Pain and oth cond assoc w fem gntl org and menstrual cycle"	"Rheumatoid arthritis with rheumatoid factor"	1	123	22	145
"N94"	"M16"	"Pain and oth cond assoc w fem gntl org and menstrual cycle"	"Osteoarthritis of hip"	1	355	2	357
"N94"	"M17"	"Pain and oth cond assoc w fem gntl org and menstrual cycle"	"Osteoarthritis of knee"	1	1026	41	1067
"N94"	"M19"	"Pain and oth cond assoc w fem gntl org and menstrual cycle"	"Other and unspecified osteoarthritis"	1	671	13	684
"N94"	"M67"	"Pain and oth cond assoc w fem gntl org and menstrual cycle"	"Other disorders of synovium and tendon"	1	589	414	1003
"N94"	"M81"	"Pain and oth cond assoc w fem gntl org and menstrual cycle"	"Osteoporosis without current pathological fracture"	1	466	6	472
"N94"	"M85"	"Pain and oth cond assoc w fem gntl org and menstrual cycle"	"Other disorders of bone density and structure"	1	405	3	408
"N94"	"N17"	"Pain and oth cond assoc w fem gntl org and menstrual cycle"	"Acute kidney failure"	1	43	0	43
"N94"	"N18"	"Pain and oth cond assoc w fem gntl org and menstrual cycle"	"Chronic kidney disease (CKD)"	1	103	4	107
"N94"	"N63"	"Pain and oth cond assoc w fem gntl org and menstrual cycle"	"Unspecified lump in breast"	1	457	203	660
"N94"	"N95"	"Pain and oth cond assoc w fem gntl org and menstrual cycle"	"Menopausal and other perimenopausal disorders"	1	993	336	1329
"N94"	"O72"	"Pain and oth cond assoc w fem gntl org and menstrual cycle"	"Postpartum hemorrhage"	1	3012	1291	4303
"N95"	"A04"	"Menopausal and other perimenopausal disorders"	"Other bacterial intestinal infections"	1	215	33	248
"N95"	"A41"	"Menopausal and other perimenopausal disorders"	"Other sepsis"	1	1402	174	1576
"N95"	"B37"	"Menopausal and other perimenopausal disorders"	"Candidiasis"	1	284	132	416
"N95"	"C16"	"Menopausal and other perimenopausal disorders"	"Malignant neoplasm of stomach"	1	93	3	96
"N95"	"C34"	"Menopausal and other perimenopausal disorders"	"Malignant neoplasm of bronchus and lung"	1	735	0	735
"N95"	"C44"	"Menopausal and other perimenopausal disorders"	"Other and unspecified malignant neoplasm of skin"	1	605	143	748
"N95"	"C52"	"Menopausal and other perimenopausal disorders"	"Malignant neoplasm of vagina"	1	73	20	93
"N95"	"C53"	"Menopausal and other perimenopausal disorders"	"Malignant neoplasm of cervix uteri"	1	525	231	756
"N95"	"C57"	"Menopausal and other perimenopausal disorders"	"Malignant neoplasm of other and unsp female genital organs"	1	142	14	156
"N95"	"C71"	"Menopausal and other perimenopausal disorders"	"Malignant neoplasm of brain"	1	90	11	101
"N95"	"C78"	"Menopausal and other perimenopausal disorders"	"Secondary malignant neoplasm of resp and digestive organs"	1	1218	0	1218
"N95"	"C83"	"Menopausal and other perimenopausal disorders"	"Non-follicular lymphoma"	1	95	30	125
"N95"	"C90"	"Menopausal and other perimenopausal disorders"	"Multiple myeloma and malignant plasma cell neoplasms"	1	55	12	67
"N95"	"D47"	"Menopausal and other perimenopausal disorders"	"Oth neoplm of uncrt behav of lymphoid, hematpoetc & rel tiss"	1	144	11	155
"N95"	"D50"	"Menopausal and other perimenopausal disorders"	"Iron deficiency anemia"	1	480	234	714
"N95"	"E11"	"Menopausal and other perimenopausal disorders"	"Type 2 diabetes mellitus"	1	1748	1379	3127
"N95"	"E41"	"Menopausal and other perimenopausal disorders"	"Nutritional marasmus"	1	45	0	45
"N95"	"E64"	"Menopausal and other perimenopausal disorders"	"Sequelae of malnutrition and other nutritional deficiencies"	1	129	15	144
"N95"	"E83"	"Menopausal and other perimenopausal disorders"	"Disorders of mineral metabolism"	1	249	21	270
"N95"	"E86"	"Menopausal and other perimenopausal disorders"	"Volume depletion"	1	1964	0	1964
"N95"	"G45"	"Menopausal and other perimenopausal disorders"	"Transient cerebral ischemic attacks and related syndromes"	1	614	383	997
"N95"	"G62"	"Menopausal and other perimenopausal disorders"	"Other and unspecified polyneuropathies"	1	286	86	372
"N95"	"H02"	"Menopausal and other perimenopausal disorders"	"Other disorders of eyelid"	1	527	310	837
"N95"	"H25"	"Menopausal and other perimenopausal disorders"	"Age-related cataract"	1	3273	1043	4316
"N95"	"H34"	"Menopausal and other perimenopausal disorders"	"Retinal vascular occlusions"	1	139	58	197
"N95"	"H35"	"Menopausal and other perimenopausal disorders"	"Other retinal disorders"	1	1090	280	1370
"N95"	"H36"	"Menopausal and other perimenopausal disorders"	"Retinal disorders in diseases classified elsewhere"	1	201	108	309
"N95"	"H43"	"Menopausal and other perimenopausal disorders"	"Disorders of vitreous body"	1	337	151	488
"N95"	"I27"	"Menopausal and other perimenopausal disorders"	"Other pulmonary heart diseases"	1	172	45	217
"N95"	"I34"	"Menopausal and other perimenopausal disorders"	"Nonrheumatic mitral valve disorders"	1	269	98	367
"N95"	"I42"	"Menopausal and other perimenopausal disorders"	"Cardiomyopathy"	1	140	58	198
"N95"	"I50"	"Menopausal and other perimenopausal disorders"	"Heart failure"	1	1448	492	1940
"N95"	"I51"	"Menopausal and other perimenopausal disorders"	"Complications and ill-defined descriptions of heart disease"	1	292	134	426
"N95"	"I61"	"Menopausal and other perimenopausal disorders"	"Nontraumatic intracerebral hemorrhage"	1	262	62	324
"N95"	"I69"	"Menopausal and other perimenopausal disorders"	"Sequelae of cerebrovascular disease"	1	1083	419	1502
"N95"	"I82"	"Menopausal and other perimenopausal disorders"	"Other venous embolism and thrombosis"	1	118	48	166
"N95"	"J15"	"Menopausal and other perimenopausal disorders"	"Bacterial pneumonia, not elsewhere classified"	1	1007	90	1097
"N95"	"J22"	"Menopausal and other perimenopausal disorders"	"Unspecified acute lower respiratory infection"	1	171	12	183
"N95"	"J81"	"Menopausal and other perimenopausal disorders"	"Pulmonary edema"	1	198	38	236
"N95"	"J85"	"Menopausal and other perimenopausal disorders"	"Abscess of lung and mediastinum"	1	24	1	25
"N95"	"J91"	"Menopausal and other perimenopausal disorders"	"Pleural effusion in conditions classified elsewhere"	1	126	8	134
"N95"	"J93"	"Menopausal and other perimenopausal disorders"	"Pneumothorax and air leak"	1	119	28	147
"N95"	"J94"	"Menopausal and other perimenopausal disorders"	"Other pleural conditions"	1	84	7	91
"N95"	"J95"	"Menopausal and other perimenopausal disorders"	"Intraop and postproc comp and disorders of resp sys, NEC"	1	53	4	57
"N95"	"K31"	"Menopausal and other perimenopausal disorders"	"Other diseases of stomach and duodenum"	1	92	31	123
"N95"	"K55"	"Menopausal and other perimenopausal disorders"	"Vascular disorders of intestine"	1	144	20	164
"N95"	"K56"	"Menopausal and other perimenopausal disorders"	"Paralytic ileus and intestinal obstruction without hernia"	1	756	198	954
"N95"	"K59"	"Menopausal and other perimenopausal disorders"	"Other functional intestinal disorders"	1	2120	736	2856
"N95"	"K72"	"Menopausal and other perimenopausal disorders"	"Hepatic failure, not elsewhere classified"	1	95	31	126
"N95"	"K91"	"Menopausal and other perimenopausal disorders"	"Intraop and postproc comp and disorders of dgstv sys, NEC"	1	139	66	205
"N95"	"M19"	"Menopausal and other perimenopausal disorders"	"Other and unspecified osteoarthritis"	1	1179	547	1726
"N95"	"M70"	"Menopausal and other perimenopausal disorders"	"Soft tissue disorders related to use, overuse and pressure"	1	471	274	745
"N95"	"M80"	"Menopausal and other perimenopausal disorders"	"Osteoporosis with current pathological fracture"	1	770	121	891
"N95"	"M85"	"Menopausal and other perimenopausal disorders"	"Other disorders of bone density and structure"	1	1174	232	1406
"N95"	"N13"	"Menopausal and other perimenopausal disorders"	"Obstructive and reflux uropathy"	1	435	137	572
"N95"	"N18"	"Menopausal and other perimenopausal disorders"	"Chronic kidney disease (CKD)"	1	647	65	712
"N95"	"N19"	"Menopausal and other perimenopausal disorders"	"Unspecified kidney failure"	1	261	74	335
"N95"	"N39"	"Menopausal and other perimenopausal disorders"	"Other disorders of urinary system"	1	2674	1861	4535
"N96"	"C50"	"Recurrent pregnancy loss"	"Malignant neoplasm of breast"	1	26	0	26
"N96"	"E06"	"Recurrent pregnancy loss"	"Thyroiditis"	1	131	35	166
"N96"	"G44"	"Recurrent pregnancy loss"	"Other headache syndromes"	1	34	4	38
"N96"	"I10"	"Recurrent pregnancy loss"	"Essential (primary) hypertension"	1	93	0	93
"N96"	"I83"	"Recurrent pregnancy loss"	"Varicose veins of lower extremities"	1	87	5	92
"N96"	"K62"	"Recurrent pregnancy loss"	"Other diseases of anus and rectum"	1	37	1	38
"N96"	"K80"	"Recurrent pregnancy loss"	"Cholelithiasis"	1	133	45	178
"N96"	"M25"	"Recurrent pregnancy loss"	"Other joint disorder, not elsewhere classified"	1	70	18	88
"N96"	"M50"	"Recurrent pregnancy loss"	"Cervical disc disorders"	1	29	0	29
"N96"	"M51"	"Recurrent pregnancy loss"	"Thoracic, thoracolum, and lumbosacral intvrt disc disorders"	1	90	18	108
"N96"	"M75"	"Recurrent pregnancy loss"	"Shoulder lesions"	1	86	2	88
"N96"	"M77"	"Recurrent pregnancy loss"	"Other enthesopathies"	1	46	3	49
"N96"	"O30"	"Recurrent pregnancy loss"	"Multiple gestation"	1	174	78	252
"N96"	"O36"	"Recurrent pregnancy loss"	"Maternal care for other fetal problems"	1	417	261	678
"N96"	"O40"	"Recurrent pregnancy loss"	"Polyhydramnios"	1	75	21	96
"N96"	"O68"	"Recurrent pregnancy loss"	"Labor and delivery comp by abnlt of fetal acid-base balance"	1	636	424	1060
"N96"	"O72"	"Recurrent pregnancy loss"	"Postpartum hemorrhage"	1	1693	508	2201
"N96"	"O90"	"Recurrent pregnancy loss"	"Complications of the puerperium, not elsewhere classified"	1	148	56	204
"N96"	"O99"	"Recurrent pregnancy loss"	"Oth maternal diseases classd elsw but compl preg/chldbrth"	1	1293	650	1943
"N97"	"A41"	"Female infertility"	"Other sepsis"	1	303	45	348
"N97"	"A49"	"Female infertility"	"Bacterial infection of unspecified site"	1	236	35	271
"N97"	"B34"	"Female infertility"	"Viral infection of unspecified site"	1	331	153	484
"N97"	"C18"	"Female infertility"	"Malignant neoplasm of colon"	1	29	0	29
"N97"	"C43"	"Female infertility"	"Malignant melanoma of skin"	1	167	23	190
"N97"	"C50"	"Female infertility"	"Malignant neoplasm of breast"	1	239	0	239
"N97"	"C77"	"Female infertility"	"Secondary and unspecified malignant neoplasm of lymph nodes"	1	102	0	102
"N97"	"D10"	"Female infertility"	"Benign neoplasm of mouth and pharynx"	1	65	3	68
"N97"	"D11"	"Female infertility"	"Benign neoplasm of major salivary glands"	1	53	7	60
"N97"	"D12"	"Female infertility"	"Benign neoplasm of colon, rectum, anus and anal canal"	1	171	0	171
"N97"	"D13"	"Female infertility"	"Benign neoplasm of and ill-defined parts of digestive system"	1	57	2	59
"N97"	"D17"	"Female infertility"	"Benign lipomatous neoplasm"	1	435	21	456
"N97"	"D22"	"Female infertility"	"Melanocytic nevi"	1	510	183	693
"N97"	"D50"	"Female infertility"	"Iron deficiency anemia"	1	343	0	343
"N97"	"E03"	"Female infertility"	"Other hypothyroidism"	1	2259	585	2844
"N97"	"E05"	"Female infertility"	"Thyrotoxicosis [hyperthyroidism]"	1	910	190	1100
"N97"	"E06"	"Female infertility"	"Thyroiditis"	1	739	172	911
"N97"	"E27"	"Female infertility"	"Other disorders of adrenal gland"	1	62	16	78
"N97"	"E55"	"Female infertility"	"Vitamin D deficiency"	1	173	15	188
"N97"	"E65"	"Female infertility"	"Localized adiposity"	1	346	4	350
"N97"	"E66"	"Female infertility"	"Overweight and obesity"	1	13771	0	13771
"N97"	"E68"	"Female infertility"	"Sequelae of hyperalimentation"	1	242	0	242
"N97"	"E83"	"Female infertility"	"Disorders of mineral metabolism"	1	55	0	55
"N97"	"F31"	"Female infertility"	"Bipolar disorder"	1	55	8	63
"N97"	"F32"	"Female infertility"	"Depressive episode"	1	336	55	391
"N97"	"F33"	"Female infertility"	"Major depressive disorder, recurrent"	1	413	24	437
"N97"	"F41"	"Female infertility"	"Other anxiety disorders"	1	431	63	494
"N97"	"G44"	"Female infertility"	"Other headache syndromes"	1	419	140	559
"N97"	"G47"	"Female infertility"	"Sleep disorders"	1	284	0	284
"N97"	"G50"	"Female infertility"	"Disorders of trigeminal nerve"	1	64	0	64
"N97"	"G56"	"Female infertility"	"Mononeuropathies of upper limb"	1	1613	0	1613
"N97"	"G57"	"Female infertility"	"Mononeuropathies of lower limb"	1	144	8	152
"N97"	"G62"	"Female infertility"	"Other and unspecified polyneuropathies"	1	64	0	64
"N97"	"G95"	"Female infertility"	"Other and unspecified diseases of spinal cord"	1	55	0	55
"N97"	"G96"	"Female infertility"	"Other disorders of central nervous system"	1	193	0	193
"N97"	"G98"	"Female infertility"	"Other disorders of nervous system not elsewhere classified"	1	74	0	74
"N97"	"H04"	"Female infertility"	"Disorders of lacrimal system"	1	44	5	49
"N97"	"H16"	"Female infertility"	"Keratitis"	1	133	62	195
"N97"	"H25"	"Female infertility"	"Age-related cataract"	1	63	0	63
"N97"	"H35"	"Female infertility"	"Other retinal disorders"	1	133	12	145
"N97"	"H40"	"Female infertility"	"Glaucoma"	1	50	0	50
"N97"	"H43"	"Female infertility"	"Disorders of vitreous body"	1	64	0	64
"N97"	"H53"	"Female infertility"	"Visual disturbances"	1	175	47	222
"N97"	"H54"	"Female infertility"	"Blindness and low vision"	1	32	2	34
"N97"	"H57"	"Female infertility"	"Other disorders of eye and adnexa"	1	186	24	210
"N97"	"H81"	"Female infertility"	"Disorders of vestibular function"	1	253	54	307
"N97"	"H91"	"Female infertility"	"Other and unspecified hearing loss"	1	293	35	328
"N97"	"I10"	"Female infertility"	"Essential (primary) hypertension"	1	976	0	976
"N97"	"I20"	"Female infertility"	"Angina pectoris"	1	171	0	171
"N97"	"I21"	"Female infertility"	"Acute myocardial infarction"	1	57	0	57
"N97"	"I42"	"Female infertility"	"Cardiomyopathy"	1	44	1	45
"N97"	"I47"	"Female infertility"	"Paroxysmal tachycardia"	1	270	80	350
"N97"	"I49"	"Female infertility"	"Other cardiac arrhythmias"	1	236	5	241
"N97"	"I60"	"Female infertility"	"Nontraumatic subarachnoid hemorrhage"	1	46	4	50
"N97"	"I61"	"Female infertility"	"Nontraumatic intracerebral hemorrhage"	1	43	1	44
"N97"	"I70"	"Female infertility"	"Atherosclerosis"	1	34	0	34
"N97"	"I83"	"Female infertility"	"Varicose veins of lower extremities"	1	956	0	956
"N97"	"I89"	"Female infertility"	"Oth noninfective disorders of lymphatic vessels and nodes"	1	115	6	121
"N97"	"J01"	"Female infertility"	"Acute sinusitis"	1	294	44	338
"N97"	"J06"	"Female infertility"	"Acute upper resp infections of multiple and unsp sites"	1	212	8	220
"N97"	"K25"	"Female infertility"	"Gastric ulcer"	1	114	12	126
"N97"	"K30"	"Female infertility"	"Functional dyspepsia"	1	579	232	811
"N97"	"K40"	"Female infertility"	"Inguinal hernia"	1	146	61	207
"N97"	"K44"	"Female infertility"	"Diaphragmatic hernia"	1	291	57	348
"N97"	"K52"	"Female infertility"	"Other and unsp noninfective gastroenteritis and colitis"	1	348	143	491
"N97"	"K57"	"Female infertility"	"Diverticular disease of intestine"	1	100	0	100
"N97"	"K76"	"Female infertility"	"Other diseases of liver"	1	161	2	163
"N97"	"K83"	"Female infertility"	"Other diseases of biliary tract"	1	86	15	101
"N97"	"K86"	"Female infertility"	"Other diseases of pancreas"	1	40	0	40
"N97"	"K90"	"Female infertility"	"Intestinal malabsorption"	1	75	18	93
"N97"	"K92"	"Female infertility"	"Other diseases of digestive system"	1	123	48	171
"N97"	"L02"	"Female infertility"	"Cutaneous abscess, furuncle and carbuncle"	1	585	374	959
"N97"	"L08"	"Female infertility"	"Other local infections of skin and subcutaneous tissue"	1	268	106	374
"N97"	"L40"	"Female infertility"	"Psoriasis"	1	123	53	176
"N97"	"L71"	"Female infertility"	"Rosacea"	1	93	9	102
"N97"	"L97"	"Female infertility"	"Non-pressure chronic ulcer of lower limb, NEC"	1	34	1	35
"N97"	"M17"	"Female infertility"	"Osteoarthritis of knee"	1	384	0	384
"N97"	"M18"	"Female infertility"	"Osteoarthritis of first carpometacarpal joint"	1	34	0	34
"N97"	"M21"	"Female infertility"	"Other acquired deformities of limbs"	1	147	51	198
"N97"	"M25"	"Female infertility"	"Other joint disorder, not elsewhere classified"	1	716	116	832
"N97"	"M43"	"Female infertility"	"Other deforming dorsopathies"	1	105	35	140
"N97"	"M47"	"Female infertility"	"Spondylosis"	1	244	0	244
"N97"	"M48"	"Female infertility"	"Other spondylopathies"	1	100	0	100
"N97"	"M50"	"Female infertility"	"Cervical disc disorders"	1	365	0	365
"N97"	"M51"	"Female infertility"	"Thoracic, thoracolum, and lumbosacral intvrt disc disorders"	1	1221	98	1319
"N97"	"M65"	"Female infertility"	"Synovitis and tenosynovitis"	1	684	403	1087
"N97"	"M67"	"Female infertility"	"Other disorders of synovium and tendon"	1	563	345	908
"N97"	"M70"	"Female infertility"	"Soft tissue disorders related to use, overuse and pressure"	1	289	55	344
"N97"	"M71"	"Female infertility"	"Other bursopathies"	1	90	15	105
"N97"	"M72"	"Female infertility"	"Fibroblastic disorders"	1	189	0	189
"N97"	"M79"	"Female infertility"	"Oth and unsp soft tissue disorders, not elsewhere classified"	1	1362	581	1943
"N97"	"M81"	"Female infertility"	"Osteoporosis without current pathological fracture"	1	184	0	184
"N97"	"N18"	"Female infertility"	"Chronic kidney disease (CKD)"	1	121	9	130
"N97"	"N61"	"Female infertility"	"Inflammatory disorders of breast"	1	262	25	287
"N97"	"N64"	"Female infertility"	"Other disorders of breast"	1	645	261	906
"N97"	"N81"	"Female infertility"	"Female genital prolapse"	1	888	0	888
"N97"	"N83"	"Female infertility"	"Noninflammatory disord of ovary, fallop and broad ligament"	1	2423	2060	4483
"N97"	"N88"	"Female infertility"	"Other noninflammatory disorders of cervix uteri"	1	319	172	491
"N97"	"N92"	"Female infertility"	"Excessive, frequent and irregular menstruation"	1	3950	0	3950
"N97"	"N96"	"Female infertility"	"Recurrent pregnancy loss"	1	908	653	1561
"N97"	"N98"	"Female infertility"	"Complications associated with artificial fertilization"	1	2022	1390	3412
"N97"	"O10"	"Female infertility"	"Pre-existing hypertension compl preg/chldbrth"	1	861	84	945
"N97"	"O12"	"Female infertility"	"Gestational edema and proteinuria without hypertension"	1	938	158	1096
"N97"	"O13"	"Female infertility"	"Gestational hypertension without significant proteinuria"	1	2297	0	2297
"N97"	"O14"	"Female infertility"	"Pre-eclampsia"	1	4734	0	4734
"N97"	"O22"	"Female infertility"	"Venous complications and hemorrhoids in pregnancy"	1	301	29	330
"N97"	"O23"	"Female infertility"	"Infections of genitourinary tract in pregnancy"	1	3988	0	3988
"N97"	"O24"	"Female infertility"	"Diabetes in pregnancy, childbirth, and the puerperium"	1	4247	0	4247
"N97"	"O26"	"Female infertility"	"Maternal care for oth conditions predom related to pregnancy"	1	8223	0	8223
"N97"	"O28"	"Female infertility"	"Abnormal findings on antenatal screening of mother"	1	1820	245	2065
"N97"	"O35"	"Female infertility"	"Maternal care for known or suspected fetal abnlt and damage"	1	1402	286	1688
"N97"	"O43"	"Female infertility"	"Placental disorders"	1	291	25	316
"N97"	"O45"	"Female infertility"	"Premature separation of placenta [abruptio placentae]"	1	703	147	850
"N97"	"O46"	"Female infertility"	"Antepartum hemorrhage, not elsewhere classified"	1	2903	0	2903
"N97"	"O47"	"Female infertility"	"False labor"	1	7159	0	7159
"N97"	"O63"	"Female infertility"	"Long labor"	1	4498	0	4498
"N97"	"O64"	"Female infertility"	"Obstructed labor due to malposition and malpresent of fetus"	1	5206	0	5206
"N97"	"O65"	"Female infertility"	"Obstructed labor due to maternal pelvic abnormality"	1	2629	806	3435
"N97"	"O70"	"Female infertility"	"Perineal laceration during delivery"	1	33038	0	33038
"N97"	"O72"	"Female infertility"	"Postpartum hemorrhage"	1	31999	0	31999
"N97"	"O73"	"Female infertility"	"Retained placenta and membranes, without hemorrhage"	1	1242	169	1411
"N97"	"O75"	"Female infertility"	"Oth complications of labor and delivery, NEC"	1	5230	0	5230
"N97"	"O80"	"Female infertility"	"Encounter for full-term uncomplicated delivery"	1	40699	0	40699
"N97"	"O82"	"Female infertility"	"Encounter for cesarean delivery without indication"	1	20675	0	20675
"N97"	"O87"	"Female infertility"	"Venous complications and hemorrhoids in the puerperium"	1	723	82	805
"N97"	"O90"	"Female infertility"	"Complications of the puerperium, not elsewhere classified"	1	3170	0	3170
"N97"	"O99"	"Female infertility"	"Oth maternal diseases classd elsw but compl preg/chldbrth"	1	26033	0	26033
"N97"	"Q61"	"Female infertility"	"Cystic kidney disease"	1	59	1	60
"N97"	"Q99"	"Female infertility"	"Other chromosome abnormalities, not elsewhere classified"	1	123	56	179
"N98"	"O14"	"Complications associated with artificial fertilization"	"Pre-eclampsia"	1	148	44	192
"N98"	"O20"	"Complications associated with artificial fertilization"	"Hemorrhage in early pregnancy"	1	381	204	585
"N98"	"O23"	"Complications associated with artificial fertilization"	"Infections of genitourinary tract in pregnancy"	1	230	60	290
"N98"	"O26"	"Complications associated with artificial fertilization"	"Maternal care for oth conditions predom related to pregnancy"	1	371	115	486
"N98"	"O31"	"Complications associated with artificial fertilization"	"Complications specific to multiple gestation"	1	61	7	68
"N98"	"O32"	"Complications associated with artificial fertilization"	"Maternal care for malpresentation of fetus"	1	232	67	299
"N98"	"O36"	"Complications associated with artificial fertilization"	"Maternal care for other fetal problems"	1	338	88	426
"N98"	"O44"	"Complications associated with artificial fertilization"	"Placenta previa"	1	85	15	100
"N98"	"O47"	"Complications associated with artificial fertilization"	"False labor"	1	366	101	467
"N98"	"O64"	"Complications associated with artificial fertilization"	"Obstructed labor due to malposition and malpresent of fetus"	1	161	67	228
"N98"	"O68"	"Complications associated with artificial fertilization"	"Labor and delivery comp by abnlt of fetal acid-base balance"	1	502	172	674
"N98"	"O82"	"Complications associated with artificial fertilization"	"Encounter for cesarean delivery without indication"	1	649	214	863
"N98"	"O99"	"Complications associated with artificial fertilization"	"Oth maternal diseases classd elsw but compl preg/chldbrth"	1	997	249	1246
"N99"	"A41"	"Intraop and postproc comp and disorders of GU sys, NEC"	"Other sepsis"	1	844	417	1261
"N99"	"A46"	"Intraop and postproc comp and disorders of GU sys, NEC"	"Erysipelas"	1	189	74	263
"N99"	"A49"	"Intraop and postproc comp and disorders of GU sys, NEC"	"Bacterial infection of unspecified site"	1	231	40	271
"N99"	"C44"	"Intraop and postproc comp and disorders of GU sys, NEC"	"Other and unspecified malignant neoplasm of skin"	1	201	75	276
"N99"	"C77"	"Intraop and postproc comp and disorders of GU sys, NEC"	"Secondary and unspecified malignant neoplasm of lymph nodes"	1	104	23	127
"N99"	"D50"	"Intraop and postproc comp and disorders of GU sys, NEC"	"Iron deficiency anemia"	1	184	57	241
"N99"	"E86"	"Intraop and postproc comp and disorders of GU sys, NEC"	"Volume depletion"	1	741	96	837
"N99"	"E87"	"Intraop and postproc comp and disorders of GU sys, NEC"	"Other disorders of fluid, electrolyte and acid-base balance"	1	344	98	442
"N99"	"F41"	"Intraop and postproc comp and disorders of GU sys, NEC"	"Other anxiety disorders"	1	120	15	135
"N99"	"G47"	"Intraop and postproc comp and disorders of GU sys, NEC"	"Sleep disorders"	1	192	27	219
"N99"	"I35"	"Intraop and postproc comp and disorders of GU sys, NEC"	"Nonrheumatic aortic valve disorders"	1	262	107	369
"N99"	"I48"	"Intraop and postproc comp and disorders of GU sys, NEC"	"Atrial fibrillation and flutter"	1	881	530	1411
"N99"	"I61"	"Intraop and postproc comp and disorders of GU sys, NEC"	"Nontraumatic intracerebral hemorrhage"	1	91	25	116
"N99"	"I63"	"Intraop and postproc comp and disorders of GU sys, NEC"	"Cerebral infarction"	1	353	155	508
"N99"	"J15"	"Intraop and postproc comp and disorders of GU sys, NEC"	"Bacterial pneumonia, not elsewhere classified"	1	469	65	534
"N99"	"J18"	"Intraop and postproc comp and disorders of GU sys, NEC"	"Pneumonia, unspecified organism"	1	1318	464	1782
"N99"	"J22"	"Intraop and postproc comp and disorders of GU sys, NEC"	"Unspecified acute lower respiratory infection"	1	53	10	63
"N99"	"J44"	"Intraop and postproc comp and disorders of GU sys, NEC"	"Other chronic obstructive pulmonary disease"	1	571	355	926
"N99"	"K92"	"Intraop and postproc comp and disorders of GU sys, NEC"	"Other diseases of digestive system"	1	286	125	411
"O00"	"C50"	"Ectopic pregnancy"	"Malignant neoplasm of breast"	1	87	0	87
"O00"	"C77"	"Ectopic pregnancy"	"Secondary and unspecified malignant neoplasm of lymph nodes"	1	25	0	25
"O00"	"D23"	"Ectopic pregnancy"	"Other benign neoplasms of skin"	1	86	11	97
"O00"	"D50"	"Ectopic pregnancy"	"Iron deficiency anemia"	1	107	0	107
"O00"	"D64"	"Ectopic pregnancy"	"Other anemias"	1	119	3	122
"O00"	"E11"	"Ectopic pregnancy"	"Type 2 diabetes mellitus"	1	81	0	81
"O00"	"E68"	"Ectopic pregnancy"	"Sequelae of hyperalimentation"	1	68	0	68
"O00"	"E78"	"Ectopic pregnancy"	"Disorders of lipoprotein metabolism and other lipidemias"	1	62	0	62
"O00"	"E87"	"Ectopic pregnancy"	"Other disorders of fluid, electrolyte and acid-base balance"	1	29	0	29
"O00"	"F32"	"Ectopic pregnancy"	"Depressive episode"	1	117	13	130
"O00"	"F41"	"Ectopic pregnancy"	"Other anxiety disorders"	1	133	4	137
"O00"	"G35"	"Ectopic pregnancy"	"Multiple sclerosis"	1	32	1	33
"O00"	"G44"	"Ectopic pregnancy"	"Other headache syndromes"	1	169	14	183
"O00"	"G47"	"Ectopic pregnancy"	"Sleep disorders"	1	54	0	54
"O00"	"G56"	"Ectopic pregnancy"	"Mononeuropathies of upper limb"	1	363	0	363
"O00"	"G93"	"Ectopic pregnancy"	"Other disorders of brain"	1	25	0	25
"O00"	"H35"	"Ectopic pregnancy"	"Other retinal disorders"	1	26	0	26
"O00"	"H52"	"Ectopic pregnancy"	"Disorders of refraction and accommodation"	1	117	10	127
"O00"	"H53"	"Ectopic pregnancy"	"Visual disturbances"	1	44	0	44
"O00"	"H57"	"Ectopic pregnancy"	"Other disorders of eye and adnexa"	1	52	0	52
"O00"	"I10"	"Ectopic pregnancy"	"Essential (primary) hypertension"	1	222	0	222
"O00"	"I20"	"Ectopic pregnancy"	"Angina pectoris"	1	74	0	74
"O00"	"I48"	"Ectopic pregnancy"	"Atrial fibrillation and flutter"	1	34	0	34
"O00"	"J15"	"Ectopic pregnancy"	"Bacterial pneumonia, not elsewhere classified"	1	73	0	73
"O00"	"J18"	"Ectopic pregnancy"	"Pneumonia, unspecified organism"	1	307	19	326
"O00"	"J32"	"Ectopic pregnancy"	"Chronic sinusitis"	1	52	6	58
"O00"	"J44"	"Ectopic pregnancy"	"Other chronic obstructive pulmonary disease"	1	43	0	43
"O00"	"K21"	"Ectopic pregnancy"	"Gastro-esophageal reflux disease"	1	155	0	155
"O00"	"K25"	"Ectopic pregnancy"	"Gastric ulcer"	1	55	4	59
"O00"	"K30"	"Ectopic pregnancy"	"Functional dyspepsia"	1	236	39	275
"O00"	"K43"	"Ectopic pregnancy"	"Ventral hernia"	1	98	0	98
"O00"	"K44"	"Ectopic pregnancy"	"Diaphragmatic hernia"	1	105	0	105
"O00"	"K59"	"Ectopic pregnancy"	"Other functional intestinal disorders"	1	388	58	446
"O00"	"K60"	"Ectopic pregnancy"	"Fissure and fistula of anal and rectal regions"	1	86	15	101
"O00"	"K61"	"Ectopic pregnancy"	"Abscess of anal and rectal regions"	1	53	10	63
"O00"	"K80"	"Ectopic pregnancy"	"Cholelithiasis"	1	569	69	638
"O00"	"K85"	"Ectopic pregnancy"	"Acute pancreatitis"	1	61	7	68
"O00"	"K90"	"Ectopic pregnancy"	"Intestinal malabsorption"	1	26	0	26
"O00"	"L02"	"Ectopic pregnancy"	"Cutaneous abscess, furuncle and carbuncle"	1	203	70	273
"O00"	"L08"	"Ectopic pregnancy"	"Other local infections of skin and subcutaneous tissue"	1	109	11	120
"O00"	"L30"	"Ectopic pregnancy"	"Other and unspecified dermatitis"	1	63	5	68
"O00"	"L40"	"Ectopic pregnancy"	"Psoriasis"	1	31	0	31
"O00"	"L73"	"Ectopic pregnancy"	"Other follicular disorders"	1	63	11	74
"O00"	"L98"	"Ectopic pregnancy"	"Oth disorders of skin, subcu, not elsewhere classified"	1	51	2	53
"O00"	"M17"	"Ectopic pregnancy"	"Osteoarthritis of knee"	1	107	0	107
"O00"	"M19"	"Ectopic pregnancy"	"Other and unspecified osteoarthritis"	1	72	0	72
"O00"	"M20"	"Ectopic pregnancy"	"Acquired deformities of fingers and toes"	1	128	13	141
"O00"	"M23"	"Ectopic pregnancy"	"Internal derangement of knee"	1	429	101	530
"O00"	"M47"	"Ectopic pregnancy"	"Spondylosis"	1	54	0	54
"O00"	"M50"	"Ectopic pregnancy"	"Cervical disc disorders"	1	127	0	127
"O00"	"M51"	"Ectopic pregnancy"	"Thoracic, thoracolum, and lumbosacral intvrt disc disorders"	1	429	4	433
"O00"	"M54"	"Ectopic pregnancy"	"Dorsalgia"	1	732	171	903
"O00"	"M65"	"Ectopic pregnancy"	"Synovitis and tenosynovitis"	1	217	60	277
"O00"	"M70"	"Ectopic pregnancy"	"Soft tissue disorders related to use, overuse and pressure"	1	91	3	94
"O00"	"M79"	"Ectopic pregnancy"	"Oth and unsp soft tissue disorders, not elsewhere classified"	1	504	79	583
"O00"	"M85"	"Ectopic pregnancy"	"Other disorders of bone density and structure"	1	25	0	25
"O00"	"N76"	"Ectopic pregnancy"	"Other inflammation of vagina and vulva"	1	148	65	213
"O00"	"N81"	"Ectopic pregnancy"	"Female genital prolapse"	1	186	0	186
"O00"	"N83"	"Ectopic pregnancy"	"Noninflammatory disord of ovary, fallop and broad ligament"	1	981	644	1625
"O00"	"N97"	"Ectopic pregnancy"	"Female infertility"	1	2256	1479	3735
"O00"	"N98"	"Ectopic pregnancy"	"Complications associated with artificial fertilization"	1	215	90	305
"O00"	"O44"	"Ectopic pregnancy"	"Placenta previa"	1	192	40	232
"O00"	"O72"	"Ectopic pregnancy"	"Postpartum hemorrhage"	1	4675	0	4675
"O00"	"O82"	"Ectopic pregnancy"	"Encounter for cesarean delivery without indication"	1	2137	1187	3324
"O00"	"O99"	"Ectopic pregnancy"	"Oth maternal diseases classd elsw but compl preg/chldbrth"	1	2818	1188	4006
"O01"	"O26"	"Hydatidiform mole"	"Maternal care for oth conditions predom related to pregnancy"	1	165	42	207
"O01"	"O70"	"Hydatidiform mole"	"Perineal laceration during delivery"	1	406	216	622
"O01"	"O72"	"Hydatidiform mole"	"Postpartum hemorrhage"	1	394	95	489
"O02"	"A41"	"Other abnormal products of conception"	"Other sepsis"	1	196	7	203
"O02"	"A46"	"Other abnormal products of conception"	"Erysipelas"	1	161	12	173
"O02"	"B34"	"Other abnormal products of conception"	"Viral infection of unspecified site"	1	455	193	648
"O02"	"C18"	"Other abnormal products of conception"	"Malignant neoplasm of colon"	1	28	0	28
"O02"	"C43"	"Other abnormal products of conception"	"Malignant melanoma of skin"	1	161	19	180
"O02"	"C50"	"Other abnormal products of conception"	"Malignant neoplasm of breast"	1	307	0	307
"O02"	"C56"	"Other abnormal products of conception"	"Malignant neoplasm of ovary"	1	29	0	29
"O02"	"C73"	"Other abnormal products of conception"	"Malignant neoplasm of thyroid gland"	1	42	0	42
"O02"	"C78"	"Other abnormal products of conception"	"Secondary malignant neoplasm of resp and digestive organs"	1	52	0	52
"O02"	"C79"	"Other abnormal products of conception"	"Secondary malignant neoplasm of other and unspecified sites"	1	35	0	35
"O02"	"D10"	"Other abnormal products of conception"	"Benign neoplasm of mouth and pharynx"	1	74	3	77
"O02"	"D14"	"Other abnormal products of conception"	"Benign neoplasm of middle ear and respiratory system"	1	56	7	63
"O02"	"D18"	"Other abnormal products of conception"	"Hemangioma and lymphangioma, any site"	1	68	19	87
"O02"	"D21"	"Other abnormal products of conception"	"Other benign neoplasms of connective and other soft tissue"	1	97	16	113
"O02"	"D22"	"Other abnormal products of conception"	"Melanocytic nevi"	1	509	132	641
"O02"	"D23"	"Other abnormal products of conception"	"Other benign neoplasms of skin"	1	396	97	493
"O02"	"D25"	"Other abnormal products of conception"	"Leiomyoma of uterus"	1	1372	0	1372
"O02"	"D50"	"Other abnormal products of conception"	"Iron deficiency anemia"	1	379	4	383
"O02"	"D72"	"Other abnormal products of conception"	"Other disorders of white blood cells"	1	42	1	43
"O02"	"E05"	"Other abnormal products of conception"	"Thyrotoxicosis [hyperthyroidism]"	1	829	175	1004
"O02"	"E21"	"Other abnormal products of conception"	"Hyperparathyroidism and other disorders of parathyroid gland"	1	59	0	59
"O02"	"E34"	"Other abnormal products of conception"	"Other endocrine disorders"	1	82	26	108
"O02"	"E78"	"Other abnormal products of conception"	"Disorders of lipoprotein metabolism and other lipidemias"	1	222	0	222
"O02"	"E86"	"Other abnormal products of conception"	"Volume depletion"	1	177	37	214
"O02"	"E87"	"Other abnormal products of conception"	"Other disorders of fluid, electrolyte and acid-base balance"	1	101	0	101
"O02"	"E88"	"Other abnormal products of conception"	"Other and unspecified metabolic disorders"	1	53	5	58
"O02"	"F31"	"Other abnormal products of conception"	"Bipolar disorder"	1	59	3	62
"O02"	"F32"	"Other abnormal products of conception"	"Depressive episode"	1	358	62	420
"O02"	"F41"	"Other abnormal products of conception"	"Other anxiety disorders"	1	489	64	553
"O02"	"F43"	"Other abnormal products of conception"	"Reaction to severe stress, and adjustment disorders"	1	502	34	536
"O02"	"F60"	"Other abnormal products of conception"	"Specific personality disorders"	1	135	30	165
"O02"	"G35"	"Other abnormal products of conception"	"Multiple sclerosis"	1	159	22	181
"O02"	"G37"	"Other abnormal products of conception"	"Other demyelinating diseases of central nervous system"	1	49	4	53
"O02"	"G43"	"Other abnormal products of conception"	"Migraine"	1	771	232	1003
"O02"	"G47"	"Other abnormal products of conception"	"Sleep disorders"	1	217	0	217
"O02"	"G50"	"Other abnormal products of conception"	"Disorders of trigeminal nerve"	1	68	0	68
"O02"	"G51"	"Other abnormal products of conception"	"Facial nerve disorders"	1	128	43	171
"O02"	"G54"	"Other abnormal products of conception"	"Nerve root and plexus disorders"	1	72	5	77
"O02"	"G55"	"Other abnormal products of conception"	"Nerve root and plexus compressions in diseases classd elswhr"	1	31	0	31
"O02"	"G56"	"Other abnormal products of conception"	"Mononeuropathies of upper limb"	1	1296	77	1373
"O02"	"G57"	"Other abnormal products of conception"	"Mononeuropathies of lower limb"	1	125	1	126
"O02"	"G62"	"Other abnormal products of conception"	"Other and unspecified polyneuropathies"	1	62	0	62
"O02"	"G93"	"Other abnormal products of conception"	"Other disorders of brain"	1	58	8	66
"O02"	"G95"	"Other abnormal products of conception"	"Other and unspecified diseases of spinal cord"	1	31	0	31
"O02"	"G97"	"Other abnormal products of conception"	"Intraop and postproc comp and disorders of nervous sys, NEC"	1	65	12	77
"O02"	"H02"	"Other abnormal products of conception"	"Other disorders of eyelid"	1	202	0	202
"O02"	"H05"	"Other abnormal products of conception"	"Disorders of orbit"	1	40	4	44
"O02"	"H16"	"Other abnormal products of conception"	"Keratitis"	1	180	48	228
"O02"	"H18"	"Other abnormal products of conception"	"Other disorders of cornea"	1	51	2	53
"O02"	"H33"	"Other abnormal products of conception"	"Retinal detachments and breaks"	1	50	0	50
"O02"	"H35"	"Other abnormal products of conception"	"Other retinal disorders"	1	125	5	130
"O02"	"H36"	"Other abnormal products of conception"	"Retinal disorders in diseases classified elsewhere"	1	130	10	140
"O02"	"H44"	"Other abnormal products of conception"	"Disorders of globe"	1	90	10	100
"O02"	"H54"	"Other abnormal products of conception"	"Blindness and low vision"	1	46	3	49
"O02"	"H57"	"Other abnormal products of conception"	"Other disorders of eye and adnexa"	1	243	6	249
"O02"	"H60"	"Other abnormal products of conception"	"Otitis externa"	1	160	67	227
"O02"	"H91"	"Other abnormal products of conception"	"Other and unspecified hearing loss"	1	264	12	276
"O02"	"H93"	"Other abnormal products of conception"	"Other disorders of ear, not elsewhere classified"	1	273	12	285
"O02"	"I10"	"Other abnormal products of conception"	"Essential (primary) hypertension"	1	968	0	968
"O02"	"I20"	"Other abnormal products of conception"	"Angina pectoris"	1	208	0	208
"O02"	"I21"	"Other abnormal products of conception"	"Acute myocardial infarction"	1	66	0	66
"O02"	"I25"	"Other abnormal products of conception"	"Chronic ischemic heart disease"	1	76	0	76
"O02"	"I42"	"Other abnormal products of conception"	"Cardiomyopathy"	1	37	0	37
"O02"	"I50"	"Other abnormal products of conception"	"Heart failure"	1	39	0	39
"O02"	"I51"	"Other abnormal products of conception"	"Complications and ill-defined descriptions of heart disease"	1	109	7	116
"O02"	"I60"	"Other abnormal products of conception"	"Nontraumatic subarachnoid hemorrhage"	1	73	4	77
"O02"	"I61"	"Other abnormal products of conception"	"Nontraumatic intracerebral hemorrhage"	1	31	0	31
"O02"	"I78"	"Other abnormal products of conception"	"Diseases of capillaries"	1	79	23	102
"O02"	"I80"	"Other abnormal products of conception"	"Phlebitis and thrombophlebitis"	1	358	79	437
"O02"	"I82"	"Other abnormal products of conception"	"Other venous embolism and thrombosis"	1	86	11	97
"O02"	"I83"	"Other abnormal products of conception"	"Varicose veins of lower extremities"	1	1410	0	1410
"O02"	"I89"	"Other abnormal products of conception"	"Oth noninfective disorders of lymphatic vessels and nodes"	1	64	0	64
"O02"	"I95"	"Other abnormal products of conception"	"Hypotension"	1	67	15	82
"O02"	"J10"	"Other abnormal products of conception"	"Influenza due to other identified influenza virus"	1	40	0	40
"O02"	"J15"	"Other abnormal products of conception"	"Bacterial pneumonia, not elsewhere classified"	1	285	11	296
"O02"	"J18"	"Other abnormal products of conception"	"Pneumonia, unspecified organism"	1	942	153	1095
"O02"	"J22"	"Other abnormal products of conception"	"Unspecified acute lower respiratory infection"	1	39	0	39
"O02"	"J96"	"Other abnormal products of conception"	"Respiratory failure, not elsewhere classified"	1	126	0	126
"O02"	"J98"	"Other abnormal products of conception"	"Other respiratory disorders"	1	51	9	60
"O02"	"K04"	"Other abnormal products of conception"	"Diseases of pulp and periapical tissues"	1	154	26	180
"O02"	"K08"	"Other abnormal products of conception"	"Other disorders of teeth and supporting structures"	1	108	27	135
"O02"	"K21"	"Other abnormal products of conception"	"Gastro-esophageal reflux disease"	1	558	58	616
"O02"	"K29"	"Other abnormal products of conception"	"Gastritis and duodenitis"	1	412	229	641
"O02"	"K41"	"Other abnormal products of conception"	"Femoral hernia"	1	30	3	33
"O02"	"K42"	"Other abnormal products of conception"	"Umbilical hernia"	1	483	12	495
"O02"	"K44"	"Other abnormal products of conception"	"Diaphragmatic hernia"	1	296	24	320
"O02"	"K60"	"Other abnormal products of conception"	"Fissure and fistula of anal and rectal regions"	1	353	131	484
"O02"	"K62"	"Other abnormal products of conception"	"Other diseases of anus and rectum"	1	496	29	525
"O02"	"K65"	"Other abnormal products of conception"	"Peritonitis"	1	72	7	79
"O02"	"K80"	"Other abnormal products of conception"	"Cholelithiasis"	1	2099	447	2546
"O02"	"K81"	"Other abnormal products of conception"	"Cholecystitis"	1	169	17	186
"O02"	"K90"	"Other abnormal products of conception"	"Intestinal malabsorption"	1	88	18	106
"O02"	"K91"	"Other abnormal products of conception"	"Intraop and postproc comp and disorders of dgstv sys, NEC"	1	63	0	63
"O02"	"K92"	"Other abnormal products of conception"	"Other diseases of digestive system"	1	147	63	210
"O02"	"L08"	"Other abnormal products of conception"	"Other local infections of skin and subcutaneous tissue"	1	279	109	388
"O02"	"L30"	"Other abnormal products of conception"	"Other and unspecified dermatitis"	1	270	49	319
"O02"	"L40"	"Other abnormal products of conception"	"Psoriasis"	1	155	37	192
"O02"	"L73"	"Other abnormal products of conception"	"Other follicular disorders"	1	145	70	215
"O02"	"L90"	"Other abnormal products of conception"	"Atrophic disorders of skin"	1	444	126	570
"O02"	"M05"	"Other abnormal products of conception"	"Rheumatoid arthritis with rheumatoid factor"	1	123	0	123
"O02"	"M06"	"Other abnormal products of conception"	"Other rheumatoid arthritis"	1	164	12	176
"O02"	"M17"	"Other abnormal products of conception"	"Osteoarthritis of knee"	1	360	0	360
"O02"	"M18"	"Other abnormal products of conception"	"Osteoarthritis of first carpometacarpal joint"	1	38	0	38
"O02"	"M19"	"Other abnormal products of conception"	"Other and unspecified osteoarthritis"	1	226	0	226
"O02"	"M20"	"Other abnormal products of conception"	"Acquired deformities of fingers and toes"	1	424	79	503
"O02"	"M21"	"Other abnormal products of conception"	"Other acquired deformities of limbs"	1	141	62	203
"O02"	"M31"	"Other abnormal products of conception"	"Other necrotizing vasculopathies"	1	27	2	29
"O02"	"M46"	"Other abnormal products of conception"	"Other inflammatory spondylopathies"	1	109	3	112
"O02"	"M47"	"Other abnormal products of conception"	"Spondylosis"	1	231	0	231
"O02"	"M50"	"Other abnormal products of conception"	"Cervical disc disorders"	1	391	0	391
"O02"	"M71"	"Other abnormal products of conception"	"Other bursopathies"	1	66	10	76
"O02"	"M72"	"Other abnormal products of conception"	"Fibroblastic disorders"	1	146	0	146
"O02"	"M77"	"Other abnormal products of conception"	"Other enthesopathies"	1	512	16	528
"O02"	"M85"	"Other abnormal products of conception"	"Other disorders of bone density and structure"	1	159	0	159
"O02"	"M96"	"Other abnormal products of conception"	"Intraop and postproc comp and disorders of ms sys, NEC"	1	28	0	28
"O02"	"N17"	"Other abnormal products of conception"	"Acute kidney failure"	1	30	0	30
"O02"	"N18"	"Other abnormal products of conception"	"Chronic kidney disease (CKD)"	1	81	0	81
"O02"	"N61"	"Other abnormal products of conception"	"Inflammatory disorders of breast"	1	225	23	248
"O02"	"N63"	"Other abnormal products of conception"	"Unspecified lump in breast"	1	879	130	1009
"O02"	"N71"	"Other abnormal products of conception"	"Inflammatory disease of uterus, except cervix"	1	1296	641	1937
"O02"	"N80"	"Other abnormal products of conception"	"Endometriosis"	1	589	410	999
"O02"	"N82"	"Other abnormal products of conception"	"Fistulae involving female genital tract"	1	43	6	49
"O02"	"N85"	"Other abnormal products of conception"	"Other noninflammatory disorders of uterus, except cervix"	1	322	47	369
"O02"	"N92"	"Other abnormal products of conception"	"Excessive, frequent and irregular menstruation"	1	4084	0	4084
"O02"	"N94"	"Other abnormal products of conception"	"Pain and oth cond assoc w fem gntl org and menstrual cycle"	1	1137	568	1705
"O02"	"N96"	"Other abnormal products of conception"	"Recurrent pregnancy loss"	1	4998	0	4998
"O02"	"O01"	"Other abnormal products of conception"	"Hydatidiform mole"	1	888	411	1299
"O02"	"O08"	"Other abnormal products of conception"	"Complications following ectopic and molar pregnancy"	1	9886	0	9886
"O02"	"O13"	"Other abnormal products of conception"	"Gestational hypertension without significant proteinuria"	1	1341	562	1903
"O02"	"O14"	"Other abnormal products of conception"	"Pre-eclampsia"	1	1960	1312	3272
"O02"	"O23"	"Other abnormal products of conception"	"Infections of genitourinary tract in pregnancy"	1	2999	1436	4435
"O02"	"O26"	"Other abnormal products of conception"	"Maternal care for oth conditions predom related to pregnancy"	1	9421	0	9421
"O02"	"O33"	"Other abnormal products of conception"	"Maternal care for disproportion"	1	220	85	305
"O02"	"O41"	"Other abnormal products of conception"	"Other disorders of amniotic fluid and membranes"	1	1136	590	1726
"O02"	"O46"	"Other abnormal products of conception"	"Antepartum hemorrhage, not elsewhere classified"	1	2035	831	2866
"O02"	"O47"	"Other abnormal products of conception"	"False labor"	1	4466	2008	6474
"O02"	"O62"	"Other abnormal products of conception"	"Abnormalities of forces of labor"	1	12925	10849	23774
"O02"	"O68"	"Other abnormal products of conception"	"Labor and delivery comp by abnlt of fetal acid-base balance"	1	9246	6437	15683
"O02"	"O72"	"Other abnormal products of conception"	"Postpartum hemorrhage"	1	28826	0	28826
"O02"	"O80"	"Other abnormal products of conception"	"Encounter for full-term uncomplicated delivery"	1	21459	19187	40646
"O02"	"O82"	"Other abnormal products of conception"	"Encounter for cesarean delivery without indication"	1	17685	0	17685
"O02"	"O87"	"Other abnormal products of conception"	"Venous complications and hemorrhoids in the puerperium"	1	464	203	667
"O02"	"O90"	"Other abnormal products of conception"	"Complications of the puerperium, not elsewhere classified"	1	1808	735	2543
"O02"	"O92"	"Other abnormal products of conception"	"Oth disord of brst/lactatn assoc w pregnancy and the puerp"	1	1932	718	2650
"O02"	"O98"	"Other abnormal products of conception"	"Matern infec/parastc dis classd elsw but compl preg/chldbrth"	1	304	99	403
"O02"	"O99"	"Other abnormal products of conception"	"Oth maternal diseases classd elsw but compl preg/chldbrth"	1	21454	0	21454
"O02"	"Q65"	"Other abnormal products of conception"	"Congenital deformities of hip"	1	74	17	91
"O03"	"A41"	"Spontaneous abortion"	"Other sepsis"	1	226	0	226
"O03"	"B34"	"Spontaneous abortion"	"Viral infection of unspecified site"	1	457	100	557
"O03"	"B37"	"Spontaneous abortion"	"Candidiasis"	1	204	78	282
"O03"	"C18"	"Spontaneous abortion"	"Malignant neoplasm of colon"	1	26	0	26
"O03"	"C50"	"Spontaneous abortion"	"Malignant neoplasm of breast"	1	311	0	311
"O03"	"C79"	"Spontaneous abortion"	"Secondary malignant neoplasm of other and unspecified sites"	1	38	0	38
"O03"	"D07"	"Spontaneous abortion"	"Carcinoma in situ of other and unspecified genital organs"	1	33	0	33
"O03"	"D12"	"Spontaneous abortion"	"Benign neoplasm of colon, rectum, anus and anal canal"	1	170	0	170
"O03"	"D13"	"Spontaneous abortion"	"Benign neoplasm of and ill-defined parts of digestive system"	1	64	0	64
"O03"	"D14"	"Spontaneous abortion"	"Benign neoplasm of middle ear and respiratory system"	1	77	0	77
"O03"	"D17"	"Spontaneous abortion"	"Benign lipomatous neoplasm"	1	442	0	442
"O03"	"D18"	"Spontaneous abortion"	"Hemangioma and lymphangioma, any site"	1	80	23	103
"O03"	"D21"	"Spontaneous abortion"	"Other benign neoplasms of connective and other soft tissue"	1	127	5	132
"O03"	"D22"	"Spontaneous abortion"	"Melanocytic nevi"	1	491	56	547
"O03"	"D23"	"Spontaneous abortion"	"Other benign neoplasms of skin"	1	425	56	481
"O03"	"D24"	"Spontaneous abortion"	"Benign neoplasm of breast"	1	762	144	906
"O03"	"D32"	"Spontaneous abortion"	"Benign neoplasm of meninges"	1	30	0	30
"O03"	"D33"	"Spontaneous abortion"	"Benign neoplasm of brain and oth prt central nervous system"	1	43	0	43
"O03"	"D62"	"Spontaneous abortion"	"Acute posthemorrhagic anemia"	1	316	99	415
"O03"	"D86"	"Spontaneous abortion"	"Sarcoidosis"	1	108	13	121
"O03"	"E04"	"Spontaneous abortion"	"Other nontoxic goiter"	1	892	4	896
"O03"	"E05"	"Spontaneous abortion"	"Thyrotoxicosis [hyperthyroidism]"	1	931	80	1011
"O03"	"E21"	"Spontaneous abortion"	"Hyperparathyroidism and other disorders of parathyroid gland"	1	78	0	78
"O03"	"E22"	"Spontaneous abortion"	"Hyperfunction of pituitary gland"	1	99	30	129
"O03"	"E27"	"Spontaneous abortion"	"Other disorders of adrenal gland"	1	33	0	33
"O03"	"E34"	"Spontaneous abortion"	"Other endocrine disorders"	1	65	12	77
"O03"	"E73"	"Spontaneous abortion"	"Lactose intolerance"	1	85	12	97
"O03"	"E86"	"Spontaneous abortion"	"Volume depletion"	1	215	5	220
"O03"	"F11"	"Spontaneous abortion"	"Opioid related disorders"	1	91	30	121
"O03"	"F20"	"Spontaneous abortion"	"Schizophrenia"	1	62	7	69
"O03"	"F33"	"Spontaneous abortion"	"Major depressive disorder, recurrent"	1	486	4	490
"O03"	"F52"	"Spontaneous abortion"	"Sexual dysfnct not due to a substance or known physiol cond"	1	71	13	84
"O03"	"G24"	"Spontaneous abortion"	"Dystonia"	1	41	1	42
"O03"	"G35"	"Spontaneous abortion"	"Multiple sclerosis"	1	179	6	185
"O03"	"G37"	"Spontaneous abortion"	"Other demyelinating diseases of central nervous system"	1	55	0	55
"O03"	"G43"	"Spontaneous abortion"	"Migraine"	1	885	141	1026
"O03"	"G47"	"Spontaneous abortion"	"Sleep disorders"	1	180	0	180
"O03"	"G50"	"Spontaneous abortion"	"Disorders of trigeminal nerve"	1	87	0	87
"O03"	"G51"	"Spontaneous abortion"	"Facial nerve disorders"	1	163	18	181
"O03"	"G54"	"Spontaneous abortion"	"Nerve root and plexus disorders"	1	91	1	92
"O03"	"G56"	"Spontaneous abortion"	"Mononeuropathies of upper limb"	1	1433	0	1433
"O03"	"G62"	"Spontaneous abortion"	"Other and unspecified polyneuropathies"	1	54	0	54
"O03"	"G91"	"Spontaneous abortion"	"Hydrocephalus"	1	35	0	35
"O03"	"G97"	"Spontaneous abortion"	"Intraop and postproc comp and disorders of nervous sys, NEC"	1	58	8	66
"O03"	"G98"	"Spontaneous abortion"	"Other disorders of nervous system not elsewhere classified"	1	101	0	101
"O03"	"H25"	"Spontaneous abortion"	"Age-related cataract"	1	44	0	44
"O03"	"H26"	"Spontaneous abortion"	"Other cataract"	1	71	0	71
"O03"	"H33"	"Spontaneous abortion"	"Retinal detachments and breaks"	1	64	0	64
"O03"	"H35"	"Spontaneous abortion"	"Other retinal disorders"	1	126	0	126
"O03"	"H36"	"Spontaneous abortion"	"Retinal disorders in diseases classified elsewhere"	1	152	0	152
"O03"	"H40"	"Spontaneous abortion"	"Glaucoma"	1	50	0	50
"O03"	"H47"	"Spontaneous abortion"	"Other disorders of optic [2nd] nerve and visual pathways"	1	39	5	44
"O03"	"H52"	"Spontaneous abortion"	"Disorders of refraction and accommodation"	1	475	82	557
"O03"	"H53"	"Spontaneous abortion"	"Visual disturbances"	1	215	2	217
"O03"	"H57"	"Spontaneous abortion"	"Other disorders of eye and adnexa"	1	194	0	194
"O03"	"H60"	"Spontaneous abortion"	"Otitis externa"	1	172	51	223
"O03"	"H80"	"Spontaneous abortion"	"Otosclerosis"	1	92	19	111
"O03"	"H81"	"Spontaneous abortion"	"Disorders of vestibular function"	1	299	24	323
"O03"	"H90"	"Spontaneous abortion"	"Conductive and sensorineural hearing loss"	1	235	36	271
"O03"	"H91"	"Spontaneous abortion"	"Other and unspecified hearing loss"	1	348	0	348
"O03"	"I21"	"Spontaneous abortion"	"Acute myocardial infarction"	1	74	0	74
"O03"	"I25"	"Spontaneous abortion"	"Chronic ischemic heart disease"	1	93	0	93
"O03"	"I26"	"Spontaneous abortion"	"Pulmonary embolism"	1	162	9	171
"O03"	"I34"	"Spontaneous abortion"	"Nonrheumatic mitral valve disorders"	1	61	3	64
"O03"	"I47"	"Spontaneous abortion"	"Paroxysmal tachycardia"	1	356	51	407
"O03"	"I48"	"Spontaneous abortion"	"Atrial fibrillation and flutter"	1	129	0	129
"O03"	"I49"	"Spontaneous abortion"	"Other cardiac arrhythmias"	1	281	0	281
"O03"	"I50"	"Spontaneous abortion"	"Heart failure"	1	43	0	43
"O03"	"I61"	"Spontaneous abortion"	"Nontraumatic intracerebral hemorrhage"	1	48	0	48
"O03"	"I63"	"Spontaneous abortion"	"Cerebral infarction"	1	115	0	115
"O03"	"I73"	"Spontaneous abortion"	"Other peripheral vascular diseases"	1	120	0	120
"O03"	"I78"	"Spontaneous abortion"	"Diseases of capillaries"	1	128	9	137
"O03"	"I80"	"Spontaneous abortion"	"Phlebitis and thrombophlebitis"	1	424	37	461
"O03"	"I82"	"Spontaneous abortion"	"Other venous embolism and thrombosis"	1	113	3	116
"O03"	"I89"	"Spontaneous abortion"	"Oth noninfective disorders of lymphatic vessels and nodes"	1	58	0	58
"O03"	"I95"	"Spontaneous abortion"	"Hypotension"	1	64	10	74
"O03"	"I99"	"Spontaneous abortion"	"Other and unspecified disorders of circulatory system"	1	29	2	31
"O03"	"J01"	"Spontaneous abortion"	"Acute sinusitis"	1	340	20	360
"O03"	"J03"	"Spontaneous abortion"	"Acute tonsillitis"	1	604	374	978
"O03"	"J18"	"Spontaneous abortion"	"Pneumonia, unspecified organism"	1	1058	32	1090
"O03"	"J32"	"Spontaneous abortion"	"Chronic sinusitis"	1	202	13	215
"O03"	"J33"	"Spontaneous abortion"	"Nasal polyp"	1	79	13	92
"O03"	"J40"	"Spontaneous abortion"	"Bronchitis, not specified as acute or chronic"	1	25	0	25
"O03"	"J42"	"Spontaneous abortion"	"Unspecified chronic bronchitis"	1	39	0	39
"O03"	"J45"	"Spontaneous abortion"	"Asthma"	1	1077	608	1685
"O03"	"J93"	"Spontaneous abortion"	"Pneumothorax and air leak"	1	68	11	79
"O03"	"J96"	"Spontaneous abortion"	"Respiratory failure, not elsewhere classified"	1	136	0	136
"O03"	"J98"	"Spontaneous abortion"	"Other respiratory disorders"	1	79	8	87
"O03"	"K04"	"Spontaneous abortion"	"Diseases of pulp and periapical tissues"	1	170	3	173
"O03"	"K05"	"Spontaneous abortion"	"Gingivitis and periodontal diseases"	1	91	0	91
"O03"	"K08"	"Spontaneous abortion"	"Other disorders of teeth and supporting structures"	1	133	19	152
"O03"	"K11"	"Spontaneous abortion"	"Diseases of salivary glands"	1	120	19	139
"O03"	"K12"	"Spontaneous abortion"	"Stomatitis and related lesions"	1	94	17	111
"O03"	"K20"	"Spontaneous abortion"	"Esophagitis"	1	112	6	118
"O03"	"K22"	"Spontaneous abortion"	"Other diseases of esophagus"	1	123	2	125
"O03"	"K30"	"Spontaneous abortion"	"Functional dyspepsia"	1	805	139	944
"O03"	"K42"	"Spontaneous abortion"	"Umbilical hernia"	1	499	0	499
"O03"	"K43"	"Spontaneous abortion"	"Ventral hernia"	1	334	0	334
"O03"	"K52"	"Spontaneous abortion"	"Other and unsp noninfective gastroenteritis and colitis"	1	429	75	504
"O03"	"K57"	"Spontaneous abortion"	"Diverticular disease of intestine"	1	112	0	112
"O03"	"K58"	"Spontaneous abortion"	"Irritable bowel syndrome"	1	455	160	615
"O03"	"K59"	"Spontaneous abortion"	"Other functional intestinal disorders"	1	1212	108	1320
"O03"	"K65"	"Spontaneous abortion"	"Peritonitis"	1	119	6	125
"O03"	"K66"	"Spontaneous abortion"	"Other disorders of peritoneum"	1	73	18	91
"O03"	"K81"	"Spontaneous abortion"	"Cholecystitis"	1	223	14	237
"O03"	"K86"	"Spontaneous abortion"	"Other diseases of pancreas"	1	49	0	49
"O03"	"K90"	"Spontaneous abortion"	"Intestinal malabsorption"	1	119	3	122
"O03"	"K91"	"Spontaneous abortion"	"Intraop and postproc comp and disorders of dgstv sys, NEC"	1	59	0	59
"O03"	"L02"	"Spontaneous abortion"	"Cutaneous abscess, furuncle and carbuncle"	1	806	268	1074
"O03"	"L23"	"Spontaneous abortion"	"Allergic contact dermatitis"	1	148	55	203
"O03"	"L40"	"Spontaneous abortion"	"Psoriasis"	1	181	16	197
"O03"	"L50"	"Spontaneous abortion"	"Urticaria"	1	358	128	486
"O03"	"L71"	"Spontaneous abortion"	"Rosacea"	1	94	0	94
"O03"	"L72"	"Spontaneous abortion"	"Follicular cysts of skin and subcutaneous tissue"	1	129	0	129
"O03"	"L73"	"Spontaneous abortion"	"Other follicular disorders"	1	190	42	232
"O03"	"L92"	"Spontaneous abortion"	"Granulomatous disorders of skin and subcutaneous tissue"	1	45	2	47
"O03"	"L98"	"Spontaneous abortion"	"Oth disorders of skin, subcu, not elsewhere classified"	1	209	8	217
"O03"	"M02"	"Spontaneous abortion"	"Postinfective and reactive arthropathies"	1	124	52	176
"O03"	"M05"	"Spontaneous abortion"	"Rheumatoid arthritis with rheumatoid factor"	1	126	0	126
"O03"	"M06"	"Spontaneous abortion"	"Other rheumatoid arthritis"	1	175	5	180
"O03"	"M13"	"Spontaneous abortion"	"Other arthritis"	1	227	4	231
"O03"	"M16"	"Spontaneous abortion"	"Osteoarthritis of hip"	1	120	0	120
"O03"	"M19"	"Spontaneous abortion"	"Other and unspecified osteoarthritis"	1	251	0	251
"O03"	"M20"	"Spontaneous abortion"	"Acquired deformities of fingers and toes"	1	530	31	561
"O03"	"M21"	"Spontaneous abortion"	"Other acquired deformities of limbs"	1	155	20	175
"O03"	"M25"	"Spontaneous abortion"	"Other joint disorder, not elsewhere classified"	1	897	14	911
"O03"	"M32"	"Spontaneous abortion"	"Systemic lupus erythematosus (SLE)"	1	61	12	73
"O03"	"M46"	"Spontaneous abortion"	"Other inflammatory spondylopathies"	1	116	0	116
"O03"	"M47"	"Spontaneous abortion"	"Spondylosis"	1	242	0	242
"O03"	"M48"	"Spontaneous abortion"	"Other spondylopathies"	1	103	0	103
"O03"	"M50"	"Spontaneous abortion"	"Cervical disc disorders"	1	374	0	374
"O03"	"M53"	"Spontaneous abortion"	"Other and unspecified dorsopathies, not elsewhere classified"	1	369	9	378
"O03"	"M54"	"Spontaneous abortion"	"Dorsalgia"	1	3135	0	3135
"O03"	"M62"	"Spontaneous abortion"	"Other disorders of muscle"	1	1954	812	2766
"O03"	"M70"	"Spontaneous abortion"	"Soft tissue disorders related to use, overuse and pressure"	1	366	22	388
"O03"	"M72"	"Spontaneous abortion"	"Fibroblastic disorders"	1	156	0	156
"O03"	"M77"	"Spontaneous abortion"	"Other enthesopathies"	1	582	0	582
"O03"	"M79"	"Spontaneous abortion"	"Oth and unsp soft tissue disorders, not elsewhere classified"	1	2383	0	2383
"O03"	"M81"	"Spontaneous abortion"	"Osteoporosis without current pathological fracture"	1	84	0	84
"O03"	"M85"	"Spontaneous abortion"	"Other disorders of bone density and structure"	1	134	0	134
"O03"	"M89"	"Spontaneous abortion"	"Other disorders of bone"	1	71	13	84
"O03"	"M96"	"Spontaneous abortion"	"Intraop and postproc comp and disorders of ms sys, NEC"	1	26	0	26
"O03"	"N18"	"Spontaneous abortion"	"Chronic kidney disease (CKD)"	1	64	0	64
"O03"	"N20"	"Spontaneous abortion"	"Calculus of kidney and ureter"	1	683	102	785
"O03"	"N60"	"Spontaneous abortion"	"Benign mammary dysplasia"	1	795	67	862
"O03"	"N63"	"Spontaneous abortion"	"Unspecified lump in breast"	1	1047	21	1068
"O03"	"N76"	"Spontaneous abortion"	"Other inflammation of vagina and vulva"	1	548	221	769
"O03"	"N82"	"Spontaneous abortion"	"Fistulae involving female genital tract"	1	45	4	49
"O03"	"N89"	"Spontaneous abortion"	"Other noninflammatory disorders of vagina"	1	182	60	242
"O03"	"N90"	"Spontaneous abortion"	"Other noninflammatory disorders of vulva and perineum"	1	268	77	345
"O03"	"N94"	"Spontaneous abortion"	"Pain and oth cond assoc w fem gntl org and menstrual cycle"	1	1434	412	1846
"O03"	"O00"	"Spontaneous abortion"	"Ectopic pregnancy"	1	3100	2271	5371
"O03"	"O10"	"Spontaneous abortion"	"Pre-existing hypertension compl preg/chldbrth"	1	573	207	780
"O03"	"O12"	"Spontaneous abortion"	"Gestational edema and proteinuria without hypertension"	1	605	266	871
"O03"	"O24"	"Spontaneous abortion"	"Diabetes in pregnancy, childbirth, and the puerperium"	1	2478	696	3174
"O03"	"O26"	"Spontaneous abortion"	"Maternal care for oth conditions predom related to pregnancy"	1	9001	0	9001
"O03"	"O33"	"Spontaneous abortion"	"Maternal care for disproportion"	1	247	97	344
"O03"	"O36"	"Spontaneous abortion"	"Maternal care for other fetal problems"	1	5206	2132	7338
"O03"	"O40"	"Spontaneous abortion"	"Polyhydramnios"	1	764	186	950
"O03"	"O45"	"Spontaneous abortion"	"Premature separation of placenta [abruptio placentae]"	1	599	303	902
"O03"	"O60"	"Spontaneous abortion"	"Preterm labor"	1	829	520	1349
"O03"	"O61"	"Spontaneous abortion"	"Failed induction of labor"	1	369	110	479
"O03"	"O62"	"Spontaneous abortion"	"Abnormalities of forces of labor"	1	12972	10414	23386
"O03"	"O67"	"Spontaneous abortion"	"Labor and delivery comp by intrapartum hemorrhage, NEC"	1	376	110	486
"O03"	"O68"	"Spontaneous abortion"	"Labor and delivery comp by abnlt of fetal acid-base balance"	1	9022	5968	14990
"O03"	"O70"	"Spontaneous abortion"	"Perineal laceration during delivery"	1	27401	0	27401
"O03"	"O71"	"Spontaneous abortion"	"Other obstetric trauma"	1	2746	2092	4838
"O03"	"O72"	"Spontaneous abortion"	"Postpartum hemorrhage"	1	23553	0	23553
"O03"	"O86"	"Spontaneous abortion"	"Other puerperal infections"	1	1000	515	1515
"O03"	"O99"	"Spontaneous abortion"	"Oth maternal diseases classd elsw but compl preg/chldbrth"	1	19298	0	19298
"O04"	"A09"	"Complications following (induced) termination of pregnancy"	"Infectious gastroenteritis and colitis, unspecified"	1	1388	914	2302
"O04"	"A40"	"Complications following (induced) termination of pregnancy"	"Streptococcal sepsis"	1	36	1	37
"O04"	"A41"	"Complications following (induced) termination of pregnancy"	"Other sepsis"	1	417	0	417
"O04"	"A46"	"Complications following (induced) termination of pregnancy"	"Erysipelas"	1	359	0	359
"O04"	"A49"	"Complications following (induced) termination of pregnancy"	"Bacterial infection of unspecified site"	1	464	0	464
"O04"	"B00"	"Complications following (induced) termination of pregnancy"	"Herpesviral [herpes simplex] infections"	1	185	58	243
"O04"	"B20"	"Complications following (induced) termination of pregnancy"	"Human immunodeficiency virus [HIV] disease"	1	41	6	47
"O04"	"B35"	"Complications following (induced) termination of pregnancy"	"Dermatophytosis"	1	61	5	66
"O04"	"B36"	"Complications following (induced) termination of pregnancy"	"Other superficial mycoses"	1	88	6	94
"O04"	"B95"	"Complications following (induced) termination of pregnancy"	"Strep as the cause of diseases classified elsewhere"	1	103	0	103
"O04"	"B96"	"Complications following (induced) termination of pregnancy"	"Oth bacterial agents as the cause of diseases classd elswhr"	1	45	0	45
"O04"	"C18"	"Complications following (induced) termination of pregnancy"	"Malignant neoplasm of colon"	1	42	0	42
"O04"	"C44"	"Complications following (induced) termination of pregnancy"	"Other and unspecified malignant neoplasm of skin"	1	122	0	122
"O04"	"C49"	"Complications following (induced) termination of pregnancy"	"Malignant neoplasm of other connective and soft tissue"	1	47	0	47
"O04"	"C50"	"Complications following (induced) termination of pregnancy"	"Malignant neoplasm of breast"	1	475	0	475
"O04"	"C53"	"Complications following (induced) termination of pregnancy"	"Malignant neoplasm of cervix uteri"	1	242	0	242
"O04"	"C78"	"Complications following (induced) termination of pregnancy"	"Secondary malignant neoplasm of resp and digestive organs"	1	89	0	89
"O04"	"C85"	"Complications following (induced) termination of pregnancy"	"Oth and unspecified types of non-Hodgkin lymphoma"	1	34	1	35
"O04"	"D07"	"Complications following (induced) termination of pregnancy"	"Carcinoma in situ of other and unspecified genital organs"	1	45	0	45
"O04"	"D12"	"Complications following (induced) termination of pregnancy"	"Benign neoplasm of colon, rectum, anus and anal canal"	1	277	0	277
"O04"	"D14"	"Complications following (induced) termination of pregnancy"	"Benign neoplasm of middle ear and respiratory system"	1	129	0	129
"O04"	"D17"	"Complications following (induced) termination of pregnancy"	"Benign lipomatous neoplasm"	1	837	0	837
"O04"	"D21"	"Complications following (induced) termination of pregnancy"	"Other benign neoplasms of connective and other soft tissue"	1	188	0	188
"O04"	"D23"	"Complications following (induced) termination of pregnancy"	"Other benign neoplasms of skin"	1	797	93	890
"O04"	"D24"	"Complications following (induced) termination of pregnancy"	"Benign neoplasm of breast"	1	2006	0	2006
"O04"	"D25"	"Complications following (induced) termination of pregnancy"	"Leiomyoma of uterus"	1	1712	0	1712
"O04"	"D26"	"Complications following (induced) termination of pregnancy"	"Other benign neoplasms of uterus"	1	77	12	89
"O04"	"D28"	"Complications following (induced) termination of pregnancy"	"Benign neoplasm of other and unsp female genital organs"	1	251	48	299
"O04"	"D32"	"Complications following (induced) termination of pregnancy"	"Benign neoplasm of meninges"	1	35	0	35
"O04"	"D33"	"Complications following (induced) termination of pregnancy"	"Benign neoplasm of brain and oth prt central nervous system"	1	89	0	89
"O04"	"D34"	"Complications following (induced) termination of pregnancy"	"Benign neoplasm of thyroid gland"	1	110	0	110
"O04"	"D35"	"Complications following (induced) termination of pregnancy"	"Benign neoplasm of other and unspecified endocrine glands"	1	97	0	97
"O04"	"D39"	"Complications following (induced) termination of pregnancy"	"Neoplasm of uncertain behavior of female genital organs"	1	93	18	111
"O04"	"D50"	"Complications following (induced) termination of pregnancy"	"Iron deficiency anemia"	1	702	0	702
"O04"	"D61"	"Complications following (induced) termination of pregnancy"	"Oth aplastic anemias and other bone marrow failure syndromes"	1	34	0	34
"O04"	"D69"	"Complications following (induced) termination of pregnancy"	"Purpura and other hemorrhagic conditions"	1	331	89	420
"O04"	"D75"	"Complications following (induced) termination of pregnancy"	"Other and unsp diseases of blood and blood-forming organs"	1	62	0	62
"O04"	"D84"	"Complications following (induced) termination of pregnancy"	"Other immunodeficiencies"	1	38	0	38
"O04"	"E05"	"Complications following (induced) termination of pregnancy"	"Thyrotoxicosis [hyperthyroidism]"	1	1286	0	1286
"O04"	"E07"	"Complications following (induced) termination of pregnancy"	"Other disorders of thyroid"	1	81	2	83
"O04"	"E10"	"Complications following (induced) termination of pregnancy"	"Type 1 diabetes mellitus"	1	260	139	399
"O04"	"E13"	"Complications following (induced) termination of pregnancy"	"Other specified diabetes mellitus"	1	39	0	39
"O04"	"E27"	"Complications following (induced) termination of pregnancy"	"Other disorders of adrenal gland"	1	84	0	84
"O04"	"E28"	"Complications following (induced) termination of pregnancy"	"Ovarian dysfunction"	1	506	153	659
"O04"	"E61"	"Complications following (induced) termination of pregnancy"	"Deficiency of other nutrient elements"	1	42	0	42
"O04"	"E65"	"Complications following (induced) termination of pregnancy"	"Localized adiposity"	1	800	29	829
"O04"	"E78"	"Complications following (induced) termination of pregnancy"	"Disorders of lipoprotein metabolism and other lipidemias"	1	383	0	383
"O04"	"E86"	"Complications following (induced) termination of pregnancy"	"Volume depletion"	1	360	12	372
"O04"	"E87"	"Complications following (induced) termination of pregnancy"	"Other disorders of fluid, electrolyte and acid-base balance"	1	218	0	218
"O04"	"E88"	"Complications following (induced) termination of pregnancy"	"Other and unspecified metabolic disorders"	1	110	2	112
"O04"	"F06"	"Complications following (induced) termination of pregnancy"	"Other mental disorders due to known physiological condition"	1	67	0	67
"O04"	"F07"	"Complications following (induced) termination of pregnancy"	"Personality & behavrl disorders due to known physiol cond"	1	82	5	87
"O04"	"F12"	"Complications following (induced) termination of pregnancy"	"Cannabis related disorders"	1	223	93	316
"O04"	"F17"	"Complications following (induced) termination of pregnancy"	"Nicotine dependence"	1	3503	0	3503
"O04"	"F22"	"Complications following (induced) termination of pregnancy"	"Delusional disorders"	1	38	0	38
"O04"	"F31"	"Complications following (induced) termination of pregnancy"	"Bipolar disorder"	1	139	0	139
"O04"	"F32"	"Complications following (induced) termination of pregnancy"	"Depressive episode"	1	1128	45	1173
"O04"	"F34"	"Complications following (induced) termination of pregnancy"	"Persistent mood [affective] disorders"	1	83	0	83
"O04"	"F60"	"Complications following (induced) termination of pregnancy"	"Specific personality disorders"	1	525	39	564
"O04"	"G03"	"Complications following (induced) termination of pregnancy"	"Meningitis due to other and unspecified causes"	1	58	8	66
"O04"	"G44"	"Complications following (induced) termination of pregnancy"	"Other headache syndromes"	1	1620	0	1620
"O04"	"G47"	"Complications following (induced) termination of pregnancy"	"Sleep disorders"	1	444	0	444
"O04"	"G57"	"Complications following (induced) termination of pregnancy"	"Mononeuropathies of lower limb"	1	278	0	278
"O04"	"G62"	"Complications following (induced) termination of pregnancy"	"Other and unspecified polyneuropathies"	1	98	0	98
"O04"	"G70"	"Complications following (induced) termination of pregnancy"	"Myasthenia gravis and other myoneural disorders"	1	24	1	25
"O04"	"G72"	"Complications following (induced) termination of pregnancy"	"Other and unspecified myopathies"	1	29	0	29
"O04"	"G82"	"Complications following (induced) termination of pregnancy"	"Paraplegia (paraparesis) and quadriplegia (quadriparesis)"	1	54	1	55
"O04"	"G90"	"Complications following (induced) termination of pregnancy"	"Disorders of autonomic nervous system"	1	47	5	52
"O04"	"G91"	"Complications following (induced) termination of pregnancy"	"Hydrocephalus"	1	35	0	35
"O04"	"G93"	"Complications following (induced) termination of pregnancy"	"Other disorders of brain"	1	171	0	171
"O04"	"G95"	"Complications following (induced) termination of pregnancy"	"Other and unspecified diseases of spinal cord"	1	72	0	72
"O04"	"G98"	"Complications following (induced) termination of pregnancy"	"Other disorders of nervous system not elsewhere classified"	1	202	0	202
"O04"	"H02"	"Complications following (induced) termination of pregnancy"	"Other disorders of eyelid"	1	441	0	441
"O04"	"H10"	"Complications following (induced) termination of pregnancy"	"Conjunctivitis"	1	1293	627	1920
"O04"	"H17"	"Complications following (induced) termination of pregnancy"	"Corneal scars and opacities"	1	33	0	33
"O04"	"H34"	"Complications following (induced) termination of pregnancy"	"Retinal vascular occlusions"	1	31	0	31
"O04"	"H35"	"Complications following (induced) termination of pregnancy"	"Other retinal disorders"	1	226	0	226
"O04"	"H44"	"Complications following (induced) termination of pregnancy"	"Disorders of globe"	1	181	0	181
"O04"	"H46"	"Complications following (induced) termination of pregnancy"	"Optic neuritis"	1	110	7	117
"O04"	"H49"	"Complications following (induced) termination of pregnancy"	"Paralytic strabismus"	1	64	5	69
"O04"	"H52"	"Complications following (induced) termination of pregnancy"	"Disorders of refraction and accommodation"	1	987	103	1090
"O04"	"H53"	"Complications following (induced) termination of pregnancy"	"Visual disturbances"	1	485	6	491
"O04"	"H57"	"Complications following (induced) termination of pregnancy"	"Other disorders of eye and adnexa"	1	423	0	423
"O04"	"H81"	"Complications following (induced) termination of pregnancy"	"Disorders of vestibular function"	1	664	0	664
"O04"	"H90"	"Complications following (induced) termination of pregnancy"	"Conductive and sensorineural hearing loss"	1	492	78	570
"O04"	"H91"	"Complications following (induced) termination of pregnancy"	"Other and unspecified hearing loss"	1	592	0	592
"O04"	"H93"	"Complications following (induced) termination of pregnancy"	"Other disorders of ear, not elsewhere classified"	1	573	0	573
"O04"	"I15"	"Complications following (induced) termination of pregnancy"	"Secondary hypertension"	1	113	0	113
"O04"	"I20"	"Complications following (induced) termination of pregnancy"	"Angina pectoris"	1	484	0	484
"O04"	"I34"	"Complications following (induced) termination of pregnancy"	"Nonrheumatic mitral valve disorders"	1	86	0	86
"O04"	"I45"	"Complications following (induced) termination of pregnancy"	"Other conduction disorders"	1	110	37	147
"O04"	"I46"	"Complications following (induced) termination of pregnancy"	"Cardiac arrest"	1	76	0	76
"O04"	"I47"	"Complications following (induced) termination of pregnancy"	"Paroxysmal tachycardia"	1	722	92	814
"O04"	"I50"	"Complications following (induced) termination of pregnancy"	"Heart failure"	1	101	0	101
"O04"	"I60"	"Complications following (induced) termination of pregnancy"	"Nontraumatic subarachnoid hemorrhage"	1	200	0	200
"O04"	"I61"	"Complications following (induced) termination of pregnancy"	"Nontraumatic intracerebral hemorrhage"	1	115	0	115
"O04"	"I67"	"Complications following (induced) termination of pregnancy"	"Other cerebrovascular diseases"	1	93	0	93
"O04"	"I70"	"Complications following (induced) termination of pregnancy"	"Atherosclerosis"	1	96	0	96
"O04"	"I73"	"Complications following (induced) termination of pregnancy"	"Other peripheral vascular diseases"	1	223	0	223
"O04"	"I74"	"Complications following (induced) termination of pregnancy"	"Arterial embolism and thrombosis"	1	57	0	57
"O04"	"I82"	"Complications following (induced) termination of pregnancy"	"Other venous embolism and thrombosis"	1	169	0	169
"O04"	"I87"	"Complications following (induced) termination of pregnancy"	"Other disorders of veins"	1	84	0	84
"O04"	"I88"	"Complications following (induced) termination of pregnancy"	"Nonspecific lymphadenitis"	1	259	115	374
"O04"	"I89"	"Complications following (induced) termination of pregnancy"	"Oth noninfective disorders of lymphatic vessels and nodes"	1	150	0	150
"O04"	"I95"	"Complications following (induced) termination of pregnancy"	"Hypotension"	1	133	6	139
"O04"	"J02"	"Complications following (induced) termination of pregnancy"	"Acute pharyngitis"	1	276	125	401
"O04"	"J03"	"Complications following (induced) termination of pregnancy"	"Acute tonsillitis"	1	1420	845	2265
"O04"	"J10"	"Complications following (induced) termination of pregnancy"	"Influenza due to other identified influenza virus"	1	45	0	45
"O04"	"J22"	"Complications following (induced) termination of pregnancy"	"Unspecified acute lower respiratory infection"	1	50	0	50
"O04"	"J30"	"Complications following (induced) termination of pregnancy"	"Vasomotor and allergic rhinitis"	1	835	487	1322
"O04"	"J31"	"Complications following (induced) termination of pregnancy"	"Chronic rhinitis, nasopharyngitis and pharyngitis"	1	138	17	155
"O04"	"J34"	"Complications following (induced) termination of pregnancy"	"Other and unspecified disorders of nose and nasal sinuses"	1	798	184	982
"O04"	"J41"	"Complications following (induced) termination of pregnancy"	"Simple and mucopurulent chronic bronchitis"	1	43	2	45
"O04"	"J42"	"Complications following (induced) termination of pregnancy"	"Unspecified chronic bronchitis"	1	84	0	84
"O04"	"J45"	"Complications following (induced) termination of pregnancy"	"Asthma"	1	2361	1476	3837
"O04"	"J47"	"Complications following (induced) termination of pregnancy"	"Bronchiectasis"	1	47	0	47
"O04"	"J84"	"Complications following (induced) termination of pregnancy"	"Other interstitial pulmonary diseases"	1	57	0	57
"O04"	"J90"	"Complications following (induced) termination of pregnancy"	"Pleural effusion, not elsewhere classified"	1	50	0	50
"O04"	"J91"	"Complications following (induced) termination of pregnancy"	"Pleural effusion in conditions classified elsewhere"	1	33	0	33
"O04"	"K02"	"Complications following (induced) termination of pregnancy"	"Dental caries"	1	222	68	290
"O04"	"K08"	"Complications following (induced) termination of pregnancy"	"Other disorders of teeth and supporting structures"	1	350	20	370
"O04"	"K11"	"Complications following (induced) termination of pregnancy"	"Diseases of salivary glands"	1	258	15	273
"O04"	"K22"	"Complications following (induced) termination of pregnancy"	"Other diseases of esophagus"	1	208	0	208
"O04"	"K26"	"Complications following (induced) termination of pregnancy"	"Duodenal ulcer"	1	168	21	189
"O04"	"K27"	"Complications following (induced) termination of pregnancy"	"Peptic ulcer, site unspecified"	1	121	13	134
"O04"	"K42"	"Complications following (induced) termination of pregnancy"	"Umbilical hernia"	1	586	0	586
"O04"	"K46"	"Complications following (induced) termination of pregnancy"	"Unspecified abdominal hernia"	1	55	0	55
"O04"	"K50"	"Complications following (induced) termination of pregnancy"	"Crohn's disease [regional enteritis]"	1	329	132	461
"O04"	"K59"	"Complications following (induced) termination of pregnancy"	"Other functional intestinal disorders"	1	2766	0	2766
"O04"	"K63"	"Complications following (induced) termination of pregnancy"	"Other diseases of intestine"	1	154	0	154
"O04"	"K65"	"Complications following (induced) termination of pregnancy"	"Peritonitis"	1	174	5	179
"O04"	"K71"	"Complications following (induced) termination of pregnancy"	"Toxic liver disease"	1	104	21	125
"O04"	"K72"	"Complications following (induced) termination of pregnancy"	"Hepatic failure, not elsewhere classified"	1	43	0	43
"O04"	"K76"	"Complications following (induced) termination of pregnancy"	"Other diseases of liver"	1	205	0	205
"O04"	"K81"	"Complications following (induced) termination of pregnancy"	"Cholecystitis"	1	381	0	381
"O04"	"K83"	"Complications following (induced) termination of pregnancy"	"Other diseases of biliary tract"	1	150	0	150
"O04"	"K85"	"Complications following (induced) termination of pregnancy"	"Acute pancreatitis"	1	344	2	346
"O04"	"L21"	"Complications following (induced) termination of pregnancy"	"Seborrheic dermatitis"	1	74	15	89
"O04"	"L27"	"Complications following (induced) termination of pregnancy"	"Dermatitis due to substances taken internally"	1	49	8	57
"O04"	"L28"	"Complications following (induced) termination of pregnancy"	"Lichen simplex chronicus and prurigo"	1	83	0	83
"O04"	"L29"	"Complications following (induced) termination of pregnancy"	"Pruritus"	1	188	0	188
"O04"	"L30"	"Complications following (induced) termination of pregnancy"	"Other and unspecified dermatitis"	1	706	6	712
"O04"	"L50"	"Complications following (induced) termination of pregnancy"	"Urticaria"	1	930	188	1118
"O04"	"L71"	"Complications following (induced) termination of pregnancy"	"Rosacea"	1	185	0	185
"O04"	"L72"	"Complications following (induced) termination of pregnancy"	"Follicular cysts of skin and subcutaneous tissue"	1	306	0	306
"O04"	"L73"	"Complications following (induced) termination of pregnancy"	"Other follicular disorders"	1	490	68	558
"O04"	"L82"	"Complications following (induced) termination of pregnancy"	"Seborrheic keratosis"	1	52	0	52
"O04"	"L90"	"Complications following (induced) termination of pregnancy"	"Atrophic disorders of skin"	1	1260	151	1411
"O04"	"L93"	"Complications following (induced) termination of pregnancy"	"Lupus erythematosus"	1	63	1	64
"O04"	"L94"	"Complications following (induced) termination of pregnancy"	"Other localized connective tissue disorders"	1	30	3	33
"O04"	"L95"	"Complications following (induced) termination of pregnancy"	"Vasculitis limited to skin, not elsewhere classified"	1	52	6	58
"O04"	"M00"	"Complications following (induced) termination of pregnancy"	"Pyogenic arthritis"	1	57	10	67
"O04"	"M05"	"Complications following (induced) termination of pregnancy"	"Rheumatoid arthritis with rheumatoid factor"	1	228	0	228
"O04"	"M06"	"Complications following (induced) termination of pregnancy"	"Other rheumatoid arthritis"	1	263	0	263
"O04"	"M10"	"Complications following (induced) termination of pregnancy"	"Gout"	1	81	0	81
"O04"	"M12"	"Complications following (induced) termination of pregnancy"	"Other and unspecified arthropathy"	1	47	3	50
"O04"	"M17"	"Complications following (induced) termination of pregnancy"	"Osteoarthritis of knee"	1	774	0	774
"O04"	"M19"	"Complications following (induced) termination of pregnancy"	"Other and unspecified osteoarthritis"	1	513	0	513
"O04"	"M21"	"Complications following (induced) termination of pregnancy"	"Other acquired deformities of limbs"	1	420	66	486
"O04"	"M23"	"Complications following (induced) termination of pregnancy"	"Internal derangement of knee"	1	4993	0	4993
"O04"	"M34"	"Complications following (induced) termination of pregnancy"	"Systemic sclerosis [scleroderma]"	1	33	0	33
"O04"	"M46"	"Complications following (induced) termination of pregnancy"	"Other inflammatory spondylopathies"	1	195	0	195
"O04"	"M47"	"Complications following (induced) termination of pregnancy"	"Spondylosis"	1	466	0	466
"O04"	"M48"	"Complications following (induced) termination of pregnancy"	"Other spondylopathies"	1	188	0	188
"O04"	"M51"	"Complications following (induced) termination of pregnancy"	"Thoracic, thoracolum, and lumbosacral intvrt disc disorders"	1	2814	0	2814
"O04"	"M60"	"Complications following (induced) termination of pregnancy"	"Myositis"	1	71	3	74
"O04"	"M71"	"Complications following (induced) termination of pregnancy"	"Other bursopathies"	1	208	7	215
"O04"	"M76"	"Complications following (induced) termination of pregnancy"	"Enthesopathies, lower limb, excluding foot"	1	939	95	1034
"O04"	"M79"	"Complications following (induced) termination of pregnancy"	"Oth and unsp soft tissue disorders, not elsewhere classified"	1	5515	0	5515
"O04"	"M81"	"Complications following (induced) termination of pregnancy"	"Osteoporosis without current pathological fracture"	1	130	0	130
"O04"	"M87"	"Complications following (induced) termination of pregnancy"	"Osteonecrosis"	1	29	0	29
"O04"	"M94"	"Complications following (induced) termination of pregnancy"	"Other disorders of cartilage"	1	107	3	110
"O04"	"M95"	"Complications following (induced) termination of pregnancy"	"Oth acquired deformities of ms sys and connective tissue"	1	380	103	483
"O04"	"N10"	"Complications following (induced) termination of pregnancy"	"Acute pyelonephritis"	1	1127	468	1595
"O04"	"N17"	"Complications following (induced) termination of pregnancy"	"Acute kidney failure"	1	57	0	57
"O04"	"N18"	"Complications following (induced) termination of pregnancy"	"Chronic kidney disease (CKD)"	1	121	0	121
"O04"	"N19"	"Complications following (induced) termination of pregnancy"	"Unspecified kidney failure"	1	57	0	57
"O04"	"N20"	"Complications following (induced) termination of pregnancy"	"Calculus of kidney and ureter"	1	1601	0	1601
"O04"	"N21"	"Complications following (induced) termination of pregnancy"	"Calculus of lower urinary tract"	1	68	18	86
"O04"	"N32"	"Complications following (induced) termination of pregnancy"	"Other disorders of bladder"	1	100	0	100
"O04"	"N60"	"Complications following (induced) termination of pregnancy"	"Benign mammary dysplasia"	1	1949	0	1949
"O04"	"N61"	"Complications following (induced) termination of pregnancy"	"Inflammatory disorders of breast"	1	587	0	587
"O04"	"N62"	"Complications following (induced) termination of pregnancy"	"Hypertrophy of breast"	1	883	509	1392
"O04"	"N63"	"Complications following (induced) termination of pregnancy"	"Unspecified lump in breast"	1	2045	0	2045
"O04"	"N64"	"Complications following (induced) termination of pregnancy"	"Other disorders of breast"	1	2933	0	2933
"O04"	"N71"	"Complications following (induced) termination of pregnancy"	"Inflammatory disease of uterus, except cervix"	1	2942	752	3694
"O04"	"N73"	"Complications following (induced) termination of pregnancy"	"Other female pelvic inflammatory diseases"	1	567	157	724
"O04"	"N75"	"Complications following (induced) termination of pregnancy"	"Diseases of Bartholin's gland"	1	850	154	1004
"O04"	"N76"	"Complications following (induced) termination of pregnancy"	"Other inflammation of vagina and vulva"	1	1519	343	1862
"O04"	"N83"	"Complications following (induced) termination of pregnancy"	"Noninflammatory disord of ovary, fallop and broad ligament"	1	5201	0	5201
"O04"	"N85"	"Complications following (induced) termination of pregnancy"	"Other noninflammatory disorders of uterus, except cervix"	1	299	0	299
"O04"	"N87"	"Complications following (induced) termination of pregnancy"	"Dysplasia of cervix uteri"	1	5282	0	5282
"O04"	"N90"	"Complications following (induced) termination of pregnancy"	"Other noninflammatory disorders of vulva and perineum"	1	715	91	806
"O04"	"N91"	"Complications following (induced) termination of pregnancy"	"Absent, scanty and rare menstruation"	1	281	94	375
"O04"	"N96"	"Complications following (induced) termination of pregnancy"	"Recurrent pregnancy loss"	1	360	66	426
"O04"	"N97"	"Complications following (induced) termination of pregnancy"	"Female infertility"	1	1976	491	2467
"O04"	"N99"	"Complications following (induced) termination of pregnancy"	"Intraop and postproc comp and disorders of GU sys, NEC"	1	240	51	291
"O04"	"O02"	"Complications following (induced) termination of pregnancy"	"Other abnormal products of conception"	1	6070	2943	9013
"O04"	"O24"	"Complications following (induced) termination of pregnancy"	"Diabetes in pregnancy, childbirth, and the puerperium"	1	1538	270	1808
"O04"	"O26"	"Complications following (induced) termination of pregnancy"	"Maternal care for oth conditions predom related to pregnancy"	1	4560	2429	6989
"O04"	"O31"	"Complications following (induced) termination of pregnancy"	"Complications specific to multiple gestation"	1	75	23	98
"O04"	"O32"	"Complications following (induced) termination of pregnancy"	"Maternal care for malpresentation of fetus"	1	1987	985	2972
"O04"	"O40"	"Complications following (induced) termination of pregnancy"	"Polyhydramnios"	1	515	81	596
"O04"	"O41"	"Complications following (induced) termination of pregnancy"	"Other disorders of amniotic fluid and membranes"	1	725	326	1051
"O04"	"O44"	"Complications following (induced) termination of pregnancy"	"Placenta previa"	1	545	81	626
"O04"	"O62"	"Complications following (induced) termination of pregnancy"	"Abnormalities of forces of labor"	1	10742	9103	19845
"O04"	"O63"	"Complications following (induced) termination of pregnancy"	"Long labor"	1	1832	910	2742
"O04"	"O66"	"Complications following (induced) termination of pregnancy"	"Other obstructed labor"	1	983	463	1446
"O04"	"O67"	"Complications following (induced) termination of pregnancy"	"Labor and delivery comp by intrapartum hemorrhage, NEC"	1	227	31	258
"O04"	"O68"	"Complications following (induced) termination of pregnancy"	"Labor and delivery comp by abnlt of fetal acid-base balance"	1	8051	4320	12371
"O04"	"O72"	"Complications following (induced) termination of pregnancy"	"Postpartum hemorrhage"	1	18644	0	18644
"O04"	"O82"	"Complications following (induced) termination of pregnancy"	"Encounter for cesarean delivery without indication"	1	11592	0	11592
"O04"	"O85"	"Complications following (induced) termination of pregnancy"	"Puerperal sepsis"	1	456	229	685
"O04"	"O87"	"Complications following (induced) termination of pregnancy"	"Venous complications and hemorrhoids in the puerperium"	1	282	93	375
"O04"	"O90"	"Complications following (induced) termination of pregnancy"	"Complications of the puerperium, not elsewhere classified"	1	1254	326	1580
"O04"	"O91"	"Complications following (induced) termination of pregnancy"	"Infect of breast assoc w pregnancy, the puerp and lactation"	1	806	154	960
"O04"	"O99"	"Complications following (induced) termination of pregnancy"	"Oth maternal diseases classd elsw but compl preg/chldbrth"	1	16476	0	16476
"O04"	"Q27"	"Complications following (induced) termination of pregnancy"	"Other congenital malformations of peripheral vascular system"	1	117	3	120
"O04"	"Q83"	"Complications following (induced) termination of pregnancy"	"Congenital malformations of breast"	1	312	142	454
"O08"	"D17"	"Complications following ectopic and molar pregnancy"	"Benign lipomatous neoplasm"	1	102	19	121
"O08"	"D22"	"Complications following ectopic and molar pregnancy"	"Melanocytic nevi"	1	138	65	203
"O08"	"E04"	"Complications following ectopic and molar pregnancy"	"Other nontoxic goiter"	1	172	43	215
"O08"	"E65"	"Complications following ectopic and molar pregnancy"	"Localized adiposity"	1	103	22	125
"O08"	"E68"	"Complications following ectopic and molar pregnancy"	"Sequelae of hyperalimentation"	1	77	12	89
"O08"	"E87"	"Complications following ectopic and molar pregnancy"	"Other disorders of fluid, electrolyte and acid-base balance"	1	43	4	47
"O08"	"G43"	"Complications following ectopic and molar pregnancy"	"Migraine"	1	280	156	436
"O08"	"I20"	"Complications following ectopic and molar pregnancy"	"Angina pectoris"	1	83	0	83
"O08"	"I48"	"Complications following ectopic and molar pregnancy"	"Atrial fibrillation and flutter"	1	36	4	40
"O08"	"I69"	"Complications following ectopic and molar pregnancy"	"Sequelae of cerebrovascular disease"	1	28	0	28
"O08"	"I83"	"Complications following ectopic and molar pregnancy"	"Varicose veins of lower extremities"	1	250	65	315
"O08"	"J18"	"Complications following ectopic and molar pregnancy"	"Pneumonia, unspecified organism"	1	279	125	404
"O08"	"J44"	"Complications following ectopic and molar pregnancy"	"Other chronic obstructive pulmonary disease"	1	53	0	53
"O08"	"J96"	"Complications following ectopic and molar pregnancy"	"Respiratory failure, not elsewhere classified"	1	82	2	84
"O08"	"K21"	"Complications following ectopic and molar pregnancy"	"Gastro-esophageal reflux disease"	1	207	56	263
"O08"	"K43"	"Complications following ectopic and molar pregnancy"	"Ventral hernia"	1	91	12	103
"O08"	"K56"	"Complications following ectopic and molar pregnancy"	"Paralytic ileus and intestinal obstruction without hernia"	1	59	4	63
"O08"	"K57"	"Complications following ectopic and molar pregnancy"	"Diverticular disease of intestine"	1	45	0	45
"O08"	"K62"	"Complications following ectopic and molar pregnancy"	"Other diseases of anus and rectum"	1	189	55	244
"O08"	"K76"	"Complications following ectopic and molar pregnancy"	"Other diseases of liver"	1	32	3	35
"O08"	"M05"	"Complications following ectopic and molar pregnancy"	"Rheumatoid arthritis with rheumatoid factor"	1	28	1	29
"O08"	"M16"	"Complications following ectopic and molar pregnancy"	"Osteoarthritis of hip"	1	39	0	39
"O08"	"M17"	"Complications following ectopic and molar pregnancy"	"Osteoarthritis of knee"	1	84	0	84
"O08"	"M19"	"Complications following ectopic and molar pregnancy"	"Other and unspecified osteoarthritis"	1	81	0	81
"O08"	"M50"	"Complications following ectopic and molar pregnancy"	"Cervical disc disorders"	1	150	5	155
"O08"	"M53"	"Complications following ectopic and molar pregnancy"	"Other and unspecified dorsopathies, not elsewhere classified"	1	102	32	134
"O08"	"M75"	"Complications following ectopic and molar pregnancy"	"Shoulder lesions"	1	437	39	476
"O08"	"M77"	"Complications following ectopic and molar pregnancy"	"Other enthesopathies"	1	147	36	183
"O08"	"M81"	"Complications following ectopic and molar pregnancy"	"Osteoporosis without current pathological fracture"	1	34	0	34
"O08"	"M85"	"Complications following ectopic and molar pregnancy"	"Other disorders of bone density and structure"	1	39	0	39
"O08"	"N20"	"Complications following ectopic and molar pregnancy"	"Calculus of kidney and ureter"	1	216	98	314
"O08"	"N85"	"Complications following ectopic and molar pregnancy"	"Other noninflammatory disorders of uterus, except cervix"	1	135	60	195
"O08"	"N96"	"Complications following ectopic and molar pregnancy"	"Recurrent pregnancy loss"	1	620	176	796
"O10"	"D25"	"Pre-existing hypertension compl preg/chldbrth"	"Leiomyoma of uterus"	1	72	1	73
"O10"	"I83"	"Pre-existing hypertension compl preg/chldbrth"	"Varicose veins of lower extremities"	1	105	7	112
"O10"	"M17"	"Pre-existing hypertension compl preg/chldbrth"	"Osteoarthritis of knee"	1	52	0	52
"O10"	"M19"	"Pre-existing hypertension compl preg/chldbrth"	"Other and unspecified osteoarthritis"	1	33	0	33
"O10"	"M25"	"Pre-existing hypertension compl preg/chldbrth"	"Other joint disorder, not elsewhere classified"	1	70	22	92
"O10"	"M50"	"Pre-existing hypertension compl preg/chldbrth"	"Cervical disc disorders"	1	30	0	30
"O10"	"N18"	"Pre-existing hypertension compl preg/chldbrth"	"Chronic kidney disease (CKD)"	1	90	23	113
"O10"	"N81"	"Pre-existing hypertension compl preg/chldbrth"	"Female genital prolapse"	1	70	2	72
"O10"	"O72"	"Pre-existing hypertension compl preg/chldbrth"	"Postpartum hemorrhage"	1	1936	1392	3328
"O10"	"O90"	"Pre-existing hypertension compl preg/chldbrth"	"Complications of the puerperium, not elsewhere classified"	1	326	145	471
"O12"	"M75"	"Gestational edema and proteinuria without hypertension"	"Shoulder lesions"	1	130	0	130
"O12"	"O72"	"Gestational edema and proteinuria without hypertension"	"Postpartum hemorrhage"	1	2774	1059	3833
"O12"	"O73"	"Gestational edema and proteinuria without hypertension"	"Retained placenta and membranes, without hemorrhage"	1	145	59	204
"O12"	"O87"	"Gestational edema and proteinuria without hypertension"	"Venous complications and hemorrhoids in the puerperium"	1	92	34	126
"O12"	"O90"	"Gestational edema and proteinuria without hypertension"	"Complications of the puerperium, not elsewhere classified"	1	410	114	524
"O12"	"O91"	"Gestational edema and proteinuria without hypertension"	"Infect of breast assoc w pregnancy, the puerp and lactation"	1	157	37	194
"O13"	"A41"	"Gestational hypertension without significant proteinuria"	"Other sepsis"	1	36	2	38
"O13"	"A46"	"Gestational hypertension without significant proteinuria"	"Erysipelas"	1	41	2	43
"O13"	"D12"	"Gestational hypertension without significant proteinuria"	"Benign neoplasm of colon, rectum, anus and anal canal"	1	26	0	26
"O13"	"E68"	"Gestational hypertension without significant proteinuria"	"Sequelae of hyperalimentation"	1	79	0	79
"O13"	"E87"	"Gestational hypertension without significant proteinuria"	"Other disorders of fluid, electrolyte and acid-base balance"	1	39	0	39
"O13"	"G47"	"Gestational hypertension without significant proteinuria"	"Sleep disorders"	1	79	0	79
"O13"	"G96"	"Gestational hypertension without significant proteinuria"	"Other disorders of central nervous system"	1	53	4	57
"O13"	"I15"	"Gestational hypertension without significant proteinuria"	"Secondary hypertension"	1	186	62	248
"O13"	"I20"	"Gestational hypertension without significant proteinuria"	"Angina pectoris"	1	59	0	59
"O13"	"I80"	"Gestational hypertension without significant proteinuria"	"Phlebitis and thrombophlebitis"	1	72	14	86
"O13"	"I83"	"Gestational hypertension without significant proteinuria"	"Varicose veins of lower extremities"	1	266	6	272
"O13"	"J18"	"Gestational hypertension without significant proteinuria"	"Pneumonia, unspecified organism"	1	193	50	243
"O13"	"K56"	"Gestational hypertension without significant proteinuria"	"Paralytic ileus and intestinal obstruction without hernia"	1	62	10	72
"O13"	"K62"	"Gestational hypertension without significant proteinuria"	"Other diseases of anus and rectum"	1	58	14	72
"O13"	"K64"	"Gestational hypertension without significant proteinuria"	"Hemorrhoids and perianal venous thrombosis"	1	125	0	125
"O13"	"K80"	"Gestational hypertension without significant proteinuria"	"Cholelithiasis"	1	596	183	779
"O13"	"M16"	"Gestational hypertension without significant proteinuria"	"Osteoarthritis of hip"	1	29	0	29
"O13"	"M17"	"Gestational hypertension without significant proteinuria"	"Osteoarthritis of knee"	1	88	0	88
"O13"	"M19"	"Gestational hypertension without significant proteinuria"	"Other and unspecified osteoarthritis"	1	49	0	49
"O13"	"M25"	"Gestational hypertension without significant proteinuria"	"Other joint disorder, not elsewhere classified"	1	131	47	178
"O13"	"M50"	"Gestational hypertension without significant proteinuria"	"Cervical disc disorders"	1	66	0	66
"O13"	"M75"	"Gestational hypertension without significant proteinuria"	"Shoulder lesions"	1	195	7	202
"O13"	"M85"	"Gestational hypertension without significant proteinuria"	"Other disorders of bone density and structure"	1	26	0	26
"O13"	"N39"	"Gestational hypertension without significant proteinuria"	"Other disorders of urinary system"	1	231	36	267
"O13"	"N93"	"Gestational hypertension without significant proteinuria"	"Other abnormal uterine and vaginal bleeding"	1	171	55	226
"O13"	"O72"	"Gestational hypertension without significant proteinuria"	"Postpartum hemorrhage"	1	6201	4290	10491
"O13"	"O82"	"Gestational hypertension without significant proteinuria"	"Encounter for cesarean delivery without indication"	1	3748	3132	6880
"O13"	"O91"	"Gestational hypertension without significant proteinuria"	"Infect of breast assoc w pregnancy, the puerp and lactation"	1	353	83	436
"O13"	"O92"	"Gestational hypertension without significant proteinuria"	"Oth disord of brst/lactatn assoc w pregnancy and the puerp"	1	589	313	902
"O14"	"A41"	"Pre-eclampsia"	"Other sepsis"	1	118	3	121
"O14"	"B34"	"Pre-eclampsia"	"Viral infection of unspecified site"	1	151	61	212
"O14"	"C53"	"Pre-eclampsia"	"Malignant neoplasm of cervix uteri"	1	40	0	40
"O14"	"D12"	"Pre-eclampsia"	"Benign neoplasm of colon, rectum, anus and anal canal"	1	42	0	42
"O14"	"D27"	"Pre-eclampsia"	"Benign neoplasm of ovary"	1	182	83	265
"O14"	"E03"	"Pre-eclampsia"	"Other hypothyroidism"	1	410	64	474
"O14"	"E66"	"Pre-eclampsia"	"Overweight and obesity"	1	3402	2586	5988
"O14"	"E68"	"Pre-eclampsia"	"Sequelae of hyperalimentation"	1	136	0	136
"O14"	"E87"	"Pre-eclampsia"	"Other disorders of fluid, electrolyte and acid-base balance"	1	69	0	69
"O14"	"F17"	"Pre-eclampsia"	"Nicotine dependence"	1	198	38	236
"O14"	"F32"	"Pre-eclampsia"	"Depressive episode"	1	159	65	224
"O14"	"G47"	"Pre-eclampsia"	"Sleep disorders"	1	158	0	158
"O14"	"G54"	"Pre-eclampsia"	"Nerve root and plexus disorders"	1	30	0	30
"O14"	"G96"	"Pre-eclampsia"	"Other disorders of central nervous system"	1	89	0	89
"O14"	"G98"	"Pre-eclampsia"	"Other disorders of nervous system not elsewhere classified"	1	35	0	35
"O14"	"H02"	"Pre-eclampsia"	"Other disorders of eyelid"	1	63	0	63
"O14"	"H26"	"Pre-eclampsia"	"Other cataract"	1	33	0	33
"O14"	"H36"	"Pre-eclampsia"	"Retinal disorders in diseases classified elsewhere"	1	118	18	136
"O14"	"H53"	"Pre-eclampsia"	"Visual disturbances"	1	88	15	103
"O14"	"H91"	"Pre-eclampsia"	"Other and unspecified hearing loss"	1	116	9	125
"O14"	"I10"	"Pre-eclampsia"	"Essential (primary) hypertension"	1	2410	0	2410
"O14"	"I15"	"Pre-eclampsia"	"Secondary hypertension"	1	308	74	382
"O14"	"I20"	"Pre-eclampsia"	"Angina pectoris"	1	112	0	112
"O14"	"I25"	"Pre-eclampsia"	"Chronic ischemic heart disease"	1	62	0	62
"O14"	"I48"	"Pre-eclampsia"	"Atrial fibrillation and flutter"	1	49	0	49
"O14"	"I69"	"Pre-eclampsia"	"Sequelae of cerebrovascular disease"	1	60	0	60
"O14"	"J15"	"Pre-eclampsia"	"Bacterial pneumonia, not elsewhere classified"	1	126	6	132
"O14"	"J32"	"Pre-eclampsia"	"Chronic sinusitis"	1	87	13	100
"O14"	"J44"	"Pre-eclampsia"	"Other chronic obstructive pulmonary disease"	1	40	0	40
"O14"	"J96"	"Pre-eclampsia"	"Respiratory failure, not elsewhere classified"	1	82	9	91
"O14"	"K04"	"Pre-eclampsia"	"Diseases of pulp and periapical tissues"	1	53	5	58
"O14"	"K05"	"Pre-eclampsia"	"Gingivitis and periodontal diseases"	1	28	1	29
"O14"	"K25"	"Pre-eclampsia"	"Gastric ulcer"	1	30	0	30
"O14"	"K30"	"Pre-eclampsia"	"Functional dyspepsia"	1	216	70	286
"O14"	"K44"	"Pre-eclampsia"	"Diaphragmatic hernia"	1	114	2	116
"O14"	"K56"	"Pre-eclampsia"	"Paralytic ileus and intestinal obstruction without hernia"	1	114	11	125
"O14"	"K60"	"Pre-eclampsia"	"Fissure and fistula of anal and rectal regions"	1	133	40	173
"O14"	"K62"	"Pre-eclampsia"	"Other diseases of anus and rectum"	1	164	9	173
"O14"	"K65"	"Pre-eclampsia"	"Peritonitis"	1	50	10	60
"O14"	"L73"	"Pre-eclampsia"	"Other follicular disorders"	1	64	13	77
"O14"	"L98"	"Pre-eclampsia"	"Oth disorders of skin, subcu, not elsewhere classified"	1	103	5	108
"O14"	"M06"	"Pre-eclampsia"	"Other rheumatoid arthritis"	1	56	11	67
"O14"	"M16"	"Pre-eclampsia"	"Osteoarthritis of hip"	1	43	0	43
"O14"	"M19"	"Pre-eclampsia"	"Other and unspecified osteoarthritis"	1	83	0	83
"O14"	"M50"	"Pre-eclampsia"	"Cervical disc disorders"	1	103	0	103
"O14"	"M51"	"Pre-eclampsia"	"Thoracic, thoracolum, and lumbosacral intvrt disc disorders"	1	466	6	472
"O14"	"M53"	"Pre-eclampsia"	"Other and unspecified dorsopathies, not elsewhere classified"	1	147	26	173
"O14"	"M67"	"Pre-eclampsia"	"Other disorders of synovium and tendon"	1	250	120	370
"O14"	"M77"	"Pre-eclampsia"	"Other enthesopathies"	1	198	4	202
"O14"	"M79"	"Pre-eclampsia"	"Oth and unsp soft tissue disorders, not elsewhere classified"	1	521	168	689
"O14"	"N06"	"Pre-eclampsia"	"Isolated proteinuria with specified morphological lesion"	1	89	19	108
"O14"	"N20"	"Pre-eclampsia"	"Calculus of kidney and ureter"	1	208	59	267
"O14"	"N39"	"Pre-eclampsia"	"Other disorders of urinary system"	1	534	22	556
"O14"	"N61"	"Pre-eclampsia"	"Inflammatory disorders of breast"	1	105	8	113
"O14"	"N63"	"Pre-eclampsia"	"Unspecified lump in breast"	1	256	29	285
"O14"	"N64"	"Pre-eclampsia"	"Other disorders of breast"	1	324	97	421
"O14"	"N71"	"Pre-eclampsia"	"Inflammatory disease of uterus, except cervix"	1	242	130	372
"O14"	"N83"	"Pre-eclampsia"	"Noninflammatory disord of ovary, fallop and broad ligament"	1	410	204	614
"O14"	"N84"	"Pre-eclampsia"	"Polyp of female genital tract"	1	205	0	205
"O14"	"N92"	"Pre-eclampsia"	"Excessive, frequent and irregular menstruation"	1	1250	0	1250
"O14"	"O34"	"Pre-eclampsia"	"Maternal care for abnormality of pelvic organs"	1	2483	882	3365
"O14"	"O61"	"Pre-eclampsia"	"Failed induction of labor"	1	537	336	873
"O14"	"O66"	"Pre-eclampsia"	"Other obstructed labor"	1	935	683	1618
"O14"	"O68"	"Pre-eclampsia"	"Labor and delivery comp by abnlt of fetal acid-base balance"	1	6447	5688	12135
"O14"	"O70"	"Pre-eclampsia"	"Perineal laceration during delivery"	1	8986	6991	15977
"O14"	"O71"	"Pre-eclampsia"	"Other obstetric trauma"	1	1896	1380	3276
"O14"	"O80"	"Pre-eclampsia"	"Encounter for full-term uncomplicated delivery"	1	11119	9341	20460
"O14"	"O85"	"Pre-eclampsia"	"Puerperal sepsis"	1	573	241	814
"O14"	"O90"	"Pre-eclampsia"	"Complications of the puerperium, not elsewhere classified"	1	1956	660	2616
"O14"	"O91"	"Pre-eclampsia"	"Infect of breast assoc w pregnancy, the puerp and lactation"	1	770	169	939
"O14"	"O92"	"Pre-eclampsia"	"Oth disord of brst/lactatn assoc w pregnancy and the puerp"	1	1163	646	1809
"O15"	"O34"	"Eclampsia"	"Maternal care for abnormality of pelvic organs"	1	70	7	77
"O16"	"I10"	"Unspecified maternal hypertension"	"Essential (primary) hypertension"	1	115	35	150
"O20"	"A41"	"Hemorrhage in early pregnancy"	"Other sepsis"	1	227	0	227
"O20"	"A46"	"Hemorrhage in early pregnancy"	"Erysipelas"	1	202	0	202
"O20"	"A49"	"Hemorrhage in early pregnancy"	"Bacterial infection of unspecified site"	1	234	2	236
"O20"	"C43"	"Hemorrhage in early pregnancy"	"Malignant melanoma of skin"	1	141	0	141
"O20"	"C50"	"Hemorrhage in early pregnancy"	"Malignant neoplasm of breast"	1	248	0	248
"O20"	"C53"	"Hemorrhage in early pregnancy"	"Malignant neoplasm of cervix uteri"	1	102	0	102
"O20"	"C73"	"Hemorrhage in early pregnancy"	"Malignant neoplasm of thyroid gland"	1	57	0	57
"O20"	"C77"	"Hemorrhage in early pregnancy"	"Secondary and unspecified malignant neoplasm of lymph nodes"	1	44	0	44
"O20"	"C78"	"Hemorrhage in early pregnancy"	"Secondary malignant neoplasm of resp and digestive organs"	1	48	0	48
"O20"	"D17"	"Hemorrhage in early pregnancy"	"Benign lipomatous neoplasm"	1	417	0	417
"O20"	"D22"	"Hemorrhage in early pregnancy"	"Melanocytic nevi"	1	527	79	606
"O20"	"D23"	"Hemorrhage in early pregnancy"	"Other benign neoplasms of skin"	1	420	55	475
"O20"	"D27"	"Hemorrhage in early pregnancy"	"Benign neoplasm of ovary"	1	667	304	971
"O20"	"D86"	"Hemorrhage in early pregnancy"	"Sarcoidosis"	1	106	20	126
"O20"	"E04"	"Hemorrhage in early pregnancy"	"Other nontoxic goiter"	1	882	10	892
"O20"	"E10"	"Hemorrhage in early pregnancy"	"Type 1 diabetes mellitus"	1	159	70	229
"O20"	"E11"	"Hemorrhage in early pregnancy"	"Type 2 diabetes mellitus"	1	396	0	396
"O20"	"E21"	"Hemorrhage in early pregnancy"	"Hyperparathyroidism and other disorders of parathyroid gland"	1	68	0	68
"O20"	"E27"	"Hemorrhage in early pregnancy"	"Other disorders of adrenal gland"	1	33	0	33
"O20"	"E64"	"Hemorrhage in early pregnancy"	"Sequelae of malnutrition and other nutritional deficiencies"	1	34	0	34
"O20"	"E66"	"Hemorrhage in early pregnancy"	"Overweight and obesity"	1	9250	0	9250
"O20"	"E68"	"Hemorrhage in early pregnancy"	"Sequelae of hyperalimentation"	1	319	0	319
"O20"	"E86"	"Hemorrhage in early pregnancy"	"Volume depletion"	1	216	15	231
"O20"	"E87"	"Hemorrhage in early pregnancy"	"Other disorders of fluid, electrolyte and acid-base balance"	1	98	0	98
"O20"	"E89"	"Hemorrhage in early pregnancy"	"Postproc endocrine and metabolic comp and disorders, NEC"	1	160	0	160
"O20"	"F11"	"Hemorrhage in early pregnancy"	"Opioid related disorders"	1	91	25	116
"O20"	"F13"	"Hemorrhage in early pregnancy"	"Sedative, hypnotic, or anxiolytic related disorders"	1	32	3	35
"O20"	"F17"	"Hemorrhage in early pregnancy"	"Nicotine dependence"	1	798	0	798
"O20"	"F20"	"Hemorrhage in early pregnancy"	"Schizophrenia"	1	60	7	67
"O20"	"F40"	"Hemorrhage in early pregnancy"	"Phobic anxiety disorders"	1	264	51	315
"O20"	"F45"	"Hemorrhage in early pregnancy"	"Somatoform disorders"	1	83	30	113
"O20"	"F53"	"Hemorrhage in early pregnancy"	"Mental and behavrl disorders assoc with the puerperium, NEC"	1	63	16	79
"O20"	"F60"	"Hemorrhage in early pregnancy"	"Specific personality disorders"	1	154	15	169
"O20"	"G37"	"Hemorrhage in early pregnancy"	"Other demyelinating diseases of central nervous system"	1	53	5	58
"O20"	"G44"	"Hemorrhage in early pregnancy"	"Other headache syndromes"	1	799	48	847
"O20"	"G47"	"Hemorrhage in early pregnancy"	"Sleep disorders"	1	185	0	185
"O20"	"G50"	"Hemorrhage in early pregnancy"	"Disorders of trigeminal nerve"	1	83	0	83
"O20"	"G54"	"Hemorrhage in early pregnancy"	"Nerve root and plexus disorders"	1	76	1	77
"O20"	"G56"	"Hemorrhage in early pregnancy"	"Mononeuropathies of upper limb"	1	1401	0	1401
"O20"	"G83"	"Hemorrhage in early pregnancy"	"Other paralytic syndromes"	1	44	6	50
"O20"	"G91"	"Hemorrhage in early pregnancy"	"Hydrocephalus"	1	29	1	30
"O20"	"G95"	"Hemorrhage in early pregnancy"	"Other and unspecified diseases of spinal cord"	1	28	0	28
"O20"	"G96"	"Hemorrhage in early pregnancy"	"Other disorders of central nervous system"	1	246	0	246
"O20"	"G98"	"Hemorrhage in early pregnancy"	"Other disorders of nervous system not elsewhere classified"	1	112	0	112
"O20"	"H02"	"Hemorrhage in early pregnancy"	"Other disorders of eyelid"	1	173	0	173
"O20"	"H26"	"Hemorrhage in early pregnancy"	"Other cataract"	1	54	0	54
"O20"	"H35"	"Hemorrhage in early pregnancy"	"Other retinal disorders"	1	103	0	103
"O20"	"H43"	"Hemorrhage in early pregnancy"	"Disorders of vitreous body"	1	47	0	47
"O20"	"H52"	"Hemorrhage in early pregnancy"	"Disorders of refraction and accommodation"	1	457	95	552
"O20"	"H53"	"Hemorrhage in early pregnancy"	"Visual disturbances"	1	219	7	226
"O20"	"H54"	"Hemorrhage in early pregnancy"	"Blindness and low vision"	1	45	2	47
"O20"	"H91"	"Hemorrhage in early pregnancy"	"Other and unspecified hearing loss"	1	284	5	289
"O20"	"I10"	"Hemorrhage in early pregnancy"	"Essential (primary) hypertension"	1	838	0	838
"O20"	"I15"	"Hemorrhage in early pregnancy"	"Secondary hypertension"	1	103	0	103
"O20"	"I21"	"Hemorrhage in early pregnancy"	"Acute myocardial infarction"	1	74	0	74
"O20"	"I26"	"Hemorrhage in early pregnancy"	"Pulmonary embolism"	1	174	11	185
"O20"	"I34"	"Hemorrhage in early pregnancy"	"Nonrheumatic mitral valve disorders"	1	67	2	69
"O20"	"I42"	"Hemorrhage in early pregnancy"	"Cardiomyopathy"	1	42	0	42
"O20"	"I47"	"Hemorrhage in early pregnancy"	"Paroxysmal tachycardia"	1	425	73	498
"O20"	"I48"	"Hemorrhage in early pregnancy"	"Atrial fibrillation and flutter"	1	120	0	120
"O20"	"I50"	"Hemorrhage in early pregnancy"	"Heart failure"	1	54	0	54
"O20"	"I67"	"Hemorrhage in early pregnancy"	"Other cerebrovascular diseases"	1	53	0	53
"O20"	"I70"	"Hemorrhage in early pregnancy"	"Atherosclerosis"	1	40	0	40
"O20"	"I73"	"Hemorrhage in early pregnancy"	"Other peripheral vascular diseases"	1	101	1	102
"O20"	"I87"	"Hemorrhage in early pregnancy"	"Other disorders of veins"	1	48	0	48
"O20"	"I99"	"Hemorrhage in early pregnancy"	"Other and unspecified disorders of circulatory system"	1	29	1	30
"O20"	"J15"	"Hemorrhage in early pregnancy"	"Bacterial pneumonia, not elsewhere classified"	1	319	0	319
"O20"	"J18"	"Hemorrhage in early pregnancy"	"Pneumonia, unspecified organism"	1	1293	94	1387
"O20"	"J34"	"Hemorrhage in early pregnancy"	"Other and unspecified disorders of nose and nasal sinuses"	1	247	105	352
"O20"	"J44"	"Hemorrhage in early pregnancy"	"Other chronic obstructive pulmonary disease"	1	139	0	139
"O20"	"J93"	"Hemorrhage in early pregnancy"	"Pneumothorax and air leak"	1	75	14	89
"O20"	"J96"	"Hemorrhage in early pregnancy"	"Respiratory failure, not elsewhere classified"	1	139	0	139
"O20"	"J98"	"Hemorrhage in early pregnancy"	"Other respiratory disorders"	1	72	5	77
"O20"	"K02"	"Hemorrhage in early pregnancy"	"Dental caries"	1	80	11	91
"O20"	"K13"	"Hemorrhage in early pregnancy"	"Other diseases of lip and oral mucosa"	1	33	2	35
"O20"	"K22"	"Hemorrhage in early pregnancy"	"Other diseases of esophagus"	1	111	2	113
"O20"	"K25"	"Hemorrhage in early pregnancy"	"Gastric ulcer"	1	167	6	173
"O20"	"K30"	"Hemorrhage in early pregnancy"	"Functional dyspepsia"	1	810	158	968
"O20"	"K57"	"Hemorrhage in early pregnancy"	"Diverticular disease of intestine"	1	97	0	97
"O20"	"K59"	"Hemorrhage in early pregnancy"	"Other functional intestinal disorders"	1	1280	233	1513
"O20"	"K60"	"Hemorrhage in early pregnancy"	"Fissure and fistula of anal and rectal regions"	1	459	116	575
"O20"	"K61"	"Hemorrhage in early pregnancy"	"Abscess of anal and rectal regions"	1	215	67	282
"O20"	"K62"	"Hemorrhage in early pregnancy"	"Other diseases of anus and rectum"	1	505	4	509
"O20"	"K63"	"Hemorrhage in early pregnancy"	"Other diseases of intestine"	1	86	0	86
"O20"	"K65"	"Hemorrhage in early pregnancy"	"Peritonitis"	1	88	6	94
"O20"	"K80"	"Hemorrhage in early pregnancy"	"Cholelithiasis"	1	3093	0	3093
"O20"	"K91"	"Hemorrhage in early pregnancy"	"Intraop and postproc comp and disorders of dgstv sys, NEC"	1	60	0	60
"O20"	"L08"	"Hemorrhage in early pregnancy"	"Other local infections of skin and subcutaneous tissue"	1	464	87	551
"O20"	"L50"	"Hemorrhage in early pregnancy"	"Urticaria"	1	460	142	602
"O20"	"L71"	"Hemorrhage in early pregnancy"	"Rosacea"	1	91	0	91
"O20"	"L72"	"Hemorrhage in early pregnancy"	"Follicular cysts of skin and subcutaneous tissue"	1	112	0	112
"O20"	"L73"	"Hemorrhage in early pregnancy"	"Other follicular disorders"	1	179	52	231
"O20"	"L90"	"Hemorrhage in early pregnancy"	"Atrophic disorders of skin"	1	518	93	611
"O20"	"M06"	"Hemorrhage in early pregnancy"	"Other rheumatoid arthritis"	1	205	3	208
"O20"	"M07"	"Hemorrhage in early pregnancy"	"Enteropathic arthropathies"	1	136	0	136
"O20"	"M16"	"Hemorrhage in early pregnancy"	"Osteoarthritis of hip"	1	134	0	134
"O20"	"M18"	"Hemorrhage in early pregnancy"	"Osteoarthritis of first carpometacarpal joint"	1	33	0	33
"O20"	"M24"	"Hemorrhage in early pregnancy"	"Other specific joint derangements"	1	208	115	323
"O20"	"M43"	"Hemorrhage in early pregnancy"	"Other deforming dorsopathies"	1	125	12	137
"O20"	"M45"	"Hemorrhage in early pregnancy"	"Ankylosing spondylitis"	1	48	0	48
"O20"	"M46"	"Hemorrhage in early pregnancy"	"Other inflammatory spondylopathies"	1	132	0	132
"O20"	"M53"	"Hemorrhage in early pregnancy"	"Other and unspecified dorsopathies, not elsewhere classified"	1	434	7	441
"O20"	"M54"	"Hemorrhage in early pregnancy"	"Dorsalgia"	1	3587	0	3587
"O20"	"M65"	"Hemorrhage in early pregnancy"	"Synovitis and tenosynovitis"	1	708	267	975
"O20"	"M71"	"Hemorrhage in early pregnancy"	"Other bursopathies"	1	87	2	89
"O20"	"M72"	"Hemorrhage in early pregnancy"	"Fibroblastic disorders"	1	123	0	123
"O20"	"M75"	"Hemorrhage in early pregnancy"	"Shoulder lesions"	1	1068	0	1068
"O20"	"M76"	"Hemorrhage in early pregnancy"	"Enthesopathies, lower limb, excluding foot"	1	285	48	333
"O20"	"M79"	"Hemorrhage in early pregnancy"	"Oth and unsp soft tissue disorders, not elsewhere classified"	1	2093	365	2458
"O20"	"M81"	"Hemorrhage in early pregnancy"	"Osteoporosis without current pathological fracture"	1	93	0	93
"O20"	"M84"	"Hemorrhage in early pregnancy"	"Disorder of continuity of bone"	1	30	1	31
"O20"	"N20"	"Hemorrhage in early pregnancy"	"Calculus of kidney and ureter"	1	826	138	964
"O20"	"N31"	"Hemorrhage in early pregnancy"	"Neuromuscular dysfunction of bladder, NEC"	1	64	7	71
"O20"	"N32"	"Hemorrhage in early pregnancy"	"Other disorders of bladder"	1	43	1	44
"O20"	"N39"	"Hemorrhage in early pregnancy"	"Other disorders of urinary system"	1	1454	0	1454
"O20"	"N60"	"Hemorrhage in early pregnancy"	"Benign mammary dysplasia"	1	748	43	791
"O20"	"N61"	"Hemorrhage in early pregnancy"	"Inflammatory disorders of breast"	1	282	15	297
"O20"	"N64"	"Hemorrhage in early pregnancy"	"Other disorders of breast"	1	1067	184	1251
"O20"	"N71"	"Hemorrhage in early pregnancy"	"Inflammatory disease of uterus, except cervix"	1	1094	604	1698
"O20"	"N75"	"Hemorrhage in early pregnancy"	"Diseases of Bartholin's gland"	1	285	108	393
"O20"	"N80"	"Hemorrhage in early pregnancy"	"Endometriosis"	1	541	307	848
"O20"	"N84"	"Hemorrhage in early pregnancy"	"Polyp of female genital tract"	1	1055	58	1113
"O20"	"N87"	"Hemorrhage in early pregnancy"	"Dysplasia of cervix uteri"	1	1154	710	1864
"O20"	"N92"	"Hemorrhage in early pregnancy"	"Excessive, frequent and irregular menstruation"	1	4557	0	4557
"O20"	"N93"	"Hemorrhage in early pregnancy"	"Other abnormal uterine and vaginal bleeding"	1	1474	330	1804
"O20"	"N95"	"Hemorrhage in early pregnancy"	"Menopausal and other perimenopausal disorders"	1	44	0	44
"O20"	"N96"	"Hemorrhage in early pregnancy"	"Recurrent pregnancy loss"	1	2003	498	2501
"O20"	"O03"	"Hemorrhage in early pregnancy"	"Spontaneous abortion"	1	12474	9834	22308
"O20"	"O10"	"Hemorrhage in early pregnancy"	"Pre-existing hypertension compl preg/chldbrth"	1	705	206	911
"O20"	"O12"	"Hemorrhage in early pregnancy"	"Gestational edema and proteinuria without hypertension"	1	753	309	1062
"O20"	"O21"	"Hemorrhage in early pregnancy"	"Excessive vomiting in pregnancy"	1	1654	1231	2885
"O20"	"O23"	"Hemorrhage in early pregnancy"	"Infections of genitourinary tract in pregnancy"	1	7186	0	7186
"O20"	"O26"	"Hemorrhage in early pregnancy"	"Maternal care for oth conditions predom related to pregnancy"	1	11666	0	11666
"O20"	"O33"	"Hemorrhage in early pregnancy"	"Maternal care for disproportion"	1	277	92	369
"O20"	"O34"	"Hemorrhage in early pregnancy"	"Maternal care for abnormality of pelvic organs"	1	7804	0	7804
"O20"	"O35"	"Hemorrhage in early pregnancy"	"Maternal care for known or suspected fetal abnlt and damage"	1	1258	434	1692
"O20"	"O36"	"Hemorrhage in early pregnancy"	"Maternal care for other fetal problems"	1	9251	0	9251
"O20"	"O42"	"Hemorrhage in early pregnancy"	"Premature rupture of membranes"	1	10418	0	10418
"O20"	"O43"	"Hemorrhage in early pregnancy"	"Placental disorders"	1	504	183	687
"O20"	"O47"	"Hemorrhage in early pregnancy"	"False labor"	1	10686	0	10686
"O20"	"O61"	"Hemorrhage in early pregnancy"	"Failed induction of labor"	1	428	102	530
"O20"	"O62"	"Hemorrhage in early pregnancy"	"Abnormalities of forces of labor"	1	29388	0	29388
"O20"	"O63"	"Hemorrhage in early pregnancy"	"Long labor"	1	2744	1626	4370
"O20"	"O64"	"Hemorrhage in early pregnancy"	"Obstructed labor due to malposition and malpresent of fetus"	1	3717	1884	5601
"O20"	"O68"	"Hemorrhage in early pregnancy"	"Labor and delivery comp by abnlt of fetal acid-base balance"	1	18584	0	18584
"O20"	"O70"	"Hemorrhage in early pregnancy"	"Perineal laceration during delivery"	1	31657	0	31657
"O20"	"O71"	"Hemorrhage in early pregnancy"	"Other obstetric trauma"	1	3943	2169	6112
"O20"	"O82"	"Hemorrhage in early pregnancy"	"Encounter for cesarean delivery without indication"	1	21139	0	21139
"O20"	"O86"	"Hemorrhage in early pregnancy"	"Other puerperal infections"	1	1790	623	2413
"O20"	"O89"	"Hemorrhage in early pregnancy"	"Complications of anesthesia during the puerperium"	1	145	36	181
"O20"	"O99"	"Hemorrhage in early pregnancy"	"Oth maternal diseases classd elsw but compl preg/chldbrth"	1	24216	0	24216
"O20"	"Q27"	"Hemorrhage in early pregnancy"	"Other congenital malformations of peripheral vascular system"	1	147	21	168
"O21"	"A46"	"Excessive vomiting in pregnancy"	"Erysipelas"	1	34	1	35
"O21"	"C50"	"Excessive vomiting in pregnancy"	"Malignant neoplasm of breast"	1	47	0	47
"O21"	"D12"	"Excessive vomiting in pregnancy"	"Benign neoplasm of colon, rectum, anus and anal canal"	1	33	0	33
"O21"	"D50"	"Excessive vomiting in pregnancy"	"Iron deficiency anemia"	1	217	27	244
"O21"	"E05"	"Excessive vomiting in pregnancy"	"Thyrotoxicosis [hyperthyroidism]"	1	714	199	913
"O21"	"E11"	"Excessive vomiting in pregnancy"	"Type 2 diabetes mellitus"	1	79	0	79
"O21"	"E66"	"Excessive vomiting in pregnancy"	"Overweight and obesity"	1	2298	1259	3557
"O21"	"E68"	"Excessive vomiting in pregnancy"	"Sequelae of hyperalimentation"	1	98	0	98
"O21"	"F33"	"Excessive vomiting in pregnancy"	"Major depressive disorder, recurrent"	1	254	99	353
"O21"	"G98"	"Excessive vomiting in pregnancy"	"Other disorders of nervous system not elsewhere classified"	1	38	0	38
"O21"	"I49"	"Excessive vomiting in pregnancy"	"Other cardiac arrhythmias"	1	72	20	92
"O21"	"I69"	"Excessive vomiting in pregnancy"	"Sequelae of cerebrovascular disease"	1	26	0	26
"O21"	"I80"	"Excessive vomiting in pregnancy"	"Phlebitis and thrombophlebitis"	1	109	30	139
"O21"	"J44"	"Excessive vomiting in pregnancy"	"Other chronic obstructive pulmonary disease"	1	30	0	30
"O21"	"K43"	"Excessive vomiting in pregnancy"	"Ventral hernia"	1	104	1	105
"O21"	"K56"	"Excessive vomiting in pregnancy"	"Paralytic ileus and intestinal obstruction without hernia"	1	65	4	69
"O21"	"K80"	"Excessive vomiting in pregnancy"	"Cholelithiasis"	1	1053	231	1284
"O21"	"M17"	"Excessive vomiting in pregnancy"	"Osteoarthritis of knee"	1	63	0	63
"O21"	"M25"	"Excessive vomiting in pregnancy"	"Other joint disorder, not elsewhere classified"	1	241	53	294
"O21"	"M47"	"Excessive vomiting in pregnancy"	"Spondylosis"	1	71	0	71
"O21"	"M50"	"Excessive vomiting in pregnancy"	"Cervical disc disorders"	1	100	0	100
"O21"	"M51"	"Excessive vomiting in pregnancy"	"Thoracic, thoracolum, and lumbosacral intvrt disc disorders"	1	398	13	411
"O21"	"M54"	"Excessive vomiting in pregnancy"	"Dorsalgia"	1	732	320	1052
"O21"	"M75"	"Excessive vomiting in pregnancy"	"Shoulder lesions"	1	344	6	350
"O21"	"M79"	"Excessive vomiting in pregnancy"	"Oth and unsp soft tissue disorders, not elsewhere classified"	1	452	259	711
"O21"	"M81"	"Excessive vomiting in pregnancy"	"Osteoporosis without current pathological fracture"	1	34	0	34
"O21"	"M85"	"Excessive vomiting in pregnancy"	"Other disorders of bone density and structure"	1	44	0	44
"O21"	"N60"	"Excessive vomiting in pregnancy"	"Benign mammary dysplasia"	1	113	45	158
"O21"	"N81"	"Excessive vomiting in pregnancy"	"Female genital prolapse"	1	391	11	402
"O21"	"N92"	"Excessive vomiting in pregnancy"	"Excessive, frequent and irregular menstruation"	1	999	59	1058
"O21"	"O23"	"Excessive vomiting in pregnancy"	"Infections of genitourinary tract in pregnancy"	1	1532	948	2480
"O21"	"O26"	"Excessive vomiting in pregnancy"	"Maternal care for oth conditions predom related to pregnancy"	1	2857	1905	4762
"O21"	"O33"	"Excessive vomiting in pregnancy"	"Maternal care for disproportion"	1	104	26	130
"O21"	"O34"	"Excessive vomiting in pregnancy"	"Maternal care for abnormality of pelvic organs"	1	1528	470	1998
"O21"	"O36"	"Excessive vomiting in pregnancy"	"Maternal care for other fetal problems"	1	1706	963	2669
"O21"	"O41"	"Excessive vomiting in pregnancy"	"Other disorders of amniotic fluid and membranes"	1	368	198	566
"O21"	"O42"	"Excessive vomiting in pregnancy"	"Premature rupture of membranes"	1	1534	924	2458
"O21"	"O44"	"Excessive vomiting in pregnancy"	"Placenta previa"	1	190	76	266
"O21"	"O45"	"Excessive vomiting in pregnancy"	"Premature separation of placenta [abruptio placentae]"	1	177	79	256
"O21"	"O46"	"Excessive vomiting in pregnancy"	"Antepartum hemorrhage, not elsewhere classified"	1	554	320	874
"O21"	"O47"	"Excessive vomiting in pregnancy"	"False labor"	1	1951	1081	3032
"O21"	"O74"	"Excessive vomiting in pregnancy"	"Complications of anesthesia during labor and delivery"	1	40	7	47
"O21"	"O75"	"Excessive vomiting in pregnancy"	"Oth complications of labor and delivery, NEC"	1	1155	537	1692
"O21"	"O99"	"Excessive vomiting in pregnancy"	"Oth maternal diseases classd elsw but compl preg/chldbrth"	1	5227	3502	8729
"O22"	"D68"	"Venous complications and hemorrhoids in pregnancy"	"Other coagulation defects"	1	215	95	310
"O23"	"A46"	"Infections of genitourinary tract in pregnancy"	"Erysipelas"	1	65	7	72
"O23"	"C50"	"Infections of genitourinary tract in pregnancy"	"Malignant neoplasm of breast"	1	88	0	88
"O23"	"D64"	"Infections of genitourinary tract in pregnancy"	"Other anemias"	1	209	39	248
"O23"	"E55"	"Infections of genitourinary tract in pregnancy"	"Vitamin D deficiency"	1	242	69	311
"O23"	"E68"	"Infections of genitourinary tract in pregnancy"	"Sequelae of hyperalimentation"	1	192	0	192
"O23"	"E87"	"Infections of genitourinary tract in pregnancy"	"Other disorders of fluid, electrolyte and acid-base balance"	1	56	3	59
"O23"	"G47"	"Infections of genitourinary tract in pregnancy"	"Sleep disorders"	1	131	0	131
"O23"	"G96"	"Infections of genitourinary tract in pregnancy"	"Other disorders of central nervous system"	1	152	3	155
"O23"	"H53"	"Infections of genitourinary tract in pregnancy"	"Visual disturbances"	1	114	30	144
"O23"	"H93"	"Infections of genitourinary tract in pregnancy"	"Other disorders of ear, not elsewhere classified"	1	89	23	112
"O23"	"I10"	"Infections of genitourinary tract in pregnancy"	"Essential (primary) hypertension"	1	443	3	446
"O23"	"I20"	"Infections of genitourinary tract in pregnancy"	"Angina pectoris"	1	106	0	106
"O23"	"I21"	"Infections of genitourinary tract in pregnancy"	"Acute myocardial infarction"	1	31	0	31
"O23"	"I25"	"Infections of genitourinary tract in pregnancy"	"Chronic ischemic heart disease"	1	35	0	35
"O23"	"I26"	"Infections of genitourinary tract in pregnancy"	"Pulmonary embolism"	1	78	24	102
"O23"	"I48"	"Infections of genitourinary tract in pregnancy"	"Atrial fibrillation and flutter"	1	49	6	55
"O23"	"I50"	"Infections of genitourinary tract in pregnancy"	"Heart failure"	1	29	0	29
"O23"	"I63"	"Infections of genitourinary tract in pregnancy"	"Cerebral infarction"	1	62	0	62
"O23"	"I69"	"Infections of genitourinary tract in pregnancy"	"Sequelae of cerebrovascular disease"	1	53	0	53
"O23"	"I89"	"Infections of genitourinary tract in pregnancy"	"Oth noninfective disorders of lymphatic vessels and nodes"	1	33	2	35
"O23"	"J96"	"Infections of genitourinary tract in pregnancy"	"Respiratory failure, not elsewhere classified"	1	79	7	86
"O23"	"K44"	"Infections of genitourinary tract in pregnancy"	"Diaphragmatic hernia"	1	129	27	156
"O23"	"K56"	"Infections of genitourinary tract in pregnancy"	"Paralytic ileus and intestinal obstruction without hernia"	1	121	31	152
"O23"	"K57"	"Infections of genitourinary tract in pregnancy"	"Diverticular disease of intestine"	1	45	0	45
"O23"	"K59"	"Infections of genitourinary tract in pregnancy"	"Other functional intestinal disorders"	1	484	307	791
"O23"	"K62"	"Infections of genitourinary tract in pregnancy"	"Other diseases of anus and rectum"	1	198	51	249
"O23"	"K65"	"Infections of genitourinary tract in pregnancy"	"Peritonitis"	1	55	13	68
"O23"	"K83"	"Infections of genitourinary tract in pregnancy"	"Other diseases of biliary tract"	1	49	10	59
"O23"	"L90"	"Infections of genitourinary tract in pregnancy"	"Atrophic disorders of skin"	1	210	105	315
"O23"	"M05"	"Infections of genitourinary tract in pregnancy"	"Rheumatoid arthritis with rheumatoid factor"	1	51	3	54
"O23"	"M16"	"Infections of genitourinary tract in pregnancy"	"Osteoarthritis of hip"	1	50	0	50
"O23"	"M19"	"Infections of genitourinary tract in pregnancy"	"Other and unspecified osteoarthritis"	1	101	0	101
"O23"	"M48"	"Infections of genitourinary tract in pregnancy"	"Other spondylopathies"	1	40	0	40
"O23"	"M50"	"Infections of genitourinary tract in pregnancy"	"Cervical disc disorders"	1	151	0	151
"O23"	"M72"	"Infections of genitourinary tract in pregnancy"	"Fibroblastic disorders"	1	47	2	49
"O23"	"M75"	"Infections of genitourinary tract in pregnancy"	"Shoulder lesions"	1	494	0	494
"O23"	"M77"	"Infections of genitourinary tract in pregnancy"	"Other enthesopathies"	1	161	27	188
"O23"	"M85"	"Infections of genitourinary tract in pregnancy"	"Other disorders of bone density and structure"	1	55	0	55
"O23"	"N20"	"Infections of genitourinary tract in pregnancy"	"Calculus of kidney and ureter"	1	542	261	803
"O23"	"N92"	"Infections of genitourinary tract in pregnancy"	"Excessive, frequent and irregular menstruation"	1	1884	0	1884
"O23"	"N94"	"Infections of genitourinary tract in pregnancy"	"Pain and oth cond assoc w fem gntl org and menstrual cycle"	1	494	330	824
"O23"	"O72"	"Infections of genitourinary tract in pregnancy"	"Postpartum hemorrhage"	1	11971	7633	19604
"O23"	"O85"	"Infections of genitourinary tract in pregnancy"	"Puerperal sepsis"	1	454	306	760
"O24"	"A41"	"Diabetes in pregnancy, childbirth, and the puerperium"	"Other sepsis"	1	96	1	97
"O24"	"A49"	"Diabetes in pregnancy, childbirth, and the puerperium"	"Bacterial infection of unspecified site"	1	77	15	92
"O24"	"C50"	"Diabetes in pregnancy, childbirth, and the puerperium"	"Malignant neoplasm of breast"	1	67	0	67
"O24"	"D64"	"Diabetes in pregnancy, childbirth, and the puerperium"	"Other anemias"	1	176	8	184
"O24"	"E03"	"Diabetes in pregnancy, childbirth, and the puerperium"	"Other hypothyroidism"	1	526	260	786
"O24"	"E04"	"Diabetes in pregnancy, childbirth, and the puerperium"	"Other nontoxic goiter"	1	221	50	271
"O24"	"E13"	"Diabetes in pregnancy, childbirth, and the puerperium"	"Other specified diabetes mellitus"	1	119	12	131
"O24"	"E65"	"Diabetes in pregnancy, childbirth, and the puerperium"	"Localized adiposity"	1	253	36	289
"O24"	"E78"	"Diabetes in pregnancy, childbirth, and the puerperium"	"Disorders of lipoprotein metabolism and other lipidemias"	1	300	0	300
"O24"	"E86"	"Diabetes in pregnancy, childbirth, and the puerperium"	"Volume depletion"	1	69	22	91
"O24"	"E87"	"Diabetes in pregnancy, childbirth, and the puerperium"	"Other disorders of fluid, electrolyte and acid-base balance"	1	39	0	39
"O24"	"F17"	"Diabetes in pregnancy, childbirth, and the puerperium"	"Nicotine dependence"	1	144	59	203
"O24"	"F43"	"Diabetes in pregnancy, childbirth, and the puerperium"	"Reaction to severe stress, and adjustment disorders"	1	149	54	203
"O24"	"G47"	"Diabetes in pregnancy, childbirth, and the puerperium"	"Sleep disorders"	1	158	1	159
"O24"	"G56"	"Diabetes in pregnancy, childbirth, and the puerperium"	"Mononeuropathies of upper limb"	1	731	179	910
"O24"	"G98"	"Diabetes in pregnancy, childbirth, and the puerperium"	"Other disorders of nervous system not elsewhere classified"	1	54	1	55
"O24"	"H02"	"Diabetes in pregnancy, childbirth, and the puerperium"	"Other disorders of eyelid"	1	46	4	50
"O24"	"H35"	"Diabetes in pregnancy, childbirth, and the puerperium"	"Other retinal disorders"	1	93	9	102
"O24"	"H36"	"Diabetes in pregnancy, childbirth, and the puerperium"	"Retinal disorders in diseases classified elsewhere"	1	897	135	1032
"O24"	"I10"	"Diabetes in pregnancy, childbirth, and the puerperium"	"Essential (primary) hypertension"	1	794	0	794
"O24"	"I35"	"Diabetes in pregnancy, childbirth, and the puerperium"	"Nonrheumatic aortic valve disorders"	1	28	0	28
"O24"	"I48"	"Diabetes in pregnancy, childbirth, and the puerperium"	"Atrial fibrillation and flutter"	1	39	0	39
"O24"	"I80"	"Diabetes in pregnancy, childbirth, and the puerperium"	"Phlebitis and thrombophlebitis"	1	106	44	150
"O24"	"J15"	"Diabetes in pregnancy, childbirth, and the puerperium"	"Bacterial pneumonia, not elsewhere classified"	1	110	15	125
"O24"	"J18"	"Diabetes in pregnancy, childbirth, and the puerperium"	"Pneumonia, unspecified organism"	1	307	94	401
"O24"	"J44"	"Diabetes in pregnancy, childbirth, and the puerperium"	"Other chronic obstructive pulmonary disease"	1	60	0	60
"O24"	"J96"	"Diabetes in pregnancy, childbirth, and the puerperium"	"Respiratory failure, not elsewhere classified"	1	64	5	69
"O24"	"K57"	"Diabetes in pregnancy, childbirth, and the puerperium"	"Diverticular disease of intestine"	1	37	0	37
"O24"	"K62"	"Diabetes in pregnancy, childbirth, and the puerperium"	"Other diseases of anus and rectum"	1	110	44	154
"O24"	"M05"	"Diabetes in pregnancy, childbirth, and the puerperium"	"Rheumatoid arthritis with rheumatoid factor"	1	60	4	64
"O24"	"M17"	"Diabetes in pregnancy, childbirth, and the puerperium"	"Osteoarthritis of knee"	1	145	0	145
"O24"	"M19"	"Diabetes in pregnancy, childbirth, and the puerperium"	"Other and unspecified osteoarthritis"	1	68	0	68
"O24"	"M25"	"Diabetes in pregnancy, childbirth, and the puerperium"	"Other joint disorder, not elsewhere classified"	1	249	80	329
"O24"	"M51"	"Diabetes in pregnancy, childbirth, and the puerperium"	"Thoracic, thoracolum, and lumbosacral intvrt disc disorders"	1	352	85	437
"O24"	"M53"	"Diabetes in pregnancy, childbirth, and the puerperium"	"Other and unspecified dorsopathies, not elsewhere classified"	1	116	35	151
"O24"	"M77"	"Diabetes in pregnancy, childbirth, and the puerperium"	"Other enthesopathies"	1	151	42	193
"O24"	"M81"	"Diabetes in pregnancy, childbirth, and the puerperium"	"Osteoporosis without current pathological fracture"	1	33	0	33
"O24"	"M85"	"Diabetes in pregnancy, childbirth, and the puerperium"	"Other disorders of bone density and structure"	1	40	0	40
"O24"	"N84"	"Diabetes in pregnancy, childbirth, and the puerperium"	"Polyp of female genital tract"	1	144	40	184
"O24"	"N92"	"Diabetes in pregnancy, childbirth, and the puerperium"	"Excessive, frequent and irregular menstruation"	1	1121	128	1249
"O24"	"N93"	"Diabetes in pregnancy, childbirth, and the puerperium"	"Other abnormal uterine and vaginal bleeding"	1	238	117	355
"O24"	"O34"	"Diabetes in pregnancy, childbirth, and the puerperium"	"Maternal care for abnormality of pelvic organs"	1	1982	1242	3224
"O24"	"O70"	"Diabetes in pregnancy, childbirth, and the puerperium"	"Perineal laceration during delivery"	1	6140	4688	10828
"O24"	"O72"	"Diabetes in pregnancy, childbirth, and the puerperium"	"Postpartum hemorrhage"	1	15406	0	15406
"O24"	"O85"	"Diabetes in pregnancy, childbirth, and the puerperium"	"Puerperal sepsis"	1	305	146	451
"O24"	"O86"	"Diabetes in pregnancy, childbirth, and the puerperium"	"Other puerperal infections"	1	668	335	1003
"O24"	"O87"	"Diabetes in pregnancy, childbirth, and the puerperium"	"Venous complications and hemorrhoids in the puerperium"	1	200	89	289
"O26"	"A46"	"Maternal care for oth conditions predom related to pregnancy"	"Erysipelas"	1	141	4	145
"O26"	"A49"	"Maternal care for oth conditions predom related to pregnancy"	"Bacterial infection of unspecified site"	1	224	29	253
"O26"	"B18"	"Maternal care for oth conditions predom related to pregnancy"	"Chronic viral hepatitis"	1	106	36	142
"O26"	"C43"	"Maternal care for oth conditions predom related to pregnancy"	"Malignant melanoma of skin"	1	118	7	125
"O26"	"C44"	"Maternal care for oth conditions predom related to pregnancy"	"Other and unspecified malignant neoplasm of skin"	1	58	0	58
"O26"	"C50"	"Maternal care for oth conditions predom related to pregnancy"	"Malignant neoplasm of breast"	1	169	0	169
"O26"	"C53"	"Maternal care for oth conditions predom related to pregnancy"	"Malignant neoplasm of cervix uteri"	1	92	0	92
"O26"	"C77"	"Maternal care for oth conditions predom related to pregnancy"	"Secondary and unspecified malignant neoplasm of lymph nodes"	1	45	0	45
"O26"	"D12"	"Maternal care for oth conditions predom related to pregnancy"	"Benign neoplasm of colon, rectum, anus and anal canal"	1	166	0	166
"O26"	"D24"	"Maternal care for oth conditions predom related to pregnancy"	"Benign neoplasm of breast"	1	481	179	660
"O26"	"D72"	"Maternal care for oth conditions predom related to pregnancy"	"Other disorders of white blood cells"	1	28	1	29
"O26"	"E06"	"Maternal care for oth conditions predom related to pregnancy"	"Thyroiditis"	1	274	35	309
"O26"	"E11"	"Maternal care for oth conditions predom related to pregnancy"	"Type 2 diabetes mellitus"	1	289	0	289
"O26"	"E21"	"Maternal care for oth conditions predom related to pregnancy"	"Hyperparathyroidism and other disorders of parathyroid gland"	1	74	0	74
"O26"	"E27"	"Maternal care for oth conditions predom related to pregnancy"	"Other disorders of adrenal gland"	1	49	1	50
"O26"	"E65"	"Maternal care for oth conditions predom related to pregnancy"	"Localized adiposity"	1	724	21	745
"O26"	"E83"	"Maternal care for oth conditions predom related to pregnancy"	"Disorders of mineral metabolism"	1	66	0	66
"O26"	"E87"	"Maternal care for oth conditions predom related to pregnancy"	"Other disorders of fluid, electrolyte and acid-base balance"	1	110	0	110
"O26"	"E89"	"Maternal care for oth conditions predom related to pregnancy"	"Postproc endocrine and metabolic comp and disorders, NEC"	1	100	8	108
"O26"	"F33"	"Maternal care for oth conditions predom related to pregnancy"	"Major depressive disorder, recurrent"	1	535	149	684
"O26"	"G35"	"Maternal care for oth conditions predom related to pregnancy"	"Multiple sclerosis"	1	166	26	192
"O26"	"G47"	"Maternal care for oth conditions predom related to pregnancy"	"Sleep disorders"	1	301	0	301
"O26"	"G54"	"Maternal care for oth conditions predom related to pregnancy"	"Nerve root and plexus disorders"	1	57	5	62
"O26"	"G62"	"Maternal care for oth conditions predom related to pregnancy"	"Other and unspecified polyneuropathies"	1	53	0	53
"O26"	"G95"	"Maternal care for oth conditions predom related to pregnancy"	"Other and unspecified diseases of spinal cord"	1	33	0	33
"O26"	"H26"	"Maternal care for oth conditions predom related to pregnancy"	"Other cataract"	1	47	0	47
"O26"	"H33"	"Maternal care for oth conditions predom related to pregnancy"	"Retinal detachments and breaks"	1	43	1	44
"O26"	"H35"	"Maternal care for oth conditions predom related to pregnancy"	"Other retinal disorders"	1	99	3	102
"O26"	"H36"	"Maternal care for oth conditions predom related to pregnancy"	"Retinal disorders in diseases classified elsewhere"	1	62	14	76
"O26"	"H52"	"Maternal care for oth conditions predom related to pregnancy"	"Disorders of refraction and accommodation"	1	403	116	519
"O26"	"H91"	"Maternal care for oth conditions predom related to pregnancy"	"Other and unspecified hearing loss"	1	254	37	291
"O26"	"I25"	"Maternal care for oth conditions predom related to pregnancy"	"Chronic ischemic heart disease"	1	49	0	49
"O26"	"I42"	"Maternal care for oth conditions predom related to pregnancy"	"Cardiomyopathy"	1	30	0	30
"O26"	"I47"	"Maternal care for oth conditions predom related to pregnancy"	"Paroxysmal tachycardia"	1	302	129	431
"O26"	"I61"	"Maternal care for oth conditions predom related to pregnancy"	"Nontraumatic intracerebral hemorrhage"	1	32	1	33
"O26"	"I69"	"Maternal care for oth conditions predom related to pregnancy"	"Sequelae of cerebrovascular disease"	1	79	0	79
"O26"	"I89"	"Maternal care for oth conditions predom related to pregnancy"	"Oth noninfective disorders of lymphatic vessels and nodes"	1	52	0	52
"O26"	"J15"	"Maternal care for oth conditions predom related to pregnancy"	"Bacterial pneumonia, not elsewhere classified"	1	306	13	319
"O26"	"J18"	"Maternal care for oth conditions predom related to pregnancy"	"Pneumonia, unspecified organism"	1	1011	165	1176
"O26"	"K02"	"Maternal care for oth conditions predom related to pregnancy"	"Dental caries"	1	103	37	140
"O26"	"K04"	"Maternal care for oth conditions predom related to pregnancy"	"Diseases of pulp and periapical tissues"	1	162	13	175
"O26"	"K05"	"Maternal care for oth conditions predom related to pregnancy"	"Gingivitis and periodontal diseases"	1	83	8	91
"O26"	"K21"	"Maternal care for oth conditions predom related to pregnancy"	"Gastro-esophageal reflux disease"	1	596	59	655
"O26"	"K25"	"Maternal care for oth conditions predom related to pregnancy"	"Gastric ulcer"	1	168	16	184
"O26"	"K31"	"Maternal care for oth conditions predom related to pregnancy"	"Other diseases of stomach and duodenum"	1	26	0	26
"O26"	"K42"	"Maternal care for oth conditions predom related to pregnancy"	"Umbilical hernia"	1	676	22	698
"O26"	"K52"	"Maternal care for oth conditions predom related to pregnancy"	"Other and unsp noninfective gastroenteritis and colitis"	1	378	179	557
"O26"	"K57"	"Maternal care for oth conditions predom related to pregnancy"	"Diverticular disease of intestine"	1	103	0	103
"O26"	"K62"	"Maternal care for oth conditions predom related to pregnancy"	"Other diseases of anus and rectum"	1	489	28	517
"O26"	"K80"	"Maternal care for oth conditions predom related to pregnancy"	"Cholelithiasis"	1	3854	0	3854
"O26"	"K86"	"Maternal care for oth conditions predom related to pregnancy"	"Other diseases of pancreas"	1	44	5	49
"O26"	"L73"	"Maternal care for oth conditions predom related to pregnancy"	"Other follicular disorders"	1	138	48	186
"O26"	"L90"	"Maternal care for oth conditions predom related to pregnancy"	"Atrophic disorders of skin"	1	522	123	645
"O26"	"M17"	"Maternal care for oth conditions predom related to pregnancy"	"Osteoarthritis of knee"	1	359	0	359
"O26"	"M19"	"Maternal care for oth conditions predom related to pregnancy"	"Other and unspecified osteoarthritis"	1	263	0	263
"O26"	"M21"	"Maternal care for oth conditions predom related to pregnancy"	"Other acquired deformities of limbs"	1	161	66	227
"O26"	"M35"	"Maternal care for oth conditions predom related to pregnancy"	"Other systemic involvement of connective tissue"	1	412	270	682
"O26"	"M46"	"Maternal care for oth conditions predom related to pregnancy"	"Other inflammatory spondylopathies"	1	215	21	236
"O26"	"M48"	"Maternal care for oth conditions predom related to pregnancy"	"Other spondylopathies"	1	86	0	86
"O26"	"M54"	"Maternal care for oth conditions predom related to pregnancy"	"Dorsalgia"	1	3319	1295	4614
"O26"	"M70"	"Maternal care for oth conditions predom related to pregnancy"	"Soft tissue disorders related to use, overuse and pressure"	1	375	77	452
"O26"	"M75"	"Maternal care for oth conditions predom related to pregnancy"	"Shoulder lesions"	1	1290	0	1290
"O26"	"M76"	"Maternal care for oth conditions predom related to pregnancy"	"Enthesopathies, lower limb, excluding foot"	1	310	103	413
"O26"	"M77"	"Maternal care for oth conditions predom related to pregnancy"	"Other enthesopathies"	1	545	23	568
"O26"	"M85"	"Maternal care for oth conditions predom related to pregnancy"	"Other disorders of bone density and structure"	1	122	0	122
"O26"	"N60"	"Maternal care for oth conditions predom related to pregnancy"	"Benign mammary dysplasia"	1	523	113	636
"O26"	"N61"	"Maternal care for oth conditions predom related to pregnancy"	"Inflammatory disorders of breast"	1	236	29	265
"O26"	"N75"	"Maternal care for oth conditions predom related to pregnancy"	"Diseases of Bartholin's gland"	1	202	97	299
"O26"	"N83"	"Maternal care for oth conditions predom related to pregnancy"	"Noninflammatory disord of ovary, fallop and broad ligament"	1	1115	713	1828
"O26"	"N87"	"Maternal care for oth conditions predom related to pregnancy"	"Dysplasia of cervix uteri"	1	999	567	1566
"O26"	"N95"	"Maternal care for oth conditions predom related to pregnancy"	"Menopausal and other perimenopausal disorders"	1	42	0	42
"O26"	"O34"	"Maternal care for oth conditions predom related to pregnancy"	"Maternal care for abnormality of pelvic organs"	1	3501	2460	5961
"O26"	"O72"	"Maternal care for oth conditions predom related to pregnancy"	"Postpartum hemorrhage"	1	31227	0	31227
"O26"	"O73"	"Maternal care for oth conditions predom related to pregnancy"	"Retained placenta and membranes, without hemorrhage"	1	864	483	1347
"O26"	"O74"	"Maternal care for oth conditions predom related to pregnancy"	"Complications of anesthesia during labor and delivery"	1	101	39	140
"O26"	"O75"	"Maternal care for oth conditions predom related to pregnancy"	"Oth complications of labor and delivery, NEC"	1	3236	2445	5681
"O26"	"O85"	"Maternal care for oth conditions predom related to pregnancy"	"Puerperal sepsis"	1	993	419	1412
"O26"	"O86"	"Maternal care for oth conditions predom related to pregnancy"	"Other puerperal infections"	1	1618	852	2470
"O26"	"O89"	"Maternal care for oth conditions predom related to pregnancy"	"Complications of anesthesia during the puerperium"	1	158	71	229
"O26"	"O91"	"Maternal care for oth conditions predom related to pregnancy"	"Infect of breast assoc w pregnancy, the puerp and lactation"	1	1277	443	1720
"O26"	"O92"	"Maternal care for oth conditions predom related to pregnancy"	"Oth disord of brst/lactatn assoc w pregnancy and the puerp"	1	2526	1079	3605
"O28"	"A46"	"Abnormal findings on antenatal screening of mother"	"Erysipelas"	1	28	0	28
"O28"	"D25"	"Abnormal findings on antenatal screening of mother"	"Leiomyoma of uterus"	1	108	13	121
"O28"	"E11"	"Abnormal findings on antenatal screening of mother"	"Type 2 diabetes mellitus"	1	78	15	93
"O28"	"E78"	"Abnormal findings on antenatal screening of mother"	"Disorders of lipoprotein metabolism and other lipidemias"	1	44	0	44
"O28"	"I10"	"Abnormal findings on antenatal screening of mother"	"Essential (primary) hypertension"	1	176	8	184
"O28"	"I20"	"Abnormal findings on antenatal screening of mother"	"Angina pectoris"	1	35	0	35
"O28"	"J06"	"Abnormal findings on antenatal screening of mother"	"Acute upper resp infections of multiple and unsp sites"	1	34	4	38
"O28"	"J18"	"Abnormal findings on antenatal screening of mother"	"Pneumonia, unspecified organism"	1	165	58	223
"O28"	"K80"	"Abnormal findings on antenatal screening of mother"	"Cholelithiasis"	1	399	145	544
"O28"	"M17"	"Abnormal findings on antenatal screening of mother"	"Osteoarthritis of knee"	1	68	0	68
"O28"	"M25"	"Abnormal findings on antenatal screening of mother"	"Other joint disorder, not elsewhere classified"	1	119	28	147
"O28"	"M47"	"Abnormal findings on antenatal screening of mother"	"Spondylosis"	1	37	0	37
"O28"	"M50"	"Abnormal findings on antenatal screening of mother"	"Cervical disc disorders"	1	52	0	52
"O28"	"M51"	"Abnormal findings on antenatal screening of mother"	"Thoracic, thoracolum, and lumbosacral intvrt disc disorders"	1	173	31	204
"O28"	"M75"	"Abnormal findings on antenatal screening of mother"	"Shoulder lesions"	1	173	5	178
"O28"	"M77"	"Abnormal findings on antenatal screening of mother"	"Other enthesopathies"	1	62	9	71
"O28"	"N39"	"Abnormal findings on antenatal screening of mother"	"Other disorders of urinary system"	1	186	24	210
"O28"	"N92"	"Abnormal findings on antenatal screening of mother"	"Excessive, frequent and irregular menstruation"	1	662	39	701
"O28"	"O72"	"Abnormal findings on antenatal screening of mother"	"Postpartum hemorrhage"	1	4991	2503	7494
"O28"	"O82"	"Abnormal findings on antenatal screening of mother"	"Encounter for cesarean delivery without indication"	1	2862	2237	5099
"O28"	"O86"	"Abnormal findings on antenatal screening of mother"	"Other puerperal infections"	1	329	210	539
"O28"	"O90"	"Abnormal findings on antenatal screening of mother"	"Complications of the puerperium, not elsewhere classified"	1	670	299	969
"O28"	"O92"	"Abnormal findings on antenatal screening of mother"	"Oth disord of brst/lactatn assoc w pregnancy and the puerp"	1	565	346	911
"O30"	"C50"	"Multiple gestation"	"Malignant neoplasm of breast"	1	67	0	67
"O30"	"C53"	"Multiple gestation"	"Malignant neoplasm of cervix uteri"	1	38	2	40
"O30"	"D12"	"Multiple gestation"	"Benign neoplasm of colon, rectum, anus and anal canal"	1	47	0	47
"O30"	"D17"	"Multiple gestation"	"Benign lipomatous neoplasm"	1	137	3	140
"O30"	"D22"	"Multiple gestation"	"Melanocytic nevi"	1	135	48	183
"O30"	"D50"	"Multiple gestation"	"Iron deficiency anemia"	1	143	4	147
"O30"	"E11"	"Multiple gestation"	"Type 2 diabetes mellitus"	1	103	0	103
"O30"	"E66"	"Multiple gestation"	"Overweight and obesity"	1	1857	1303	3160
"O30"	"E87"	"Multiple gestation"	"Other disorders of fluid, electrolyte and acid-base balance"	1	35	0	35
"O30"	"E89"	"Multiple gestation"	"Postproc endocrine and metabolic comp and disorders, NEC"	1	42	2	44
"O30"	"F17"	"Multiple gestation"	"Nicotine dependence"	1	166	19	185
"O30"	"G43"	"Multiple gestation"	"Migraine"	1	210	48	258
"O30"	"G47"	"Multiple gestation"	"Sleep disorders"	1	72	0	72
"O30"	"H57"	"Multiple gestation"	"Other disorders of eye and adnexa"	1	46	9	55
"O30"	"H81"	"Multiple gestation"	"Disorders of vestibular function"	1	104	17	121
"O30"	"I10"	"Multiple gestation"	"Essential (primary) hypertension"	1	320	0	320
"O30"	"I26"	"Multiple gestation"	"Pulmonary embolism"	1	50	7	57
"O30"	"I48"	"Multiple gestation"	"Atrial fibrillation and flutter"	1	38	0	38
"O30"	"I50"	"Multiple gestation"	"Heart failure"	1	28	0	28
"O30"	"J15"	"Multiple gestation"	"Bacterial pneumonia, not elsewhere classified"	1	108	0	108
"O30"	"J18"	"Multiple gestation"	"Pneumonia, unspecified organism"	1	321	43	364
"O30"	"J32"	"Multiple gestation"	"Chronic sinusitis"	1	54	8	62
"O30"	"J44"	"Multiple gestation"	"Other chronic obstructive pulmonary disease"	1	29	0	29
"O30"	"J96"	"Multiple gestation"	"Respiratory failure, not elsewhere classified"	1	38	0	38
"O30"	"K30"	"Multiple gestation"	"Functional dyspepsia"	1	131	53	184
"O30"	"K42"	"Multiple gestation"	"Umbilical hernia"	1	329	6	335
"O30"	"K59"	"Multiple gestation"	"Other functional intestinal disorders"	1	245	74	319
"O30"	"K76"	"Multiple gestation"	"Other diseases of liver"	1	41	3	44
"O30"	"K80"	"Multiple gestation"	"Cholelithiasis"	1	823	151	974
"O30"	"K83"	"Multiple gestation"	"Other diseases of biliary tract"	1	35	3	38
"O30"	"K85"	"Multiple gestation"	"Acute pancreatitis"	1	63	9	72
"O30"	"M07"	"Multiple gestation"	"Enteropathic arthropathies"	1	30	0	30
"O30"	"M13"	"Multiple gestation"	"Other arthritis"	1	68	10	78
"O30"	"M20"	"Multiple gestation"	"Acquired deformities of fingers and toes"	1	107	28	135
"O30"	"M23"	"Multiple gestation"	"Internal derangement of knee"	1	288	177	465
"O30"	"M25"	"Multiple gestation"	"Other joint disorder, not elsewhere classified"	1	236	26	262
"O30"	"M47"	"Multiple gestation"	"Spondylosis"	1	59	0	59
"O30"	"M51"	"Multiple gestation"	"Thoracic, thoracolum, and lumbosacral intvrt disc disorders"	1	359	1	360
"O30"	"M54"	"Multiple gestation"	"Dorsalgia"	1	544	184	728
"O30"	"M67"	"Multiple gestation"	"Other disorders of synovium and tendon"	1	172	89	261
"O30"	"M72"	"Multiple gestation"	"Fibroblastic disorders"	1	52	0	52
"O30"	"M77"	"Multiple gestation"	"Other enthesopathies"	1	126	0	126
"O30"	"M81"	"Multiple gestation"	"Osteoporosis without current pathological fracture"	1	26	0	26
"O30"	"N39"	"Multiple gestation"	"Other disorders of urinary system"	1	330	9	339
"O30"	"N61"	"Multiple gestation"	"Inflammatory disorders of breast"	1	72	9	81
"O30"	"N81"	"Multiple gestation"	"Female genital prolapse"	1	260	0	260
"O30"	"O23"	"Multiple gestation"	"Infections of genitourinary tract in pregnancy"	1	1401	1003	2404
"O30"	"O45"	"Multiple gestation"	"Premature separation of placenta [abruptio placentae]"	1	338	180	518
"O30"	"O47"	"Multiple gestation"	"False labor"	1	3643	2895	6538
"O30"	"O61"	"Multiple gestation"	"Failed induction of labor"	1	233	67	300
"O30"	"O64"	"Multiple gestation"	"Obstructed labor due to malposition and malpresent of fetus"	1	2741	1372	4113
"O30"	"O68"	"Multiple gestation"	"Labor and delivery comp by abnlt of fetal acid-base balance"	1	2781	2337	5118
"O30"	"O72"	"Multiple gestation"	"Postpartum hemorrhage"	1	10230	0	10230
"O30"	"O75"	"Multiple gestation"	"Oth complications of labor and delivery, NEC"	1	987	502	1489
"O30"	"O82"	"Multiple gestation"	"Encounter for cesarean delivery without indication"	1	1872	1495	3367
"O30"	"O85"	"Multiple gestation"	"Puerperal sepsis"	1	462	169	631
"O30"	"O86"	"Multiple gestation"	"Other puerperal infections"	1	870	318	1188
"O30"	"O87"	"Multiple gestation"	"Venous complications and hemorrhoids in the puerperium"	1	263	94	357
"O30"	"O99"	"Multiple gestation"	"Oth maternal diseases classd elsw but compl preg/chldbrth"	1	4989	4316	9305
"O31"	"O72"	"Complications specific to multiple gestation"	"Postpartum hemorrhage"	1	604	268	872
"O32"	"A46"	"Maternal care for malpresentation of fetus"	"Erysipelas"	1	79	4	83
"O32"	"A49"	"Maternal care for malpresentation of fetus"	"Bacterial infection of unspecified site"	1	82	20	102
"O32"	"B34"	"Maternal care for malpresentation of fetus"	"Viral infection of unspecified site"	1	193	103	296
"O32"	"C77"	"Maternal care for malpresentation of fetus"	"Secondary and unspecified malignant neoplasm of lymph nodes"	1	45	0	45
"O32"	"D12"	"Maternal care for malpresentation of fetus"	"Benign neoplasm of colon, rectum, anus and anal canal"	1	71	0	71
"O32"	"D33"	"Maternal care for malpresentation of fetus"	"Benign neoplasm of brain and oth prt central nervous system"	1	25	1	26
"O32"	"D62"	"Maternal care for malpresentation of fetus"	"Acute posthemorrhagic anemia"	1	54	9	63
"O32"	"E04"	"Maternal care for malpresentation of fetus"	"Other nontoxic goiter"	1	389	17	406
"O32"	"E11"	"Maternal care for malpresentation of fetus"	"Type 2 diabetes mellitus"	1	155	0	155
"O32"	"E68"	"Maternal care for malpresentation of fetus"	"Sequelae of hyperalimentation"	1	150	0	150
"O32"	"E86"	"Maternal care for malpresentation of fetus"	"Volume depletion"	1	72	20	92
"O32"	"F32"	"Maternal care for malpresentation of fetus"	"Depressive episode"	1	160	47	207
"O32"	"F33"	"Maternal care for malpresentation of fetus"	"Major depressive disorder, recurrent"	1	155	48	203
"O32"	"F41"	"Maternal care for malpresentation of fetus"	"Other anxiety disorders"	1	173	49	222
"O32"	"F43"	"Maternal care for malpresentation of fetus"	"Reaction to severe stress, and adjustment disorders"	1	275	25	300
"O32"	"G35"	"Maternal care for malpresentation of fetus"	"Multiple sclerosis"	1	84	8	92
"O32"	"G43"	"Maternal care for malpresentation of fetus"	"Migraine"	1	341	100	441
"O32"	"G44"	"Maternal care for malpresentation of fetus"	"Other headache syndromes"	1	248	56	304
"O32"	"G45"	"Maternal care for malpresentation of fetus"	"Transient cerebral ischemic attacks and related syndromes"	1	59	0	59
"O32"	"G47"	"Maternal care for malpresentation of fetus"	"Sleep disorders"	1	96	0	96
"O32"	"G54"	"Maternal care for malpresentation of fetus"	"Nerve root and plexus disorders"	1	28	1	29
"O32"	"G62"	"Maternal care for malpresentation of fetus"	"Other and unspecified polyneuropathies"	1	28	0	28
"O32"	"G93"	"Maternal care for malpresentation of fetus"	"Other disorders of brain"	1	28	1	29
"O32"	"G96"	"Maternal care for malpresentation of fetus"	"Other disorders of central nervous system"	1	98	0	98
"O32"	"H16"	"Maternal care for malpresentation of fetus"	"Keratitis"	1	74	23	97
"O32"	"H36"	"Maternal care for malpresentation of fetus"	"Retinal disorders in diseases classified elsewhere"	1	51	9	60
"O32"	"H53"	"Maternal care for malpresentation of fetus"	"Visual disturbances"	1	87	10	97
"O32"	"H57"	"Maternal care for malpresentation of fetus"	"Other disorders of eye and adnexa"	1	105	8	113
"O32"	"H81"	"Maternal care for malpresentation of fetus"	"Disorders of vestibular function"	1	104	18	122
"O32"	"H90"	"Maternal care for malpresentation of fetus"	"Conductive and sensorineural hearing loss"	1	110	24	134
"O32"	"I15"	"Maternal care for malpresentation of fetus"	"Secondary hypertension"	1	56	12	68
"O32"	"I26"	"Maternal care for malpresentation of fetus"	"Pulmonary embolism"	1	53	6	59
"O32"	"I49"	"Maternal care for malpresentation of fetus"	"Other cardiac arrhythmias"	1	137	9	146
"O32"	"I60"	"Maternal care for malpresentation of fetus"	"Nontraumatic subarachnoid hemorrhage"	1	27	1	28
"O32"	"I63"	"Maternal care for malpresentation of fetus"	"Cerebral infarction"	1	39	0	39
"O32"	"I67"	"Maternal care for malpresentation of fetus"	"Other cerebrovascular diseases"	1	29	0	29
"O32"	"J18"	"Maternal care for malpresentation of fetus"	"Pneumonia, unspecified organism"	1	444	80	524
"O32"	"J96"	"Maternal care for malpresentation of fetus"	"Respiratory failure, not elsewhere classified"	1	58	1	59
"O32"	"K04"	"Maternal care for malpresentation of fetus"	"Diseases of pulp and periapical tissues"	1	52	7	59
"O32"	"K21"	"Maternal care for malpresentation of fetus"	"Gastro-esophageal reflux disease"	1	197	17	214
"O32"	"K30"	"Maternal care for malpresentation of fetus"	"Functional dyspepsia"	1	230	85	315
"O32"	"K43"	"Maternal care for malpresentation of fetus"	"Ventral hernia"	1	272	0	272
"O32"	"K44"	"Maternal care for malpresentation of fetus"	"Diaphragmatic hernia"	1	133	3	136
"O32"	"K60"	"Maternal care for malpresentation of fetus"	"Fissure and fistula of anal and rectal regions"	1	169	53	222
"O32"	"K62"	"Maternal care for malpresentation of fetus"	"Other diseases of anus and rectum"	1	233	24	257
"O32"	"K63"	"Maternal care for malpresentation of fetus"	"Other diseases of intestine"	1	31	2	33
"O32"	"K64"	"Maternal care for malpresentation of fetus"	"Hemorrhoids and perianal venous thrombosis"	1	278	0	278
"O32"	"K81"	"Maternal care for malpresentation of fetus"	"Cholecystitis"	1	83	4	87
"O32"	"K83"	"Maternal care for malpresentation of fetus"	"Other diseases of biliary tract"	1	45	3	48
"O32"	"K85"	"Maternal care for malpresentation of fetus"	"Acute pancreatitis"	1	83	13	96
"O32"	"L08"	"Maternal care for malpresentation of fetus"	"Other local infections of skin and subcutaneous tissue"	1	145	63	208
"O32"	"L40"	"Maternal care for malpresentation of fetus"	"Psoriasis"	1	67	19	86
"O32"	"M05"	"Maternal care for malpresentation of fetus"	"Rheumatoid arthritis with rheumatoid factor"	1	65	3	68
"O32"	"M06"	"Maternal care for malpresentation of fetus"	"Other rheumatoid arthritis"	1	85	15	100
"O32"	"M07"	"Maternal care for malpresentation of fetus"	"Enteropathic arthropathies"	1	64	0	64
"O32"	"M13"	"Maternal care for malpresentation of fetus"	"Other arthritis"	1	107	14	121
"O32"	"M17"	"Maternal care for malpresentation of fetus"	"Osteoarthritis of knee"	1	140	0	140
"O32"	"M20"	"Maternal care for malpresentation of fetus"	"Acquired deformities of fingers and toes"	1	200	42	242
"O32"	"M21"	"Maternal care for malpresentation of fetus"	"Other acquired deformities of limbs"	1	75	25	100
"O32"	"M25"	"Maternal care for malpresentation of fetus"	"Other joint disorder, not elsewhere classified"	1	377	45	422
"O32"	"M47"	"Maternal care for malpresentation of fetus"	"Spondylosis"	1	83	0	83
"O32"	"M48"	"Maternal care for malpresentation of fetus"	"Other spondylopathies"	1	43	0	43
"O32"	"M50"	"Maternal care for malpresentation of fetus"	"Cervical disc disorders"	1	137	0	137
"O32"	"M51"	"Maternal care for malpresentation of fetus"	"Thoracic, thoracolum, and lumbosacral intvrt disc disorders"	1	554	9	563
"O32"	"M53"	"Maternal care for malpresentation of fetus"	"Other and unspecified dorsopathies, not elsewhere classified"	1	177	25	202
"O32"	"M70"	"Maternal care for malpresentation of fetus"	"Soft tissue disorders related to use, overuse and pressure"	1	125	10	135
"O32"	"M77"	"Maternal care for malpresentation of fetus"	"Other enthesopathies"	1	222	0	222
"O32"	"N18"	"Maternal care for malpresentation of fetus"	"Chronic kidney disease (CKD)"	1	26	0	26
"O32"	"N60"	"Maternal care for malpresentation of fetus"	"Benign mammary dysplasia"	1	303	42	345
"O32"	"N64"	"Maternal care for malpresentation of fetus"	"Other disorders of breast"	1	459	179	638
"O32"	"N75"	"Maternal care for malpresentation of fetus"	"Diseases of Bartholin's gland"	1	120	49	169
"O32"	"N81"	"Maternal care for malpresentation of fetus"	"Female genital prolapse"	1	451	0	451
"O32"	"N83"	"Maternal care for malpresentation of fetus"	"Noninflammatory disord of ovary, fallop and broad ligament"	1	469	271	740
"O32"	"N93"	"Maternal care for malpresentation of fetus"	"Other abnormal uterine and vaginal bleeding"	1	420	105	525
"O32"	"O34"	"Maternal care for malpresentation of fetus"	"Maternal care for abnormality of pelvic organs"	1	4980	2575	7555
"O32"	"O61"	"Maternal care for malpresentation of fetus"	"Failed induction of labor"	1	308	139	447
"O32"	"O71"	"Maternal care for malpresentation of fetus"	"Other obstetric trauma"	1	1351	1057	2408
"O32"	"O75"	"Maternal care for malpresentation of fetus"	"Oth complications of labor and delivery, NEC"	1	5103	0	5103
"O32"	"O85"	"Maternal care for malpresentation of fetus"	"Puerperal sepsis"	1	454	297	751
"O32"	"O92"	"Maternal care for malpresentation of fetus"	"Oth disord of brst/lactatn assoc w pregnancy and the puerp"	1	1205	848	2053
"O33"	"K59"	"Maternal care for disproportion"	"Other functional intestinal disorders"	1	31	3	34
"O33"	"M54"	"Maternal care for disproportion"	"Dorsalgia"	1	81	16	97
"O33"	"M79"	"Maternal care for disproportion"	"Oth and unsp soft tissue disorders, not elsewhere classified"	1	63	3	66
"O34"	"A41"	"Maternal care for abnormality of pelvic organs"	"Other sepsis"	1	101	22	123
"O34"	"D17"	"Maternal care for abnormality of pelvic organs"	"Benign lipomatous neoplasm"	1	232	46	278
"O34"	"D50"	"Maternal care for abnormality of pelvic organs"	"Iron deficiency anemia"	1	310	36	346
"O34"	"E04"	"Maternal care for abnormality of pelvic organs"	"Other nontoxic goiter"	1	350	80	430
"O34"	"E68"	"Maternal care for abnormality of pelvic organs"	"Sequelae of hyperalimentation"	1	254	13	267
"O34"	"E78"	"Maternal care for abnormality of pelvic organs"	"Disorders of lipoprotein metabolism and other lipidemias"	1	103	0	103
"O34"	"E87"	"Maternal care for abnormality of pelvic organs"	"Other disorders of fluid, electrolyte and acid-base balance"	1	57	0	57
"O34"	"G45"	"Maternal care for abnormality of pelvic organs"	"Transient cerebral ischemic attacks and related syndromes"	1	68	1	69
"O34"	"G56"	"Maternal care for abnormality of pelvic organs"	"Mononeuropathies of upper limb"	1	678	251	929
"O34"	"G62"	"Maternal care for abnormality of pelvic organs"	"Other and unspecified polyneuropathies"	1	26	0	26
"O34"	"H02"	"Maternal care for abnormality of pelvic organs"	"Other disorders of eyelid"	1	102	16	118
"O34"	"H57"	"Maternal care for abnormality of pelvic organs"	"Other disorders of eye and adnexa"	1	115	27	142
"O34"	"I20"	"Maternal care for abnormality of pelvic organs"	"Angina pectoris"	1	113	0	113
"O34"	"I49"	"Maternal care for abnormality of pelvic organs"	"Other cardiac arrhythmias"	1	131	40	171
"O34"	"I63"	"Maternal care for abnormality of pelvic organs"	"Cerebral infarction"	1	40	0	40
"O34"	"I69"	"Maternal care for abnormality of pelvic organs"	"Sequelae of cerebrovascular disease"	1	47	1	48
"O34"	"J15"	"Maternal care for abnormality of pelvic organs"	"Bacterial pneumonia, not elsewhere classified"	1	164	41	205
"O34"	"J18"	"Maternal care for abnormality of pelvic organs"	"Pneumonia, unspecified organism"	1	464	220	684
"O34"	"J44"	"Maternal care for abnormality of pelvic organs"	"Other chronic obstructive pulmonary disease"	1	56	3	59
"O34"	"J96"	"Maternal care for abnormality of pelvic organs"	"Respiratory failure, not elsewhere classified"	1	59	9	68
"O34"	"K57"	"Maternal care for abnormality of pelvic organs"	"Diverticular disease of intestine"	1	73	0	73
"O34"	"K62"	"Maternal care for abnormality of pelvic organs"	"Other diseases of anus and rectum"	1	197	65	262
"O34"	"M16"	"Maternal care for abnormality of pelvic organs"	"Osteoarthritis of hip"	1	79	0	79
"O34"	"M17"	"Maternal care for abnormality of pelvic organs"	"Osteoarthritis of knee"	1	169	0	169
"O34"	"M48"	"Maternal care for abnormality of pelvic organs"	"Other spondylopathies"	1	44	0	44
"O34"	"M50"	"Maternal care for abnormality of pelvic organs"	"Cervical disc disorders"	1	226	6	232
"O34"	"M51"	"Maternal care for abnormality of pelvic organs"	"Thoracic, thoracolum, and lumbosacral intvrt disc disorders"	1	588	139	727
"O34"	"M72"	"Maternal care for abnormality of pelvic organs"	"Fibroblastic disorders"	1	100	1	101
"O34"	"M75"	"Maternal care for abnormality of pelvic organs"	"Shoulder lesions"	1	654	38	692
"O34"	"M85"	"Maternal care for abnormality of pelvic organs"	"Other disorders of bone density and structure"	1	66	0	66
"O34"	"M99"	"Maternal care for abnormality of pelvic organs"	"Biomechanical lesions, not elsewhere classified"	1	51	11	62
"O34"	"N39"	"Maternal care for abnormality of pelvic organs"	"Other disorders of urinary system"	1	496	134	630
"O34"	"N60"	"Maternal care for abnormality of pelvic organs"	"Benign mammary dysplasia"	1	257	135	392
"O34"	"N92"	"Maternal care for abnormality of pelvic organs"	"Excessive, frequent and irregular menstruation"	1	2597	0	2597
"O34"	"O91"	"Maternal care for abnormality of pelvic organs"	"Infect of breast assoc w pregnancy, the puerp and lactation"	1	695	450	1145
"O35"	"C50"	"Maternal care for known or suspected fetal abnlt and damage"	"Malignant neoplasm of breast"	1	30	0	30
"O35"	"E78"	"Maternal care for known or suspected fetal abnlt and damage"	"Disorders of lipoprotein metabolism and other lipidemias"	1	33	1	34
"O35"	"G56"	"Maternal care for known or suspected fetal abnlt and damage"	"Mononeuropathies of upper limb"	1	137	61	198
"O35"	"I10"	"Maternal care for known or suspected fetal abnlt and damage"	"Essential (primary) hypertension"	1	113	16	129
"O35"	"I20"	"Maternal care for known or suspected fetal abnlt and damage"	"Angina pectoris"	1	28	0	28
"O35"	"M19"	"Maternal care for known or suspected fetal abnlt and damage"	"Other and unspecified osteoarthritis"	1	25	1	26
"O35"	"M47"	"Maternal care for known or suspected fetal abnlt and damage"	"Spondylosis"	1	25	0	25
"O35"	"M50"	"Maternal care for known or suspected fetal abnlt and damage"	"Cervical disc disorders"	1	29	0	29
"O35"	"M75"	"Maternal care for known or suspected fetal abnlt and damage"	"Shoulder lesions"	1	95	35	130
"O35"	"O72"	"Maternal care for known or suspected fetal abnlt and damage"	"Postpartum hemorrhage"	1	4780	2839	7619
"O35"	"O90"	"Maternal care for known or suspected fetal abnlt and damage"	"Complications of the puerperium, not elsewhere classified"	1	494	251	745
"O35"	"O92"	"Maternal care for known or suspected fetal abnlt and damage"	"Oth disord of brst/lactatn assoc w pregnancy and the puerp"	1	722	461	1183
"O36"	"A41"	"Maternal care for other fetal problems"	"Other sepsis"	1	173	27	200
"O36"	"C50"	"Maternal care for other fetal problems"	"Malignant neoplasm of breast"	1	154	0	154
"O36"	"D13"	"Maternal care for other fetal problems"	"Benign neoplasm of and ill-defined parts of digestive system"	1	44	0	44
"O36"	"D14"	"Maternal care for other fetal problems"	"Benign neoplasm of middle ear and respiratory system"	1	47	6	53
"O36"	"D22"	"Maternal care for other fetal problems"	"Melanocytic nevi"	1	382	152	534
"O36"	"D24"	"Maternal care for other fetal problems"	"Benign neoplasm of breast"	1	363	212	575
"O36"	"D25"	"Maternal care for other fetal problems"	"Leiomyoma of uterus"	1	415	6	421
"O36"	"D35"	"Maternal care for other fetal problems"	"Benign neoplasm of other and unspecified endocrine glands"	1	55	11	66
"O36"	"D50"	"Maternal care for other fetal problems"	"Iron deficiency anemia"	1	379	46	425
"O36"	"D64"	"Maternal care for other fetal problems"	"Other anemias"	1	275	55	330
"O36"	"D68"	"Maternal care for other fetal problems"	"Other coagulation defects"	1	757	352	1109
"O36"	"E03"	"Maternal care for other fetal problems"	"Other hypothyroidism"	1	710	467	1177
"O36"	"E11"	"Maternal care for other fetal problems"	"Type 2 diabetes mellitus"	1	385	53	438
"O36"	"E55"	"Maternal care for other fetal problems"	"Vitamin D deficiency"	1	300	121	421
"O36"	"E65"	"Maternal care for other fetal problems"	"Localized adiposity"	1	436	65	501
"O36"	"E78"	"Maternal care for other fetal problems"	"Disorders of lipoprotein metabolism and other lipidemias"	1	190	0	190
"O36"	"E86"	"Maternal care for other fetal problems"	"Volume depletion"	1	124	51	175
"O36"	"E87"	"Maternal care for other fetal problems"	"Other disorders of fluid, electrolyte and acid-base balance"	1	121	2	123
"O36"	"F43"	"Maternal care for other fetal problems"	"Reaction to severe stress, and adjustment disorders"	1	444	120	564
"O36"	"G47"	"Maternal care for other fetal problems"	"Sleep disorders"	1	185	0	185
"O36"	"G50"	"Maternal care for other fetal problems"	"Disorders of trigeminal nerve"	1	57	2	59
"O36"	"G62"	"Maternal care for other fetal problems"	"Other and unspecified polyneuropathies"	1	39	0	39
"O36"	"G96"	"Maternal care for other fetal problems"	"Other disorders of central nervous system"	1	177	4	181
"O36"	"H25"	"Maternal care for other fetal problems"	"Age-related cataract"	1	50	0	50
"O36"	"H40"	"Maternal care for other fetal problems"	"Glaucoma"	1	37	3	40
"O36"	"H57"	"Maternal care for other fetal problems"	"Other disorders of eye and adnexa"	1	169	44	213
"O36"	"H81"	"Maternal care for other fetal problems"	"Disorders of vestibular function"	1	159	60	219
"O36"	"H93"	"Maternal care for other fetal problems"	"Other disorders of ear, not elsewhere classified"	1	149	29	178
"O36"	"I26"	"Maternal care for other fetal problems"	"Pulmonary embolism"	1	107	34	141
"O36"	"I42"	"Maternal care for other fetal problems"	"Cardiomyopathy"	1	42	6	48
"O36"	"I49"	"Maternal care for other fetal problems"	"Other cardiac arrhythmias"	1	217	50	267
"O36"	"I60"	"Maternal care for other fetal problems"	"Nontraumatic subarachnoid hemorrhage"	1	33	4	37
"O36"	"I63"	"Maternal care for other fetal problems"	"Cerebral infarction"	1	68	0	68
"O36"	"I73"	"Maternal care for other fetal problems"	"Other peripheral vascular diseases"	1	62	2	64
"O36"	"I89"	"Maternal care for other fetal problems"	"Oth noninfective disorders of lymphatic vessels and nodes"	1	58	2	60
"O36"	"J06"	"Maternal care for other fetal problems"	"Acute upper resp infections of multiple and unsp sites"	1	223	38	261
"O36"	"J32"	"Maternal care for other fetal problems"	"Chronic sinusitis"	1	166	43	209
"O36"	"J44"	"Maternal care for other fetal problems"	"Other chronic obstructive pulmonary disease"	1	97	0	97
"O36"	"J96"	"Maternal care for other fetal problems"	"Respiratory failure, not elsewhere classified"	1	125	9	134
"O36"	"K43"	"Maternal care for other fetal problems"	"Ventral hernia"	1	329	0	329
"O36"	"K57"	"Maternal care for other fetal problems"	"Diverticular disease of intestine"	1	72	0	72
"O36"	"K59"	"Maternal care for other fetal problems"	"Other functional intestinal disorders"	1	578	348	926
"O36"	"K60"	"Maternal care for other fetal problems"	"Fissure and fistula of anal and rectal regions"	1	237	115	352
"O36"	"K62"	"Maternal care for other fetal problems"	"Other diseases of anus and rectum"	1	283	72	355
"O36"	"K85"	"Maternal care for other fetal problems"	"Acute pancreatitis"	1	166	53	219
"O36"	"K86"	"Maternal care for other fetal problems"	"Other diseases of pancreas"	1	32	3	35
"O36"	"L90"	"Maternal care for other fetal problems"	"Atrophic disorders of skin"	1	350	154	504
"O36"	"M05"	"Maternal care for other fetal problems"	"Rheumatoid arthritis with rheumatoid factor"	1	79	4	83
"O36"	"M07"	"Maternal care for other fetal problems"	"Enteropathic arthropathies"	1	106	0	106
"O36"	"M17"	"Maternal care for other fetal problems"	"Osteoarthritis of knee"	1	257	0	257
"O36"	"M19"	"Maternal care for other fetal problems"	"Other and unspecified osteoarthritis"	1	158	0	158
"O36"	"M25"	"Maternal care for other fetal problems"	"Other joint disorder, not elsewhere classified"	1	530	113	643
"O36"	"M46"	"Maternal care for other fetal problems"	"Other inflammatory spondylopathies"	1	82	10	92
"O36"	"M47"	"Maternal care for other fetal problems"	"Spondylosis"	1	169	0	169
"O36"	"M53"	"Maternal care for other fetal problems"	"Other and unspecified dorsopathies, not elsewhere classified"	1	252	66	318
"O36"	"M70"	"Maternal care for other fetal problems"	"Soft tissue disorders related to use, overuse and pressure"	1	202	74	276
"O36"	"M72"	"Maternal care for other fetal problems"	"Fibroblastic disorders"	1	96	2	98
"O36"	"M75"	"Maternal care for other fetal problems"	"Shoulder lesions"	1	780	0	780
"O36"	"M77"	"Maternal care for other fetal problems"	"Other enthesopathies"	1	314	50	364
"O36"	"M85"	"Maternal care for other fetal problems"	"Other disorders of bone density and structure"	1	123	0	123
"O36"	"M99"	"Maternal care for other fetal problems"	"Biomechanical lesions, not elsewhere classified"	1	78	1	79
"O36"	"N20"	"Maternal care for other fetal problems"	"Calculus of kidney and ureter"	1	345	168	513
"O36"	"N39"	"Maternal care for other fetal problems"	"Other disorders of urinary system"	1	841	143	984
"O36"	"N60"	"Maternal care for other fetal problems"	"Benign mammary dysplasia"	1	371	99	470
"O36"	"N61"	"Maternal care for other fetal problems"	"Inflammatory disorders of breast"	1	216	39	255
"O36"	"N63"	"Maternal care for other fetal problems"	"Unspecified lump in breast"	1	618	176	794
"O36"	"N84"	"Maternal care for other fetal problems"	"Polyp of female genital tract"	1	344	45	389
"O36"	"N92"	"Maternal care for other fetal problems"	"Excessive, frequent and irregular menstruation"	1	2637	0	2637
"O36"	"N94"	"Maternal care for other fetal problems"	"Pain and oth cond assoc w fem gntl org and menstrual cycle"	1	612	435	1047
"O36"	"N95"	"Maternal care for other fetal problems"	"Menopausal and other perimenopausal disorders"	1	37	0	37
"O36"	"O72"	"Maternal care for other fetal problems"	"Postpartum hemorrhage"	1	20151	14272	34423
"O36"	"O86"	"Maternal care for other fetal problems"	"Other puerperal infections"	1	1327	976	2303
"O36"	"O90"	"Maternal care for other fetal problems"	"Complications of the puerperium, not elsewhere classified"	1	2577	1077	3654
"O36"	"O91"	"Maternal care for other fetal problems"	"Infect of breast assoc w pregnancy, the puerp and lactation"	1	1383	462	1845
"O40"	"M17"	"Polyhydramnios"	"Osteoarthritis of knee"	1	29	0	29
"O40"	"M51"	"Polyhydramnios"	"Thoracic, thoracolum, and lumbosacral intvrt disc disorders"	1	95	23	118
"O41"	"C50"	"Other disorders of amniotic fluid and membranes"	"Malignant neoplasm of breast"	1	31	0	31
"O41"	"E68"	"Other disorders of amniotic fluid and membranes"	"Sequelae of hyperalimentation"	1	37	0	37
"O41"	"E78"	"Other disorders of amniotic fluid and membranes"	"Disorders of lipoprotein metabolism and other lipidemias"	1	31	0	31
"O41"	"G43"	"Other disorders of amniotic fluid and membranes"	"Migraine"	1	104	33	137
"O41"	"G56"	"Other disorders of amniotic fluid and membranes"	"Mononeuropathies of upper limb"	1	182	28	210
"O41"	"G96"	"Other disorders of amniotic fluid and membranes"	"Other disorders of central nervous system"	1	29	0	29
"O41"	"J18"	"Other disorders of amniotic fluid and membranes"	"Pneumonia, unspecified organism"	1	182	36	218
"O41"	"K44"	"Other disorders of amniotic fluid and membranes"	"Diaphragmatic hernia"	1	45	3	48
"O41"	"K62"	"Other disorders of amniotic fluid and membranes"	"Other diseases of anus and rectum"	1	69	5	74
"O41"	"M51"	"Other disorders of amniotic fluid and membranes"	"Thoracic, thoracolum, and lumbosacral intvrt disc disorders"	1	196	9	205
"O41"	"M54"	"Other disorders of amniotic fluid and membranes"	"Dorsalgia"	1	320	111	431
"O41"	"M85"	"Other disorders of amniotic fluid and membranes"	"Other disorders of bone density and structure"	1	25	0	25
"O41"	"N20"	"Other disorders of amniotic fluid and membranes"	"Calculus of kidney and ureter"	1	82	23	105
"O41"	"O34"	"Other disorders of amniotic fluid and membranes"	"Maternal care for abnormality of pelvic organs"	1	927	671	1598
"O41"	"O90"	"Other disorders of amniotic fluid and membranes"	"Complications of the puerperium, not elsewhere classified"	1	583	223	806
"O41"	"O91"	"Other disorders of amniotic fluid and membranes"	"Infect of breast assoc w pregnancy, the puerp and lactation"	1	281	91	372
"O42"	"A41"	"Premature rupture of membranes"	"Other sepsis"	1	135	16	151
"O42"	"C43"	"Premature rupture of membranes"	"Malignant melanoma of skin"	1	110	24	134
"O42"	"C73"	"Premature rupture of membranes"	"Malignant neoplasm of thyroid gland"	1	59	5	64
"O42"	"C77"	"Premature rupture of membranes"	"Secondary and unspecified malignant neoplasm of lymph nodes"	1	47	0	47
"O42"	"D17"	"Premature rupture of membranes"	"Benign lipomatous neoplasm"	1	280	30	310
"O42"	"D21"	"Premature rupture of membranes"	"Other benign neoplasms of connective and other soft tissue"	1	74	20	94
"O42"	"D35"	"Premature rupture of membranes"	"Benign neoplasm of other and unspecified endocrine glands"	1	40	5	45
"O42"	"D50"	"Premature rupture of membranes"	"Iron deficiency anemia"	1	229	3	232
"O42"	"D62"	"Premature rupture of membranes"	"Acute posthemorrhagic anemia"	1	90	32	122
"O42"	"E11"	"Premature rupture of membranes"	"Type 2 diabetes mellitus"	1	234	0	234
"O42"	"E68"	"Premature rupture of membranes"	"Sequelae of hyperalimentation"	1	226	0	226
"O42"	"E78"	"Premature rupture of membranes"	"Disorders of lipoprotein metabolism and other lipidemias"	1	140	0	140
"O42"	"E87"	"Premature rupture of membranes"	"Other disorders of fluid, electrolyte and acid-base balance"	1	82	0	82
"O42"	"E89"	"Premature rupture of membranes"	"Postproc endocrine and metabolic comp and disorders, NEC"	1	112	20	132
"O42"	"F32"	"Premature rupture of membranes"	"Depressive episode"	1	213	108	321
"O42"	"F43"	"Premature rupture of membranes"	"Reaction to severe stress, and adjustment disorders"	1	432	57	489
"O42"	"G37"	"Premature rupture of membranes"	"Other demyelinating diseases of central nervous system"	1	47	7	54
"O42"	"G43"	"Premature rupture of membranes"	"Migraine"	1	518	229	747
"O42"	"G45"	"Premature rupture of membranes"	"Transient cerebral ischemic attacks and related syndromes"	1	102	0	102
"O42"	"G62"	"Premature rupture of membranes"	"Other and unspecified polyneuropathies"	1	39	0	39
"O42"	"G96"	"Premature rupture of membranes"	"Other disorders of central nervous system"	1	182	16	198
"O42"	"G98"	"Premature rupture of membranes"	"Other disorders of nervous system not elsewhere classified"	1	86	1	87
"O42"	"H02"	"Premature rupture of membranes"	"Other disorders of eyelid"	1	167	11	178
"O42"	"H20"	"Premature rupture of membranes"	"Iridocyclitis"	1	85	26	111
"O42"	"H25"	"Premature rupture of membranes"	"Age-related cataract"	1	47	0	47
"O42"	"H33"	"Premature rupture of membranes"	"Retinal detachments and breaks"	1	40	0	40
"O42"	"H36"	"Premature rupture of membranes"	"Retinal disorders in diseases classified elsewhere"	1	50	3	53
"O42"	"H40"	"Premature rupture of membranes"	"Glaucoma"	1	28	0	28
"O42"	"H43"	"Premature rupture of membranes"	"Disorders of vitreous body"	1	26	0	26
"O42"	"H53"	"Premature rupture of membranes"	"Visual disturbances"	1	131	38	169
"O42"	"H57"	"Premature rupture of membranes"	"Other disorders of eye and adnexa"	1	146	22	168
"O42"	"H91"	"Premature rupture of membranes"	"Other and unspecified hearing loss"	1	167	43	210
"O42"	"H93"	"Premature rupture of membranes"	"Other disorders of ear, not elsewhere classified"	1	150	20	170
"O42"	"I15"	"Premature rupture of membranes"	"Secondary hypertension"	1	61	7	68
"O42"	"I20"	"Premature rupture of membranes"	"Angina pectoris"	1	115	0	115
"O42"	"I21"	"Premature rupture of membranes"	"Acute myocardial infarction"	1	33	0	33
"O42"	"I25"	"Premature rupture of membranes"	"Chronic ischemic heart disease"	1	37	0	37
"O42"	"I35"	"Premature rupture of membranes"	"Nonrheumatic aortic valve disorders"	1	44	0	44
"O42"	"I42"	"Premature rupture of membranes"	"Cardiomyopathy"	1	40	0	40
"O42"	"I49"	"Premature rupture of membranes"	"Other cardiac arrhythmias"	1	185	34	219
"O42"	"I50"	"Premature rupture of membranes"	"Heart failure"	1	31	0	31
"O42"	"I60"	"Premature rupture of membranes"	"Nontraumatic subarachnoid hemorrhage"	1	35	0	35
"O42"	"I69"	"Premature rupture of membranes"	"Sequelae of cerebrovascular disease"	1	38	0	38
"O42"	"I73"	"Premature rupture of membranes"	"Other peripheral vascular diseases"	1	45	9	54
"O42"	"I80"	"Premature rupture of membranes"	"Phlebitis and thrombophlebitis"	1	254	74	328
"O42"	"I82"	"Premature rupture of membranes"	"Other venous embolism and thrombosis"	1	52	3	55
"O42"	"I83"	"Premature rupture of membranes"	"Varicose veins of lower extremities"	1	1160	0	1160
"O42"	"I89"	"Premature rupture of membranes"	"Oth noninfective disorders of lymphatic vessels and nodes"	1	37	0	37
"O42"	"J01"	"Premature rupture of membranes"	"Acute sinusitis"	1	306	82	388
"O42"	"J09"	"Premature rupture of membranes"	"Influenza due to certain identified influenza viruses"	1	30	0	30
"O42"	"J18"	"Premature rupture of membranes"	"Pneumonia, unspecified organism"	1	646	154	800
"O42"	"J44"	"Premature rupture of membranes"	"Other chronic obstructive pulmonary disease"	1	77	0	77
"O42"	"J90"	"Premature rupture of membranes"	"Pleural effusion, not elsewhere classified"	1	28	2	30
"O42"	"K30"	"Premature rupture of membranes"	"Functional dyspepsia"	1	355	169	524
"O42"	"K56"	"Premature rupture of membranes"	"Paralytic ileus and intestinal obstruction without hernia"	1	146	18	164
"O42"	"K59"	"Premature rupture of membranes"	"Other functional intestinal disorders"	1	535	295	830
"O42"	"K60"	"Premature rupture of membranes"	"Fissure and fistula of anal and rectal regions"	1	331	131	462
"O42"	"K63"	"Premature rupture of membranes"	"Other diseases of intestine"	1	56	11	67
"O42"	"K81"	"Premature rupture of membranes"	"Cholecystitis"	1	136	14	150
"O42"	"L29"	"Premature rupture of membranes"	"Pruritus"	1	64	19	83
"O42"	"L30"	"Premature rupture of membranes"	"Other and unspecified dermatitis"	1	206	75	281
"O42"	"L90"	"Premature rupture of membranes"	"Atrophic disorders of skin"	1	274	130	404
"O42"	"M07"	"Premature rupture of membranes"	"Enteropathic arthropathies"	1	99	2	101
"O42"	"M17"	"Premature rupture of membranes"	"Osteoarthritis of knee"	1	232	0	232
"O42"	"M48"	"Premature rupture of membranes"	"Other spondylopathies"	1	48	0	48
"O42"	"M51"	"Premature rupture of membranes"	"Thoracic, thoracolum, and lumbosacral intvrt disc disorders"	1	908	55	963
"O42"	"M53"	"Premature rupture of membranes"	"Other and unspecified dorsopathies, not elsewhere classified"	1	249	65	314
"O42"	"M54"	"Premature rupture of membranes"	"Dorsalgia"	1	1428	640	2068
"O42"	"M72"	"Premature rupture of membranes"	"Fibroblastic disorders"	1	116	0	116
"O42"	"M75"	"Premature rupture of membranes"	"Shoulder lesions"	1	776	0	776
"O42"	"M77"	"Premature rupture of membranes"	"Other enthesopathies"	1	308	37	345
"O42"	"M81"	"Premature rupture of membranes"	"Osteoporosis without current pathological fracture"	1	57	0	57
"O42"	"M96"	"Premature rupture of membranes"	"Intraop and postproc comp and disorders of ms sys, NEC"	1	26	0	26
"O42"	"N20"	"Premature rupture of membranes"	"Calculus of kidney and ureter"	1	421	147	568
"O42"	"N71"	"Premature rupture of membranes"	"Inflammatory disease of uterus, except cervix"	1	506	307	813
"O42"	"N92"	"Premature rupture of membranes"	"Excessive, frequent and irregular menstruation"	1	2408	0	2408
"O42"	"N94"	"Premature rupture of membranes"	"Pain and oth cond assoc w fem gntl org and menstrual cycle"	1	718	454	1172
"O42"	"O85"	"Premature rupture of membranes"	"Puerperal sepsis"	1	843	583	1426
"O44"	"E11"	"Placenta previa"	"Type 2 diabetes mellitus"	1	25	0	25
"O44"	"M51"	"Placenta previa"	"Thoracic, thoracolum, and lumbosacral intvrt disc disorders"	1	87	7	94
"O44"	"M75"	"Placenta previa"	"Shoulder lesions"	1	84	0	84
"O44"	"N39"	"Placenta previa"	"Other disorders of urinary system"	1	88	15	103
"O44"	"O90"	"Placenta previa"	"Complications of the puerperium, not elsewhere classified"	1	320	152	472
"O44"	"O92"	"Placenta previa"	"Oth disord of brst/lactatn assoc w pregnancy and the puerp"	1	257	146	403
"O45"	"D25"	"Premature separation of placenta [abruptio placentae]"	"Leiomyoma of uterus"	1	63	0	63
"O45"	"E11"	"Premature separation of placenta [abruptio placentae]"	"Type 2 diabetes mellitus"	1	25	0	25
"O45"	"J18"	"Premature separation of placenta [abruptio placentae]"	"Pneumonia, unspecified organism"	1	121	9	130
"O45"	"K30"	"Premature separation of placenta [abruptio placentae]"	"Functional dyspepsia"	1	67	7	74
"O45"	"K80"	"Premature separation of placenta [abruptio placentae]"	"Cholelithiasis"	1	202	20	222
"O45"	"M23"	"Premature separation of placenta [abruptio placentae]"	"Internal derangement of knee"	1	99	32	131
"O45"	"N39"	"Premature separation of placenta [abruptio placentae]"	"Other disorders of urinary system"	1	86	0	86
"O45"	"N83"	"Premature separation of placenta [abruptio placentae]"	"Noninflammatory disord of ovary, fallop and broad ligament"	1	111	47	158
"O46"	"A41"	"Antepartum hemorrhage, not elsewhere classified"	"Other sepsis"	1	44	6	50
"O46"	"A46"	"Antepartum hemorrhage, not elsewhere classified"	"Erysipelas"	1	33	2	35
"O46"	"A49"	"Antepartum hemorrhage, not elsewhere classified"	"Bacterial infection of unspecified site"	1	45	5	50
"O46"	"E11"	"Antepartum hemorrhage, not elsewhere classified"	"Type 2 diabetes mellitus"	1	78	0	78
"O46"	"E66"	"Antepartum hemorrhage, not elsewhere classified"	"Overweight and obesity"	1	1202	779	1981
"O46"	"E78"	"Antepartum hemorrhage, not elsewhere classified"	"Disorders of lipoprotein metabolism and other lipidemias"	1	45	0	45
"O46"	"E87"	"Antepartum hemorrhage, not elsewhere classified"	"Other disorders of fluid, electrolyte and acid-base balance"	1	40	0	40
"O46"	"F41"	"Antepartum hemorrhage, not elsewhere classified"	"Other anxiety disorders"	1	99	14	113
"O46"	"G35"	"Antepartum hemorrhage, not elsewhere classified"	"Multiple sclerosis"	1	36	3	39
"O46"	"G44"	"Antepartum hemorrhage, not elsewhere classified"	"Other headache syndromes"	1	149	32	181
"O46"	"G56"	"Antepartum hemorrhage, not elsewhere classified"	"Mononeuropathies of upper limb"	1	320	26	346
"O46"	"H53"	"Antepartum hemorrhage, not elsewhere classified"	"Visual disturbances"	1	59	10	69
"O46"	"H81"	"Antepartum hemorrhage, not elsewhere classified"	"Disorders of vestibular function"	1	61	11	72
"O46"	"I10"	"Antepartum hemorrhage, not elsewhere classified"	"Essential (primary) hypertension"	1	170	0	170
"O46"	"I63"	"Antepartum hemorrhage, not elsewhere classified"	"Cerebral infarction"	1	25	0	25
"O46"	"J15"	"Antepartum hemorrhage, not elsewhere classified"	"Bacterial pneumonia, not elsewhere classified"	1	72	2	74
"O46"	"K30"	"Antepartum hemorrhage, not elsewhere classified"	"Functional dyspepsia"	1	158	64	222
"O46"	"K56"	"Antepartum hemorrhage, not elsewhere classified"	"Paralytic ileus and intestinal obstruction without hernia"	1	57	7	64
"O46"	"K59"	"Antepartum hemorrhage, not elsewhere classified"	"Other functional intestinal disorders"	1	250	93	343
"O46"	"K62"	"Antepartum hemorrhage, not elsewhere classified"	"Other diseases of anus and rectum"	1	130	10	140
"O46"	"K80"	"Antepartum hemorrhage, not elsewhere classified"	"Cholelithiasis"	1	645	101	746
"O46"	"K83"	"Antepartum hemorrhage, not elsewhere classified"	"Other diseases of biliary tract"	1	24	1	25
"O46"	"L90"	"Antepartum hemorrhage, not elsewhere classified"	"Atrophic disorders of skin"	1	127	31	158
"O46"	"L98"	"Antepartum hemorrhage, not elsewhere classified"	"Oth disorders of skin, subcu, not elsewhere classified"	1	50	8	58
"O46"	"M13"	"Antepartum hemorrhage, not elsewhere classified"	"Other arthritis"	1	37	5	42
"O46"	"M47"	"Antepartum hemorrhage, not elsewhere classified"	"Spondylosis"	1	37	0	37
"O46"	"M54"	"Antepartum hemorrhage, not elsewhere classified"	"Dorsalgia"	1	557	193	750
"O46"	"M67"	"Antepartum hemorrhage, not elsewhere classified"	"Other disorders of synovium and tendon"	1	145	67	212
"O46"	"M70"	"Antepartum hemorrhage, not elsewhere classified"	"Soft tissue disorders related to use, overuse and pressure"	1	87	14	101
"O46"	"N39"	"Antepartum hemorrhage, not elsewhere classified"	"Other disorders of urinary system"	1	303	36	339
"O46"	"N92"	"Antepartum hemorrhage, not elsewhere classified"	"Excessive, frequent and irregular menstruation"	1	1123	21	1144
"O46"	"O34"	"Antepartum hemorrhage, not elsewhere classified"	"Maternal care for abnormality of pelvic organs"	1	1347	1010	2357
"O46"	"O66"	"Antepartum hemorrhage, not elsewhere classified"	"Other obstructed labor"	1	363	233	596
"O46"	"O67"	"Antepartum hemorrhage, not elsewhere classified"	"Labor and delivery comp by intrapartum hemorrhage, NEC"	1	353	224	577
"O46"	"O70"	"Antepartum hemorrhage, not elsewhere classified"	"Perineal laceration during delivery"	1	4889	3563	8452
"O46"	"O72"	"Antepartum hemorrhage, not elsewhere classified"	"Postpartum hemorrhage"	1	6686	3017	9703
"O46"	"O73"	"Antepartum hemorrhage, not elsewhere classified"	"Retained placenta and membranes, without hemorrhage"	1	369	199	568
"O46"	"O75"	"Antepartum hemorrhage, not elsewhere classified"	"Oth complications of labor and delivery, NEC"	1	1030	616	1646
"O46"	"O85"	"Antepartum hemorrhage, not elsewhere classified"	"Puerperal sepsis"	1	313	139	452
"O46"	"O90"	"Antepartum hemorrhage, not elsewhere classified"	"Complications of the puerperium, not elsewhere classified"	1	841	273	1114
"O46"	"O91"	"Antepartum hemorrhage, not elsewhere classified"	"Infect of breast assoc w pregnancy, the puerp and lactation"	1	452	128	580
"O47"	"A41"	"False labor"	"Other sepsis"	1	159	14	173
"O47"	"B95"	"False labor"	"Strep as the cause of diseases classified elsewhere"	1	99	30	129
"O47"	"C50"	"False labor"	"Malignant neoplasm of breast"	1	118	0	118
"O47"	"C77"	"False labor"	"Secondary and unspecified malignant neoplasm of lymph nodes"	1	26	0	26
"O47"	"C79"	"False labor"	"Secondary malignant neoplasm of other and unspecified sites"	1	29	0	29
"O47"	"D12"	"False labor"	"Benign neoplasm of colon, rectum, anus and anal canal"	1	97	0	97
"O47"	"D17"	"False labor"	"Benign lipomatous neoplasm"	1	273	32	305
"O47"	"D24"	"False labor"	"Benign neoplasm of breast"	1	351	166	517
"O47"	"D25"	"False labor"	"Leiomyoma of uterus"	1	393	0	393
"O47"	"E66"	"False labor"	"Overweight and obesity"	1	2749	2309	5058
"O47"	"E86"	"False labor"	"Volume depletion"	1	148	60	208
"O47"	"E87"	"False labor"	"Other disorders of fluid, electrolyte and acid-base balance"	1	79	0	79
"O47"	"E89"	"False labor"	"Postproc endocrine and metabolic comp and disorders, NEC"	1	75	11	86
"O47"	"F31"	"False labor"	"Bipolar disorder"	1	25	0	25
"O47"	"F32"	"False labor"	"Depressive episode"	1	279	95	374
"O47"	"G35"	"False labor"	"Multiple sclerosis"	1	126	10	136
"O47"	"G44"	"False labor"	"Other headache syndromes"	1	454	147	601
"O47"	"G47"	"False labor"	"Sleep disorders"	1	168	0	168
"O47"	"G54"	"False labor"	"Nerve root and plexus disorders"	1	30	3	33
"O47"	"G62"	"False labor"	"Other and unspecified polyneuropathies"	1	34	0	34
"O47"	"G96"	"False labor"	"Other disorders of central nervous system"	1	228	1	229
"O47"	"H02"	"False labor"	"Other disorders of eyelid"	1	112	0	112
"O47"	"H53"	"False labor"	"Visual disturbances"	1	151	41	192
"O47"	"I15"	"False labor"	"Secondary hypertension"	1	64	12	76
"O47"	"I25"	"False labor"	"Chronic ischemic heart disease"	1	43	0	43
"O47"	"I26"	"False labor"	"Pulmonary embolism"	1	118	19	137
"O47"	"I35"	"False labor"	"Nonrheumatic aortic valve disorders"	1	38	1	39
"O47"	"I48"	"False labor"	"Atrial fibrillation and flutter"	1	84	0	84
"O47"	"I69"	"False labor"	"Sequelae of cerebrovascular disease"	1	57	0	57
"O47"	"I73"	"False labor"	"Other peripheral vascular diseases"	1	50	3	53
"O47"	"I82"	"False labor"	"Other venous embolism and thrombosis"	1	60	4	64
"O47"	"J15"	"False labor"	"Bacterial pneumonia, not elsewhere classified"	1	206	9	215
"O47"	"J32"	"False labor"	"Chronic sinusitis"	1	173	41	214
"O47"	"J44"	"False labor"	"Other chronic obstructive pulmonary disease"	1	82	0	82
"O47"	"K04"	"False labor"	"Diseases of pulp and periapical tissues"	1	85	22	107
"O47"	"K05"	"False labor"	"Gingivitis and periodontal diseases"	1	49	8	57
"O47"	"K21"	"False labor"	"Gastro-esophageal reflux disease"	1	376	68	444
"O47"	"K30"	"False labor"	"Functional dyspepsia"	1	442	230	672
"O47"	"K52"	"False labor"	"Other and unsp noninfective gastroenteritis and colitis"	1	283	164	447
"O47"	"K57"	"False labor"	"Diverticular disease of intestine"	1	64	0	64
"O47"	"K63"	"False labor"	"Other diseases of intestine"	1	54	6	60
"O47"	"K80"	"False labor"	"Cholelithiasis"	1	1710	395	2105
"O47"	"K83"	"False labor"	"Other diseases of biliary tract"	1	80	9	89
"O47"	"K86"	"False labor"	"Other diseases of pancreas"	1	30	1	31
"O47"	"L90"	"False labor"	"Atrophic disorders of skin"	1	310	118	428
"O47"	"L98"	"False labor"	"Oth disorders of skin, subcu, not elsewhere classified"	1	135	26	161
"O47"	"M05"	"False labor"	"Rheumatoid arthritis with rheumatoid factor"	1	64	4	68
"O47"	"M06"	"False labor"	"Other rheumatoid arthritis"	1	91	19	110
"O47"	"M13"	"False labor"	"Other arthritis"	1	141	25	166
"O47"	"M25"	"False labor"	"Other joint disorder, not elsewhere classified"	1	604	122	726
"O47"	"M48"	"False labor"	"Other spondylopathies"	1	59	0	59
"O47"	"M50"	"False labor"	"Cervical disc disorders"	1	241	0	241
"O47"	"M70"	"False labor"	"Soft tissue disorders related to use, overuse and pressure"	1	190	57	247
"O47"	"M75"	"False labor"	"Shoulder lesions"	1	738	0	738
"O47"	"M77"	"False labor"	"Other enthesopathies"	1	327	22	349
"O47"	"N18"	"False labor"	"Chronic kidney disease (CKD)"	1	53	0	53
"O47"	"N20"	"False labor"	"Calculus of kidney and ureter"	1	439	152	591
"O47"	"N61"	"False labor"	"Inflammatory disorders of breast"	1	157	23	180
"O47"	"N82"	"False labor"	"Fistulae involving female genital tract"	1	27	2	29
"O47"	"N88"	"False labor"	"Other noninflammatory disorders of cervix uteri"	1	126	48	174
"O47"	"O66"	"False labor"	"Other obstructed labor"	1	1034	513	1547
"O47"	"O68"	"False labor"	"Labor and delivery comp by abnlt of fetal acid-base balance"	1	7590	5412	13002
"O47"	"O72"	"False labor"	"Postpartum hemorrhage"	1	26911	0	26911
"O47"	"O85"	"False labor"	"Puerperal sepsis"	1	800	335	1135
"O47"	"O86"	"False labor"	"Other puerperal infections"	1	1362	677	2039
"O47"	"O87"	"False labor"	"Venous complications and hemorrhoids in the puerperium"	1	482	188	670
"O47"	"O91"	"False labor"	"Infect of breast assoc w pregnancy, the puerp and lactation"	1	1284	375	1659
"O47"	"O92"	"False labor"	"Oth disord of brst/lactatn assoc w pregnancy and the puerp"	1	1964	754	2718
"O48"	"A41"	"Late pregnancy"	"Other sepsis"	1	94	0	94
"O48"	"A46"	"Late pregnancy"	"Erysipelas"	1	78	0	78
"O48"	"C50"	"Late pregnancy"	"Malignant neoplasm of breast"	1	145	0	145
"O48"	"D06"	"Late pregnancy"	"Carcinoma in situ of cervix uteri"	1	171	77	248
"O48"	"D23"	"Late pregnancy"	"Other benign neoplasms of skin"	1	247	24	271
"O48"	"D27"	"Late pregnancy"	"Benign neoplasm of ovary"	1	295	91	386
"O48"	"D64"	"Late pregnancy"	"Other anemias"	1	175	0	175
"O48"	"D69"	"Late pregnancy"	"Purpura and other hemorrhagic conditions"	1	76	24	100
"O48"	"D86"	"Late pregnancy"	"Sarcoidosis"	1	52	5	57
"O48"	"E03"	"Late pregnancy"	"Other hypothyroidism"	1	497	15	512
"O48"	"E04"	"Late pregnancy"	"Other nontoxic goiter"	1	478	0	478
"O48"	"E05"	"Late pregnancy"	"Thyrotoxicosis [hyperthyroidism]"	1	430	48	478
"O48"	"E10"	"Late pregnancy"	"Type 1 diabetes mellitus"	1	38	0	38
"O48"	"E65"	"Late pregnancy"	"Localized adiposity"	1	242	0	242
"O48"	"E66"	"Late pregnancy"	"Overweight and obesity"	1	3941	2364	6305
"O48"	"E68"	"Late pregnancy"	"Sequelae of hyperalimentation"	1	145	0	145
"O48"	"E86"	"Late pregnancy"	"Volume depletion"	1	72	4	76
"O48"	"E87"	"Late pregnancy"	"Other disorders of fluid, electrolyte and acid-base balance"	1	34	0	34
"O48"	"F33"	"Late pregnancy"	"Major depressive disorder, recurrent"	1	147	2	149
"O48"	"F43"	"Late pregnancy"	"Reaction to severe stress, and adjustment disorders"	1	218	0	218
"O48"	"G35"	"Late pregnancy"	"Multiple sclerosis"	1	93	0	93
"O48"	"G37"	"Late pregnancy"	"Other demyelinating diseases of central nervous system"	1	28	0	28
"O48"	"G44"	"Late pregnancy"	"Other headache syndromes"	1	281	6	287
"O48"	"G45"	"Late pregnancy"	"Transient cerebral ischemic attacks and related syndromes"	1	49	0	49
"O48"	"G50"	"Late pregnancy"	"Disorders of trigeminal nerve"	1	34	0	34
"O48"	"G51"	"Late pregnancy"	"Facial nerve disorders"	1	90	16	106
"O48"	"G56"	"Late pregnancy"	"Mononeuropathies of upper limb"	1	677	0	677
"O48"	"G96"	"Late pregnancy"	"Other disorders of central nervous system"	1	78	0	78
"O48"	"G97"	"Late pregnancy"	"Intraop and postproc comp and disorders of nervous sys, NEC"	1	39	0	39
"O48"	"G98"	"Late pregnancy"	"Other disorders of nervous system not elsewhere classified"	1	43	0	43
"O48"	"H02"	"Late pregnancy"	"Other disorders of eyelid"	1	92	0	92
"O48"	"H47"	"Late pregnancy"	"Other disorders of optic [2nd] nerve and visual pathways"	1	28	2	30
"O48"	"H52"	"Late pregnancy"	"Disorders of refraction and accommodation"	1	297	15	312
"O48"	"H57"	"Late pregnancy"	"Other disorders of eye and adnexa"	1	76	0	76
"O48"	"H81"	"Late pregnancy"	"Disorders of vestibular function"	1	149	0	149
"O48"	"I20"	"Late pregnancy"	"Angina pectoris"	1	79	0	79
"O48"	"I26"	"Late pregnancy"	"Pulmonary embolism"	1	55	0	55
"O48"	"I47"	"Late pregnancy"	"Paroxysmal tachycardia"	1	162	23	185
"O48"	"I63"	"Late pregnancy"	"Cerebral infarction"	1	38	0	38
"O48"	"I73"	"Late pregnancy"	"Other peripheral vascular diseases"	1	34	0	34
"O48"	"I82"	"Late pregnancy"	"Other venous embolism and thrombosis"	1	30	0	30
"O48"	"I95"	"Late pregnancy"	"Hypotension"	1	37	3	40
"O48"	"J01"	"Late pregnancy"	"Acute sinusitis"	1	168	11	179
"O48"	"J03"	"Late pregnancy"	"Acute tonsillitis"	1	372	170	542
"O48"	"J15"	"Late pregnancy"	"Bacterial pneumonia, not elsewhere classified"	1	121	0	121
"O48"	"J18"	"Late pregnancy"	"Pneumonia, unspecified organism"	1	505	3	508
"O48"	"J32"	"Late pregnancy"	"Chronic sinusitis"	1	132	3	135
"O48"	"J44"	"Late pregnancy"	"Other chronic obstructive pulmonary disease"	1	34	0	34
"O48"	"J98"	"Late pregnancy"	"Other respiratory disorders"	1	27	1	28
"O48"	"K04"	"Late pregnancy"	"Diseases of pulp and periapical tissues"	1	62	0	62
"O48"	"K11"	"Late pregnancy"	"Diseases of salivary glands"	1	43	5	48
"O48"	"K12"	"Late pregnancy"	"Stomatitis and related lesions"	1	45	5	50
"O48"	"K25"	"Late pregnancy"	"Gastric ulcer"	1	54	0	54
"O48"	"K30"	"Late pregnancy"	"Functional dyspepsia"	1	331	33	364
"O48"	"K43"	"Late pregnancy"	"Ventral hernia"	1	198	0	198
"O48"	"K44"	"Late pregnancy"	"Diaphragmatic hernia"	1	180	0	180
"O48"	"K45"	"Late pregnancy"	"Other abdominal hernia"	1	87	0	87
"O48"	"K51"	"Late pregnancy"	"Ulcerative colitis"	1	167	41	208
"O48"	"K57"	"Late pregnancy"	"Diverticular disease of intestine"	1	31	0	31
"O48"	"K58"	"Late pregnancy"	"Irritable bowel syndrome"	1	204	58	262
"O48"	"K60"	"Late pregnancy"	"Fissure and fistula of anal and rectal regions"	1	273	29	302
"O48"	"K63"	"Late pregnancy"	"Other diseases of intestine"	1	31	0	31
"O48"	"K65"	"Late pregnancy"	"Peritonitis"	1	54	3	57
"O48"	"K76"	"Late pregnancy"	"Other diseases of liver"	1	35	0	35
"O48"	"K85"	"Late pregnancy"	"Acute pancreatitis"	1	158	7	165
"O48"	"K90"	"Late pregnancy"	"Intestinal malabsorption"	1	44	0	44
"O48"	"K92"	"Late pregnancy"	"Other diseases of digestive system"	1	56	7	63
"O48"	"L02"	"Late pregnancy"	"Cutaneous abscess, furuncle and carbuncle"	1	333	111	444
"O48"	"L29"	"Late pregnancy"	"Pruritus"	1	41	1	42
"O48"	"L30"	"Late pregnancy"	"Other and unspecified dermatitis"	1	165	19	184
"O48"	"L72"	"Late pregnancy"	"Follicular cysts of skin and subcutaneous tissue"	1	67	0	67
"O48"	"L90"	"Late pregnancy"	"Atrophic disorders of skin"	1	315	15	330
"O48"	"L98"	"Late pregnancy"	"Oth disorders of skin, subcu, not elsewhere classified"	1	147	5	152
"O48"	"M07"	"Late pregnancy"	"Enteropathic arthropathies"	1	47	0	47
"O48"	"M16"	"Late pregnancy"	"Osteoarthritis of hip"	1	68	0	68
"O48"	"M19"	"Late pregnancy"	"Other and unspecified osteoarthritis"	1	86	0	86
"O48"	"M21"	"Late pregnancy"	"Other acquired deformities of limbs"	1	111	12	123
"O48"	"M25"	"Late pregnancy"	"Other joint disorder, not elsewhere classified"	1	404	0	404
"O48"	"M35"	"Late pregnancy"	"Other systemic involvement of connective tissue"	1	131	28	159
"O48"	"M46"	"Late pregnancy"	"Other inflammatory spondylopathies"	1	69	0	69
"O48"	"M47"	"Late pregnancy"	"Spondylosis"	1	77	0	77
"O48"	"M53"	"Late pregnancy"	"Other and unspecified dorsopathies, not elsewhere classified"	1	198	0	198
"O48"	"M65"	"Late pregnancy"	"Synovitis and tenosynovitis"	1	397	77	474
"O48"	"M70"	"Late pregnancy"	"Soft tissue disorders related to use, overuse and pressure"	1	189	3	192
"O48"	"M72"	"Late pregnancy"	"Fibroblastic disorders"	1	67	0	67
"O48"	"M75"	"Late pregnancy"	"Shoulder lesions"	1	503	0	503
"O48"	"M76"	"Late pregnancy"	"Enthesopathies, lower limb, excluding foot"	1	158	27	185
"O48"	"M77"	"Late pregnancy"	"Other enthesopathies"	1	261	0	261
"O48"	"M85"	"Late pregnancy"	"Other disorders of bone density and structure"	1	57	0	57
"O48"	"M99"	"Late pregnancy"	"Biomechanical lesions, not elsewhere classified"	1	63	0	63
"O48"	"N20"	"Late pregnancy"	"Calculus of kidney and ureter"	1	318	13	331
"O48"	"N60"	"Late pregnancy"	"Benign mammary dysplasia"	1	372	7	379
"O48"	"N71"	"Late pregnancy"	"Inflammatory disease of uterus, except cervix"	1	398	155	553
"O48"	"N76"	"Late pregnancy"	"Other inflammation of vagina and vulva"	1	208	102	310
"O48"	"N82"	"Late pregnancy"	"Fistulae involving female genital tract"	1	30	1	31
"O48"	"N87"	"Late pregnancy"	"Dysplasia of cervix uteri"	1	672	215	887
"O48"	"N89"	"Late pregnancy"	"Other noninflammatory disorders of vagina"	1	94	27	121
"O48"	"N92"	"Late pregnancy"	"Excessive, frequent and irregular menstruation"	1	1478	0	1478
"O48"	"N94"	"Late pregnancy"	"Pain and oth cond assoc w fem gntl org and menstrual cycle"	1	666	135	801
"O48"	"O24"	"Late pregnancy"	"Diabetes in pregnancy, childbirth, and the puerperium"	1	550	192	742
"O48"	"O30"	"Late pregnancy"	"Multiple gestation"	1	592	197	789
"O48"	"O34"	"Late pregnancy"	"Maternal care for abnormality of pelvic organs"	1	2920	966	3886
"O48"	"O61"	"Late pregnancy"	"Failed induction of labor"	1	662	478	1140
"O48"	"O85"	"Late pregnancy"	"Puerperal sepsis"	1	574	261	835
"O48"	"O86"	"Late pregnancy"	"Other puerperal infections"	1	933	571	1504
"O48"	"O90"	"Late pregnancy"	"Complications of the puerperium, not elsewhere classified"	1	1673	483	2156
"O48"	"O91"	"Late pregnancy"	"Infect of breast assoc w pregnancy, the puerp and lactation"	1	966	218	1184
"O48"	"O92"	"Late pregnancy"	"Oth disord of brst/lactatn assoc w pregnancy and the puerp"	1	988	413	1401
"O48"	"Q61"	"Late pregnancy"	"Cystic kidney disease"	1	28	0	28
"O60"	"C50"	"Preterm labor"	"Malignant neoplasm of breast"	1	37	0	37
"O60"	"D24"	"Preterm labor"	"Benign neoplasm of breast"	1	71	11	82
"O60"	"D64"	"Preterm labor"	"Other anemias"	1	54	0	54
"O60"	"E11"	"Preterm labor"	"Type 2 diabetes mellitus"	1	59	0	59
"O60"	"E78"	"Preterm labor"	"Disorders of lipoprotein metabolism and other lipidemias"	1	34	0	34
"O60"	"F17"	"Preterm labor"	"Nicotine dependence"	1	85	2	87
"O60"	"G43"	"Preterm labor"	"Migraine"	1	114	11	125
"O60"	"G44"	"Preterm labor"	"Other headache syndromes"	1	89	5	94
"O60"	"I47"	"Preterm labor"	"Paroxysmal tachycardia"	1	43	7	50
"O60"	"J15"	"Preterm labor"	"Bacterial pneumonia, not elsewhere classified"	1	47	1	48
"O60"	"J18"	"Preterm labor"	"Pneumonia, unspecified organism"	1	152	17	169
"O60"	"K21"	"Preterm labor"	"Gastro-esophageal reflux disease"	1	85	1	86
"O60"	"K52"	"Preterm labor"	"Other and unsp noninfective gastroenteritis and colitis"	1	61	16	77
"O60"	"K62"	"Preterm labor"	"Other diseases of anus and rectum"	1	70	1	71
"O60"	"L02"	"Preterm labor"	"Cutaneous abscess, furuncle and carbuncle"	1	105	32	137
"O60"	"M62"	"Preterm labor"	"Other disorders of muscle"	1	194	92	286
"O60"	"N20"	"Preterm labor"	"Calculus of kidney and ureter"	1	82	21	103
"O60"	"N92"	"Preterm labor"	"Excessive, frequent and irregular menstruation"	1	490	0	490
"O60"	"O90"	"Preterm labor"	"Complications of the puerperium, not elsewhere classified"	1	309	186	495
"O60"	"O91"	"Preterm labor"	"Infect of breast assoc w pregnancy, the puerp and lactation"	1	287	114	401
"O62"	"B18"	"Abnormalities of forces of labor"	"Chronic viral hepatitis"	1	285	48	333
"O62"	"B25"	"Abnormalities of forces of labor"	"Cytomegaloviral disease"	1	62	11	73
"O62"	"B36"	"Abnormalities of forces of labor"	"Other superficial mycoses"	1	127	39	166
"O62"	"B96"	"Abnormalities of forces of labor"	"Oth bacterial agents as the cause of diseases classd elswhr"	1	39	1	40
"O62"	"C18"	"Abnormalities of forces of labor"	"Malignant neoplasm of colon"	1	57	0	57
"O62"	"C34"	"Abnormalities of forces of labor"	"Malignant neoplasm of bronchus and lung"	1	33	0	33
"O62"	"C53"	"Abnormalities of forces of labor"	"Malignant neoplasm of cervix uteri"	1	294	0	294
"O62"	"C56"	"Abnormalities of forces of labor"	"Malignant neoplasm of ovary"	1	69	0	69
"O62"	"C71"	"Abnormalities of forces of labor"	"Malignant neoplasm of brain"	1	58	0	58
"O62"	"C78"	"Abnormalities of forces of labor"	"Secondary malignant neoplasm of resp and digestive organs"	1	87	0	87
"O62"	"D11"	"Abnormalities of forces of labor"	"Benign neoplasm of major salivary glands"	1	164	2	166
"O62"	"D13"	"Abnormalities of forces of labor"	"Benign neoplasm of and ill-defined parts of digestive system"	1	120	0	120
"O62"	"D14"	"Abnormalities of forces of labor"	"Benign neoplasm of middle ear and respiratory system"	1	156	7	163
"O62"	"D23"	"Abnormalities of forces of labor"	"Other benign neoplasms of skin"	1	1131	158	1289
"O62"	"D25"	"Abnormalities of forces of labor"	"Leiomyoma of uterus"	1	1174	0	1174
"O62"	"D26"	"Abnormalities of forces of labor"	"Other benign neoplasms of uterus"	1	68	10	78
"O62"	"D32"	"Abnormalities of forces of labor"	"Benign neoplasm of meninges"	1	55	0	55
"O62"	"D35"	"Abnormalities of forces of labor"	"Benign neoplasm of other and unspecified endocrine glands"	1	121	0	121
"O62"	"D50"	"Abnormalities of forces of labor"	"Iron deficiency anemia"	1	742	0	742
"O62"	"D51"	"Abnormalities of forces of labor"	"Vitamin B12 deficiency anemia"	1	135	19	154
"O62"	"D63"	"Abnormalities of forces of labor"	"Anemia in chronic diseases classified elsewhere"	1	44	0	44
"O62"	"D68"	"Abnormalities of forces of labor"	"Other coagulation defects"	1	728	271	999
"O62"	"D75"	"Abnormalities of forces of labor"	"Other and unsp diseases of blood and blood-forming organs"	1	81	1	82
"O62"	"D83"	"Abnormalities of forces of labor"	"Common variable immunodeficiency"	1	28	1	29
"O62"	"D84"	"Abnormalities of forces of labor"	"Other immunodeficiencies"	1	47	0	47
"O62"	"E04"	"Abnormalities of forces of labor"	"Other nontoxic goiter"	1	2216	0	2216
"O62"	"E05"	"Abnormalities of forces of labor"	"Thyrotoxicosis [hyperthyroidism]"	1	2452	0	2452
"O62"	"E10"	"Abnormalities of forces of labor"	"Type 1 diabetes mellitus"	1	314	177	491
"O62"	"E20"	"Abnormalities of forces of labor"	"Hypoparathyroidism"	1	42	0	42
"O62"	"E21"	"Abnormalities of forces of labor"	"Hyperparathyroidism and other disorders of parathyroid gland"	1	140	0	140
"O62"	"E23"	"Abnormalities of forces of labor"	"Hypofunction and other disorders of the pituitary gland"	1	132	2	134
"O62"	"E24"	"Abnormalities of forces of labor"	"Cushing's syndrome"	1	29	1	30
"O62"	"E27"	"Abnormalities of forces of labor"	"Other disorders of adrenal gland"	1	87	0	87
"O62"	"E53"	"Abnormalities of forces of labor"	"Deficiency of other B group vitamins"	1	38	0	38
"O62"	"E64"	"Abnormalities of forces of labor"	"Sequelae of malnutrition and other nutritional deficiencies"	1	53	0	53
"O62"	"E68"	"Abnormalities of forces of labor"	"Sequelae of hyperalimentation"	1	592	0	592
"O62"	"E78"	"Abnormalities of forces of labor"	"Disorders of lipoprotein metabolism and other lipidemias"	1	394	0	394
"O62"	"F32"	"Abnormalities of forces of labor"	"Depressive episode"	1	977	160	1137
"O62"	"F33"	"Abnormalities of forces of labor"	"Major depressive disorder, recurrent"	1	889	129	1018
"O62"	"F34"	"Abnormalities of forces of labor"	"Persistent mood [affective] disorders"	1	69	5	74
"O62"	"F41"	"Abnormalities of forces of labor"	"Other anxiety disorders"	1	910	117	1027
"O62"	"F44"	"Abnormalities of forces of labor"	"Dissociative and conversion disorders"	1	104	18	122
"O62"	"F45"	"Abnormalities of forces of labor"	"Somatoform disorders"	1	141	52	193
"O62"	"G04"	"Abnormalities of forces of labor"	"Encephalitis, myelitis and encephalomyelitis"	1	59	7	66
"O62"	"G24"	"Abnormalities of forces of labor"	"Dystonia"	1	93	3	96
"O62"	"G25"	"Abnormalities of forces of labor"	"Other extrapyramidal and movement disorders"	1	47	0	47
"O62"	"G35"	"Abnormalities of forces of labor"	"Multiple sclerosis"	1	466	18	484
"O62"	"G43"	"Abnormalities of forces of labor"	"Migraine"	1	2597	0	2597
"O62"	"G45"	"Abnormalities of forces of labor"	"Transient cerebral ischemic attacks and related syndromes"	1	281	0	281
"O62"	"G54"	"Abnormalities of forces of labor"	"Nerve root and plexus disorders"	1	158	0	158
"O62"	"G56"	"Abnormalities of forces of labor"	"Mononeuropathies of upper limb"	1	3391	0	3391
"O62"	"G58"	"Abnormalities of forces of labor"	"Other mononeuropathies"	1	29	0	29
"O62"	"G64"	"Abnormalities of forces of labor"	"Other disorders of peripheral nervous system"	1	45	0	45
"O62"	"G72"	"Abnormalities of forces of labor"	"Other and unspecified myopathies"	1	29	0	29
"O62"	"G90"	"Abnormalities of forces of labor"	"Disorders of autonomic nervous system"	1	44	6	50
"O62"	"G93"	"Abnormalities of forces of labor"	"Other disorders of brain"	1	171	0	171
"O62"	"G95"	"Abnormalities of forces of labor"	"Other and unspecified diseases of spinal cord"	1	73	0	73
"O62"	"G96"	"Abnormalities of forces of labor"	"Other disorders of central nervous system"	1	547	0	547
"O62"	"G98"	"Abnormalities of forces of labor"	"Other disorders of nervous system not elsewhere classified"	1	229	0	229
"O62"	"H05"	"Abnormalities of forces of labor"	"Disorders of orbit"	1	118	7	125
"O62"	"H33"	"Abnormalities of forces of labor"	"Retinal detachments and breaks"	1	103	0	103
"O62"	"H34"	"Abnormalities of forces of labor"	"Retinal vascular occlusions"	1	35	0	35
"O62"	"H35"	"Abnormalities of forces of labor"	"Other retinal disorders"	1	255	0	255
"O62"	"H40"	"Abnormalities of forces of labor"	"Glaucoma"	1	86	0	86
"O62"	"H49"	"Abnormalities of forces of labor"	"Paralytic strabismus"	1	85	11	96
"O62"	"H52"	"Abnormalities of forces of labor"	"Disorders of refraction and accommodation"	1	1368	246	1614
"O62"	"H53"	"Abnormalities of forces of labor"	"Visual disturbances"	1	538	21	559
"O62"	"H54"	"Abnormalities of forces of labor"	"Blindness and low vision"	1	90	4	94
"O62"	"H57"	"Abnormalities of forces of labor"	"Other disorders of eye and adnexa"	1	539	0	539
"O62"	"H60"	"Abnormalities of forces of labor"	"Otitis externa"	1	427	137	564
"O62"	"H61"	"Abnormalities of forces of labor"	"Other disorders of external ear"	1	93	32	125
"O62"	"H80"	"Abnormalities of forces of labor"	"Otosclerosis"	1	269	33	302
"O62"	"H83"	"Abnormalities of forces of labor"	"Other diseases of inner ear"	1	62	11	73
"O62"	"H91"	"Abnormalities of forces of labor"	"Other and unspecified hearing loss"	1	770	0	770
"O62"	"H92"	"Abnormalities of forces of labor"	"Otalgia and effusion of ear"	1	130	11	141
"O62"	"H93"	"Abnormalities of forces of labor"	"Other disorders of ear, not elsewhere classified"	1	602	0	602
"O62"	"I15"	"Abnormalities of forces of labor"	"Secondary hypertension"	1	199	10	209
"O62"	"I30"	"Abnormalities of forces of labor"	"Acute pericarditis"	1	92	4	96
"O62"	"I46"	"Abnormalities of forces of labor"	"Cardiac arrest"	1	40	0	40
"O62"	"I47"	"Abnormalities of forces of labor"	"Paroxysmal tachycardia"	1	756	150	906
"O62"	"I48"	"Abnormalities of forces of labor"	"Atrial fibrillation and flutter"	1	232	0	232
"O62"	"I50"	"Abnormalities of forces of labor"	"Heart failure"	1	89	0	89
"O62"	"I60"	"Abnormalities of forces of labor"	"Nontraumatic subarachnoid hemorrhage"	1	160	0	160
"O62"	"I61"	"Abnormalities of forces of labor"	"Nontraumatic intracerebral hemorrhage"	1	81	0	81
"O62"	"I63"	"Abnormalities of forces of labor"	"Cerebral infarction"	1	203	0	203
"O62"	"I67"	"Abnormalities of forces of labor"	"Other cerebrovascular diseases"	1	89	0	89
"O62"	"I69"	"Abnormalities of forces of labor"	"Sequelae of cerebrovascular disease"	1	152	0	152
"O62"	"I70"	"Abnormalities of forces of labor"	"Atherosclerosis"	1	63	1	64
"O62"	"I72"	"Abnormalities of forces of labor"	"Other aneurysm"	1	42	0	42
"O62"	"I78"	"Abnormalities of forces of labor"	"Diseases of capillaries"	1	310	50	360
"O62"	"I83"	"Abnormalities of forces of labor"	"Varicose veins of lower extremities"	1	4166	0	4166
"O62"	"I87"	"Abnormalities of forces of labor"	"Other disorders of veins"	1	107	0	107
"O62"	"J06"	"Abnormalities of forces of labor"	"Acute upper resp infections of multiple and unsp sites"	1	703	0	703
"O62"	"J10"	"Abnormalities of forces of labor"	"Influenza due to other identified influenza virus"	1	92	0	92
"O62"	"J11"	"Abnormalities of forces of labor"	"Influenza due to unidentified influenza virus"	1	528	247	775
"O62"	"J13"	"Abnormalities of forces of labor"	"Pneumonia due to Streptococcus pneumoniae"	1	93	4	97
"O62"	"J20"	"Abnormalities of forces of labor"	"Acute bronchitis"	1	314	143	457
"O62"	"J31"	"Abnormalities of forces of labor"	"Chronic rhinitis, nasopharyngitis and pharyngitis"	1	164	34	198
"O62"	"J33"	"Abnormalities of forces of labor"	"Nasal polyp"	1	163	23	186
"O62"	"J34"	"Abnormalities of forces of labor"	"Other and unspecified disorders of nose and nasal sinuses"	1	623	294	917
"O62"	"J42"	"Abnormalities of forces of labor"	"Unspecified chronic bronchitis"	1	44	6	50
"O62"	"J44"	"Abnormalities of forces of labor"	"Other chronic obstructive pulmonary disease"	1	220	0	220
"O62"	"J90"	"Abnormalities of forces of labor"	"Pleural effusion, not elsewhere classified"	1	59	0	59
"O62"	"J93"	"Abnormalities of forces of labor"	"Pneumothorax and air leak"	1	130	39	169
"O62"	"J94"	"Abnormalities of forces of labor"	"Other pleural conditions"	1	33	0	33
"O62"	"K02"	"Abnormalities of forces of labor"	"Dental caries"	1	170	43	213
"O62"	"K05"	"Abnormalities of forces of labor"	"Gingivitis and periodontal diseases"	1	158	3	161
"O62"	"K08"	"Abnormalities of forces of labor"	"Other disorders of teeth and supporting structures"	1	226	68	294
"O62"	"K12"	"Abnormalities of forces of labor"	"Stomatitis and related lesions"	1	241	63	304
"O62"	"K21"	"Abnormalities of forces of labor"	"Gastro-esophageal reflux disease"	1	1275	0	1275
"O62"	"K25"	"Abnormalities of forces of labor"	"Gastric ulcer"	1	316	0	316
"O62"	"K27"	"Abnormalities of forces of labor"	"Peptic ulcer, site unspecified"	1	63	14	77
"O62"	"K31"	"Abnormalities of forces of labor"	"Other diseases of stomach and duodenum"	1	50	0	50
"O62"	"K40"	"Abnormalities of forces of labor"	"Inguinal hernia"	1	476	129	605
"O62"	"K43"	"Abnormalities of forces of labor"	"Ventral hernia"	1	829	0	829
"O62"	"K44"	"Abnormalities of forces of labor"	"Diaphragmatic hernia"	1	833	0	833
"O62"	"K45"	"Abnormalities of forces of labor"	"Other abdominal hernia"	1	446	0	446
"O62"	"K50"	"Abnormalities of forces of labor"	"Crohn's disease [regional enteritis]"	1	314	196	510
"O62"	"K52"	"Abnormalities of forces of labor"	"Other and unsp noninfective gastroenteritis and colitis"	1	885	267	1152
"O62"	"K56"	"Abnormalities of forces of labor"	"Paralytic ileus and intestinal obstruction without hernia"	1	498	30	528
"O62"	"K58"	"Abnormalities of forces of labor"	"Irritable bowel syndrome"	1	1044	491	1535
"O62"	"K59"	"Abnormalities of forces of labor"	"Other functional intestinal disorders"	1	2693	0	2693
"O62"	"K61"	"Abnormalities of forces of labor"	"Abscess of anal and rectal regions"	1	494	151	645
"O62"	"K62"	"Abnormalities of forces of labor"	"Other diseases of anus and rectum"	1	1228	0	1228
"O62"	"K70"	"Abnormalities of forces of labor"	"Alcoholic liver disease"	1	29	0	29
"O62"	"K71"	"Abnormalities of forces of labor"	"Toxic liver disease"	1	57	12	69
"O62"	"K75"	"Abnormalities of forces of labor"	"Other inflammatory liver diseases"	1	47	1	48
"O62"	"K76"	"Abnormalities of forces of labor"	"Other diseases of liver"	1	341	0	341
"O62"	"K80"	"Abnormalities of forces of labor"	"Cholelithiasis"	1	9489	0	9489
"O62"	"K82"	"Abnormalities of forces of labor"	"Other diseases of gallbladder"	1	60	0	60
"O62"	"K83"	"Abnormalities of forces of labor"	"Other diseases of biliary tract"	1	309	0	309
"O62"	"K85"	"Abnormalities of forces of labor"	"Acute pancreatitis"	1	754	41	795
"O62"	"K86"	"Abnormalities of forces of labor"	"Other diseases of pancreas"	1	92	0	92
"O62"	"K91"	"Abnormalities of forces of labor"	"Intraop and postproc comp and disorders of dgstv sys, NEC"	1	154	0	154
"O62"	"K92"	"Abnormalities of forces of labor"	"Other diseases of digestive system"	1	282	82	364
"O62"	"L23"	"Abnormalities of forces of labor"	"Allergic contact dermatitis"	1	389	136	525
"O62"	"L28"	"Abnormalities of forces of labor"	"Lichen simplex chronicus and prurigo"	1	116	1	117
"O62"	"L29"	"Abnormalities of forces of labor"	"Pruritus"	1	236	19	255
"O62"	"L30"	"Abnormalities of forces of labor"	"Other and unspecified dermatitis"	1	777	100	877
"O62"	"L73"	"Abnormalities of forces of labor"	"Other follicular disorders"	1	376	137	513
"O62"	"L95"	"Abnormalities of forces of labor"	"Vasculitis limited to skin, not elsewhere classified"	1	35	2	37
"O62"	"L97"	"Abnormalities of forces of labor"	"Non-pressure chronic ulcer of lower limb, NEC"	1	28	0	28
"O62"	"M05"	"Abnormalities of forces of labor"	"Rheumatoid arthritis with rheumatoid factor"	1	350	0	350
"O62"	"M06"	"Abnormalities of forces of labor"	"Other rheumatoid arthritis"	1	455	24	479
"O62"	"M07"	"Abnormalities of forces of labor"	"Enteropathic arthropathies"	1	312	0	312
"O62"	"M17"	"Abnormalities of forces of labor"	"Osteoarthritis of knee"	1	730	0	730
"O62"	"M18"	"Abnormalities of forces of labor"	"Osteoarthritis of first carpometacarpal joint"	1	59	0	59
"O62"	"M19"	"Abnormalities of forces of labor"	"Other and unspecified osteoarthritis"	1	474	0	474
"O62"	"M20"	"Abnormalities of forces of labor"	"Acquired deformities of fingers and toes"	1	1184	138	1322
"O62"	"M24"	"Abnormalities of forces of labor"	"Other specific joint derangements"	1	443	246	689
"O62"	"M31"	"Abnormalities of forces of labor"	"Other necrotizing vasculopathies"	1	66	0	66
"O62"	"M43"	"Abnormalities of forces of labor"	"Other deforming dorsopathies"	1	278	26	304
"O62"	"M45"	"Abnormalities of forces of labor"	"Ankylosing spondylitis"	1	153	8	161
"O62"	"M46"	"Abnormalities of forces of labor"	"Other inflammatory spondylopathies"	1	312	0	312
"O62"	"M48"	"Abnormalities of forces of labor"	"Other spondylopathies"	1	161	0	161
"O62"	"M50"	"Abnormalities of forces of labor"	"Cervical disc disorders"	1	672	0	672
"O62"	"M53"	"Abnormalities of forces of labor"	"Other and unspecified dorsopathies, not elsewhere classified"	1	974	18	992
"O62"	"M60"	"Abnormalities of forces of labor"	"Myositis"	1	70	7	77
"O62"	"M62"	"Abnormalities of forces of labor"	"Other disorders of muscle"	1	4070	1849	5919
"O62"	"M65"	"Abnormalities of forces of labor"	"Synovitis and tenosynovitis"	1	1852	696	2548
"O62"	"M66"	"Abnormalities of forces of labor"	"Spontaneous rupture of synovium and tendon"	1	73	0	73
"O62"	"M70"	"Abnormalities of forces of labor"	"Soft tissue disorders related to use, overuse and pressure"	1	801	38	839
"O62"	"M71"	"Abnormalities of forces of labor"	"Other bursopathies"	1	218	29	247
"O62"	"M72"	"Abnormalities of forces of labor"	"Fibroblastic disorders"	1	348	0	348
"O62"	"M76"	"Abnormalities of forces of labor"	"Enthesopathies, lower limb, excluding foot"	1	728	160	888
"O62"	"M77"	"Abnormalities of forces of labor"	"Other enthesopathies"	1	1264	0	1264
"O62"	"M84"	"Abnormalities of forces of labor"	"Disorder of continuity of bone"	1	69	9	78
"O62"	"M87"	"Abnormalities of forces of labor"	"Osteonecrosis"	1	33	0	33
"O62"	"M89"	"Abnormalities of forces of labor"	"Other disorders of bone"	1	118	37	155
"O62"	"M94"	"Abnormalities of forces of labor"	"Other disorders of cartilage"	1	101	31	132
"O62"	"M95"	"Abnormalities of forces of labor"	"Oth acquired deformities of ms sys and connective tissue"	1	245	120	365
"O62"	"M99"	"Abnormalities of forces of labor"	"Biomechanical lesions, not elsewhere classified"	1	294	0	294
"O62"	"N12"	"Abnormalities of forces of labor"	"Tubulo-interstitial nephritis, not spcf as acute or chronic"	1	244	63	307
"O62"	"N17"	"Abnormalities of forces of labor"	"Acute kidney failure"	1	54	0	54
"O62"	"N18"	"Abnormalities of forces of labor"	"Chronic kidney disease (CKD)"	1	98	0	98
"O62"	"N19"	"Abnormalities of forces of labor"	"Unspecified kidney failure"	1	47	0	47
"O62"	"N20"	"Abnormalities of forces of labor"	"Calculus of kidney and ureter"	1	1718	200	1918
"O62"	"N28"	"Abnormalities of forces of labor"	"Oth disorders of kidney and ureter, not elsewhere classified"	1	126	29	155
"O62"	"N32"	"Abnormalities of forces of labor"	"Other disorders of bladder"	1	113	0	113
"O62"	"N35"	"Abnormalities of forces of labor"	"Urethral stricture"	1	33	1	34
"O62"	"N36"	"Abnormalities of forces of labor"	"Other disorders of urethra"	1	141	27	168
"O62"	"N39"	"Abnormalities of forces of labor"	"Other disorders of urinary system"	1	3377	0	3377
"O62"	"N61"	"Abnormalities of forces of labor"	"Inflammatory disorders of breast"	1	854	10	864
"O62"	"N63"	"Abnormalities of forces of labor"	"Unspecified lump in breast"	1	3053	0	3053
"O62"	"N64"	"Abnormalities of forces of labor"	"Other disorders of breast"	1	3423	0	3423
"O62"	"N71"	"Abnormalities of forces of labor"	"Inflammatory disease of uterus, except cervix"	1	2374	878	3252
"O62"	"N72"	"Abnormalities of forces of labor"	"Inflammatory disease of cervix uteri"	1	214	115	329
"O62"	"N75"	"Abnormalities of forces of labor"	"Diseases of Bartholin's gland"	1	703	260	963
"O62"	"N80"	"Abnormalities of forces of labor"	"Endometriosis"	1	903	527	1430
"O62"	"N84"	"Abnormalities of forces of labor"	"Polyp of female genital tract"	1	1445	0	1445
"O62"	"N87"	"Abnormalities of forces of labor"	"Dysplasia of cervix uteri"	1	3180	1569	4749
"O62"	"N88"	"Abnormalities of forces of labor"	"Other noninflammatory disorders of cervix uteri"	1	230	31	261
"O62"	"N89"	"Abnormalities of forces of labor"	"Other noninflammatory disorders of vagina"	1	588	194	782
"O62"	"N93"	"Abnormalities of forces of labor"	"Other abnormal uterine and vaginal bleeding"	1	2846	0	2846
"O62"	"O08"	"Abnormalities of forces of labor"	"Complications following ectopic and molar pregnancy"	1	2931	1430	4361
"O62"	"O33"	"Abnormalities of forces of labor"	"Maternal care for disproportion"	1	907	415	1322
"O62"	"O34"	"Abnormalities of forces of labor"	"Maternal care for abnormality of pelvic organs"	1	14796	0	14796
"O62"	"O44"	"Abnormalities of forces of labor"	"Placenta previa"	1	1050	548	1598
"O62"	"O85"	"Abnormalities of forces of labor"	"Puerperal sepsis"	1	2872	1835	4707
"O62"	"O90"	"Abnormalities of forces of labor"	"Complications of the puerperium, not elsewhere classified"	1	12264	0	12264
"O62"	"Q61"	"Abnormalities of forces of labor"	"Cystic kidney disease"	1	120	6	126
"O62"	"Q65"	"Abnormalities of forces of labor"	"Congenital deformities of hip"	1	251	12	263
"O62"	"Q83"	"Abnormalities of forces of labor"	"Congenital malformations of breast"	1	330	149	479
"O63"	"A46"	"Long labor"	"Erysipelas"	1	54	1	55
"O63"	"A49"	"Long labor"	"Bacterial infection of unspecified site"	1	71	17	88
"O63"	"B34"	"Long labor"	"Viral infection of unspecified site"	1	178	89	267
"O63"	"D12"	"Long labor"	"Benign neoplasm of colon, rectum, anus and anal canal"	1	63	0	63
"O63"	"D24"	"Long labor"	"Benign neoplasm of breast"	1	235	117	352
"O63"	"D25"	"Long labor"	"Leiomyoma of uterus"	1	173	0	173
"O63"	"D62"	"Long labor"	"Acute posthemorrhagic anemia"	1	51	11	62
"O63"	"E04"	"Long labor"	"Other nontoxic goiter"	1	299	7	306
"O63"	"E11"	"Long labor"	"Type 2 diabetes mellitus"	1	96	0	96
"O63"	"E55"	"Long labor"	"Vitamin D deficiency"	1	73	5	78
"O63"	"E66"	"Long labor"	"Overweight and obesity"	1	2016	1617	3633
"O63"	"E68"	"Long labor"	"Sequelae of hyperalimentation"	1	78	0	78
"O63"	"F17"	"Long labor"	"Nicotine dependence"	1	157	16	173
"O63"	"F32"	"Long labor"	"Depressive episode"	1	119	47	166
"O63"	"F41"	"Long labor"	"Other anxiety disorders"	1	134	36	170
"O63"	"F43"	"Long labor"	"Reaction to severe stress, and adjustment disorders"	1	193	2	195
"O63"	"G43"	"Long labor"	"Migraine"	1	328	88	416
"O63"	"G45"	"Long labor"	"Transient cerebral ischemic attacks and related syndromes"	1	38	0	38
"O63"	"G47"	"Long labor"	"Sleep disorders"	1	79	0	79
"O63"	"G56"	"Long labor"	"Mononeuropathies of upper limb"	1	501	46	547
"O63"	"G96"	"Long labor"	"Other disorders of central nervous system"	1	92	0	92
"O63"	"G97"	"Long labor"	"Intraop and postproc comp and disorders of nervous sys, NEC"	1	35	4	39
"O63"	"H53"	"Long labor"	"Visual disturbances"	1	67	19	86
"O63"	"I49"	"Long labor"	"Other cardiac arrhythmias"	1	122	8	130
"O63"	"I80"	"Long labor"	"Phlebitis and thrombophlebitis"	1	114	35	149
"O63"	"J06"	"Long labor"	"Acute upper resp infections of multiple and unsp sites"	1	121	5	126
"O63"	"K21"	"Long labor"	"Gastro-esophageal reflux disease"	1	161	36	197
"O63"	"K76"	"Long labor"	"Other diseases of liver"	1	42	2	44
"O63"	"K83"	"Long labor"	"Other diseases of biliary tract"	1	37	0	37
"O63"	"K85"	"Long labor"	"Acute pancreatitis"	1	133	13	146
"O63"	"L30"	"Long labor"	"Other and unspecified dermatitis"	1	108	36	144
"O63"	"L40"	"Long labor"	"Psoriasis"	1	59	15	74
"O63"	"L90"	"Long labor"	"Atrophic disorders of skin"	1	183	60	243
"O63"	"M07"	"Long labor"	"Enteropathic arthropathies"	1	49	0	49
"O63"	"M13"	"Long labor"	"Other arthritis"	1	83	17	100
"O63"	"M17"	"Long labor"	"Osteoarthritis of knee"	1	92	0	92
"O63"	"M20"	"Long labor"	"Acquired deformities of fingers and toes"	1	140	58	198
"O63"	"M47"	"Long labor"	"Spondylosis"	1	50	0	50
"O63"	"M51"	"Long labor"	"Thoracic, thoracolum, and lumbosacral intvrt disc disorders"	1	449	12	461
"O63"	"M75"	"Long labor"	"Shoulder lesions"	1	406	0	406
"O63"	"M79"	"Long labor"	"Oth and unsp soft tissue disorders, not elsewhere classified"	1	451	263	714
"O63"	"M85"	"Long labor"	"Other disorders of bone density and structure"	1	48	0	48
"O63"	"N39"	"Long labor"	"Other disorders of urinary system"	1	558	29	587
"O63"	"N61"	"Long labor"	"Inflammatory disorders of breast"	1	119	11	130
"O63"	"N64"	"Long labor"	"Other disorders of breast"	1	453	117	570
"O63"	"N71"	"Long labor"	"Inflammatory disease of uterus, except cervix"	1	340	145	485
"O63"	"N83"	"Long labor"	"Noninflammatory disord of ovary, fallop and broad ligament"	1	410	231	641
"O63"	"N84"	"Long labor"	"Polyp of female genital tract"	1	252	1	253
"O63"	"N92"	"Long labor"	"Excessive, frequent and irregular menstruation"	1	1022	0	1022
"O63"	"N94"	"Long labor"	"Pain and oth cond assoc w fem gntl org and menstrual cycle"	1	593	266	859
"O63"	"O85"	"Long labor"	"Puerperal sepsis"	1	482	255	737
"O63"	"O90"	"Long labor"	"Complications of the puerperium, not elsewhere classified"	1	1423	656	2079
"O63"	"O91"	"Long labor"	"Infect of breast assoc w pregnancy, the puerp and lactation"	1	1105	193	1298
"O63"	"O92"	"Long labor"	"Oth disord of brst/lactatn assoc w pregnancy and the puerp"	1	943	570	1513
"O64"	"A46"	"Obstructed labor due to malposition and malpresent of fetus"	"Erysipelas"	1	73	0	73
"O64"	"A49"	"Obstructed labor due to malposition and malpresent of fetus"	"Bacterial infection of unspecified site"	1	103	12	115
"O64"	"B34"	"Obstructed labor due to malposition and malpresent of fetus"	"Viral infection of unspecified site"	1	169	49	218
"O64"	"C50"	"Obstructed labor due to malposition and malpresent of fetus"	"Malignant neoplasm of breast"	1	121	0	121
"O64"	"D12"	"Obstructed labor due to malposition and malpresent of fetus"	"Benign neoplasm of colon, rectum, anus and anal canal"	1	69	0	69
"O64"	"D27"	"Obstructed labor due to malposition and malpresent of fetus"	"Benign neoplasm of ovary"	1	210	96	306
"O64"	"D62"	"Obstructed labor due to malposition and malpresent of fetus"	"Acute posthemorrhagic anemia"	1	65	6	71
"O64"	"D86"	"Obstructed labor due to malposition and malpresent of fetus"	"Sarcoidosis"	1	46	8	54
"O64"	"E11"	"Obstructed labor due to malposition and malpresent of fetus"	"Type 2 diabetes mellitus"	1	117	0	117
"O64"	"E86"	"Obstructed labor due to malposition and malpresent of fetus"	"Volume depletion"	1	82	11	93
"O64"	"E87"	"Obstructed labor due to malposition and malpresent of fetus"	"Other disorders of fluid, electrolyte and acid-base balance"	1	30	0	30
"O64"	"E89"	"Obstructed labor due to malposition and malpresent of fetus"	"Postproc endocrine and metabolic comp and disorders, NEC"	1	51	1	52
"O64"	"F32"	"Obstructed labor due to malposition and malpresent of fetus"	"Depressive episode"	1	164	35	199
"O64"	"F33"	"Obstructed labor due to malposition and malpresent of fetus"	"Major depressive disorder, recurrent"	1	129	27	156
"O64"	"F43"	"Obstructed labor due to malposition and malpresent of fetus"	"Reaction to severe stress, and adjustment disorders"	1	233	0	233
"O64"	"G43"	"Obstructed labor due to malposition and malpresent of fetus"	"Migraine"	1	342	64	406
"O64"	"G45"	"Obstructed labor due to malposition and malpresent of fetus"	"Transient cerebral ischemic attacks and related syndromes"	1	40	0	40
"O64"	"G97"	"Obstructed labor due to malposition and malpresent of fetus"	"Intraop and postproc comp and disorders of nervous sys, NEC"	1	37	2	39
"O64"	"G98"	"Obstructed labor due to malposition and malpresent of fetus"	"Other disorders of nervous system not elsewhere classified"	1	53	0	53
"O64"	"H02"	"Obstructed labor due to malposition and malpresent of fetus"	"Other disorders of eyelid"	1	89	0	89
"O64"	"H81"	"Obstructed labor due to malposition and malpresent of fetus"	"Disorders of vestibular function"	1	154	4	158
"O64"	"H90"	"Obstructed labor due to malposition and malpresent of fetus"	"Conductive and sensorineural hearing loss"	1	116	15	131
"O64"	"I26"	"Obstructed labor due to malposition and malpresent of fetus"	"Pulmonary embolism"	1	65	3	68
"O64"	"I47"	"Obstructed labor due to malposition and malpresent of fetus"	"Paroxysmal tachycardia"	1	135	23	158
"O64"	"I48"	"Obstructed labor due to malposition and malpresent of fetus"	"Atrial fibrillation and flutter"	1	39	0	39
"O64"	"I49"	"Obstructed labor due to malposition and malpresent of fetus"	"Other cardiac arrhythmias"	1	127	2	129
"O64"	"I60"	"Obstructed labor due to malposition and malpresent of fetus"	"Nontraumatic subarachnoid hemorrhage"	1	26	0	26
"O64"	"I63"	"Obstructed labor due to malposition and malpresent of fetus"	"Cerebral infarction"	1	37	0	37
"O64"	"I82"	"Obstructed labor due to malposition and malpresent of fetus"	"Other venous embolism and thrombosis"	1	27	1	28
"O64"	"J01"	"Obstructed labor due to malposition and malpresent of fetus"	"Acute sinusitis"	1	192	25	217
"O64"	"J03"	"Obstructed labor due to malposition and malpresent of fetus"	"Acute tonsillitis"	1	350	227	577
"O64"	"J18"	"Obstructed labor due to malposition and malpresent of fetus"	"Pneumonia, unspecified organism"	1	483	42	525
"O64"	"K21"	"Obstructed labor due to malposition and malpresent of fetus"	"Gastro-esophageal reflux disease"	1	232	6	238
"O64"	"K22"	"Obstructed labor due to malposition and malpresent of fetus"	"Other diseases of esophagus"	1	29	0	29
"O64"	"K25"	"Obstructed labor due to malposition and malpresent of fetus"	"Gastric ulcer"	1	50	5	55
"O64"	"K43"	"Obstructed labor due to malposition and malpresent of fetus"	"Ventral hernia"	1	246	0	246
"O64"	"K45"	"Obstructed labor due to malposition and malpresent of fetus"	"Other abdominal hernia"	1	71	0	71
"O64"	"K52"	"Obstructed labor due to malposition and malpresent of fetus"	"Other and unsp noninfective gastroenteritis and colitis"	1	136	59	195
"O64"	"K56"	"Obstructed labor due to malposition and malpresent of fetus"	"Paralytic ileus and intestinal obstruction without hernia"	1	141	33	174
"O64"	"K59"	"Obstructed labor due to malposition and malpresent of fetus"	"Other functional intestinal disorders"	1	419	70	489
"O64"	"K60"	"Obstructed labor due to malposition and malpresent of fetus"	"Fissure and fistula of anal and rectal regions"	1	236	40	276
"O64"	"K62"	"Obstructed labor due to malposition and malpresent of fetus"	"Other diseases of anus and rectum"	1	228	0	228
"O64"	"K65"	"Obstructed labor due to malposition and malpresent of fetus"	"Peritonitis"	1	60	7	67
"O64"	"K66"	"Obstructed labor due to malposition and malpresent of fetus"	"Other disorders of peritoneum"	1	56	6	62
"O64"	"K80"	"Obstructed labor due to malposition and malpresent of fetus"	"Cholelithiasis"	1	1458	107	1565
"O64"	"K83"	"Obstructed labor due to malposition and malpresent of fetus"	"Other diseases of biliary tract"	1	51	3	54
"O64"	"K85"	"Obstructed labor due to malposition and malpresent of fetus"	"Acute pancreatitis"	1	112	10	122
"O64"	"L02"	"Obstructed labor due to malposition and malpresent of fetus"	"Cutaneous abscess, furuncle and carbuncle"	1	293	124	417
"O64"	"L08"	"Obstructed labor due to malposition and malpresent of fetus"	"Other local infections of skin and subcutaneous tissue"	1	146	25	171
"O64"	"L30"	"Obstructed labor due to malposition and malpresent of fetus"	"Other and unspecified dermatitis"	1	110	25	135
"O64"	"L40"	"Obstructed labor due to malposition and malpresent of fetus"	"Psoriasis"	1	79	14	93
"O64"	"L50"	"Obstructed labor due to malposition and malpresent of fetus"	"Urticaria"	1	149	70	219
"O64"	"L98"	"Obstructed labor due to malposition and malpresent of fetus"	"Oth disorders of skin, subcu, not elsewhere classified"	1	109	7	116
"O64"	"M13"	"Obstructed labor due to malposition and malpresent of fetus"	"Other arthritis"	1	99	3	102
"O64"	"M20"	"Obstructed labor due to malposition and malpresent of fetus"	"Acquired deformities of fingers and toes"	1	206	30	236
"O64"	"M23"	"Obstructed labor due to malposition and malpresent of fetus"	"Internal derangement of knee"	1	548	204	752
"O64"	"M25"	"Obstructed labor due to malposition and malpresent of fetus"	"Other joint disorder, not elsewhere classified"	1	396	6	402
"O64"	"M35"	"Obstructed labor due to malposition and malpresent of fetus"	"Other systemic involvement of connective tissue"	1	111	38	149
"O64"	"M47"	"Obstructed labor due to malposition and malpresent of fetus"	"Spondylosis"	1	82	0	82
"O64"	"M48"	"Obstructed labor due to malposition and malpresent of fetus"	"Other spondylopathies"	1	25	0	25
"O64"	"M50"	"Obstructed labor due to malposition and malpresent of fetus"	"Cervical disc disorders"	1	139	0	139
"O64"	"M51"	"Obstructed labor due to malposition and malpresent of fetus"	"Thoracic, thoracolum, and lumbosacral intvrt disc disorders"	1	612	0	612
"O64"	"M65"	"Obstructed labor due to malposition and malpresent of fetus"	"Synovitis and tenosynovitis"	1	334	125	459
"O64"	"M75"	"Obstructed labor due to malposition and malpresent of fetus"	"Shoulder lesions"	1	466	0	466
"O64"	"M77"	"Obstructed labor due to malposition and malpresent of fetus"	"Other enthesopathies"	1	224	0	224
"O64"	"M79"	"Obstructed labor due to malposition and malpresent of fetus"	"Oth and unsp soft tissue disorders, not elsewhere classified"	1	713	156	869
"O64"	"M81"	"Obstructed labor due to malposition and malpresent of fetus"	"Osteoporosis without current pathological fracture"	1	37	0	37
"O64"	"M85"	"Obstructed labor due to malposition and malpresent of fetus"	"Other disorders of bone density and structure"	1	52	0	52
"O64"	"N13"	"Obstructed labor due to malposition and malpresent of fetus"	"Obstructive and reflux uropathy"	1	101	39	140
"O64"	"N30"	"Obstructed labor due to malposition and malpresent of fetus"	"Cystitis"	1	444	303	747
"O64"	"N39"	"Obstructed labor due to malposition and malpresent of fetus"	"Other disorders of urinary system"	1	525	0	525
"O64"	"N60"	"Obstructed labor due to malposition and malpresent of fetus"	"Benign mammary dysplasia"	1	296	16	312
"O64"	"N83"	"Obstructed labor due to malposition and malpresent of fetus"	"Noninflammatory disord of ovary, fallop and broad ligament"	1	556	211	767
"O64"	"N94"	"Obstructed labor due to malposition and malpresent of fetus"	"Pain and oth cond assoc w fem gntl org and menstrual cycle"	1	603	171	774
"O64"	"N99"	"Obstructed labor due to malposition and malpresent of fetus"	"Intraop and postproc comp and disorders of GU sys, NEC"	1	103	17	120
"O65"	"A04"	"Obstructed labor due to maternal pelvic abnormality"	"Other bacterial intestinal infections"	1	30	3	33
"O65"	"A09"	"Obstructed labor due to maternal pelvic abnormality"	"Infectious gastroenteritis and colitis, unspecified"	1	299	116	415
"O65"	"A46"	"Obstructed labor due to maternal pelvic abnormality"	"Erysipelas"	1	57	0	57
"O65"	"A49"	"Obstructed labor due to maternal pelvic abnormality"	"Bacterial infection of unspecified site"	1	86	0	86
"O65"	"C50"	"Obstructed labor due to maternal pelvic abnormality"	"Malignant neoplasm of breast"	1	107	0	107
"O65"	"D06"	"Obstructed labor due to maternal pelvic abnormality"	"Carcinoma in situ of cervix uteri"	1	143	49	192
"O65"	"D12"	"Obstructed labor due to maternal pelvic abnormality"	"Benign neoplasm of colon, rectum, anus and anal canal"	1	57	0	57
"O65"	"D17"	"Obstructed labor due to maternal pelvic abnormality"	"Benign lipomatous neoplasm"	1	154	0	154
"O65"	"D24"	"Obstructed labor due to maternal pelvic abnormality"	"Benign neoplasm of breast"	1	391	1	392
"O65"	"D27"	"Obstructed labor due to maternal pelvic abnormality"	"Benign neoplasm of ovary"	1	299	44	343
"O65"	"D50"	"Obstructed labor due to maternal pelvic abnormality"	"Iron deficiency anemia"	1	83	0	83
"O65"	"D64"	"Obstructed labor due to maternal pelvic abnormality"	"Other anemias"	1	137	0	137
"O65"	"D68"	"Obstructed labor due to maternal pelvic abnormality"	"Other coagulation defects"	1	92	4	96
"O65"	"E10"	"Obstructed labor due to maternal pelvic abnormality"	"Type 1 diabetes mellitus"	1	78	15	93
"O65"	"E68"	"Obstructed labor due to maternal pelvic abnormality"	"Sequelae of hyperalimentation"	1	87	0	87
"O65"	"F17"	"Obstructed labor due to maternal pelvic abnormality"	"Nicotine dependence"	1	96	0	96
"O65"	"F33"	"Obstructed labor due to maternal pelvic abnormality"	"Major depressive disorder, recurrent"	1	87	0	87
"O65"	"F41"	"Obstructed labor due to maternal pelvic abnormality"	"Other anxiety disorders"	1	107	0	107
"O65"	"F43"	"Obstructed labor due to maternal pelvic abnormality"	"Reaction to severe stress, and adjustment disorders"	1	122	0	122
"O65"	"F45"	"Obstructed labor due to maternal pelvic abnormality"	"Somatoform disorders"	1	28	0	28
"O65"	"H36"	"Obstructed labor due to maternal pelvic abnormality"	"Retinal disorders in diseases classified elsewhere"	1	33	0	33
"O65"	"H53"	"Obstructed labor due to maternal pelvic abnormality"	"Visual disturbances"	1	71	0	71
"O65"	"H81"	"Obstructed labor due to maternal pelvic abnormality"	"Disorders of vestibular function"	1	146	0	146
"O65"	"I20"	"Obstructed labor due to maternal pelvic abnormality"	"Angina pectoris"	1	52	0	52
"O65"	"I47"	"Obstructed labor due to maternal pelvic abnormality"	"Paroxysmal tachycardia"	1	150	0	150
"O65"	"I48"	"Obstructed labor due to maternal pelvic abnormality"	"Atrial fibrillation and flutter"	1	43	0	43
"O65"	"I60"	"Obstructed labor due to maternal pelvic abnormality"	"Nontraumatic subarachnoid hemorrhage"	1	25	0	25
"O65"	"I73"	"Obstructed labor due to maternal pelvic abnormality"	"Other peripheral vascular diseases"	1	31	0	31
"O65"	"J06"	"Obstructed labor due to maternal pelvic abnormality"	"Acute upper resp infections of multiple and unsp sites"	1	40	0	40
"O65"	"J15"	"Obstructed labor due to maternal pelvic abnormality"	"Bacterial pneumonia, not elsewhere classified"	1	83	0	83
"O65"	"J18"	"Obstructed labor due to maternal pelvic abnormality"	"Pneumonia, unspecified organism"	1	467	0	467
"O65"	"J20"	"Obstructed labor due to maternal pelvic abnormality"	"Acute bronchitis"	1	58	2	60
"O65"	"J98"	"Obstructed labor due to maternal pelvic abnormality"	"Other respiratory disorders"	1	25	0	25
"O65"	"K11"	"Obstructed labor due to maternal pelvic abnormality"	"Diseases of salivary glands"	1	33	0	33
"O65"	"K12"	"Obstructed labor due to maternal pelvic abnormality"	"Stomatitis and related lesions"	1	30	0	30
"O65"	"K26"	"Obstructed labor due to maternal pelvic abnormality"	"Duodenal ulcer"	1	36	1	37
"O65"	"K29"	"Obstructed labor due to maternal pelvic abnormality"	"Gastritis and duodenitis"	1	222	17	239
"O65"	"K30"	"Obstructed labor due to maternal pelvic abnormality"	"Functional dyspepsia"	1	299	0	299
"O65"	"K43"	"Obstructed labor due to maternal pelvic abnormality"	"Ventral hernia"	1	158	0	158
"O65"	"K51"	"Obstructed labor due to maternal pelvic abnormality"	"Ulcerative colitis"	1	135	26	161
"O65"	"K52"	"Obstructed labor due to maternal pelvic abnormality"	"Other and unsp noninfective gastroenteritis and colitis"	1	191	6	197
"O65"	"K57"	"Obstructed labor due to maternal pelvic abnormality"	"Diverticular disease of intestine"	1	31	0	31
"O65"	"K59"	"Obstructed labor due to maternal pelvic abnormality"	"Other functional intestinal disorders"	1	338	0	338
"O65"	"K61"	"Obstructed labor due to maternal pelvic abnormality"	"Abscess of anal and rectal regions"	1	99	7	106
"O65"	"K62"	"Obstructed labor due to maternal pelvic abnormality"	"Other diseases of anus and rectum"	1	179	0	179
"O65"	"K80"	"Obstructed labor due to maternal pelvic abnormality"	"Cholelithiasis"	1	1493	0	1493
"O65"	"K81"	"Obstructed labor due to maternal pelvic abnormality"	"Cholecystitis"	1	91	0	91
"O65"	"K83"	"Obstructed labor due to maternal pelvic abnormality"	"Other diseases of biliary tract"	1	39	0	39
"O65"	"K91"	"Obstructed labor due to maternal pelvic abnormality"	"Intraop and postproc comp and disorders of dgstv sys, NEC"	1	28	0	28
"O65"	"K92"	"Obstructed labor due to maternal pelvic abnormality"	"Other diseases of digestive system"	1	43	0	43
"O65"	"L02"	"Obstructed labor due to maternal pelvic abnormality"	"Cutaneous abscess, furuncle and carbuncle"	1	354	28	382
"O65"	"L03"	"Obstructed labor due to maternal pelvic abnormality"	"Cellulitis and acute lymphangitis"	1	105	32	137
"O65"	"L50"	"Obstructed labor due to maternal pelvic abnormality"	"Urticaria"	1	215	11	226
"O65"	"L68"	"Obstructed labor due to maternal pelvic abnormality"	"Hypertrichosis"	1	106	31	137
"O65"	"L73"	"Obstructed labor due to maternal pelvic abnormality"	"Other follicular disorders"	1	69	14	83
"O65"	"L98"	"Obstructed labor due to maternal pelvic abnormality"	"Oth disorders of skin, subcu, not elsewhere classified"	1	106	0	106
"O65"	"M07"	"Obstructed labor due to maternal pelvic abnormality"	"Enteropathic arthropathies"	1	38	0	38
"O65"	"M13"	"Obstructed labor due to maternal pelvic abnormality"	"Other arthritis"	1	87	0	87
"O65"	"M17"	"Obstructed labor due to maternal pelvic abnormality"	"Osteoarthritis of knee"	1	86	0	86
"O65"	"M19"	"Obstructed labor due to maternal pelvic abnormality"	"Other and unspecified osteoarthritis"	1	48	0	48
"O65"	"M21"	"Obstructed labor due to maternal pelvic abnormality"	"Other acquired deformities of limbs"	1	87	0	87
"O65"	"M23"	"Obstructed labor due to maternal pelvic abnormality"	"Internal derangement of knee"	1	699	0	699
"O65"	"M35"	"Obstructed labor due to maternal pelvic abnormality"	"Other systemic involvement of connective tissue"	1	132	5	137
"O65"	"M43"	"Obstructed labor due to maternal pelvic abnormality"	"Other deforming dorsopathies"	1	54	0	54
"O65"	"M50"	"Obstructed labor due to maternal pelvic abnormality"	"Cervical disc disorders"	1	100	0	100
"O65"	"M51"	"Obstructed labor due to maternal pelvic abnormality"	"Thoracic, thoracolum, and lumbosacral intvrt disc disorders"	1	444	0	444
"O65"	"M62"	"Obstructed labor due to maternal pelvic abnormality"	"Other disorders of muscle"	1	841	108	949
"O65"	"M65"	"Obstructed labor due to maternal pelvic abnormality"	"Synovitis and tenosynovitis"	1	365	24	389
"O65"	"M67"	"Obstructed labor due to maternal pelvic abnormality"	"Other disorders of synovium and tendon"	1	375	6	381
"O65"	"M76"	"Obstructed labor due to maternal pelvic abnormality"	"Enthesopathies, lower limb, excluding foot"	1	142	0	142
"O65"	"M85"	"Obstructed labor due to maternal pelvic abnormality"	"Other disorders of bone density and structure"	1	31	0	31
"O65"	"N10"	"Obstructed labor due to maternal pelvic abnormality"	"Acute pyelonephritis"	1	117	24	141
"O65"	"N20"	"Obstructed labor due to maternal pelvic abnormality"	"Calculus of kidney and ureter"	1	291	0	291
"O65"	"N61"	"Obstructed labor due to maternal pelvic abnormality"	"Inflammatory disorders of breast"	1	127	0	127
"O65"	"N75"	"Obstructed labor due to maternal pelvic abnormality"	"Diseases of Bartholin's gland"	1	171	7	178
"O65"	"N76"	"Obstructed labor due to maternal pelvic abnormality"	"Other inflammation of vagina and vulva"	1	204	44	248
"O65"	"N83"	"Obstructed labor due to maternal pelvic abnormality"	"Noninflammatory disord of ovary, fallop and broad ligament"	1	624	27	651
"O65"	"N84"	"Obstructed labor due to maternal pelvic abnormality"	"Polyp of female genital tract"	1	197	0	197
"O65"	"N87"	"Obstructed labor due to maternal pelvic abnormality"	"Dysplasia of cervix uteri"	1	545	124	669
"O65"	"N88"	"Obstructed labor due to maternal pelvic abnormality"	"Other noninflammatory disorders of cervix uteri"	1	38	0	38
"O65"	"N94"	"Obstructed labor due to maternal pelvic abnormality"	"Pain and oth cond assoc w fem gntl org and menstrual cycle"	1	741	35	776
"O65"	"O04"	"Obstructed labor due to maternal pelvic abnormality"	"Complications following (induced) termination of pregnancy"	1	2571	1210	3781
"O65"	"O08"	"Obstructed labor due to maternal pelvic abnormality"	"Complications following ectopic and molar pregnancy"	1	389	96	485
"O65"	"O33"	"Obstructed labor due to maternal pelvic abnormality"	"Maternal care for disproportion"	1	633	262	895
"O65"	"O90"	"Obstructed labor due to maternal pelvic abnormality"	"Complications of the puerperium, not elsewhere classified"	1	1282	452	1734
"O66"	"D12"	"Other obstructed labor"	"Benign neoplasm of colon, rectum, anus and anal canal"	1	33	0	33
"O66"	"E11"	"Other obstructed labor"	"Type 2 diabetes mellitus"	1	147	0	147
"O66"	"F17"	"Other obstructed labor"	"Nicotine dependence"	1	120	39	159
"O66"	"F41"	"Other obstructed labor"	"Other anxiety disorders"	1	99	24	123
"O66"	"F43"	"Other obstructed labor"	"Reaction to severe stress, and adjustment disorders"	1	134	5	139
"O66"	"G35"	"Other obstructed labor"	"Multiple sclerosis"	1	31	0	31
"O66"	"G43"	"Other obstructed labor"	"Migraine"	1	159	48	207
"O66"	"G47"	"Other obstructed labor"	"Sleep disorders"	1	53	0	53
"O66"	"H57"	"Other obstructed labor"	"Other disorders of eye and adnexa"	1	41	1	42
"O66"	"I63"	"Other obstructed labor"	"Cerebral infarction"	1	25	0	25
"O66"	"J15"	"Other obstructed labor"	"Bacterial pneumonia, not elsewhere classified"	1	65	1	66
"O66"	"J18"	"Other obstructed labor"	"Pneumonia, unspecified organism"	1	223	34	257
"O66"	"K30"	"Other obstructed labor"	"Functional dyspepsia"	1	137	33	170
"O66"	"K59"	"Other obstructed labor"	"Other functional intestinal disorders"	1	209	44	253
"O66"	"K65"	"Other obstructed labor"	"Peritonitis"	1	36	1	37
"O66"	"K85"	"Other obstructed labor"	"Acute pancreatitis"	1	62	6	68
"O66"	"M17"	"Other obstructed labor"	"Osteoarthritis of knee"	1	83	0	83
"O66"	"M19"	"Other obstructed labor"	"Other and unspecified osteoarthritis"	1	58	0	58
"O66"	"M20"	"Other obstructed labor"	"Acquired deformities of fingers and toes"	1	85	15	100
"O66"	"M23"	"Other obstructed labor"	"Internal derangement of knee"	1	256	123	379
"O66"	"M50"	"Other obstructed labor"	"Cervical disc disorders"	1	76	0	76
"O66"	"M62"	"Other obstructed labor"	"Other disorders of muscle"	1	310	157	467
"O66"	"M67"	"Other obstructed labor"	"Other disorders of synovium and tendon"	1	166	67	233
"O66"	"M75"	"Other obstructed labor"	"Shoulder lesions"	1	237	0	237
"O66"	"N39"	"Other obstructed labor"	"Other disorders of urinary system"	1	276	0	276
"O66"	"N83"	"Other obstructed labor"	"Noninflammatory disord of ovary, fallop and broad ligament"	1	224	105	329
"O66"	"O34"	"Other obstructed labor"	"Maternal care for abnormality of pelvic organs"	1	1525	660	2185
"O66"	"O90"	"Other obstructed labor"	"Complications of the puerperium, not elsewhere classified"	1	963	476	1439
"O67"	"I10"	"Labor and delivery comp by intrapartum hemorrhage, NEC"	"Essential (primary) hypertension"	1	39	3	42
"O68"	"A40"	"Labor and delivery comp by abnlt of fetal acid-base balance"	"Streptococcal sepsis"	1	45	4	49
"O68"	"A41"	"Labor and delivery comp by abnlt of fetal acid-base balance"	"Other sepsis"	1	340	22	362
"O68"	"A46"	"Labor and delivery comp by abnlt of fetal acid-base balance"	"Erysipelas"	1	258	7	265
"O68"	"A49"	"Labor and delivery comp by abnlt of fetal acid-base balance"	"Bacterial infection of unspecified site"	1	354	84	438
"O68"	"B02"	"Labor and delivery comp by abnlt of fetal acid-base balance"	"Zoster [herpes zoster]"	1	65	17	82
"O68"	"B34"	"Labor and delivery comp by abnlt of fetal acid-base balance"	"Viral infection of unspecified site"	1	883	298	1181
"O68"	"C34"	"Labor and delivery comp by abnlt of fetal acid-base balance"	"Malignant neoplasm of bronchus and lung"	1	25	0	25
"O68"	"C43"	"Labor and delivery comp by abnlt of fetal acid-base balance"	"Malignant melanoma of skin"	1	282	19	301
"O68"	"C44"	"Labor and delivery comp by abnlt of fetal acid-base balance"	"Other and unspecified malignant neoplasm of skin"	1	112	0	112
"O68"	"C49"	"Labor and delivery comp by abnlt of fetal acid-base balance"	"Malignant neoplasm of other connective and soft tissue"	1	37	2	39
"O68"	"C53"	"Labor and delivery comp by abnlt of fetal acid-base balance"	"Malignant neoplasm of cervix uteri"	1	190	0	190
"O68"	"C73"	"Labor and delivery comp by abnlt of fetal acid-base balance"	"Malignant neoplasm of thyroid gland"	1	94	3	97
"O68"	"C77"	"Labor and delivery comp by abnlt of fetal acid-base balance"	"Secondary and unspecified malignant neoplasm of lymph nodes"	1	97	0	97
"O68"	"C78"	"Labor and delivery comp by abnlt of fetal acid-base balance"	"Secondary malignant neoplasm of resp and digestive organs"	1	66	0	66
"O68"	"C85"	"Labor and delivery comp by abnlt of fetal acid-base balance"	"Oth and unspecified types of non-Hodgkin lymphoma"	1	31	0	31
"O68"	"D07"	"Labor and delivery comp by abnlt of fetal acid-base balance"	"Carcinoma in situ of other and unspecified genital organs"	1	29	2	31
"O68"	"D13"	"Labor and delivery comp by abnlt of fetal acid-base balance"	"Benign neoplasm of and ill-defined parts of digestive system"	1	86	2	88
"O68"	"D14"	"Labor and delivery comp by abnlt of fetal acid-base balance"	"Benign neoplasm of middle ear and respiratory system"	1	98	13	111
"O68"	"D27"	"Labor and delivery comp by abnlt of fetal acid-base balance"	"Benign neoplasm of ovary"	1	701	467	1168
"O68"	"D28"	"Labor and delivery comp by abnlt of fetal acid-base balance"	"Benign neoplasm of other and unsp female genital organs"	1	190	86	276
"O68"	"D32"	"Labor and delivery comp by abnlt of fetal acid-base balance"	"Benign neoplasm of meninges"	1	44	0	44
"O68"	"D33"	"Labor and delivery comp by abnlt of fetal acid-base balance"	"Benign neoplasm of brain and oth prt central nervous system"	1	69	10	79
"O68"	"D43"	"Labor and delivery comp by abnlt of fetal acid-base balance"	"Neoplasm of uncertain behavior of brain and cnsl"	1	35	0	35
"O68"	"D50"	"Labor and delivery comp by abnlt of fetal acid-base balance"	"Iron deficiency anemia"	1	586	1	587
"O68"	"D51"	"Labor and delivery comp by abnlt of fetal acid-base balance"	"Vitamin B12 deficiency anemia"	1	89	32	121
"O68"	"D64"	"Labor and delivery comp by abnlt of fetal acid-base balance"	"Other anemias"	1	545	19	564
"O68"	"D68"	"Labor and delivery comp by abnlt of fetal acid-base balance"	"Other coagulation defects"	1	478	325	803
"O68"	"D75"	"Labor and delivery comp by abnlt of fetal acid-base balance"	"Other and unsp diseases of blood and blood-forming organs"	1	60	4	64
"O68"	"D86"	"Labor and delivery comp by abnlt of fetal acid-base balance"	"Sarcoidosis"	1	184	50	234
"O68"	"E11"	"Labor and delivery comp by abnlt of fetal acid-base balance"	"Type 2 diabetes mellitus"	1	541	0	541
"O68"	"E13"	"Labor and delivery comp by abnlt of fetal acid-base balance"	"Other specified diabetes mellitus"	1	44	3	47
"O68"	"E27"	"Labor and delivery comp by abnlt of fetal acid-base balance"	"Other disorders of adrenal gland"	1	52	0	52
"O68"	"E53"	"Labor and delivery comp by abnlt of fetal acid-base balance"	"Deficiency of other B group vitamins"	1	31	0	31
"O68"	"E61"	"Labor and delivery comp by abnlt of fetal acid-base balance"	"Deficiency of other nutrient elements"	1	47	0	47
"O68"	"E64"	"Labor and delivery comp by abnlt of fetal acid-base balance"	"Sequelae of malnutrition and other nutritional deficiencies"	1	44	0	44
"O68"	"E86"	"Labor and delivery comp by abnlt of fetal acid-base balance"	"Volume depletion"	1	236	76	312
"O68"	"E88"	"Labor and delivery comp by abnlt of fetal acid-base balance"	"Other and unspecified metabolic disorders"	1	87	26	113
"O68"	"E89"	"Labor and delivery comp by abnlt of fetal acid-base balance"	"Postproc endocrine and metabolic comp and disorders, NEC"	1	206	43	249
"O68"	"F32"	"Labor and delivery comp by abnlt of fetal acid-base balance"	"Depressive episode"	1	509	256	765
"O68"	"F41"	"Labor and delivery comp by abnlt of fetal acid-base balance"	"Other anxiety disorders"	1	561	203	764
"O68"	"G03"	"Labor and delivery comp by abnlt of fetal acid-base balance"	"Meningitis due to other and unspecified causes"	1	62	14	76
"O68"	"G37"	"Labor and delivery comp by abnlt of fetal acid-base balance"	"Other demyelinating diseases of central nervous system"	1	100	16	116
"O68"	"G43"	"Labor and delivery comp by abnlt of fetal acid-base balance"	"Migraine"	1	1242	424	1666
"O68"	"G44"	"Labor and delivery comp by abnlt of fetal acid-base balance"	"Other headache syndromes"	1	866	206	1072
"O68"	"G50"	"Labor and delivery comp by abnlt of fetal acid-base balance"	"Disorders of trigeminal nerve"	1	115	0	115
"O68"	"G51"	"Labor and delivery comp by abnlt of fetal acid-base balance"	"Facial nerve disorders"	1	236	114	350
"O68"	"G54"	"Labor and delivery comp by abnlt of fetal acid-base balance"	"Nerve root and plexus disorders"	1	94	16	110
"O68"	"G57"	"Labor and delivery comp by abnlt of fetal acid-base balance"	"Mononeuropathies of lower limb"	1	222	24	246
"O68"	"G62"	"Labor and delivery comp by abnlt of fetal acid-base balance"	"Other and unspecified polyneuropathies"	1	76	0	76
"O68"	"G82"	"Labor and delivery comp by abnlt of fetal acid-base balance"	"Paraplegia (paraparesis) and quadriplegia (quadriparesis)"	1	35	2	37
"O68"	"G91"	"Labor and delivery comp by abnlt of fetal acid-base balance"	"Hydrocephalus"	1	34	1	35
"O68"	"G93"	"Labor and delivery comp by abnlt of fetal acid-base balance"	"Other disorders of brain"	1	81	8	89
"O68"	"G95"	"Labor and delivery comp by abnlt of fetal acid-base balance"	"Other and unspecified diseases of spinal cord"	1	47	0	47
"O68"	"H25"	"Labor and delivery comp by abnlt of fetal acid-base balance"	"Age-related cataract"	1	66	0	66
"O68"	"H26"	"Labor and delivery comp by abnlt of fetal acid-base balance"	"Other cataract"	1	86	0	86
"O68"	"H35"	"Labor and delivery comp by abnlt of fetal acid-base balance"	"Other retinal disorders"	1	160	4	164
"O68"	"H36"	"Labor and delivery comp by abnlt of fetal acid-base balance"	"Retinal disorders in diseases classified elsewhere"	1	160	11	171
"O68"	"H44"	"Labor and delivery comp by abnlt of fetal acid-base balance"	"Disorders of globe"	1	169	21	190
"O68"	"H52"	"Labor and delivery comp by abnlt of fetal acid-base balance"	"Disorders of refraction and accommodation"	1	796	317	1113
"O68"	"H54"	"Labor and delivery comp by abnlt of fetal acid-base balance"	"Blindness and low vision"	1	56	7	63
"O68"	"H57"	"Labor and delivery comp by abnlt of fetal acid-base balance"	"Other disorders of eye and adnexa"	1	390	18	408
"O68"	"H91"	"Labor and delivery comp by abnlt of fetal acid-base balance"	"Other and unspecified hearing loss"	1	459	50	509
"O68"	"H92"	"Labor and delivery comp by abnlt of fetal acid-base balance"	"Otalgia and effusion of ear"	1	83	23	106
"O68"	"I34"	"Labor and delivery comp by abnlt of fetal acid-base balance"	"Nonrheumatic mitral valve disorders"	1	65	7	72
"O68"	"I42"	"Labor and delivery comp by abnlt of fetal acid-base balance"	"Cardiomyopathy"	1	71	5	76
"O68"	"I46"	"Labor and delivery comp by abnlt of fetal acid-base balance"	"Cardiac arrest"	1	37	0	37
"O68"	"I48"	"Labor and delivery comp by abnlt of fetal acid-base balance"	"Atrial fibrillation and flutter"	1	155	0	155
"O68"	"I49"	"Labor and delivery comp by abnlt of fetal acid-base balance"	"Other cardiac arrhythmias"	1	448	45	493
"O68"	"I60"	"Labor and delivery comp by abnlt of fetal acid-base balance"	"Nontraumatic subarachnoid hemorrhage"	1	88	5	93
"O68"	"I67"	"Labor and delivery comp by abnlt of fetal acid-base balance"	"Other cerebrovascular diseases"	1	77	0	77
"O68"	"I73"	"Labor and delivery comp by abnlt of fetal acid-base balance"	"Other peripheral vascular diseases"	1	98	9	107
"O68"	"I74"	"Labor and delivery comp by abnlt of fetal acid-base balance"	"Arterial embolism and thrombosis"	1	33	2	35
"O68"	"I78"	"Labor and delivery comp by abnlt of fetal acid-base balance"	"Diseases of capillaries"	1	166	63	229
"O68"	"I80"	"Labor and delivery comp by abnlt of fetal acid-base balance"	"Phlebitis and thrombophlebitis"	1	571	130	701
"O68"	"I87"	"Labor and delivery comp by abnlt of fetal acid-base balance"	"Other disorders of veins"	1	83	5	88
"O68"	"I89"	"Labor and delivery comp by abnlt of fetal acid-base balance"	"Oth noninfective disorders of lymphatic vessels and nodes"	1	102	0	102
"O68"	"J03"	"Labor and delivery comp by abnlt of fetal acid-base balance"	"Acute tonsillitis"	1	1689	1016	2705
"O68"	"J10"	"Labor and delivery comp by abnlt of fetal acid-base balance"	"Influenza due to other identified influenza virus"	1	67	6	73
"O68"	"J13"	"Labor and delivery comp by abnlt of fetal acid-base balance"	"Pneumonia due to Streptococcus pneumoniae"	1	55	13	68
"O68"	"J15"	"Labor and delivery comp by abnlt of fetal acid-base balance"	"Bacterial pneumonia, not elsewhere classified"	1	541	34	575
"O68"	"J18"	"Labor and delivery comp by abnlt of fetal acid-base balance"	"Pneumonia, unspecified organism"	1	1788	271	2059
"O68"	"J22"	"Labor and delivery comp by abnlt of fetal acid-base balance"	"Unspecified acute lower respiratory infection"	1	60	0	60
"O68"	"J32"	"Labor and delivery comp by abnlt of fetal acid-base balance"	"Chronic sinusitis"	1	392	84	476
"O68"	"J84"	"Labor and delivery comp by abnlt of fetal acid-base balance"	"Other interstitial pulmonary diseases"	1	44	0	44
"O68"	"K04"	"Labor and delivery comp by abnlt of fetal acid-base balance"	"Diseases of pulp and periapical tissues"	1	172	41	213
"O68"	"K21"	"Labor and delivery comp by abnlt of fetal acid-base balance"	"Gastro-esophageal reflux disease"	1	671	93	764
"O68"	"K29"	"Labor and delivery comp by abnlt of fetal acid-base balance"	"Gastritis and duodenitis"	1	525	332	857
"O68"	"K37"	"Labor and delivery comp by abnlt of fetal acid-base balance"	"Unspecified appendicitis"	1	153	52	205
"O68"	"K40"	"Labor and delivery comp by abnlt of fetal acid-base balance"	"Inguinal hernia"	1	227	107	334
"O68"	"K41"	"Labor and delivery comp by abnlt of fetal acid-base balance"	"Femoral hernia"	1	51	3	54
"O68"	"K44"	"Labor and delivery comp by abnlt of fetal acid-base balance"	"Diaphragmatic hernia"	1	463	47	510
"O68"	"K51"	"Labor and delivery comp by abnlt of fetal acid-base balance"	"Ulcerative colitis"	1	449	262	711
"O68"	"K57"	"Labor and delivery comp by abnlt of fetal acid-base balance"	"Diverticular disease of intestine"	1	134	0	134
"O68"	"K63"	"Labor and delivery comp by abnlt of fetal acid-base balance"	"Other diseases of intestine"	1	118	14	132
"O68"	"K64"	"Labor and delivery comp by abnlt of fetal acid-base balance"	"Hemorrhoids and perianal venous thrombosis"	1	1218	0	1218
"O68"	"K66"	"Labor and delivery comp by abnlt of fetal acid-base balance"	"Other disorders of peritoneum"	1	97	26	123
"O68"	"K81"	"Labor and delivery comp by abnlt of fetal acid-base balance"	"Cholecystitis"	1	367	22	389
"O68"	"K83"	"Labor and delivery comp by abnlt of fetal acid-base balance"	"Other diseases of biliary tract"	1	163	7	170
"O68"	"K85"	"Labor and delivery comp by abnlt of fetal acid-base balance"	"Acute pancreatitis"	1	412	60	472
"O68"	"K91"	"Labor and delivery comp by abnlt of fetal acid-base balance"	"Intraop and postproc comp and disorders of dgstv sys, NEC"	1	90	12	102
"O68"	"L02"	"Labor and delivery comp by abnlt of fetal acid-base balance"	"Cutaneous abscess, furuncle and carbuncle"	1	924	617	1541
"O68"	"L08"	"Labor and delivery comp by abnlt of fetal acid-base balance"	"Other local infections of skin and subcutaneous tissue"	1	599	238	837
"O68"	"L29"	"Labor and delivery comp by abnlt of fetal acid-base balance"	"Pruritus"	1	121	29	150
"O68"	"L50"	"Labor and delivery comp by abnlt of fetal acid-base balance"	"Urticaria"	1	580	394	974
"O68"	"L71"	"Labor and delivery comp by abnlt of fetal acid-base balance"	"Rosacea"	1	140	9	149
"O68"	"L72"	"Labor and delivery comp by abnlt of fetal acid-base balance"	"Follicular cysts of skin and subcutaneous tissue"	1	226	16	242
"O68"	"L90"	"Labor and delivery comp by abnlt of fetal acid-base balance"	"Atrophic disorders of skin"	1	809	236	1045
"O68"	"L98"	"Labor and delivery comp by abnlt of fetal acid-base balance"	"Oth disorders of skin, subcu, not elsewhere classified"	1	303	61	364
"O68"	"M05"	"Labor and delivery comp by abnlt of fetal acid-base balance"	"Rheumatoid arthritis with rheumatoid factor"	1	220	2	222
"O68"	"M07"	"Labor and delivery comp by abnlt of fetal acid-base balance"	"Enteropathic arthropathies"	1	223	0	223
"O68"	"M16"	"Labor and delivery comp by abnlt of fetal acid-base balance"	"Osteoarthritis of hip"	1	195	0	195
"O68"	"M18"	"Labor and delivery comp by abnlt of fetal acid-base balance"	"Osteoarthritis of first carpometacarpal joint"	1	42	0	42
"O68"	"M23"	"Labor and delivery comp by abnlt of fetal acid-base balance"	"Internal derangement of knee"	1	1577	1269	2846
"O68"	"M31"	"Labor and delivery comp by abnlt of fetal acid-base balance"	"Other necrotizing vasculopathies"	1	49	3	52
"O68"	"M43"	"Labor and delivery comp by abnlt of fetal acid-base balance"	"Other deforming dorsopathies"	1	172	42	214
"O68"	"M45"	"Labor and delivery comp by abnlt of fetal acid-base balance"	"Ankylosing spondylitis"	1	84	9	93
"O68"	"M46"	"Labor and delivery comp by abnlt of fetal acid-base balance"	"Other inflammatory spondylopathies"	1	193	11	204
"O68"	"M48"	"Labor and delivery comp by abnlt of fetal acid-base balance"	"Other spondylopathies"	1	117	0	117
"O68"	"M50"	"Labor and delivery comp by abnlt of fetal acid-base balance"	"Cervical disc disorders"	1	442	0	442
"O68"	"M53"	"Labor and delivery comp by abnlt of fetal acid-base balance"	"Other and unspecified dorsopathies, not elsewhere classified"	1	564	86	650
"O68"	"M62"	"Labor and delivery comp by abnlt of fetal acid-base balance"	"Other disorders of muscle"	1	2033	1467	3500
"O68"	"M77"	"Labor and delivery comp by abnlt of fetal acid-base balance"	"Other enthesopathies"	1	784	60	844
"O68"	"M96"	"Labor and delivery comp by abnlt of fetal acid-base balance"	"Intraop and postproc comp and disorders of ms sys, NEC"	1	37	0	37
"O68"	"M99"	"Labor and delivery comp by abnlt of fetal acid-base balance"	"Biomechanical lesions, not elsewhere classified"	1	189	0	189
"O68"	"N18"	"Labor and delivery comp by abnlt of fetal acid-base balance"	"Chronic kidney disease (CKD)"	1	100	0	100
"O68"	"N31"	"Labor and delivery comp by abnlt of fetal acid-base balance"	"Neuromuscular dysfunction of bladder, NEC"	1	76	20	96
"O68"	"N32"	"Labor and delivery comp by abnlt of fetal acid-base balance"	"Other disorders of bladder"	1	75	13	88
"O68"	"N39"	"Labor and delivery comp by abnlt of fetal acid-base balance"	"Other disorders of urinary system"	1	2150	0	2150
"O68"	"N60"	"Labor and delivery comp by abnlt of fetal acid-base balance"	"Benign mammary dysplasia"	1	1087	138	1225
"O68"	"N61"	"Labor and delivery comp by abnlt of fetal acid-base balance"	"Inflammatory disorders of breast"	1	515	60	575
"O68"	"N64"	"Labor and delivery comp by abnlt of fetal acid-base balance"	"Other disorders of breast"	1	1817	562	2379
"O68"	"N71"	"Labor and delivery comp by abnlt of fetal acid-base balance"	"Inflammatory disease of uterus, except cervix"	1	1417	649	2066
"O68"	"N75"	"Labor and delivery comp by abnlt of fetal acid-base balance"	"Diseases of Bartholin's gland"	1	393	203	596
"O68"	"N82"	"Labor and delivery comp by abnlt of fetal acid-base balance"	"Fistulae involving female genital tract"	1	109	9	118
"O68"	"N88"	"Labor and delivery comp by abnlt of fetal acid-base balance"	"Other noninflammatory disorders of cervix uteri"	1	122	30	152
"O68"	"N90"	"Labor and delivery comp by abnlt of fetal acid-base balance"	"Other noninflammatory disorders of vulva and perineum"	1	517	205	722
"O68"	"N92"	"Labor and delivery comp by abnlt of fetal acid-base balance"	"Excessive, frequent and irregular menstruation"	1	4637	0	4637
"O68"	"O34"	"Labor and delivery comp by abnlt of fetal acid-base balance"	"Maternal care for abnormality of pelvic organs"	1	7759	4143	11902
"O68"	"O44"	"Labor and delivery comp by abnlt of fetal acid-base balance"	"Placenta previa"	1	617	424	1041
"O68"	"O85"	"Labor and delivery comp by abnlt of fetal acid-base balance"	"Puerperal sepsis"	1	1810	1374	3184
"O68"	"O90"	"Labor and delivery comp by abnlt of fetal acid-base balance"	"Complications of the puerperium, not elsewhere classified"	1	5938	2951	8889
"O68"	"O91"	"Labor and delivery comp by abnlt of fetal acid-base balance"	"Infect of breast assoc w pregnancy, the puerp and lactation"	1	5151	0	5151
"O69"	"M54"	"Labor and delivery complicated by umbilical cord comp"	"Dorsalgia"	1	76	3	79
"O69"	"M62"	"Labor and delivery complicated by umbilical cord comp"	"Other disorders of muscle"	1	58	4	62
"O69"	"N83"	"Labor and delivery complicated by umbilical cord comp"	"Noninflammatory disord of ovary, fallop and broad ligament"	1	39	5	44
"O69"	"O34"	"Labor and delivery complicated by umbilical cord comp"	"Maternal care for abnormality of pelvic organs"	1	176	89	265
"O70"	"A87"	"Perineal laceration during delivery"	"Viral meningitis"	1	245	125	370
"O70"	"B18"	"Perineal laceration during delivery"	"Chronic viral hepatitis"	1	195	87	282
"O70"	"B34"	"Perineal laceration during delivery"	"Viral infection of unspecified site"	1	1128	720	1848
"O70"	"C18"	"Perineal laceration during delivery"	"Malignant neoplasm of colon"	1	63	0	63
"O70"	"C34"	"Perineal laceration during delivery"	"Malignant neoplasm of bronchus and lung"	1	35	0	35
"O70"	"C50"	"Perineal laceration during delivery"	"Malignant neoplasm of breast"	1	721	0	721
"O70"	"C56"	"Perineal laceration during delivery"	"Malignant neoplasm of ovary"	1	62	0	62
"O70"	"C71"	"Perineal laceration during delivery"	"Malignant neoplasm of brain"	1	54	0	54
"O70"	"C73"	"Perineal laceration during delivery"	"Malignant neoplasm of thyroid gland"	1	170	3	173
"O70"	"C77"	"Perineal laceration during delivery"	"Secondary and unspecified malignant neoplasm of lymph nodes"	1	197	0	197
"O70"	"C78"	"Perineal laceration during delivery"	"Secondary malignant neoplasm of resp and digestive organs"	1	102	0	102
"O70"	"C92"	"Perineal laceration during delivery"	"Myeloid leukemia"	1	31	0	31
"O70"	"D10"	"Perineal laceration during delivery"	"Benign neoplasm of mouth and pharynx"	1	196	45	241
"O70"	"D14"	"Perineal laceration during delivery"	"Benign neoplasm of middle ear and respiratory system"	1	141	29	170
"O70"	"D17"	"Perineal laceration during delivery"	"Benign lipomatous neoplasm"	1	1230	74	1304
"O70"	"D21"	"Perineal laceration during delivery"	"Other benign neoplasms of connective and other soft tissue"	1	262	68	330
"O70"	"D24"	"Perineal laceration during delivery"	"Benign neoplasm of breast"	1	1583	863	2446
"O70"	"D25"	"Perineal laceration during delivery"	"Leiomyoma of uterus"	1	1080	0	1080
"O70"	"D32"	"Perineal laceration during delivery"	"Benign neoplasm of meninges"	1	64	0	64
"O70"	"D33"	"Perineal laceration during delivery"	"Benign neoplasm of brain and oth prt central nervous system"	1	135	19	154
"O70"	"D47"	"Perineal laceration during delivery"	"Oth neoplm of uncrt behav of lymphoid, hematpoetc & rel tiss"	1	25	0	25
"O70"	"D50"	"Perineal laceration during delivery"	"Iron deficiency anemia"	1	838	4	842
"O70"	"D51"	"Perineal laceration during delivery"	"Vitamin B12 deficiency anemia"	1	130	53	183
"O70"	"D63"	"Perineal laceration during delivery"	"Anemia in chronic diseases classified elsewhere"	1	37	0	37
"O70"	"D64"	"Perineal laceration during delivery"	"Other anemias"	1	879	57	936
"O70"	"E04"	"Perineal laceration during delivery"	"Other nontoxic goiter"	1	2307	0	2307
"O70"	"E05"	"Perineal laceration during delivery"	"Thyrotoxicosis [hyperthyroidism]"	1	2073	591	2664
"O70"	"E21"	"Perineal laceration during delivery"	"Hyperparathyroidism and other disorders of parathyroid gland"	1	155	0	155
"O70"	"E23"	"Perineal laceration during delivery"	"Hypofunction and other disorders of the pituitary gland"	1	129	23	152
"O70"	"E53"	"Perineal laceration during delivery"	"Deficiency of other B group vitamins"	1	52	6	58
"O70"	"E61"	"Perineal laceration during delivery"	"Deficiency of other nutrient elements"	1	65	2	67
"O70"	"E64"	"Perineal laceration during delivery"	"Sequelae of malnutrition and other nutritional deficiencies"	1	93	3	96
"O70"	"E68"	"Perineal laceration during delivery"	"Sequelae of hyperalimentation"	1	622	0	622
"O70"	"E83"	"Perineal laceration during delivery"	"Disorders of mineral metabolism"	1	125	0	125
"O70"	"E87"	"Perineal laceration during delivery"	"Other disorders of fluid, electrolyte and acid-base balance"	1	203	0	203
"O70"	"E89"	"Perineal laceration during delivery"	"Postproc endocrine and metabolic comp and disorders, NEC"	1	304	44	348
"O70"	"F06"	"Perineal laceration during delivery"	"Other mental disorders due to known physiological condition"	1	29	1	30
"O70"	"F34"	"Perineal laceration during delivery"	"Persistent mood [affective] disorders"	1	80	13	93
"O70"	"F51"	"Perineal laceration during delivery"	"Sleep disorders not due to a substance or known physiol cond"	1	40	3	43
"O70"	"G35"	"Perineal laceration during delivery"	"Multiple sclerosis"	1	472	69	541
"O70"	"G37"	"Perineal laceration during delivery"	"Other demyelinating diseases of central nervous system"	1	173	37	210
"O70"	"G44"	"Perineal laceration during delivery"	"Other headache syndromes"	1	1322	475	1797
"O70"	"G50"	"Perineal laceration during delivery"	"Disorders of trigeminal nerve"	1	224	0	224
"O70"	"G51"	"Perineal laceration during delivery"	"Facial nerve disorders"	1	390	183	573
"O70"	"G62"	"Perineal laceration during delivery"	"Other and unspecified polyneuropathies"	1	146	0	146
"O70"	"G71"	"Perineal laceration during delivery"	"Primary disorders of muscles"	1	38	6	44
"O70"	"G82"	"Perineal laceration during delivery"	"Paraplegia (paraparesis) and quadriplegia (quadriparesis)"	1	57	7	64
"O70"	"G91"	"Perineal laceration during delivery"	"Hydrocephalus"	1	46	6	52
"O70"	"G93"	"Perineal laceration during delivery"	"Other disorders of brain"	1	142	13	155
"O70"	"G95"	"Perineal laceration during delivery"	"Other and unspecified diseases of spinal cord"	1	86	0	86
"O70"	"G97"	"Perineal laceration during delivery"	"Intraop and postproc comp and disorders of nervous sys, NEC"	1	182	64	246
"O70"	"G98"	"Perineal laceration during delivery"	"Other disorders of nervous system not elsewhere classified"	1	299	0	299
"O70"	"H01"	"Perineal laceration during delivery"	"Other inflammation of eyelid"	1	128	28	156
"O70"	"H02"	"Perineal laceration during delivery"	"Other disorders of eyelid"	1	532	22	554
"O70"	"H05"	"Perineal laceration during delivery"	"Disorders of orbit"	1	104	41	145
"O70"	"H16"	"Perineal laceration during delivery"	"Keratitis"	1	395	224	619
"O70"	"H18"	"Perineal laceration during delivery"	"Other disorders of cornea"	1	231	20	251
"O70"	"H20"	"Perineal laceration during delivery"	"Iridocyclitis"	1	231	104	335
"O70"	"H26"	"Perineal laceration during delivery"	"Other cataract"	1	113	0	113
"O70"	"H34"	"Perineal laceration during delivery"	"Retinal vascular occlusions"	1	28	0	28
"O70"	"H40"	"Perineal laceration during delivery"	"Glaucoma"	1	81	0	81
"O70"	"H43"	"Perineal laceration during delivery"	"Disorders of vitreous body"	1	116	0	116
"O70"	"H46"	"Perineal laceration during delivery"	"Optic neuritis"	1	136	59	195
"O70"	"H53"	"Perineal laceration during delivery"	"Visual disturbances"	1	471	130	601
"O70"	"H57"	"Perineal laceration during delivery"	"Other disorders of eye and adnexa"	1	500	82	582
"O70"	"H83"	"Perineal laceration during delivery"	"Other diseases of inner ear"	1	59	15	74
"O70"	"I10"	"Perineal laceration during delivery"	"Essential (primary) hypertension"	1	1624	0	1624
"O70"	"I26"	"Perineal laceration during delivery"	"Pulmonary embolism"	1	307	55	362
"O70"	"I30"	"Perineal laceration during delivery"	"Acute pericarditis"	1	71	17	88
"O70"	"I48"	"Perineal laceration during delivery"	"Atrial fibrillation and flutter"	1	280	0	280
"O70"	"I60"	"Perineal laceration during delivery"	"Nontraumatic subarachnoid hemorrhage"	1	115	5	120
"O70"	"I61"	"Perineal laceration during delivery"	"Nontraumatic intracerebral hemorrhage"	1	69	0	69
"O70"	"I63"	"Perineal laceration during delivery"	"Cerebral infarction"	1	217	0	217
"O70"	"I65"	"Perineal laceration during delivery"	"Occls and stenosis of precerb art, not rslt in cereb infrc"	1	48	1	49
"O70"	"I71"	"Perineal laceration during delivery"	"Aortic aneurysm and dissection"	1	49	0	49
"O70"	"I73"	"Perineal laceration during delivery"	"Other peripheral vascular diseases"	1	163	56	219
"O70"	"I78"	"Perineal laceration during delivery"	"Diseases of capillaries"	1	285	108	393
"O70"	"I97"	"Perineal laceration during delivery"	"Intraop and postproc comp and disorders of circ sys, NEC"	1	26	0	26
"O70"	"J06"	"Perineal laceration during delivery"	"Acute upper resp infections of multiple and unsp sites"	1	746	107	853
"O70"	"J09"	"Perineal laceration during delivery"	"Influenza due to certain identified influenza viruses"	1	107	1	108
"O70"	"J10"	"Perineal laceration during delivery"	"Influenza due to other identified influenza virus"	1	107	9	116
"O70"	"J18"	"Perineal laceration during delivery"	"Pneumonia, unspecified organism"	1	2282	603	2885
"O70"	"J47"	"Perineal laceration during delivery"	"Bronchiectasis"	1	83	0	83
"O70"	"J91"	"Perineal laceration during delivery"	"Pleural effusion in conditions classified elsewhere"	1	29	0	29
"O70"	"J96"	"Perineal laceration during delivery"	"Respiratory failure, not elsewhere classified"	1	216	1	217
"O70"	"K04"	"Perineal laceration during delivery"	"Diseases of pulp and periapical tissues"	1	280	87	367
"O70"	"K05"	"Perineal laceration during delivery"	"Gingivitis and periodontal diseases"	1	141	44	185
"O70"	"K12"	"Perineal laceration during delivery"	"Stomatitis and related lesions"	1	200	106	306
"O70"	"K20"	"Perineal laceration during delivery"	"Esophagitis"	1	175	37	212
"O70"	"K30"	"Perineal laceration during delivery"	"Functional dyspepsia"	1	1363	606	1969
"O70"	"K41"	"Perineal laceration during delivery"	"Femoral hernia"	1	121	15	136
"O70"	"K44"	"Perineal laceration during delivery"	"Diaphragmatic hernia"	1	784	87	871
"O70"	"K51"	"Perineal laceration during delivery"	"Ulcerative colitis"	1	702	437	1139
"O70"	"K52"	"Perineal laceration during delivery"	"Other and unsp noninfective gastroenteritis and colitis"	1	711	476	1187
"O70"	"K57"	"Perineal laceration during delivery"	"Diverticular disease of intestine"	1	193	0	193
"O70"	"K61"	"Perineal laceration during delivery"	"Abscess of anal and rectal regions"	1	369	233	602
"O70"	"K63"	"Perineal laceration during delivery"	"Other diseases of intestine"	1	151	32	183
"O70"	"K72"	"Perineal laceration during delivery"	"Hepatic failure, not elsewhere classified"	1	26	0	26
"O70"	"K75"	"Perineal laceration during delivery"	"Other inflammatory liver diseases"	1	48	6	54
"O70"	"K76"	"Perineal laceration during delivery"	"Other diseases of liver"	1	314	7	321
"O70"	"K80"	"Perineal laceration during delivery"	"Cholelithiasis"	1	9291	0	9291
"O70"	"K81"	"Perineal laceration during delivery"	"Cholecystitis"	1	544	46	590
"O70"	"K85"	"Perineal laceration during delivery"	"Acute pancreatitis"	1	678	115	793
"O70"	"K90"	"Perineal laceration during delivery"	"Intestinal malabsorption"	1	244	62	306
"O70"	"L28"	"Perineal laceration during delivery"	"Lichen simplex chronicus and prurigo"	1	95	18	113
"O70"	"L29"	"Perineal laceration during delivery"	"Pruritus"	1	212	58	270
"O70"	"L81"	"Perineal laceration during delivery"	"Other disorders of pigmentation"	1	170	78	248
"O70"	"L92"	"Perineal laceration during delivery"	"Granulomatous disorders of skin and subcutaneous tissue"	1	110	40	150
"O70"	"M06"	"Perineal laceration during delivery"	"Other rheumatoid arthritis"	1	383	107	490
"O70"	"M15"	"Perineal laceration during delivery"	"Polyosteoarthritis"	1	40	0	40
"O70"	"M16"	"Perineal laceration during delivery"	"Osteoarthritis of hip"	1	320	0	320
"O70"	"M17"	"Perineal laceration during delivery"	"Osteoarthritis of knee"	1	772	0	772
"O70"	"M18"	"Perineal laceration during delivery"	"Osteoarthritis of first carpometacarpal joint"	1	68	0	68
"O70"	"M20"	"Perineal laceration during delivery"	"Acquired deformities of fingers and toes"	1	1014	465	1479
"O70"	"M25"	"Perineal laceration during delivery"	"Other joint disorder, not elsewhere classified"	1	1958	408	2366
"O70"	"M34"	"Perineal laceration during delivery"	"Systemic sclerosis [scleroderma]"	1	32	2	34
"O70"	"M43"	"Perineal laceration during delivery"	"Other deforming dorsopathies"	1	250	102	352
"O70"	"M45"	"Perineal laceration during delivery"	"Ankylosing spondylitis"	1	173	30	203
"O70"	"M46"	"Perineal laceration during delivery"	"Other inflammatory spondylopathies"	1	391	22	413
"O70"	"M48"	"Perineal laceration during delivery"	"Other spondylopathies"	1	163	0	163
"O70"	"M50"	"Perineal laceration during delivery"	"Cervical disc disorders"	1	741	0	741
"O70"	"M51"	"Perineal laceration during delivery"	"Thoracic, thoracolum, and lumbosacral intvrt disc disorders"	1	3413	0	3413
"O70"	"M70"	"Perineal laceration during delivery"	"Soft tissue disorders related to use, overuse and pressure"	1	753	259	1012
"O70"	"M71"	"Perineal laceration during delivery"	"Other bursopathies"	1	171	81	252
"O70"	"M75"	"Perineal laceration during delivery"	"Shoulder lesions"	1	2757	0	2757
"O70"	"M79"	"Perineal laceration during delivery"	"Oth and unsp soft tissue disorders, not elsewhere classified"	1	3257	1889	5146
"O70"	"M96"	"Perineal laceration during delivery"	"Intraop and postproc comp and disorders of ms sys, NEC"	1	64	0	64
"O70"	"M99"	"Perineal laceration during delivery"	"Biomechanical lesions, not elsewhere classified"	1	329	0	329
"O70"	"N18"	"Perineal laceration during delivery"	"Chronic kidney disease (CKD)"	1	125	0	125
"O70"	"N36"	"Perineal laceration during delivery"	"Other disorders of urethra"	1	137	57	194
"O70"	"N60"	"Perineal laceration during delivery"	"Benign mammary dysplasia"	1	1869	378	2247
"O70"	"N61"	"Perineal laceration during delivery"	"Inflammatory disorders of breast"	1	825	134	959
"O70"	"N75"	"Perineal laceration during delivery"	"Diseases of Bartholin's gland"	1	701	388	1089
"O70"	"N81"	"Perineal laceration during delivery"	"Female genital prolapse"	1	6620	0	6620
"O70"	"N83"	"Perineal laceration during delivery"	"Noninflammatory disord of ovary, fallop and broad ligament"	1	2789	1597	4386
"O70"	"N92"	"Perineal laceration during delivery"	"Excessive, frequent and irregular menstruation"	1	7894	0	7894
"O70"	"N93"	"Perineal laceration during delivery"	"Other abnormal uterine and vaginal bleeding"	1	3703	0	3703
"O70"	"N99"	"Perineal laceration during delivery"	"Intraop and postproc comp and disorders of GU sys, NEC"	1	1022	180	1202
"O70"	"O91"	"Perineal laceration during delivery"	"Infect of breast assoc w pregnancy, the puerp and lactation"	1	9139	0	9139
"O70"	"Q61"	"Perineal laceration during delivery"	"Cystic kidney disease"	1	134	16	150
"O71"	"B18"	"Other obstetric trauma"	"Chronic viral hepatitis"	1	49	9	58
"O71"	"C50"	"Other obstetric trauma"	"Malignant neoplasm of breast"	1	135	0	135
"O71"	"C53"	"Other obstetric trauma"	"Malignant neoplasm of cervix uteri"	1	76	0	76
"O71"	"C73"	"Other obstetric trauma"	"Malignant neoplasm of thyroid gland"	1	26	0	26
"O71"	"C77"	"Other obstetric trauma"	"Secondary and unspecified malignant neoplasm of lymph nodes"	1	35	0	35
"O71"	"C79"	"Other obstetric trauma"	"Secondary malignant neoplasm of other and unspecified sites"	1	26	0	26
"O71"	"D12"	"Other obstetric trauma"	"Benign neoplasm of colon, rectum, anus and anal canal"	1	96	0	96
"O71"	"D13"	"Other obstetric trauma"	"Benign neoplasm of and ill-defined parts of digestive system"	1	29	0	29
"O71"	"D17"	"Other obstetric trauma"	"Benign lipomatous neoplasm"	1	256	0	256
"O71"	"D69"	"Other obstetric trauma"	"Purpura and other hemorrhagic conditions"	1	88	22	110
"O71"	"E04"	"Other obstetric trauma"	"Other nontoxic goiter"	1	494	1	495
"O71"	"E05"	"Other obstetric trauma"	"Thyrotoxicosis [hyperthyroidism]"	1	414	53	467
"O71"	"E11"	"Other obstetric trauma"	"Type 2 diabetes mellitus"	1	100	0	100
"O71"	"E21"	"Other obstetric trauma"	"Hyperparathyroidism and other disorders of parathyroid gland"	1	30	0	30
"O71"	"E23"	"Other obstetric trauma"	"Hypofunction and other disorders of the pituitary gland"	1	25	0	25
"O71"	"E65"	"Other obstetric trauma"	"Localized adiposity"	1	262	0	262
"O71"	"E78"	"Other obstetric trauma"	"Disorders of lipoprotein metabolism and other lipidemias"	1	73	0	73
"O71"	"F17"	"Other obstetric trauma"	"Nicotine dependence"	1	189	0	189
"O71"	"F33"	"Other obstetric trauma"	"Major depressive disorder, recurrent"	1	159	6	165
"O71"	"F43"	"Other obstetric trauma"	"Reaction to severe stress, and adjustment disorders"	1	261	0	261
"O71"	"G43"	"Other obstetric trauma"	"Migraine"	1	458	72	530
"O71"	"G44"	"Other obstetric trauma"	"Other headache syndromes"	1	373	18	391
"O71"	"G45"	"Other obstetric trauma"	"Transient cerebral ischemic attacks and related syndromes"	1	68	0	68
"O71"	"G47"	"Other obstetric trauma"	"Sleep disorders"	1	116	0	116
"O71"	"G50"	"Other obstetric trauma"	"Disorders of trigeminal nerve"	1	42	0	42
"O71"	"G51"	"Other obstetric trauma"	"Facial nerve disorders"	1	59	12	71
"O71"	"G56"	"Other obstetric trauma"	"Mononeuropathies of upper limb"	1	748	18	766
"O71"	"G62"	"Other obstetric trauma"	"Other and unspecified polyneuropathies"	1	35	0	35
"O71"	"G93"	"Other obstetric trauma"	"Other disorders of brain"	1	28	0	28
"O71"	"G96"	"Other obstetric trauma"	"Other disorders of central nervous system"	1	149	0	149
"O71"	"H52"	"Other obstetric trauma"	"Disorders of refraction and accommodation"	1	278	62	340
"O71"	"H53"	"Other obstetric trauma"	"Visual disturbances"	1	92	9	101
"O71"	"H57"	"Other obstetric trauma"	"Other disorders of eye and adnexa"	1	89	0	89
"O71"	"H90"	"Other obstetric trauma"	"Conductive and sensorineural hearing loss"	1	126	26	152
"O71"	"I10"	"Other obstetric trauma"	"Essential (primary) hypertension"	1	341	0	341
"O71"	"I20"	"Other obstetric trauma"	"Angina pectoris"	1	91	0	91
"O71"	"I26"	"Other obstetric trauma"	"Pulmonary embolism"	1	81	0	81
"O71"	"I35"	"Other obstetric trauma"	"Nonrheumatic aortic valve disorders"	1	30	0	30
"O71"	"I42"	"Other obstetric trauma"	"Cardiomyopathy"	1	25	0	25
"O71"	"I47"	"Other obstetric trauma"	"Paroxysmal tachycardia"	1	165	38	203
"O71"	"I48"	"Other obstetric trauma"	"Atrial fibrillation and flutter"	1	53	0	53
"O71"	"I60"	"Other obstetric trauma"	"Nontraumatic subarachnoid hemorrhage"	1	28	1	29
"O71"	"I63"	"Other obstetric trauma"	"Cerebral infarction"	1	58	0	58
"O71"	"I82"	"Other obstetric trauma"	"Other venous embolism and thrombosis"	1	49	0	49
"O71"	"J06"	"Other obstetric trauma"	"Acute upper resp infections of multiple and unsp sites"	1	78	0	78
"O71"	"J34"	"Other obstetric trauma"	"Other and unspecified disorders of nose and nasal sinuses"	1	127	57	184
"O71"	"J44"	"Other obstetric trauma"	"Other chronic obstructive pulmonary disease"	1	54	0	54
"O71"	"J96"	"Other obstetric trauma"	"Respiratory failure, not elsewhere classified"	1	44	0	44
"O71"	"J98"	"Other obstetric trauma"	"Other respiratory disorders"	1	29	2	31
"O71"	"K20"	"Other obstetric trauma"	"Esophagitis"	1	38	0	38
"O71"	"K21"	"Other obstetric trauma"	"Gastro-esophageal reflux disease"	1	290	19	309
"O71"	"K29"	"Other obstetric trauma"	"Gastritis and duodenitis"	1	215	52	267
"O71"	"K43"	"Other obstetric trauma"	"Ventral hernia"	1	165	0	165
"O71"	"K44"	"Other obstetric trauma"	"Diaphragmatic hernia"	1	174	10	184
"O71"	"K56"	"Other obstetric trauma"	"Paralytic ileus and intestinal obstruction without hernia"	1	90	4	94
"O71"	"K60"	"Other obstetric trauma"	"Fissure and fistula of anal and rectal regions"	1	327	47	374
"O71"	"K63"	"Other obstetric trauma"	"Other diseases of intestine"	1	31	0	31
"O71"	"K80"	"Other obstetric trauma"	"Cholelithiasis"	1	1948	0	1948
"O71"	"K83"	"Other obstetric trauma"	"Other diseases of biliary tract"	1	60	3	63
"O71"	"K91"	"Other obstetric trauma"	"Intraop and postproc comp and disorders of dgstv sys, NEC"	1	28	0	28
"O71"	"L08"	"Other obstetric trauma"	"Other local infections of skin and subcutaneous tissue"	1	113	34	147
"O71"	"L30"	"Other obstetric trauma"	"Other and unspecified dermatitis"	1	146	12	158
"O71"	"L40"	"Other obstetric trauma"	"Psoriasis"	1	103	14	117
"O71"	"L50"	"Other obstetric trauma"	"Urticaria"	1	180	62	242
"O71"	"L73"	"Other obstetric trauma"	"Other follicular disorders"	1	93	30	123
"O71"	"L90"	"Other obstetric trauma"	"Atrophic disorders of skin"	1	255	55	310
"O71"	"M02"	"Other obstetric trauma"	"Postinfective and reactive arthropathies"	1	75	25	100
"O71"	"M05"	"Other obstetric trauma"	"Rheumatoid arthritis with rheumatoid factor"	1	83	0	83
"O71"	"M06"	"Other obstetric trauma"	"Other rheumatoid arthritis"	1	90	2	92
"O71"	"M13"	"Other obstetric trauma"	"Other arthritis"	1	129	10	139
"O71"	"M17"	"Other obstetric trauma"	"Osteoarthritis of knee"	1	170	0	170
"O71"	"M19"	"Other obstetric trauma"	"Other and unspecified osteoarthritis"	1	116	0	116
"O71"	"M21"	"Other obstetric trauma"	"Other acquired deformities of limbs"	1	84	29	113
"O71"	"M35"	"Other obstetric trauma"	"Other systemic involvement of connective tissue"	1	163	47	210
"O71"	"M43"	"Other obstetric trauma"	"Other deforming dorsopathies"	1	65	8	73
"O71"	"M47"	"Other obstetric trauma"	"Spondylosis"	1	88	0	88
"O71"	"M50"	"Other obstetric trauma"	"Cervical disc disorders"	1	158	0	158
"O71"	"M54"	"Other obstetric trauma"	"Dorsalgia"	1	1392	180	1572
"O71"	"M75"	"Other obstetric trauma"	"Shoulder lesions"	1	590	0	590
"O71"	"M79"	"Other obstetric trauma"	"Oth and unsp soft tissue disorders, not elsewhere classified"	1	939	160	1099
"O71"	"M85"	"Other obstetric trauma"	"Other disorders of bone density and structure"	1	78	0	78
"O71"	"N30"	"Other obstetric trauma"	"Cystitis"	1	501	318	819
"O71"	"N31"	"Other obstetric trauma"	"Neuromuscular dysfunction of bladder, NEC"	1	32	3	35
"O71"	"N39"	"Other obstetric trauma"	"Other disorders of urinary system"	1	735	0	735
"O71"	"N71"	"Other obstetric trauma"	"Inflammatory disease of uterus, except cervix"	1	469	165	634
"O71"	"N81"	"Other obstetric trauma"	"Female genital prolapse"	1	1082	0	1082
"O71"	"N92"	"Other obstetric trauma"	"Excessive, frequent and irregular menstruation"	1	1609	0	1609
"O71"	"N94"	"Other obstetric trauma"	"Pain and oth cond assoc w fem gntl org and menstrual cycle"	1	882	247	1129
"O71"	"N99"	"Other obstetric trauma"	"Intraop and postproc comp and disorders of GU sys, NEC"	1	138	28	166
"O71"	"O90"	"Other obstetric trauma"	"Complications of the puerperium, not elsewhere classified"	1	1306	938	2244
"O71"	"O92"	"Other obstetric trauma"	"Oth disord of brst/lactatn assoc w pregnancy and the puerp"	1	1269	835	2104
"O71"	"Q65"	"Other obstetric trauma"	"Congenital deformities of hip"	1	59	7	66
"O72"	"C50"	"Postpartum hemorrhage"	"Malignant neoplasm of breast"	1	591	0	591
"O72"	"C53"	"Postpartum hemorrhage"	"Malignant neoplasm of cervix uteri"	1	162	76	238
"O72"	"C77"	"Postpartum hemorrhage"	"Secondary and unspecified malignant neoplasm of lymph nodes"	1	115	21	136
"O72"	"D05"	"Postpartum hemorrhage"	"Carcinoma in situ of breast"	1	80	2	82
"O72"	"E04"	"Postpartum hemorrhage"	"Other nontoxic goiter"	1	1028	755	1783
"O72"	"E65"	"Postpartum hemorrhage"	"Localized adiposity"	1	745	470	1215
"O72"	"E68"	"Postpartum hemorrhage"	"Sequelae of hyperalimentation"	1	585	243	828
"O72"	"E78"	"Postpartum hemorrhage"	"Disorders of lipoprotein metabolism and other lipidemias"	1	302	167	469
"O72"	"H25"	"Postpartum hemorrhage"	"Age-related cataract"	1	83	10	93
"O72"	"I10"	"Postpartum hemorrhage"	"Essential (primary) hypertension"	1	1071	656	1727
"O72"	"I20"	"Postpartum hemorrhage"	"Angina pectoris"	1	231	55	286
"O72"	"I83"	"Postpartum hemorrhage"	"Varicose veins of lower extremities"	1	3026	974	4000
"O72"	"J01"	"Postpartum hemorrhage"	"Acute sinusitis"	1	1359	717	2076
"O72"	"K43"	"Postpartum hemorrhage"	"Ventral hernia"	1	656	229	885
"O72"	"K57"	"Postpartum hemorrhage"	"Diverticular disease of intestine"	1	263	0	263
"O72"	"K64"	"Postpartum hemorrhage"	"Hemorrhoids and perianal venous thrombosis"	1	3989	0	3989
"O72"	"M15"	"Postpartum hemorrhage"	"Polyosteoarthritis"	1	33	0	33
"O72"	"M19"	"Postpartum hemorrhage"	"Other and unspecified osteoarthritis"	1	388	182	570
"O72"	"M47"	"Postpartum hemorrhage"	"Spondylosis"	1	505	96	601
"O72"	"M48"	"Postpartum hemorrhage"	"Other spondylopathies"	1	158	37	195
"O72"	"M50"	"Postpartum hemorrhage"	"Cervical disc disorders"	1	561	203	764
"O72"	"N81"	"Postpartum hemorrhage"	"Female genital prolapse"	1	5099	0	5099
"O72"	"N92"	"Postpartum hemorrhage"	"Excessive, frequent and irregular menstruation"	1	5728	2924	8652
"O72"	"N95"	"Postpartum hemorrhage"	"Menopausal and other perimenopausal disorders"	1	103	0	103
"O72"	"O85"	"Postpartum hemorrhage"	"Puerperal sepsis"	1	2795	2014	4809
"O73"	"D25"	"Retained placenta and membranes, without hemorrhage"	"Leiomyoma of uterus"	1	68	6	74
"O73"	"K62"	"Retained placenta and membranes, without hemorrhage"	"Other diseases of anus and rectum"	1	60	9	69
"O73"	"K80"	"Retained placenta and membranes, without hemorrhage"	"Cholelithiasis"	1	249	76	325
"O73"	"M17"	"Retained placenta and membranes, without hemorrhage"	"Osteoarthritis of knee"	1	40	0	40
"O73"	"M25"	"Retained placenta and membranes, without hemorrhage"	"Other joint disorder, not elsewhere classified"	1	79	21	100
"O73"	"M50"	"Retained placenta and membranes, without hemorrhage"	"Cervical disc disorders"	1	25	0	25
"O73"	"M75"	"Retained placenta and membranes, without hemorrhage"	"Shoulder lesions"	1	115	2	117
"O73"	"N39"	"Retained placenta and membranes, without hemorrhage"	"Other disorders of urinary system"	1	173	34	207
"O73"	"N92"	"Retained placenta and membranes, without hemorrhage"	"Excessive, frequent and irregular menstruation"	1	389	36	425
"O75"	"A41"	"Oth complications of labor and delivery, NEC"	"Other sepsis"	1	106	23	129
"O75"	"C43"	"Oth complications of labor and delivery, NEC"	"Malignant melanoma of skin"	1	67	7	74
"O75"	"C53"	"Oth complications of labor and delivery, NEC"	"Malignant neoplasm of cervix uteri"	1	55	3	58
"O75"	"D25"	"Oth complications of labor and delivery, NEC"	"Leiomyoma of uterus"	1	199	0	199
"O75"	"D50"	"Oth complications of labor and delivery, NEC"	"Iron deficiency anemia"	1	170	4	174
"O75"	"D64"	"Oth complications of labor and delivery, NEC"	"Other anemias"	1	144	12	156
"O75"	"E11"	"Oth complications of labor and delivery, NEC"	"Type 2 diabetes mellitus"	1	102	0	102
"O75"	"E65"	"Oth complications of labor and delivery, NEC"	"Localized adiposity"	1	249	16	265
"O75"	"E68"	"Oth complications of labor and delivery, NEC"	"Sequelae of hyperalimentation"	1	165	0	165
"O75"	"E78"	"Oth complications of labor and delivery, NEC"	"Disorders of lipoprotein metabolism and other lipidemias"	1	77	0	77
"O75"	"F33"	"Oth complications of labor and delivery, NEC"	"Major depressive disorder, recurrent"	1	128	51	179
"O75"	"G43"	"Oth complications of labor and delivery, NEC"	"Migraine"	1	337	161	498
"O75"	"G45"	"Oth complications of labor and delivery, NEC"	"Transient cerebral ischemic attacks and related syndromes"	1	44	0	44
"O75"	"G96"	"Oth complications of labor and delivery, NEC"	"Other disorders of central nervous system"	1	112	6	118
"O75"	"H53"	"Oth complications of labor and delivery, NEC"	"Visual disturbances"	1	91	29	120
"O75"	"H81"	"Oth complications of labor and delivery, NEC"	"Disorders of vestibular function"	1	151	23	174
"O75"	"I10"	"Oth complications of labor and delivery, NEC"	"Essential (primary) hypertension"	1	321	0	321
"O75"	"I15"	"Oth complications of labor and delivery, NEC"	"Secondary hypertension"	1	45	4	49
"O75"	"I48"	"Oth complications of labor and delivery, NEC"	"Atrial fibrillation and flutter"	1	43	0	43
"O75"	"I50"	"Oth complications of labor and delivery, NEC"	"Heart failure"	1	28	2	30
"O75"	"I80"	"Oth complications of labor and delivery, NEC"	"Phlebitis and thrombophlebitis"	1	118	48	166
"O75"	"J06"	"Oth complications of labor and delivery, NEC"	"Acute upper resp infections of multiple and unsp sites"	1	145	20	165
"O75"	"J15"	"Oth complications of labor and delivery, NEC"	"Bacterial pneumonia, not elsewhere classified"	1	139	25	164
"O75"	"J96"	"Oth complications of labor and delivery, NEC"	"Respiratory failure, not elsewhere classified"	1	53	11	64
"O75"	"K57"	"Oth complications of labor and delivery, NEC"	"Diverticular disease of intestine"	1	38	0	38
"O75"	"K59"	"Oth complications of labor and delivery, NEC"	"Other functional intestinal disorders"	1	323	200	523
"O75"	"K63"	"Oth complications of labor and delivery, NEC"	"Other diseases of intestine"	1	39	4	43
"O75"	"K90"	"Oth complications of labor and delivery, NEC"	"Intestinal malabsorption"	1	48	10	58
"O75"	"L98"	"Oth complications of labor and delivery, NEC"	"Oth disorders of skin, subcu, not elsewhere classified"	1	95	20	115
"O75"	"M16"	"Oth complications of labor and delivery, NEC"	"Osteoarthritis of hip"	1	44	0	44
"O75"	"M20"	"Oth complications of labor and delivery, NEC"	"Acquired deformities of fingers and toes"	1	156	77	233
"O75"	"M25"	"Oth complications of labor and delivery, NEC"	"Other joint disorder, not elsewhere classified"	1	353	72	425
"O75"	"M51"	"Oth complications of labor and delivery, NEC"	"Thoracic, thoracolum, and lumbosacral intvrt disc disorders"	1	562	19	581
"O75"	"M53"	"Oth complications of labor and delivery, NEC"	"Other and unspecified dorsopathies, not elsewhere classified"	1	183	39	222
"O75"	"M54"	"Oth complications of labor and delivery, NEC"	"Dorsalgia"	1	888	363	1251
"O75"	"M70"	"Oth complications of labor and delivery, NEC"	"Soft tissue disorders related to use, overuse and pressure"	1	115	35	150
"O75"	"M75"	"Oth complications of labor and delivery, NEC"	"Shoulder lesions"	1	484	0	484
"O75"	"M77"	"Oth complications of labor and delivery, NEC"	"Other enthesopathies"	1	186	28	214
"O75"	"N20"	"Oth complications of labor and delivery, NEC"	"Calculus of kidney and ureter"	1	234	102	336
"O75"	"N61"	"Oth complications of labor and delivery, NEC"	"Inflammatory disorders of breast"	1	117	15	132
"O75"	"N63"	"Oth complications of labor and delivery, NEC"	"Unspecified lump in breast"	1	359	124	483
"O75"	"N81"	"Oth complications of labor and delivery, NEC"	"Female genital prolapse"	1	987	0	987
"O75"	"N94"	"Oth complications of labor and delivery, NEC"	"Pain and oth cond assoc w fem gntl org and menstrual cycle"	1	599	332	931
"O75"	"O90"	"Oth complications of labor and delivery, NEC"	"Complications of the puerperium, not elsewhere classified"	1	1920	1214	3134
"O75"	"O91"	"Oth complications of labor and delivery, NEC"	"Infect of breast assoc w pregnancy, the puerp and lactation"	1	1062	296	1358
"O80"	"A04"	"Encounter for full-term uncomplicated delivery"	"Other bacterial intestinal infections"	1	269	109	378
"O80"	"A18"	"Encounter for full-term uncomplicated delivery"	"Tuberculosis of other organs"	1	157	74	231
"O80"	"A26"	"Encounter for full-term uncomplicated delivery"	"Erysipeloid"	1	29	0	29
"O80"	"A40"	"Encounter for full-term uncomplicated delivery"	"Streptococcal sepsis"	1	137	0	137
"O80"	"A48"	"Encounter for full-term uncomplicated delivery"	"Other bacterial diseases, not elsewhere classified"	1	40	3	43
"O80"	"A54"	"Encounter for full-term uncomplicated delivery"	"Gonococcal infection"	1	146	17	163
"O80"	"A69"	"Encounter for full-term uncomplicated delivery"	"Other spirochetal infections"	1	206	26	232
"O80"	"B00"	"Encounter for full-term uncomplicated delivery"	"Herpesviral [herpes simplex] infections"	1	314	161	475
"O80"	"B02"	"Encounter for full-term uncomplicated delivery"	"Zoster [herpes zoster]"	1	180	18	198
"O80"	"B18"	"Encounter for full-term uncomplicated delivery"	"Chronic viral hepatitis"	1	579	62	641
"O80"	"B25"	"Encounter for full-term uncomplicated delivery"	"Cytomegaloviral disease"	1	119	28	147
"O80"	"B80"	"Encounter for full-term uncomplicated delivery"	"Enterobiasis"	1	51	4	55
"O80"	"B95"	"Encounter for full-term uncomplicated delivery"	"Strep as the cause of diseases classified elsewhere"	1	328	55	383
"O80"	"C16"	"Encounter for full-term uncomplicated delivery"	"Malignant neoplasm of stomach"	1	28	0	28
"O80"	"C34"	"Encounter for full-term uncomplicated delivery"	"Malignant neoplasm of bronchus and lung"	1	69	0	69
"O80"	"C56"	"Encounter for full-term uncomplicated delivery"	"Malignant neoplasm of ovary"	1	135	0	135
"O80"	"C77"	"Encounter for full-term uncomplicated delivery"	"Secondary and unspecified malignant neoplasm of lymph nodes"	1	277	0	277
"O80"	"C78"	"Encounter for full-term uncomplicated delivery"	"Secondary malignant neoplasm of resp and digestive organs"	1	188	0	188
"O80"	"C80"	"Encounter for full-term uncomplicated delivery"	"Malignant neoplasm without specification of site"	1	25	0	25
"O80"	"D04"	"Encounter for full-term uncomplicated delivery"	"Carcinoma in situ of skin"	1	25	0	25
"O80"	"D06"	"Encounter for full-term uncomplicated delivery"	"Carcinoma in situ of cervix uteri"	1	1427	702	2129
"O80"	"D07"	"Encounter for full-term uncomplicated delivery"	"Carcinoma in situ of other and unspecified genital organs"	1	115	0	115
"O80"	"D11"	"Encounter for full-term uncomplicated delivery"	"Benign neoplasm of major salivary glands"	1	367	10	377
"O80"	"D12"	"Encounter for full-term uncomplicated delivery"	"Benign neoplasm of colon, rectum, anus and anal canal"	1	663	0	663
"O80"	"D13"	"Encounter for full-term uncomplicated delivery"	"Benign neoplasm of and ill-defined parts of digestive system"	1	220	0	220
"O80"	"D14"	"Encounter for full-term uncomplicated delivery"	"Benign neoplasm of middle ear and respiratory system"	1	291	0	291
"O80"	"D17"	"Encounter for full-term uncomplicated delivery"	"Benign lipomatous neoplasm"	1	2076	0	2076
"O80"	"D24"	"Encounter for full-term uncomplicated delivery"	"Benign neoplasm of breast"	1	4321	0	4321
"O80"	"D27"	"Encounter for full-term uncomplicated delivery"	"Benign neoplasm of ovary"	1	2563	641	3204
"O80"	"D28"	"Encounter for full-term uncomplicated delivery"	"Benign neoplasm of other and unsp female genital organs"	1	779	136	915
"O80"	"D31"	"Encounter for full-term uncomplicated delivery"	"Benign neoplasm of eye and adnexa"	1	118	0	118
"O80"	"D32"	"Encounter for full-term uncomplicated delivery"	"Benign neoplasm of meninges"	1	88	0	88
"O80"	"D35"	"Encounter for full-term uncomplicated delivery"	"Benign neoplasm of other and unspecified endocrine glands"	1	239	0	239
"O80"	"D36"	"Encounter for full-term uncomplicated delivery"	"Benign neoplasm of other and unspecified sites"	1	188	22	210
"O80"	"D37"	"Encounter for full-term uncomplicated delivery"	"Neoplasm of uncrt behavior of oral cavity and dgstv organs"	1	28	1	29
"O80"	"D39"	"Encounter for full-term uncomplicated delivery"	"Neoplasm of uncertain behavior of female genital organs"	1	117	48	165
"O80"	"D44"	"Encounter for full-term uncomplicated delivery"	"Neoplasm of uncertain behavior of endocrine glands"	1	29	2	31
"O80"	"D47"	"Encounter for full-term uncomplicated delivery"	"Oth neoplm of uncrt behav of lymphoid, hematpoetc & rel tiss"	1	54	0	54
"O80"	"D50"	"Encounter for full-term uncomplicated delivery"	"Iron deficiency anemia"	1	1244	0	1244
"O80"	"D52"	"Encounter for full-term uncomplicated delivery"	"Folate deficiency anemia"	1	37	1	38
"O80"	"D53"	"Encounter for full-term uncomplicated delivery"	"Other nutritional anemias"	1	44	3	47
"O80"	"D61"	"Encounter for full-term uncomplicated delivery"	"Oth aplastic anemias and other bone marrow failure syndromes"	1	50	0	50
"O80"	"D62"	"Encounter for full-term uncomplicated delivery"	"Acute posthemorrhagic anemia"	1	601	4	605
"O80"	"D63"	"Encounter for full-term uncomplicated delivery"	"Anemia in chronic diseases classified elsewhere"	1	72	0	72
"O80"	"D64"	"Encounter for full-term uncomplicated delivery"	"Other anemias"	1	1402	0	1402
"O80"	"D69"	"Encounter for full-term uncomplicated delivery"	"Purpura and other hemorrhagic conditions"	1	660	221	881
"O80"	"D75"	"Encounter for full-term uncomplicated delivery"	"Other and unsp diseases of blood and blood-forming organs"	1	139	0	139
"O80"	"D86"	"Encounter for full-term uncomplicated delivery"	"Sarcoidosis"	1	567	73	640
"O80"	"E03"	"Encounter for full-term uncomplicated delivery"	"Other hypothyroidism"	1	4055	0	4055
"O80"	"E04"	"Encounter for full-term uncomplicated delivery"	"Other nontoxic goiter"	1	4121	0	4121
"O80"	"E05"	"Encounter for full-term uncomplicated delivery"	"Thyrotoxicosis [hyperthyroidism]"	1	4319	0	4319
"O80"	"E06"	"Encounter for full-term uncomplicated delivery"	"Thyroiditis"	1	1391	0	1391
"O80"	"E10"	"Encounter for full-term uncomplicated delivery"	"Type 1 diabetes mellitus"	1	627	67	694
"O80"	"E22"	"Encounter for full-term uncomplicated delivery"	"Hyperfunction of pituitary gland"	1	277	121	398
"O80"	"E23"	"Encounter for full-term uncomplicated delivery"	"Hypofunction and other disorders of the pituitary gland"	1	209	0	209
"O80"	"E34"	"Encounter for full-term uncomplicated delivery"	"Other endocrine disorders"	1	199	40	239
"O80"	"E55"	"Encounter for full-term uncomplicated delivery"	"Vitamin D deficiency"	1	979	0	979
"O80"	"E56"	"Encounter for full-term uncomplicated delivery"	"Other vitamin deficiencies"	1	108	0	108
"O80"	"E61"	"Encounter for full-term uncomplicated delivery"	"Deficiency of other nutrient elements"	1	87	0	87
"O80"	"E72"	"Encounter for full-term uncomplicated delivery"	"Other disorders of amino-acid metabolism"	1	47	3	50
"O80"	"E73"	"Encounter for full-term uncomplicated delivery"	"Lactose intolerance"	1	358	35	393
"O80"	"E89"	"Encounter for full-term uncomplicated delivery"	"Postproc endocrine and metabolic comp and disorders, NEC"	1	565	6	571
"O80"	"F06"	"Encounter for full-term uncomplicated delivery"	"Other mental disorders due to known physiological condition"	1	59	0	59
"O80"	"F07"	"Encounter for full-term uncomplicated delivery"	"Personality & behavrl disorders due to known physiol cond"	1	90	16	106
"O80"	"F17"	"Encounter for full-term uncomplicated delivery"	"Nicotine dependence"	1	2165	0	2165
"O80"	"F31"	"Encounter for full-term uncomplicated delivery"	"Bipolar disorder"	1	118	0	118
"O80"	"F32"	"Encounter for full-term uncomplicated delivery"	"Depressive episode"	1	1803	0	1803
"O80"	"F40"	"Encounter for full-term uncomplicated delivery"	"Phobic anxiety disorders"	1	488	167	655
"O80"	"F41"	"Encounter for full-term uncomplicated delivery"	"Other anxiety disorders"	1	1522	0	1522
"O80"	"F44"	"Encounter for full-term uncomplicated delivery"	"Dissociative and conversion disorders"	1	161	23	184
"O80"	"F52"	"Encounter for full-term uncomplicated delivery"	"Sexual dysfnct not due to a substance or known physiol cond"	1	423	96	519
"O80"	"F60"	"Encounter for full-term uncomplicated delivery"	"Specific personality disorders"	1	318	59	377
"O80"	"F90"	"Encounter for full-term uncomplicated delivery"	"Attention-deficit hyperactivity disorders"	1	97	16	113
"O80"	"F99"	"Encounter for full-term uncomplicated delivery"	"Mental disorder, not otherwise specified"	1	198	96	294
"O80"	"G04"	"Encounter for full-term uncomplicated delivery"	"Encephalitis, myelitis and encephalomyelitis"	1	87	10	97
"O80"	"G24"	"Encounter for full-term uncomplicated delivery"	"Dystonia"	1	160	0	160
"O80"	"G25"	"Encounter for full-term uncomplicated delivery"	"Other extrapyramidal and movement disorders"	1	79	0	79
"O80"	"G35"	"Encounter for full-term uncomplicated delivery"	"Multiple sclerosis"	1	911	8	919
"O80"	"G44"	"Encounter for full-term uncomplicated delivery"	"Other headache syndromes"	1	2840	0	2840
"O80"	"G45"	"Encounter for full-term uncomplicated delivery"	"Transient cerebral ischemic attacks and related syndromes"	1	437	0	437
"O80"	"G47"	"Encounter for full-term uncomplicated delivery"	"Sleep disorders"	1	703	0	703
"O80"	"G50"	"Encounter for full-term uncomplicated delivery"	"Disorders of trigeminal nerve"	1	318	0	318
"O80"	"G51"	"Encounter for full-term uncomplicated delivery"	"Facial nerve disorders"	1	737	115	852
"O80"	"G52"	"Encounter for full-term uncomplicated delivery"	"Disorders of other cranial nerves"	1	34	0	34
"O80"	"G54"	"Encounter for full-term uncomplicated delivery"	"Nerve root and plexus disorders"	1	302	0	302
"O80"	"G57"	"Encounter for full-term uncomplicated delivery"	"Mononeuropathies of lower limb"	1	567	0	567
"O80"	"G58"	"Encounter for full-term uncomplicated delivery"	"Other mononeuropathies"	1	62	0	62
"O80"	"G70"	"Encounter for full-term uncomplicated delivery"	"Myasthenia gravis and other myoneural disorders"	1	49	5	54
"O80"	"G72"	"Encounter for full-term uncomplicated delivery"	"Other and unspecified myopathies"	1	55	0	55
"O80"	"G83"	"Encounter for full-term uncomplicated delivery"	"Other paralytic syndromes"	1	148	1	149
"O80"	"G90"	"Encounter for full-term uncomplicated delivery"	"Disorders of autonomic nervous system"	1	101	9	110
"O80"	"G91"	"Encounter for full-term uncomplicated delivery"	"Hydrocephalus"	1	98	0	98
"O80"	"G95"	"Encounter for full-term uncomplicated delivery"	"Other and unspecified diseases of spinal cord"	1	97	0	97
"O80"	"G96"	"Encounter for full-term uncomplicated delivery"	"Other disorders of central nervous system"	1	824	0	824
"O80"	"G97"	"Encounter for full-term uncomplicated delivery"	"Intraop and postproc comp and disorders of nervous sys, NEC"	1	328	3	331
"O80"	"H00"	"Encounter for full-term uncomplicated delivery"	"Hordeolum and chalazion"	1	414	192	606
"O80"	"H04"	"Encounter for full-term uncomplicated delivery"	"Disorders of lacrimal system"	1	223	1	224
"O80"	"H05"	"Encounter for full-term uncomplicated delivery"	"Disorders of orbit"	1	206	11	217
"O80"	"H10"	"Encounter for full-term uncomplicated delivery"	"Conjunctivitis"	1	2221	1582	3803
"O80"	"H15"	"Encounter for full-term uncomplicated delivery"	"Disorders of sclera"	1	142	2	144
"O80"	"H18"	"Encounter for full-term uncomplicated delivery"	"Other disorders of cornea"	1	384	0	384
"O80"	"H26"	"Encounter for full-term uncomplicated delivery"	"Other cataract"	1	243	0	243
"O80"	"H33"	"Encounter for full-term uncomplicated delivery"	"Retinal detachments and breaks"	1	210	0	210
"O80"	"H34"	"Encounter for full-term uncomplicated delivery"	"Retinal vascular occlusions"	1	48	0	48
"O80"	"H35"	"Encounter for full-term uncomplicated delivery"	"Other retinal disorders"	1	447	0	447
"O80"	"H40"	"Encounter for full-term uncomplicated delivery"	"Glaucoma"	1	158	0	158
"O80"	"H46"	"Encounter for full-term uncomplicated delivery"	"Optic neuritis"	1	282	39	321
"O80"	"H47"	"Encounter for full-term uncomplicated delivery"	"Other disorders of optic [2nd] nerve and visual pathways"	1	171	8	179
"O80"	"H54"	"Encounter for full-term uncomplicated delivery"	"Blindness and low vision"	1	151	0	151
"O80"	"H57"	"Encounter for full-term uncomplicated delivery"	"Other disorders of eye and adnexa"	1	801	0	801
"O80"	"H60"	"Encounter for full-term uncomplicated delivery"	"Otitis externa"	1	730	195	925
"O80"	"H62"	"Encounter for full-term uncomplicated delivery"	"Disorders of external ear in diseases classified elsewhere"	1	37	5	42
"O80"	"H81"	"Encounter for full-term uncomplicated delivery"	"Disorders of vestibular function"	1	1469	0	1469
"O80"	"H82"	"Encounter for full-term uncomplicated delivery"	"Vertiginous syndromes in diseases classified elsewhere"	1	53	0	53
"O80"	"H91"	"Encounter for full-term uncomplicated delivery"	"Other and unspecified hearing loss"	1	1387	0	1387
"O80"	"H92"	"Encounter for full-term uncomplicated delivery"	"Otalgia and effusion of ear"	1	180	9	189
"O80"	"H93"	"Encounter for full-term uncomplicated delivery"	"Other disorders of ear, not elsewhere classified"	1	1114	0	1114
"O80"	"I10"	"Encounter for full-term uncomplicated delivery"	"Essential (primary) hypertension"	1	2490	0	2490
"O80"	"I24"	"Encounter for full-term uncomplicated delivery"	"Other acute ischemic heart diseases"	1	29	0	29
"O80"	"I26"	"Encounter for full-term uncomplicated delivery"	"Pulmonary embolism"	1	611	0	611
"O80"	"I30"	"Encounter for full-term uncomplicated delivery"	"Acute pericarditis"	1	147	2	149
"O80"	"I31"	"Encounter for full-term uncomplicated delivery"	"Other diseases of pericardium"	1	42	0	42
"O80"	"I34"	"Encounter for full-term uncomplicated delivery"	"Nonrheumatic mitral valve disorders"	1	166	0	166
"O80"	"I35"	"Encounter for full-term uncomplicated delivery"	"Nonrheumatic aortic valve disorders"	1	198	0	198
"O80"	"I42"	"Encounter for full-term uncomplicated delivery"	"Cardiomyopathy"	1	152	0	152
"O80"	"I44"	"Encounter for full-term uncomplicated delivery"	"Atrioventricular and left bundle-branch block"	1	107	0	107
"O80"	"I47"	"Encounter for full-term uncomplicated delivery"	"Paroxysmal tachycardia"	1	1382	199	1581
"O80"	"I51"	"Encounter for full-term uncomplicated delivery"	"Complications and ill-defined descriptions of heart disease"	1	276	53	329
"O80"	"I61"	"Encounter for full-term uncomplicated delivery"	"Nontraumatic intracerebral hemorrhage"	1	126	0	126
"O80"	"I65"	"Encounter for full-term uncomplicated delivery"	"Occls and stenosis of precerb art, not rslt in cereb infrc"	1	48	0	48
"O80"	"I69"	"Encounter for full-term uncomplicated delivery"	"Sequelae of cerebrovascular disease"	1	238	0	238
"O80"	"I73"	"Encounter for full-term uncomplicated delivery"	"Other peripheral vascular diseases"	1	368	0	368
"O80"	"I74"	"Encounter for full-term uncomplicated delivery"	"Arterial embolism and thrombosis"	1	66	0	66
"O80"	"I80"	"Encounter for full-term uncomplicated delivery"	"Phlebitis and thrombophlebitis"	1	1743	0	1743
"O80"	"I86"	"Encounter for full-term uncomplicated delivery"	"Varicose veins of other sites"	1	189	0	189
"O80"	"I89"	"Encounter for full-term uncomplicated delivery"	"Oth noninfective disorders of lymphatic vessels and nodes"	1	273	0	273
"O80"	"I95"	"Encounter for full-term uncomplicated delivery"	"Hypotension"	1	249	33	282
"O80"	"J02"	"Encounter for full-term uncomplicated delivery"	"Acute pharyngitis"	1	515	261	776
"O80"	"J03"	"Encounter for full-term uncomplicated delivery"	"Acute tonsillitis"	1	3832	1926	5758
"O80"	"J04"	"Encounter for full-term uncomplicated delivery"	"Acute laryngitis and tracheitis"	1	239	114	353
"O80"	"J11"	"Encounter for full-term uncomplicated delivery"	"Influenza due to unidentified influenza virus"	1	800	358	1158
"O80"	"J15"	"Encounter for full-term uncomplicated delivery"	"Bacterial pneumonia, not elsewhere classified"	1	1261	0	1261
"O80"	"J22"	"Encounter for full-term uncomplicated delivery"	"Unspecified acute lower respiratory infection"	1	151	0	151
"O80"	"J30"	"Encounter for full-term uncomplicated delivery"	"Vasomotor and allergic rhinitis"	1	1494	1047	2541
"O80"	"J37"	"Encounter for full-term uncomplicated delivery"	"Chronic laryngitis and laryngotracheitis"	1	106	20	126
"O80"	"J40"	"Encounter for full-term uncomplicated delivery"	"Bronchitis, not specified as acute or chronic"	1	112	11	123
"O80"	"J41"	"Encounter for full-term uncomplicated delivery"	"Simple and mucopurulent chronic bronchitis"	1	48	4	52
"O80"	"J45"	"Encounter for full-term uncomplicated delivery"	"Asthma"	1	3624	2298	5922
"O80"	"J47"	"Encounter for full-term uncomplicated delivery"	"Bronchiectasis"	1	154	0	154
"O80"	"J67"	"Encounter for full-term uncomplicated delivery"	"Hypersensitivity pneumonitis due to organic dust"	1	29	0	29
"O80"	"J85"	"Encounter for full-term uncomplicated delivery"	"Abscess of lung and mediastinum"	1	30	0	30
"O80"	"J90"	"Encounter for full-term uncomplicated delivery"	"Pleural effusion, not elsewhere classified"	1	113	0	113
"O80"	"J91"	"Encounter for full-term uncomplicated delivery"	"Pleural effusion in conditions classified elsewhere"	1	44	0	44
"O80"	"J93"	"Encounter for full-term uncomplicated delivery"	"Pneumothorax and air leak"	1	299	42	341
"O80"	"J94"	"Encounter for full-term uncomplicated delivery"	"Other pleural conditions"	1	59	0	59
"O80"	"J98"	"Encounter for full-term uncomplicated delivery"	"Other respiratory disorders"	1	270	3	273
"O80"	"K02"	"Encounter for full-term uncomplicated delivery"	"Dental caries"	1	291	68	359
"O80"	"K04"	"Encounter for full-term uncomplicated delivery"	"Diseases of pulp and periapical tissues"	1	674	13	687
"O80"	"K06"	"Encounter for full-term uncomplicated delivery"	"Other disorders of gingiva and edentulous alveolar ridge"	1	89	18	107
"O80"	"K12"	"Encounter for full-term uncomplicated delivery"	"Stomatitis and related lesions"	1	439	81	520
"O80"	"K14"	"Encounter for full-term uncomplicated delivery"	"Diseases of tongue"	1	101	11	112
"O80"	"K21"	"Encounter for full-term uncomplicated delivery"	"Gastro-esophageal reflux disease"	1	2239	0	2239
"O80"	"K30"	"Encounter for full-term uncomplicated delivery"	"Functional dyspepsia"	1	3751	0	3751
"O80"	"K40"	"Encounter for full-term uncomplicated delivery"	"Inguinal hernia"	1	1006	190	1196
"O80"	"K45"	"Encounter for full-term uncomplicated delivery"	"Other abdominal hernia"	1	607	0	607
"O80"	"K46"	"Encounter for full-term uncomplicated delivery"	"Unspecified abdominal hernia"	1	116	0	116
"O80"	"K50"	"Encounter for full-term uncomplicated delivery"	"Crohn's disease [regional enteritis]"	1	625	302	927
"O80"	"K51"	"Encounter for full-term uncomplicated delivery"	"Ulcerative colitis"	1	1489	426	1915
"O80"	"K55"	"Encounter for full-term uncomplicated delivery"	"Vascular disorders of intestine"	1	34	0	34
"O80"	"K58"	"Encounter for full-term uncomplicated delivery"	"Irritable bowel syndrome"	1	2002	706	2708
"O80"	"K60"	"Encounter for full-term uncomplicated delivery"	"Fissure and fistula of anal and rectal regions"	1	2792	0	2792
"O80"	"K61"	"Encounter for full-term uncomplicated delivery"	"Abscess of anal and rectal regions"	1	832	156	988
"O80"	"K62"	"Encounter for full-term uncomplicated delivery"	"Other diseases of anus and rectum"	1	2148	0	2148
"O80"	"K63"	"Encounter for full-term uncomplicated delivery"	"Other diseases of intestine"	1	260	0	260
"O80"	"K64"	"Encounter for full-term uncomplicated delivery"	"Hemorrhoids and perianal venous thrombosis"	1	2181	0	2181
"O80"	"K65"	"Encounter for full-term uncomplicated delivery"	"Peritonitis"	1	381	5	386
"O80"	"K75"	"Encounter for full-term uncomplicated delivery"	"Other inflammatory liver diseases"	1	81	0	81
"O80"	"K77"	"Encounter for full-term uncomplicated delivery"	"Liver disorders in diseases classified elsewhere"	1	27	2	29
"O80"	"K83"	"Encounter for full-term uncomplicated delivery"	"Other diseases of biliary tract"	1	504	0	504
"O80"	"K85"	"Encounter for full-term uncomplicated delivery"	"Acute pancreatitis"	1	1209	40	1249
"O80"	"K86"	"Encounter for full-term uncomplicated delivery"	"Other diseases of pancreas"	1	151	0	151
"O80"	"K92"	"Encounter for full-term uncomplicated delivery"	"Other diseases of digestive system"	1	574	104	678
"O80"	"L03"	"Encounter for full-term uncomplicated delivery"	"Cellulitis and acute lymphangitis"	1	998	639	1637
"O80"	"L08"	"Encounter for full-term uncomplicated delivery"	"Other local infections of skin and subcutaneous tissue"	1	1489	241	1730
"O80"	"L21"	"Encounter for full-term uncomplicated delivery"	"Seborrheic dermatitis"	1	134	32	166
"O80"	"L27"	"Encounter for full-term uncomplicated delivery"	"Dermatitis due to substances taken internally"	1	111	21	132
"O80"	"L40"	"Encounter for full-term uncomplicated delivery"	"Psoriasis"	1	852	70	922
"O80"	"L43"	"Encounter for full-term uncomplicated delivery"	"Lichen planus"	1	123	0	123
"O80"	"L50"	"Encounter for full-term uncomplicated delivery"	"Urticaria"	1	1701	566	2267
"O80"	"L65"	"Encounter for full-term uncomplicated delivery"	"Other nonscarring hair loss"	1	77	4	81
"O80"	"L71"	"Encounter for full-term uncomplicated delivery"	"Rosacea"	1	431	0	431
"O80"	"L72"	"Encounter for full-term uncomplicated delivery"	"Follicular cysts of skin and subcutaneous tissue"	1	643	0	643
"O80"	"L73"	"Encounter for full-term uncomplicated delivery"	"Other follicular disorders"	1	733	177	910
"O80"	"L81"	"Encounter for full-term uncomplicated delivery"	"Other disorders of pigmentation"	1	367	50	417
"O80"	"L93"	"Encounter for full-term uncomplicated delivery"	"Lupus erythematosus"	1	105	2	107
"O80"	"L98"	"Encounter for full-term uncomplicated delivery"	"Oth disorders of skin, subcu, not elsewhere classified"	1	792	18	810
"O80"	"M06"	"Encounter for full-term uncomplicated delivery"	"Other rheumatoid arthritis"	1	752	12	764
"O80"	"M10"	"Encounter for full-term uncomplicated delivery"	"Gout"	1	95	1	96
"O80"	"M18"	"Encounter for full-term uncomplicated delivery"	"Osteoarthritis of first carpometacarpal joint"	1	111	0	111
"O80"	"M19"	"Encounter for full-term uncomplicated delivery"	"Other and unspecified osteoarthritis"	1	777	0	777
"O80"	"M20"	"Encounter for full-term uncomplicated delivery"	"Acquired deformities of fingers and toes"	1	2578	0	2578
"O80"	"M21"	"Encounter for full-term uncomplicated delivery"	"Other acquired deformities of limbs"	1	807	124	931
"O80"	"M25"	"Encounter for full-term uncomplicated delivery"	"Other joint disorder, not elsewhere classified"	1	3630	0	3630
"O80"	"M43"	"Encounter for full-term uncomplicated delivery"	"Other deforming dorsopathies"	1	570	15	585
"O80"	"M46"	"Encounter for full-term uncomplicated delivery"	"Other inflammatory spondylopathies"	1	573	0	573
"O80"	"M51"	"Encounter for full-term uncomplicated delivery"	"Thoracic, thoracolum, and lumbosacral intvrt disc disorders"	1	5631	0	5631
"O80"	"M53"	"Encounter for full-term uncomplicated delivery"	"Other and unspecified dorsopathies, not elsewhere classified"	1	1706	0	1706
"O80"	"M54"	"Encounter for full-term uncomplicated delivery"	"Dorsalgia"	1	12741	0	12741
"O80"	"M65"	"Encounter for full-term uncomplicated delivery"	"Synovitis and tenosynovitis"	1	4450	0	4450
"O80"	"M66"	"Encounter for full-term uncomplicated delivery"	"Spontaneous rupture of synovium and tendon"	1	116	0	116
"O80"	"M67"	"Encounter for full-term uncomplicated delivery"	"Other disorders of synovium and tendon"	1	4823	0	4823
"O80"	"M72"	"Encounter for full-term uncomplicated delivery"	"Fibroblastic disorders"	1	557	0	557
"O80"	"M79"	"Encounter for full-term uncomplicated delivery"	"Oth and unsp soft tissue disorders, not elsewhere classified"	1	8748	0	8748
"O80"	"M80"	"Encounter for full-term uncomplicated delivery"	"Osteoporosis with current pathological fracture"	1	33	0	33
"O80"	"M81"	"Encounter for full-term uncomplicated delivery"	"Osteoporosis without current pathological fracture"	1	350	0	350
"O80"	"M85"	"Encounter for full-term uncomplicated delivery"	"Other disorders of bone density and structure"	1	457	0	457
"O80"	"M89"	"Encounter for full-term uncomplicated delivery"	"Other disorders of bone"	1	259	53	312
"O80"	"M94"	"Encounter for full-term uncomplicated delivery"	"Other disorders of cartilage"	1	172	40	212
"O80"	"M95"	"Encounter for full-term uncomplicated delivery"	"Oth acquired deformities of ms sys and connective tissue"	1	481	165	646
"O80"	"M99"	"Encounter for full-term uncomplicated delivery"	"Biomechanical lesions, not elsewhere classified"	1	494	0	494
"O80"	"N13"	"Encounter for full-term uncomplicated delivery"	"Obstructive and reflux uropathy"	1	763	293	1056
"O80"	"N15"	"Encounter for full-term uncomplicated delivery"	"Other renal tubulo-interstitial diseases"	1	42	5	47
"O80"	"N17"	"Encounter for full-term uncomplicated delivery"	"Acute kidney failure"	1	82	0	82
"O80"	"N28"	"Encounter for full-term uncomplicated delivery"	"Oth disorders of kidney and ureter, not elsewhere classified"	1	141	19	160
"O80"	"N30"	"Encounter for full-term uncomplicated delivery"	"Cystitis"	1	4800	2726	7526
"O80"	"N32"	"Encounter for full-term uncomplicated delivery"	"Other disorders of bladder"	1	176	0	176
"O80"	"N35"	"Encounter for full-term uncomplicated delivery"	"Urethral stricture"	1	44	0	44
"O80"	"N36"	"Encounter for full-term uncomplicated delivery"	"Other disorders of urethra"	1	280	43	323
"O80"	"N64"	"Encounter for full-term uncomplicated delivery"	"Other disorders of breast"	1	6366	0	6366
"O80"	"N71"	"Encounter for full-term uncomplicated delivery"	"Inflammatory disease of uterus, except cervix"	1	3829	1265	5094
"O80"	"N76"	"Encounter for full-term uncomplicated delivery"	"Other inflammation of vagina and vulva"	1	2016	818	2834
"O80"	"N81"	"Encounter for full-term uncomplicated delivery"	"Female genital prolapse"	1	7099	0	7099
"O80"	"N83"	"Encounter for full-term uncomplicated delivery"	"Noninflammatory disord of ovary, fallop and broad ligament"	1	7593	0	7593
"O80"	"N84"	"Encounter for full-term uncomplicated delivery"	"Polyp of female genital tract"	1	2472	0	2472
"O80"	"N89"	"Encounter for full-term uncomplicated delivery"	"Other noninflammatory disorders of vagina"	1	1082	230	1312
"O80"	"N90"	"Encounter for full-term uncomplicated delivery"	"Other noninflammatory disorders of vulva and perineum"	1	1901	322	2223
"O80"	"N93"	"Encounter for full-term uncomplicated delivery"	"Other abnormal uterine and vaginal bleeding"	1	5181	0	5181
"O80"	"N99"	"Encounter for full-term uncomplicated delivery"	"Intraop and postproc comp and disorders of GU sys, NEC"	1	1150	145	1295
"O80"	"O07"	"Encounter for full-term uncomplicated delivery"	"Failed attempted termination of pregnancy"	1	214	101	315
"O80"	"O30"	"Encounter for full-term uncomplicated delivery"	"Multiple gestation"	1	7584	0	7584
"O80"	"O40"	"Encounter for full-term uncomplicated delivery"	"Polyhydramnios"	1	1734	1096	2830
"O80"	"O44"	"Encounter for full-term uncomplicated delivery"	"Placenta previa"	1	1561	842	2403
"O80"	"O82"	"Encounter for full-term uncomplicated delivery"	"Encounter for cesarean delivery without indication"	1	14027	9926	23953
"O80"	"Q07"	"Encounter for full-term uncomplicated delivery"	"Other congenital malformations of nervous system"	1	43	4	47
"O80"	"Q18"	"Encounter for full-term uncomplicated delivery"	"Other congenital malformations of face and neck"	1	776	474	1250
"O80"	"Q28"	"Encounter for full-term uncomplicated delivery"	"Other congenital malformations of circulatory system"	1	114	36	150
"O80"	"Q40"	"Encounter for full-term uncomplicated delivery"	"Other congenital malformations of upper alimentary tract"	1	93	0	93
"O80"	"Q61"	"Encounter for full-term uncomplicated delivery"	"Cystic kidney disease"	1	209	0	209
"O80"	"Q83"	"Encounter for full-term uncomplicated delivery"	"Congenital malformations of breast"	1	616	282	898
"O82"	"A40"	"Encounter for cesarean delivery without indication"	"Streptococcal sepsis"	1	50	3	53
"O82"	"A41"	"Encounter for cesarean delivery without indication"	"Other sepsis"	1	429	32	461
"O82"	"A46"	"Encounter for cesarean delivery without indication"	"Erysipelas"	1	307	14	321
"O82"	"A49"	"Encounter for cesarean delivery without indication"	"Bacterial infection of unspecified site"	1	450	78	528
"O82"	"B18"	"Encounter for cesarean delivery without indication"	"Chronic viral hepatitis"	1	173	69	242
"O82"	"B96"	"Encounter for cesarean delivery without indication"	"Oth bacterial agents as the cause of diseases classd elswhr"	1	33	4	37
"O82"	"C18"	"Encounter for cesarean delivery without indication"	"Malignant neoplasm of colon"	1	47	0	47
"O82"	"C43"	"Encounter for cesarean delivery without indication"	"Malignant melanoma of skin"	1	322	24	346
"O82"	"C50"	"Encounter for cesarean delivery without indication"	"Malignant neoplasm of breast"	1	447	0	447
"O82"	"C53"	"Encounter for cesarean delivery without indication"	"Malignant neoplasm of cervix uteri"	1	167	23	190
"O82"	"C73"	"Encounter for cesarean delivery without indication"	"Malignant neoplasm of thyroid gland"	1	92	1	93
"O82"	"C77"	"Encounter for cesarean delivery without indication"	"Secondary and unspecified malignant neoplasm of lymph nodes"	1	118	0	118
"O82"	"C79"	"Encounter for cesarean delivery without indication"	"Secondary malignant neoplasm of other and unspecified sites"	1	88	0	88
"O82"	"D10"	"Encounter for cesarean delivery without indication"	"Benign neoplasm of mouth and pharynx"	1	136	16	152
"O82"	"D11"	"Encounter for cesarean delivery without indication"	"Benign neoplasm of major salivary glands"	1	84	18	102
"O82"	"D12"	"Encounter for cesarean delivery without indication"	"Benign neoplasm of colon, rectum, anus and anal canal"	1	266	0	266
"O82"	"D14"	"Encounter for cesarean delivery without indication"	"Benign neoplasm of middle ear and respiratory system"	1	116	14	130
"O82"	"D24"	"Encounter for cesarean delivery without indication"	"Benign neoplasm of breast"	1	915	419	1334
"O82"	"D25"	"Encounter for cesarean delivery without indication"	"Leiomyoma of uterus"	1	1382	129	1511
"O82"	"D30"	"Encounter for cesarean delivery without indication"	"Benign neoplasm of urinary organs"	1	29	0	29
"O82"	"D33"	"Encounter for cesarean delivery without indication"	"Benign neoplasm of brain and oth prt central nervous system"	1	61	17	78
"O82"	"D47"	"Encounter for cesarean delivery without indication"	"Oth neoplm of uncrt behav of lymphoid, hematpoetc & rel tiss"	1	48	0	48
"O82"	"D62"	"Encounter for cesarean delivery without indication"	"Acute posthemorrhagic anemia"	1	240	64	304
"O82"	"D72"	"Encounter for cesarean delivery without indication"	"Other disorders of white blood cells"	1	40	0	40
"O82"	"D86"	"Encounter for cesarean delivery without indication"	"Sarcoidosis"	1	190	59	249
"O82"	"E05"	"Encounter for cesarean delivery without indication"	"Thyrotoxicosis [hyperthyroidism]"	1	1150	299	1449
"O82"	"E11"	"Encounter for cesarean delivery without indication"	"Type 2 diabetes mellitus"	1	908	0	908
"O82"	"E13"	"Encounter for cesarean delivery without indication"	"Other specified diabetes mellitus"	1	65	6	71
"O82"	"E27"	"Encounter for cesarean delivery without indication"	"Other disorders of adrenal gland"	1	76	7	83
"O82"	"E68"	"Encounter for cesarean delivery without indication"	"Sequelae of hyperalimentation"	1	735	0	735
"O82"	"E88"	"Encounter for cesarean delivery without indication"	"Other and unspecified metabolic disorders"	1	101	22	123
"O82"	"F17"	"Encounter for cesarean delivery without indication"	"Nicotine dependence"	1	922	102	1024
"O82"	"F31"	"Encounter for cesarean delivery without indication"	"Bipolar disorder"	1	50	12	62
"O82"	"F32"	"Encounter for cesarean delivery without indication"	"Depressive episode"	1	569	237	806
"O82"	"G25"	"Encounter for cesarean delivery without indication"	"Other extrapyramidal and movement disorders"	1	37	0	37
"O82"	"G35"	"Encounter for cesarean delivery without indication"	"Multiple sclerosis"	1	234	73	307
"O82"	"G37"	"Encounter for cesarean delivery without indication"	"Other demyelinating diseases of central nervous system"	1	80	23	103
"O82"	"G45"	"Encounter for cesarean delivery without indication"	"Transient cerebral ischemic attacks and related syndromes"	1	236	0	236
"O82"	"G51"	"Encounter for cesarean delivery without indication"	"Facial nerve disorders"	1	252	118	370
"O82"	"G54"	"Encounter for cesarean delivery without indication"	"Nerve root and plexus disorders"	1	125	22	147
"O82"	"G55"	"Encounter for cesarean delivery without indication"	"Nerve root and plexus compressions in diseases classd elswhr"	1	37	5	42
"O82"	"G57"	"Encounter for cesarean delivery without indication"	"Mononeuropathies of lower limb"	1	266	44	310
"O82"	"G62"	"Encounter for cesarean delivery without indication"	"Other and unspecified polyneuropathies"	1	116	0	116
"O82"	"G91"	"Encounter for cesarean delivery without indication"	"Hydrocephalus"	1	55	12	67
"O82"	"G95"	"Encounter for cesarean delivery without indication"	"Other and unspecified diseases of spinal cord"	1	67	1	68
"O82"	"G96"	"Encounter for cesarean delivery without indication"	"Other disorders of central nervous system"	1	426	0	426
"O82"	"G97"	"Encounter for cesarean delivery without indication"	"Intraop and postproc comp and disorders of nervous sys, NEC"	1	146	19	165
"O82"	"H04"	"Encounter for cesarean delivery without indication"	"Disorders of lacrimal system"	1	67	7	74
"O82"	"H25"	"Encounter for cesarean delivery without indication"	"Age-related cataract"	1	108	0	108
"O82"	"H40"	"Encounter for cesarean delivery without indication"	"Glaucoma"	1	92	0	92
"O82"	"H52"	"Encounter for cesarean delivery without indication"	"Disorders of refraction and accommodation"	1	855	316	1171
"O82"	"H53"	"Encounter for cesarean delivery without indication"	"Visual disturbances"	1	333	60	393
"O82"	"H81"	"Encounter for cesarean delivery without indication"	"Disorders of vestibular function"	1	510	110	620
"O82"	"H91"	"Encounter for cesarean delivery without indication"	"Other and unspecified hearing loss"	1	450	53	503
"O82"	"H93"	"Encounter for cesarean delivery without indication"	"Other disorders of ear, not elsewhere classified"	1	405	37	442
"O82"	"I15"	"Encounter for cesarean delivery without indication"	"Secondary hypertension"	1	292	86	378
"O82"	"I25"	"Encounter for cesarean delivery without indication"	"Chronic ischemic heart disease"	1	140	0	140
"O82"	"I26"	"Encounter for cesarean delivery without indication"	"Pulmonary embolism"	1	258	60	318
"O82"	"I34"	"Encounter for cesarean delivery without indication"	"Nonrheumatic mitral valve disorders"	1	109	17	126
"O82"	"I35"	"Encounter for cesarean delivery without indication"	"Nonrheumatic aortic valve disorders"	1	98	0	98
"O82"	"I42"	"Encounter for cesarean delivery without indication"	"Cardiomyopathy"	1	107	9	116
"O82"	"I46"	"Encounter for cesarean delivery without indication"	"Cardiac arrest"	1	57	0	57
"O82"	"I49"	"Encounter for cesarean delivery without indication"	"Other cardiac arrhythmias"	1	516	61	577
"O82"	"I50"	"Encounter for cesarean delivery without indication"	"Heart failure"	1	129	0	129
"O82"	"I51"	"Encounter for cesarean delivery without indication"	"Complications and ill-defined descriptions of heart disease"	1	141	38	179
"O82"	"I60"	"Encounter for cesarean delivery without indication"	"Nontraumatic subarachnoid hemorrhage"	1	100	29	129
"O82"	"I63"	"Encounter for cesarean delivery without indication"	"Cerebral infarction"	1	197	0	197
"O82"	"I67"	"Encounter for cesarean delivery without indication"	"Other cerebrovascular diseases"	1	113	12	125
"O82"	"I74"	"Encounter for cesarean delivery without indication"	"Arterial embolism and thrombosis"	1	47	2	49
"O82"	"I78"	"Encounter for cesarean delivery without indication"	"Diseases of capillaries"	1	189	57	246
"O82"	"I82"	"Encounter for cesarean delivery without indication"	"Other venous embolism and thrombosis"	1	128	19	147
"O82"	"I83"	"Encounter for cesarean delivery without indication"	"Varicose veins of lower extremities"	1	2560	0	2560
"O82"	"I87"	"Encounter for cesarean delivery without indication"	"Other disorders of veins"	1	105	5	110
"O82"	"I89"	"Encounter for cesarean delivery without indication"	"Oth noninfective disorders of lymphatic vessels and nodes"	1	127	0	127
"O82"	"I97"	"Encounter for cesarean delivery without indication"	"Intraop and postproc comp and disorders of circ sys, NEC"	1	39	0	39
"O82"	"J01"	"Encounter for cesarean delivery without indication"	"Acute sinusitis"	1	690	132	822
"O82"	"J09"	"Encounter for cesarean delivery without indication"	"Influenza due to certain identified influenza viruses"	1	65	4	69
"O82"	"J18"	"Encounter for cesarean delivery without indication"	"Pneumonia, unspecified organism"	1	1867	344	2211
"O82"	"J33"	"Encounter for cesarean delivery without indication"	"Nasal polyp"	1	94	27	121
"O82"	"J44"	"Encounter for cesarean delivery without indication"	"Other chronic obstructive pulmonary disease"	1	213	0	213
"O82"	"J47"	"Encounter for cesarean delivery without indication"	"Bronchiectasis"	1	82	0	82
"O82"	"J84"	"Encounter for cesarean delivery without indication"	"Other interstitial pulmonary diseases"	1	58	0	58
"O82"	"J90"	"Encounter for cesarean delivery without indication"	"Pleural effusion, not elsewhere classified"	1	65	3	68
"O82"	"J98"	"Encounter for cesarean delivery without indication"	"Other respiratory disorders"	1	103	20	123
"O82"	"K08"	"Encounter for cesarean delivery without indication"	"Other disorders of teeth and supporting structures"	1	133	56	189
"O82"	"K11"	"Encounter for cesarean delivery without indication"	"Diseases of salivary glands"	1	125	48	173
"O82"	"K12"	"Encounter for cesarean delivery without indication"	"Stomatitis and related lesions"	1	128	56	184
"O82"	"K20"	"Encounter for cesarean delivery without indication"	"Esophagitis"	1	132	32	164
"O82"	"K31"	"Encounter for cesarean delivery without indication"	"Other diseases of stomach and duodenum"	1	28	0	28
"O82"	"K40"	"Encounter for cesarean delivery without indication"	"Inguinal hernia"	1	302	120	422
"O82"	"K52"	"Encounter for cesarean delivery without indication"	"Other and unsp noninfective gastroenteritis and colitis"	1	544	315	859
"O82"	"K59"	"Encounter for cesarean delivery without indication"	"Other functional intestinal disorders"	1	1518	649	2167
"O82"	"K60"	"Encounter for cesarean delivery without indication"	"Fissure and fistula of anal and rectal regions"	1	598	326	924
"O82"	"K62"	"Encounter for cesarean delivery without indication"	"Other diseases of anus and rectum"	1	784	138	922
"O82"	"K63"	"Encounter for cesarean delivery without indication"	"Other diseases of intestine"	1	155	29	184
"O82"	"K65"	"Encounter for cesarean delivery without indication"	"Peritonitis"	1	302	73	375
"O82"	"K75"	"Encounter for cesarean delivery without indication"	"Other inflammatory liver diseases"	1	36	4	40
"O82"	"K80"	"Encounter for cesarean delivery without indication"	"Cholelithiasis"	1	6141	0	6141
"O82"	"K81"	"Encounter for cesarean delivery without indication"	"Cholecystitis"	1	427	39	466
"O82"	"K85"	"Encounter for cesarean delivery without indication"	"Acute pancreatitis"	1	409	89	498
"O82"	"K86"	"Encounter for cesarean delivery without indication"	"Other diseases of pancreas"	1	66	0	66
"O82"	"K91"	"Encounter for cesarean delivery without indication"	"Intraop and postproc comp and disorders of dgstv sys, NEC"	1	133	43	176
"O82"	"L40"	"Encounter for cesarean delivery without indication"	"Psoriasis"	1	306	92	398
"O82"	"L71"	"Encounter for cesarean delivery without indication"	"Rosacea"	1	172	25	197
"O82"	"L98"	"Encounter for cesarean delivery without indication"	"Oth disorders of skin, subcu, not elsewhere classified"	1	409	63	472
"O82"	"M06"	"Encounter for cesarean delivery without indication"	"Other rheumatoid arthritis"	1	283	80	363
"O82"	"M07"	"Encounter for cesarean delivery without indication"	"Enteropathic arthropathies"	1	270	0	270
"O82"	"M18"	"Encounter for cesarean delivery without indication"	"Osteoarthritis of first carpometacarpal joint"	1	69	0	69
"O82"	"M23"	"Encounter for cesarean delivery without indication"	"Internal derangement of knee"	1	1664	1170	2834
"O82"	"M31"	"Encounter for cesarean delivery without indication"	"Other necrotizing vasculopathies"	1	46	7	53
"O82"	"M48"	"Encounter for cesarean delivery without indication"	"Other spondylopathies"	1	169	0	169
"O82"	"M50"	"Encounter for cesarean delivery without indication"	"Cervical disc disorders"	1	641	0	641
"O82"	"M51"	"Encounter for cesarean delivery without indication"	"Thoracic, thoracolum, and lumbosacral intvrt disc disorders"	1	2342	0	2342
"O82"	"M53"	"Encounter for cesarean delivery without indication"	"Other and unspecified dorsopathies, not elsewhere classified"	1	678	190	868
"O82"	"M54"	"Encounter for cesarean delivery without indication"	"Dorsalgia"	1	3525	1486	5011
"O82"	"M67"	"Encounter for cesarean delivery without indication"	"Other disorders of synovium and tendon"	1	1123	621	1744
"O82"	"M70"	"Encounter for cesarean delivery without indication"	"Soft tissue disorders related to use, overuse and pressure"	1	489	86	575
"O82"	"M71"	"Encounter for cesarean delivery without indication"	"Other bursopathies"	1	127	34	161
"O82"	"M76"	"Encounter for cesarean delivery without indication"	"Enthesopathies, lower limb, excluding foot"	1	435	179	614
"O82"	"M77"	"Encounter for cesarean delivery without indication"	"Other enthesopathies"	1	903	48	951
"O82"	"M79"	"Encounter for cesarean delivery without indication"	"Oth and unsp soft tissue disorders, not elsewhere classified"	1	2410	1078	3488
"O82"	"M80"	"Encounter for cesarean delivery without indication"	"Osteoporosis with current pathological fracture"	1	34	0	34
"O82"	"M96"	"Encounter for cesarean delivery without indication"	"Intraop and postproc comp and disorders of ms sys, NEC"	1	59	7	66
"O82"	"N32"	"Encounter for cesarean delivery without indication"	"Other disorders of bladder"	1	85	28	113
"O82"	"N39"	"Encounter for cesarean delivery without indication"	"Other disorders of urinary system"	1	1685	218	1903
"O82"	"N71"	"Encounter for cesarean delivery without indication"	"Inflammatory disease of uterus, except cervix"	1	1355	802	2157
"O82"	"N75"	"Encounter for cesarean delivery without indication"	"Diseases of Bartholin's gland"	1	411	228	639
"O82"	"N92"	"Encounter for cesarean delivery without indication"	"Excessive, frequent and irregular menstruation"	1	6968	0	6968
"O82"	"N94"	"Encounter for cesarean delivery without indication"	"Pain and oth cond assoc w fem gntl org and menstrual cycle"	1	1845	1027	2872
"O82"	"N99"	"Encounter for cesarean delivery without indication"	"Intraop and postproc comp and disorders of GU sys, NEC"	1	314	151	465
"O82"	"O34"	"Encounter for cesarean delivery without indication"	"Maternal care for abnormality of pelvic organs"	1	31073	0	31073
"O82"	"O90"	"Encounter for cesarean delivery without indication"	"Complications of the puerperium, not elsewhere classified"	1	6267	3785	10052
"O85"	"C50"	"Puerperal sepsis"	"Malignant neoplasm of breast"	1	28	0	28
"O86"	"E78"	"Other puerperal infections"	"Disorders of lipoprotein metabolism and other lipidemias"	1	45	0	45
"O86"	"G96"	"Other puerperal infections"	"Other disorders of central nervous system"	1	38	1	39
"O86"	"I10"	"Other puerperal infections"	"Essential (primary) hypertension"	1	208	0	208
"O86"	"I83"	"Other puerperal infections"	"Varicose veins of lower extremities"	1	219	0	219
"O86"	"J15"	"Other puerperal infections"	"Bacterial pneumonia, not elsewhere classified"	1	74	9	83
"O86"	"K21"	"Other puerperal infections"	"Gastro-esophageal reflux disease"	1	96	15	111
"O86"	"K59"	"Other puerperal infections"	"Other functional intestinal disorders"	1	212	90	302
"O86"	"M54"	"Other puerperal infections"	"Dorsalgia"	1	400	161	561
"O87"	"D68"	"Venous complications and hemorrhoids in the puerperium"	"Other coagulation defects"	1	72	20	92
"O87"	"I10"	"Venous complications and hemorrhoids in the puerperium"	"Essential (primary) hypertension"	1	59	1	60
"O87"	"K64"	"Venous complications and hemorrhoids in the puerperium"	"Hemorrhoids and perianal venous thrombosis"	1	207	2	209
"O87"	"K80"	"Venous complications and hemorrhoids in the puerperium"	"Cholelithiasis"	1	155	40	195
"O90"	"C50"	"Complications of the puerperium, not elsewhere classified"	"Malignant neoplasm of breast"	1	53	0	53
"O90"	"D50"	"Complications of the puerperium, not elsewhere classified"	"Iron deficiency anemia"	1	104	21	125
"O90"	"E11"	"Complications of the puerperium, not elsewhere classified"	"Type 2 diabetes mellitus"	1	83	17	100
"O90"	"G56"	"Complications of the puerperium, not elsewhere classified"	"Mononeuropathies of upper limb"	1	213	105	318
"O90"	"J15"	"Complications of the puerperium, not elsewhere classified"	"Bacterial pneumonia, not elsewhere classified"	1	79	18	97
"O90"	"M25"	"Complications of the puerperium, not elsewhere classified"	"Other joint disorder, not elsewhere classified"	1	203	99	302
"O90"	"M47"	"Complications of the puerperium, not elsewhere classified"	"Spondylosis"	1	72	0	72
"O90"	"M51"	"Complications of the puerperium, not elsewhere classified"	"Thoracic, thoracolum, and lumbosacral intvrt disc disorders"	1	316	77	393
"O90"	"M75"	"Complications of the puerperium, not elsewhere classified"	"Shoulder lesions"	1	264	37	301
"O90"	"M77"	"Complications of the puerperium, not elsewhere classified"	"Other enthesopathies"	1	120	25	145
"O90"	"M81"	"Complications of the puerperium, not elsewhere classified"	"Osteoporosis without current pathological fracture"	1	44	0	44
"O90"	"M85"	"Complications of the puerperium, not elsewhere classified"	"Other disorders of bone density and structure"	1	43	0	43
"O90"	"N81"	"Complications of the puerperium, not elsewhere classified"	"Female genital prolapse"	1	736	177	913
"O90"	"N92"	"Complications of the puerperium, not elsewhere classified"	"Excessive, frequent and irregular menstruation"	1	1027	186	1213
"O91"	"C50"	"Infect of breast assoc w pregnancy, the puerp and lactation"	"Malignant neoplasm of breast"	1	55	0	55
"O91"	"D50"	"Infect of breast assoc w pregnancy, the puerp and lactation"	"Iron deficiency anemia"	1	48	9	57
"O91"	"D64"	"Infect of breast assoc w pregnancy, the puerp and lactation"	"Other anemias"	1	47	8	55
"O91"	"E78"	"Infect of breast assoc w pregnancy, the puerp and lactation"	"Disorders of lipoprotein metabolism and other lipidemias"	1	31	0	31
"O91"	"G56"	"Infect of breast assoc w pregnancy, the puerp and lactation"	"Mononeuropathies of upper limb"	1	126	45	171
"O91"	"G96"	"Infect of breast assoc w pregnancy, the puerp and lactation"	"Other disorders of central nervous system"	1	39	3	42
"O91"	"I83"	"Infect of breast assoc w pregnancy, the puerp and lactation"	"Varicose veins of lower extremities"	1	184	15	199
"O91"	"J15"	"Infect of breast assoc w pregnancy, the puerp and lactation"	"Bacterial pneumonia, not elsewhere classified"	1	68	10	78
"O91"	"K80"	"Infect of breast assoc w pregnancy, the puerp and lactation"	"Cholelithiasis"	1	309	109	418
"O91"	"M19"	"Infect of breast assoc w pregnancy, the puerp and lactation"	"Other and unspecified osteoarthritis"	1	44	0	44
"O91"	"M51"	"Infect of breast assoc w pregnancy, the puerp and lactation"	"Thoracic, thoracolum, and lumbosacral intvrt disc disorders"	1	180	37	217
"O91"	"M75"	"Infect of breast assoc w pregnancy, the puerp and lactation"	"Shoulder lesions"	1	143	20	163
"O91"	"N39"	"Infect of breast assoc w pregnancy, the puerp and lactation"	"Other disorders of urinary system"	1	192	65	257
"O91"	"N61"	"Infect of breast assoc w pregnancy, the puerp and lactation"	"Inflammatory disorders of breast"	1	500	298	798
"O91"	"N64"	"Infect of breast assoc w pregnancy, the puerp and lactation"	"Other disorders of breast"	1	326	175	501
"O91"	"N92"	"Infect of breast assoc w pregnancy, the puerp and lactation"	"Excessive, frequent and irregular menstruation"	1	415	40	455
"O92"	"E11"	"Oth disord of brst/lactatn assoc w pregnancy and the puerp"	"Type 2 diabetes mellitus"	1	123	16	139
"O92"	"E78"	"Oth disord of brst/lactatn assoc w pregnancy and the puerp"	"Disorders of lipoprotein metabolism and other lipidemias"	1	72	4	76
"O92"	"G47"	"Oth disord of brst/lactatn assoc w pregnancy and the puerp"	"Sleep disorders"	1	69	15	84
"O92"	"I10"	"Oth disord of brst/lactatn assoc w pregnancy and the puerp"	"Essential (primary) hypertension"	1	233	47	280
"O92"	"M17"	"Oth disord of brst/lactatn assoc w pregnancy and the puerp"	"Osteoarthritis of knee"	1	73	0	73
"O92"	"M50"	"Oth disord of brst/lactatn assoc w pregnancy and the puerp"	"Cervical disc disorders"	1	83	1	84
"O92"	"M51"	"Oth disord of brst/lactatn assoc w pregnancy and the puerp"	"Thoracic, thoracolum, and lumbosacral intvrt disc disorders"	1	242	76	318
"O98"	"N92"	"Matern infec/parastc dis classd elsw but compl preg/chldbrth"	"Excessive, frequent and irregular menstruation"	1	99	27	126
"O99"	"A46"	"Oth maternal diseases classd elsw but compl preg/chldbrth"	"Erysipelas"	1	382	101	483
"O99"	"A54"	"Oth maternal diseases classd elsw but compl preg/chldbrth"	"Gonococcal infection"	1	96	35	131
"O99"	"B34"	"Oth maternal diseases classd elsw but compl preg/chldbrth"	"Viral infection of unspecified site"	1	1053	818	1871
"O99"	"C18"	"Oth maternal diseases classd elsw but compl preg/chldbrth"	"Malignant neoplasm of colon"	1	45	0	45
"O99"	"C44"	"Oth maternal diseases classd elsw but compl preg/chldbrth"	"Other and unspecified malignant neoplasm of skin"	1	151	0	151
"O99"	"C50"	"Oth maternal diseases classd elsw but compl preg/chldbrth"	"Malignant neoplasm of breast"	1	518	0	518
"O99"	"C53"	"Oth maternal diseases classd elsw but compl preg/chldbrth"	"Malignant neoplasm of cervix uteri"	1	237	18	255
"O99"	"C79"	"Oth maternal diseases classd elsw but compl preg/chldbrth"	"Secondary malignant neoplasm of other and unspecified sites"	1	87	0	87
"O99"	"D10"	"Oth maternal diseases classd elsw but compl preg/chldbrth"	"Benign neoplasm of mouth and pharynx"	1	151	69	220
"O99"	"D12"	"Oth maternal diseases classd elsw but compl preg/chldbrth"	"Benign neoplasm of colon, rectum, anus and anal canal"	1	412	4	416
"O99"	"D13"	"Oth maternal diseases classd elsw but compl preg/chldbrth"	"Benign neoplasm of and ill-defined parts of digestive system"	1	111	31	142
"O99"	"D17"	"Oth maternal diseases classd elsw but compl preg/chldbrth"	"Benign lipomatous neoplasm"	1	793	244	1037
"O99"	"D21"	"Oth maternal diseases classd elsw but compl preg/chldbrth"	"Other benign neoplasms of connective and other soft tissue"	1	198	99	297
"O99"	"D22"	"Oth maternal diseases classd elsw but compl preg/chldbrth"	"Melanocytic nevi"	1	1101	550	1651
"O99"	"D34"	"Oth maternal diseases classd elsw but compl preg/chldbrth"	"Benign neoplasm of thyroid gland"	1	123	36	159
"O99"	"E03"	"Oth maternal diseases classd elsw but compl preg/chldbrth"	"Other hypothyroidism"	1	3639	2680	6319
"O99"	"E06"	"Oth maternal diseases classd elsw but compl preg/chldbrth"	"Thyroiditis"	1	1060	395	1455
"O99"	"E11"	"Oth maternal diseases classd elsw but compl preg/chldbrth"	"Type 2 diabetes mellitus"	1	1066	156	1222
"O99"	"E64"	"Oth maternal diseases classd elsw but compl preg/chldbrth"	"Sequelae of malnutrition and other nutritional deficiencies"	1	110	30	140
"O99"	"E68"	"Oth maternal diseases classd elsw but compl preg/chldbrth"	"Sequelae of hyperalimentation"	1	1015	1	1016
"O99"	"E78"	"Oth maternal diseases classd elsw but compl preg/chldbrth"	"Disorders of lipoprotein metabolism and other lipidemias"	1	591	39	630
"O99"	"E83"	"Oth maternal diseases classd elsw but compl preg/chldbrth"	"Disorders of mineral metabolism"	1	144	34	178
"O99"	"E87"	"Oth maternal diseases classd elsw but compl preg/chldbrth"	"Other disorders of fluid, electrolyte and acid-base balance"	1	263	48	311
"O99"	"G47"	"Oth maternal diseases classd elsw but compl preg/chldbrth"	"Sleep disorders"	1	778	55	833
"O99"	"G50"	"Oth maternal diseases classd elsw but compl preg/chldbrth"	"Disorders of trigeminal nerve"	1	167	23	190
"O99"	"G55"	"Oth maternal diseases classd elsw but compl preg/chldbrth"	"Nerve root and plexus compressions in diseases classd elswhr"	1	59	13	72
"O99"	"G57"	"Oth maternal diseases classd elsw but compl preg/chldbrth"	"Mononeuropathies of lower limb"	1	258	92	350
"O99"	"G98"	"Oth maternal diseases classd elsw but compl preg/chldbrth"	"Other disorders of nervous system not elsewhere classified"	1	432	15	447
"O99"	"H26"	"Oth maternal diseases classd elsw but compl preg/chldbrth"	"Other cataract"	1	113	27	140
"O99"	"H40"	"Oth maternal diseases classd elsw but compl preg/chldbrth"	"Glaucoma"	1	77	17	94
"O99"	"H43"	"Oth maternal diseases classd elsw but compl preg/chldbrth"	"Disorders of vitreous body"	1	125	15	140
"O99"	"H57"	"Oth maternal diseases classd elsw but compl preg/chldbrth"	"Other disorders of eye and adnexa"	1	559	144	703
"O99"	"H81"	"Oth maternal diseases classd elsw but compl preg/chldbrth"	"Disorders of vestibular function"	1	484	281	765
"O99"	"I21"	"Oth maternal diseases classd elsw but compl preg/chldbrth"	"Acute myocardial infarction"	1	156	0	156
"O99"	"I25"	"Oth maternal diseases classd elsw but compl preg/chldbrth"	"Chronic ischemic heart disease"	1	168	0	168
"O99"	"I48"	"Oth maternal diseases classd elsw but compl preg/chldbrth"	"Atrial fibrillation and flutter"	1	249	65	314
"O99"	"I49"	"Oth maternal diseases classd elsw but compl preg/chldbrth"	"Other cardiac arrhythmias"	1	554	323	877
"O99"	"I63"	"Oth maternal diseases classd elsw but compl preg/chldbrth"	"Cerebral infarction"	1	243	32	275
"O99"	"I69"	"Oth maternal diseases classd elsw but compl preg/chldbrth"	"Sequelae of cerebrovascular disease"	1	223	28	251
"O99"	"I83"	"Oth maternal diseases classd elsw but compl preg/chldbrth"	"Varicose veins of lower extremities"	1	3273	0	3273
"O99"	"I89"	"Oth maternal diseases classd elsw but compl preg/chldbrth"	"Oth noninfective disorders of lymphatic vessels and nodes"	1	149	36	185
"O99"	"I97"	"Oth maternal diseases classd elsw but compl preg/chldbrth"	"Intraop and postproc comp and disorders of circ sys, NEC"	1	48	11	59
"O99"	"J06"	"Oth maternal diseases classd elsw but compl preg/chldbrth"	"Acute upper resp infections of multiple and unsp sites"	1	791	128	919
"O99"	"J10"	"Oth maternal diseases classd elsw but compl preg/chldbrth"	"Influenza due to other identified influenza virus"	1	115	32	147
"O99"	"J22"	"Oth maternal diseases classd elsw but compl preg/chldbrth"	"Unspecified acute lower respiratory infection"	1	97	20	117
"O99"	"J47"	"Oth maternal diseases classd elsw but compl preg/chldbrth"	"Bronchiectasis"	1	100	10	110
"O99"	"K21"	"Oth maternal diseases classd elsw but compl preg/chldbrth"	"Gastro-esophageal reflux disease"	1	921	508	1429
"O99"	"K28"	"Oth maternal diseases classd elsw but compl preg/chldbrth"	"Gastrojejunal ulcer"	1	40	2	42
"O99"	"K56"	"Oth maternal diseases classd elsw but compl preg/chldbrth"	"Paralytic ileus and intestinal obstruction without hernia"	1	665	353	1018
"O99"	"K57"	"Oth maternal diseases classd elsw but compl preg/chldbrth"	"Diverticular disease of intestine"	1	253	0	253
"O99"	"K60"	"Oth maternal diseases classd elsw but compl preg/chldbrth"	"Fissure and fistula of anal and rectal regions"	1	801	582	1383
"O99"	"K62"	"Oth maternal diseases classd elsw but compl preg/chldbrth"	"Other diseases of anus and rectum"	1	862	426	1288
"O99"	"K70"	"Oth maternal diseases classd elsw but compl preg/chldbrth"	"Alcoholic liver disease"	1	26	0	26
"O99"	"K82"	"Oth maternal diseases classd elsw but compl preg/chldbrth"	"Other diseases of gallbladder"	1	89	14	103
"O99"	"L30"	"Oth maternal diseases classd elsw but compl preg/chldbrth"	"Other and unspecified dermatitis"	1	615	382	997
"O99"	"L57"	"Oth maternal diseases classd elsw but compl preg/chldbrth"	"Skin changes due to chronic expsr to nonionizing radiation"	1	110	15	125
"O99"	"L71"	"Oth maternal diseases classd elsw but compl preg/chldbrth"	"Rosacea"	1	179	54	233
"O99"	"L72"	"Oth maternal diseases classd elsw but compl preg/chldbrth"	"Follicular cysts of skin and subcutaneous tissue"	1	241	95	336
"O99"	"L98"	"Oth maternal diseases classd elsw but compl preg/chldbrth"	"Oth disorders of skin, subcu, not elsewhere classified"	1	415	187	602
"O99"	"M13"	"Oth maternal diseases classd elsw but compl preg/chldbrth"	"Other arthritis"	1	389	250	639
"O99"	"M25"	"Oth maternal diseases classd elsw but compl preg/chldbrth"	"Other joint disorder, not elsewhere classified"	1	1518	742	2260
"O99"	"M46"	"Oth maternal diseases classd elsw but compl preg/chldbrth"	"Other inflammatory spondylopathies"	1	373	82	455
"O99"	"M48"	"Oth maternal diseases classd elsw but compl preg/chldbrth"	"Other spondylopathies"	1	215	0	215
"O99"	"M54"	"Oth maternal diseases classd elsw but compl preg/chldbrth"	"Dorsalgia"	1	3690	3164	6854
"O99"	"M72"	"Oth maternal diseases classd elsw but compl preg/chldbrth"	"Fibroblastic disorders"	1	338	51	389
"O99"	"M75"	"Oth maternal diseases classd elsw but compl preg/chldbrth"	"Shoulder lesions"	1	2118	388	2506
"O99"	"M81"	"Oth maternal diseases classd elsw but compl preg/chldbrth"	"Osteoporosis without current pathological fracture"	1	300	0	300
"O99"	"M85"	"Oth maternal diseases classd elsw but compl preg/chldbrth"	"Other disorders of bone density and structure"	1	399	9	408
"O99"	"N18"	"Oth maternal diseases classd elsw but compl preg/chldbrth"	"Chronic kidney disease (CKD)"	1	256	67	323
"O99"	"N20"	"Oth maternal diseases classd elsw but compl preg/chldbrth"	"Calculus of kidney and ureter"	1	1275	807	2082
"O99"	"N61"	"Oth maternal diseases classd elsw but compl preg/chldbrth"	"Inflammatory disorders of breast"	1	531	195	726
"O99"	"N63"	"Oth maternal diseases classd elsw but compl preg/chldbrth"	"Unspecified lump in breast"	1	1233	639	1872
"O99"	"N84"	"Oth maternal diseases classd elsw but compl preg/chldbrth"	"Polyp of female genital tract"	1	1037	256	1293
"O99"	"N85"	"Oth maternal diseases classd elsw but compl preg/chldbrth"	"Other noninflammatory disorders of uterus, except cervix"	1	324	111	435
"O99"	"N92"	"Oth maternal diseases classd elsw but compl preg/chldbrth"	"Excessive, frequent and irregular menstruation"	1	7871	0	7871
"O99"	"N95"	"Oth maternal diseases classd elsw but compl preg/chldbrth"	"Menopausal and other perimenopausal disorders"	1	83	0	83
"O99"	"O61"	"Oth maternal diseases classd elsw but compl preg/chldbrth"	"Failed induction of labor"	1	1519	1166	2685
"O99"	"O85"	"Oth maternal diseases classd elsw but compl preg/chldbrth"	"Puerperal sepsis"	1	2440	1702	4142
"O99"	"O92"	"Oth maternal diseases classd elsw but compl preg/chldbrth"	"Oth disord of brst/lactatn assoc w pregnancy and the puerp"	1	7598	4891	12489
"Q02"	"G47"	"Microcephaly"	"Sleep disorders"	1	24	1	25
"Q02"	"H52"	"Microcephaly"	"Disorders of refraction and accommodation"	1	111	30	141
"Q02"	"J15"	"Microcephaly"	"Bacterial pneumonia, not elsewhere classified"	1	70	4	74
"Q02"	"J96"	"Microcephaly"	"Respiratory failure, not elsewhere classified"	1	80	17	97
"Q02"	"K02"	"Microcephaly"	"Dental caries"	1	40	7	47
"Q02"	"M41"	"Microcephaly"	"Scoliosis"	1	65	4	69
"Q03"	"A09"	"Congenital hydrocephalus"	"Infectious gastroenteritis and colitis, unspecified"	1	120	39	159
"Q03"	"B34"	"Congenital hydrocephalus"	"Viral infection of unspecified site"	1	145	49	194
"Q03"	"F79"	"Congenital hydrocephalus"	"Unspecified intellectual disabilities"	1	54	8	62
"Q03"	"G80"	"Congenital hydrocephalus"	"Cerebral palsy"	1	155	58	213
"Q03"	"H50"	"Congenital hydrocephalus"	"Other strabismus"	1	135	19	154
"Q03"	"H53"	"Congenital hydrocephalus"	"Visual disturbances"	1	65	7	72
"Q03"	"J15"	"Congenital hydrocephalus"	"Bacterial pneumonia, not elsewhere classified"	1	56	8	64
"Q03"	"J96"	"Congenital hydrocephalus"	"Respiratory failure, not elsewhere classified"	1	53	11	64
"Q03"	"K02"	"Congenital hydrocephalus"	"Dental caries"	1	33	2	35
"Q03"	"K59"	"Congenital hydrocephalus"	"Other functional intestinal disorders"	1	86	22	108
"Q03"	"M21"	"Congenital hydrocephalus"	"Other acquired deformities of limbs"	1	25	0	25
"Q03"	"M41"	"Congenital hydrocephalus"	"Scoliosis"	1	43	0	43
"Q03"	"N10"	"Congenital hydrocephalus"	"Acute pyelonephritis"	1	36	4	40
"Q03"	"N39"	"Congenital hydrocephalus"	"Other disorders of urinary system"	1	62	10	72
"Q04"	"H52"	"Other congenital malformations of brain"	"Disorders of refraction and accommodation"	1	152	52	204
"Q04"	"J15"	"Other congenital malformations of brain"	"Bacterial pneumonia, not elsewhere classified"	1	79	9	88
"Q04"	"J18"	"Other congenital malformations of brain"	"Pneumonia, unspecified organism"	1	181	85	266
"Q04"	"M41"	"Other congenital malformations of brain"	"Scoliosis"	1	46	3	49
"Q05"	"A46"	"Spina bifida"	"Erysipelas"	1	29	0	29
"Q05"	"E86"	"Spina bifida"	"Volume depletion"	1	32	2	34
"Q05"	"G91"	"Spina bifida"	"Hydrocephalus"	1	104	6	110
"Q05"	"H52"	"Spina bifida"	"Disorders of refraction and accommodation"	1	38	2	40
"Q05"	"I10"	"Spina bifida"	"Essential (primary) hypertension"	1	38	4	42
"Q05"	"L08"	"Spina bifida"	"Other local infections of skin and subcutaneous tissue"	1	26	0	26
"Q05"	"L97"	"Spina bifida"	"Non-pressure chronic ulcer of lower limb, NEC"	1	35	0	35
"Q05"	"N13"	"Spina bifida"	"Obstructive and reflux uropathy"	1	48	4	52
"Q05"	"N18"	"Spina bifida"	"Chronic kidney disease (CKD)"	1	30	0	30
"Q05"	"N21"	"Spina bifida"	"Calculus of lower urinary tract"	1	25	0	25
"Q05"	"N30"	"Spina bifida"	"Cystitis"	1	191	14	205
"Q05"	"N31"	"Spina bifida"	"Neuromuscular dysfunction of bladder, NEC"	1	358	88	446
"Q05"	"O72"	"Spina bifida"	"Postpartum hemorrhage"	1	64	4	68
"Q05"	"Q06"	"Spina bifida"	"Other congenital malformations of spinal cord"	1	155	57	212
"Q17"	"A46"	"Other congenital malformations of ear"	"Erysipelas"	1	24	1	25
"Q17"	"A63"	"Other congenital malformations of ear"	"Oth predominantly sexually transmitted diseases, NEC"	1	103	0	103
"Q17"	"E03"	"Other congenital malformations of ear"	"Other hypothyroidism"	1	44	0	44
"Q17"	"E05"	"Other congenital malformations of ear"	"Thyrotoxicosis [hyperthyroidism]"	1	30	0	30
"Q17"	"E66"	"Other congenital malformations of ear"	"Overweight and obesity"	1	108	0	108
"Q17"	"F10"	"Other congenital malformations of ear"	"Alcohol related disorders"	1	270	15	285
"Q17"	"F43"	"Other congenital malformations of ear"	"Reaction to severe stress, and adjustment disorders"	1	70	1	71
"Q17"	"G47"	"Other congenital malformations of ear"	"Sleep disorders"	1	67	10	77
"Q17"	"G96"	"Other congenital malformations of ear"	"Other disorders of central nervous system"	1	37	1	38
"Q17"	"H53"	"Other congenital malformations of ear"	"Visual disturbances"	1	45	3	48
"Q17"	"H90"	"Other congenital malformations of ear"	"Conductive and sensorineural hearing loss"	1	167	77	244
"Q17"	"J01"	"Other congenital malformations of ear"	"Acute sinusitis"	1	34	3	37
"Q17"	"J06"	"Other congenital malformations of ear"	"Acute upper resp infections of multiple and unsp sites"	1	78	22	100
"Q17"	"J96"	"Other congenital malformations of ear"	"Respiratory failure, not elsewhere classified"	1	45	9	54
"Q17"	"K21"	"Other congenital malformations of ear"	"Gastro-esophageal reflux disease"	1	88	15	103
"Q17"	"K29"	"Other congenital malformations of ear"	"Gastritis and duodenitis"	1	45	2	47
"Q17"	"K30"	"Other congenital malformations of ear"	"Functional dyspepsia"	1	82	1	83
"Q17"	"K35"	"Other congenital malformations of ear"	"Acute appendicitis"	1	184	72	256
"Q17"	"K50"	"Other congenital malformations of ear"	"Crohn's disease [regional enteritis]"	1	45	0	45
"Q17"	"K51"	"Other congenital malformations of ear"	"Ulcerative colitis"	1	40	0	40
"Q17"	"K61"	"Other congenital malformations of ear"	"Abscess of anal and rectal regions"	1	30	0	30
"Q17"	"K62"	"Other congenital malformations of ear"	"Other diseases of anus and rectum"	1	53	0	53
"Q17"	"K80"	"Other congenital malformations of ear"	"Cholelithiasis"	1	73	0	73
"Q17"	"K92"	"Other congenital malformations of ear"	"Other diseases of digestive system"	1	27	1	28
"Q17"	"L02"	"Other congenital malformations of ear"	"Cutaneous abscess, furuncle and carbuncle"	1	98	25	123
"Q17"	"M17"	"Other congenital malformations of ear"	"Osteoarthritis of knee"	1	28	0	28
"Q17"	"M20"	"Other congenital malformations of ear"	"Acquired deformities of fingers and toes"	1	68	6	74
"Q17"	"M22"	"Other congenital malformations of ear"	"Disorder of patella"	1	235	28	263
"Q17"	"M25"	"Other congenital malformations of ear"	"Other joint disorder, not elsewhere classified"	1	113	7	120
"Q17"	"M41"	"Other congenital malformations of ear"	"Scoliosis"	1	111	28	139
"Q17"	"M54"	"Other congenital malformations of ear"	"Dorsalgia"	1	280	0	280
"Q17"	"M62"	"Other congenital malformations of ear"	"Other disorders of muscle"	1	186	7	193
"Q17"	"M75"	"Other congenital malformations of ear"	"Shoulder lesions"	1	134	0	134
"Q17"	"M79"	"Other congenital malformations of ear"	"Oth and unsp soft tissue disorders, not elsewhere classified"	1	435	77	512
"Q17"	"N20"	"Other congenital malformations of ear"	"Calculus of kidney and ureter"	1	54	0	54
"Q17"	"N39"	"Other congenital malformations of ear"	"Other disorders of urinary system"	1	92	19	111
"Q17"	"N45"	"Other congenital malformations of ear"	"Orchitis and epididymitis"	1	28	0	28
"Q17"	"N50"	"Other congenital malformations of ear"	"Other and unspecified disorders of male genital organs"	1	45	4	49
"Q17"	"N92"	"Other congenital malformations of ear"	"Excessive, frequent and irregular menstruation"	1	100	0	100
"Q17"	"N94"	"Other congenital malformations of ear"	"Pain and oth cond assoc w fem gntl org and menstrual cycle"	1	100	0	100
"Q17"	"N97"	"Other congenital malformations of ear"	"Female infertility"	1	73	0	73
"Q17"	"O00"	"Other congenital malformations of ear"	"Ectopic pregnancy"	1	30	0	30
"Q17"	"O02"	"Other congenital malformations of ear"	"Other abnormal products of conception"	1	86	0	86
"Q17"	"O03"	"Other congenital malformations of ear"	"Spontaneous abortion"	1	102	0	102
"Q17"	"O04"	"Other congenital malformations of ear"	"Complications following (induced) termination of pregnancy"	1	418	7	425
"Q17"	"O08"	"Other congenital malformations of ear"	"Complications following ectopic and molar pregnancy"	1	58	0	58
"Q17"	"O14"	"Other congenital malformations of ear"	"Pre-eclampsia"	1	37	0	37
"Q17"	"O21"	"Other congenital malformations of ear"	"Excessive vomiting in pregnancy"	1	29	0	29
"Q17"	"O23"	"Other congenital malformations of ear"	"Infections of genitourinary tract in pregnancy"	1	30	0	30
"Q17"	"O26"	"Other congenital malformations of ear"	"Maternal care for oth conditions predom related to pregnancy"	1	73	0	73
"Q17"	"O34"	"Other congenital malformations of ear"	"Maternal care for abnormality of pelvic organs"	1	38	0	38
"Q17"	"O36"	"Other congenital malformations of ear"	"Maternal care for other fetal problems"	1	53	0	53
"Q17"	"O42"	"Other congenital malformations of ear"	"Premature rupture of membranes"	1	55	0	55
"Q17"	"O47"	"Other congenital malformations of ear"	"False labor"	1	57	0	57
"Q17"	"O62"	"Other congenital malformations of ear"	"Abnormalities of forces of labor"	1	228	0	228
"Q17"	"O63"	"Other congenital malformations of ear"	"Long labor"	1	38	0	38
"Q17"	"O64"	"Other congenital malformations of ear"	"Obstructed labor due to malposition and malpresent of fetus"	1	25	0	25
"Q17"	"O68"	"Other congenital malformations of ear"	"Labor and delivery comp by abnlt of fetal acid-base balance"	1	156	0	156
"Q17"	"O72"	"Other congenital malformations of ear"	"Postpartum hemorrhage"	1	287	0	287
"Q17"	"O75"	"Other congenital malformations of ear"	"Oth complications of labor and delivery, NEC"	1	34	0	34
"Q18"	"A41"	"Other congenital malformations of face and neck"	"Other sepsis"	1	100	0	100
"Q18"	"C50"	"Other congenital malformations of face and neck"	"Malignant neoplasm of breast"	1	61	13	74
"Q18"	"C78"	"Other congenital malformations of face and neck"	"Secondary malignant neoplasm of resp and digestive organs"	1	58	0	58
"Q18"	"E11"	"Other congenital malformations of face and neck"	"Type 2 diabetes mellitus"	1	99	23	122
"Q18"	"E66"	"Other congenital malformations of face and neck"	"Overweight and obesity"	1	420	238	658
"Q18"	"E78"	"Other congenital malformations of face and neck"	"Disorders of lipoprotein metabolism and other lipidemias"	1	139	17	156
"Q18"	"F43"	"Other congenital malformations of face and neck"	"Reaction to severe stress, and adjustment disorders"	1	52	7	59
"Q18"	"H52"	"Other congenital malformations of face and neck"	"Disorders of refraction and accommodation"	1	95	34	129
"Q18"	"I25"	"Other congenital malformations of face and neck"	"Chronic ischemic heart disease"	1	102	19	121
"Q18"	"I48"	"Other congenital malformations of face and neck"	"Atrial fibrillation and flutter"	1	122	15	137
"Q18"	"J15"	"Other congenital malformations of face and neck"	"Bacterial pneumonia, not elsewhere classified"	1	98	8	106
"Q18"	"J18"	"Other congenital malformations of face and neck"	"Pneumonia, unspecified organism"	1	259	122	381
"Q18"	"J44"	"Other congenital malformations of face and neck"	"Other chronic obstructive pulmonary disease"	1	135	31	166
"Q18"	"K52"	"Other congenital malformations of face and neck"	"Other and unsp noninfective gastroenteritis and colitis"	1	71	17	88
"Q18"	"K59"	"Other congenital malformations of face and neck"	"Other functional intestinal disorders"	1	235	57	292
"Q18"	"K62"	"Other congenital malformations of face and neck"	"Other diseases of anus and rectum"	1	82	14	96
"Q18"	"M16"	"Other congenital malformations of face and neck"	"Osteoarthritis of hip"	1	65	11	76
"Q18"	"M19"	"Other congenital malformations of face and neck"	"Other and unspecified osteoarthritis"	1	105	11	116
"Q18"	"N18"	"Other congenital malformations of face and neck"	"Chronic kidney disease (CKD)"	1	30	1	31
"Q18"	"N30"	"Other congenital malformations of face and neck"	"Cystitis"	1	188	69	257
"Q18"	"N39"	"Other congenital malformations of face and neck"	"Other disorders of urinary system"	1	140	24	164
"Q18"	"O72"	"Other congenital malformations of face and neck"	"Postpartum hemorrhage"	1	1311	312	1623
"Q18"	"O99"	"Other congenital malformations of face and neck"	"Oth maternal diseases classd elsw but compl preg/chldbrth"	1	617	441	1058
"Q20"	"B34"	"Congenital malformations of cardiac chambers and connections"	"Viral infection of unspecified site"	1	228	54	282
"Q20"	"I33"	"Congenital malformations of cardiac chambers and connections"	"Acute and subacute endocarditis"	1	36	4	40
"Q20"	"J00"	"Congenital malformations of cardiac chambers and connections"	"Acute nasopharyngitis [common cold]"	1	143	43	186
"Q20"	"J18"	"Congenital malformations of cardiac chambers and connections"	"Pneumonia, unspecified organism"	1	237	93	330
"Q20"	"J20"	"Congenital malformations of cardiac chambers and connections"	"Acute bronchitis"	1	140	45	185
"Q20"	"K02"	"Congenital malformations of cardiac chambers and connections"	"Dental caries"	1	51	7	58
"Q21"	"A09"	"Congenital malformations of cardiac septa"	"Infectious gastroenteritis and colitis, unspecified"	1	1099	373	1472
"Q21"	"A41"	"Congenital malformations of cardiac septa"	"Other sepsis"	1	284	124	408
"Q21"	"A49"	"Congenital malformations of cardiac septa"	"Bacterial infection of unspecified site"	1	164	33	197
"Q21"	"B01"	"Congenital malformations of cardiac septa"	"Varicella [chickenpox]"	1	141	27	168
"Q21"	"B08"	"Congenital malformations of cardiac septa"	"Oth viral infect with skin and mucous membrane lesions, NEC"	1	74	24	98
"Q21"	"B34"	"Congenital malformations of cardiac septa"	"Viral infection of unspecified site"	1	1586	591	2177
"Q21"	"D82"	"Congenital malformations of cardiac septa"	"Immunodeficiency associated with other major defects"	1	76	20	96
"Q21"	"E03"	"Congenital malformations of cardiac septa"	"Other hypothyroidism"	1	136	33	169
"Q21"	"E86"	"Congenital malformations of cardiac septa"	"Volume depletion"	1	611	183	794
"Q21"	"F10"	"Congenital malformations of cardiac septa"	"Alcohol related disorders"	1	81	25	106
"Q21"	"F17"	"Congenital malformations of cardiac septa"	"Nicotine dependence"	1	39	4	43
"Q21"	"F43"	"Congenital malformations of cardiac septa"	"Reaction to severe stress, and adjustment disorders"	1	228	83	311
"Q21"	"F50"	"Congenital malformations of cardiac septa"	"Eating disorders"	1	108	21	129
"Q21"	"F70"	"Congenital malformations of cardiac septa"	"Mild intellectual disabilities"	1	46	4	50
"Q21"	"F72"	"Congenital malformations of cardiac septa"	"Severe intellectual disabilities"	1	35	0	35
"Q21"	"F79"	"Congenital malformations of cardiac septa"	"Unspecified intellectual disabilities"	1	175	32	207
"Q21"	"F98"	"Congenital malformations of cardiac septa"	"Oth behav/emotn disord w onset usly occur in chldhd and adol"	1	143	30	173
"Q21"	"G80"	"Congenital malformations of cardiac septa"	"Cerebral palsy"	1	233	62	295
"Q21"	"H04"	"Congenital malformations of cardiac septa"	"Disorders of lacrimal system"	1	76	20	96
"Q21"	"H50"	"Congenital malformations of cardiac septa"	"Other strabismus"	1	459	78	537
"Q21"	"H55"	"Congenital malformations of cardiac septa"	"Nystagmus and other irregular eye movements"	1	67	9	76
"Q21"	"H61"	"Congenital malformations of cardiac septa"	"Other disorders of external ear"	1	48	4	52
"Q21"	"H66"	"Congenital malformations of cardiac septa"	"Suppurative and unspecified otitis media"	1	995	294	1289
"Q21"	"H72"	"Congenital malformations of cardiac septa"	"Perforation of tympanic membrane"	1	86	0	86
"Q21"	"H90"	"Congenital malformations of cardiac septa"	"Conductive and sensorineural hearing loss"	1	311	28	339
"Q21"	"I37"	"Congenital malformations of cardiac septa"	"Nonrheumatic pulmonary valve disorders"	1	159	54	213
"Q21"	"I49"	"Congenital malformations of cardiac septa"	"Other cardiac arrhythmias"	1	248	134	382
"Q21"	"I50"	"Congenital malformations of cardiac septa"	"Heart failure"	1	612	411	1023
"Q21"	"I71"	"Congenital malformations of cardiac septa"	"Aortic aneurysm and dissection"	1	51	9	60
"Q21"	"J00"	"Congenital malformations of cardiac septa"	"Acute nasopharyngitis [common cold]"	1	849	386	1235
"Q21"	"J03"	"Congenital malformations of cardiac septa"	"Acute tonsillitis"	1	619	128	747
"Q21"	"J10"	"Congenital malformations of cardiac septa"	"Influenza due to other identified influenza virus"	1	63	15	78
"Q21"	"J12"	"Congenital malformations of cardiac septa"	"Viral pneumonia, not elsewhere classified"	1	542	285	827
"Q21"	"J13"	"Congenital malformations of cardiac septa"	"Pneumonia due to Streptococcus pneumoniae"	1	121	43	164
"Q21"	"J14"	"Congenital malformations of cardiac septa"	"Pneumonia due to Hemophilus influenzae"	1	116	39	155
"Q21"	"J15"	"Congenital malformations of cardiac septa"	"Bacterial pneumonia, not elsewhere classified"	1	441	93	534
"Q21"	"J18"	"Congenital malformations of cardiac septa"	"Pneumonia, unspecified organism"	1	1752	603	2355
"Q21"	"J20"	"Congenital malformations of cardiac septa"	"Acute bronchitis"	1	1093	520	1613
"Q21"	"J30"	"Congenital malformations of cardiac septa"	"Vasomotor and allergic rhinitis"	1	101	6	107
"Q21"	"J39"	"Congenital malformations of cardiac septa"	"Other diseases of upper respiratory tract"	1	139	36	175
"Q21"	"J45"	"Congenital malformations of cardiac septa"	"Asthma"	1	1507	504	2011
"Q21"	"J69"	"Congenital malformations of cardiac septa"	"Pneumonitis due to solids and liquids"	1	45	9	54
"Q21"	"J90"	"Congenital malformations of cardiac septa"	"Pleural effusion, not elsewhere classified"	1	94	28	122
"Q21"	"J95"	"Congenital malformations of cardiac septa"	"Intraop and postproc comp and disorders of resp sys, NEC"	1	38	1	39
"Q21"	"J96"	"Congenital malformations of cardiac septa"	"Respiratory failure, not elsewhere classified"	1	575	318	893
"Q21"	"J98"	"Congenital malformations of cardiac septa"	"Other respiratory disorders"	1	307	85	392
"Q21"	"K21"	"Congenital malformations of cardiac septa"	"Gastro-esophageal reflux disease"	1	281	156	437
"Q21"	"K22"	"Congenital malformations of cardiac septa"	"Other diseases of esophagus"	1	112	30	142
"Q21"	"K35"	"Congenital malformations of cardiac septa"	"Acute appendicitis"	1	101	12	113
"Q21"	"K59"	"Congenital malformations of cardiac septa"	"Other functional intestinal disorders"	1	886	263	1149
"Q21"	"M08"	"Congenital malformations of cardiac septa"	"Juvenile arthritis"	1	37	3	40
"Q21"	"M21"	"Congenital malformations of cardiac septa"	"Other acquired deformities of limbs"	1	132	2	134
"Q21"	"M24"	"Congenital malformations of cardiac septa"	"Other specific joint derangements"	1	67	17	84
"Q21"	"M54"	"Congenital malformations of cardiac septa"	"Dorsalgia"	1	167	69	236
"Q21"	"M67"	"Congenital malformations of cardiac septa"	"Other disorders of synovium and tendon"	1	97	10	107
"Q21"	"O99"	"Congenital malformations of cardiac septa"	"Oth maternal diseases classd elsw but compl preg/chldbrth"	1	286	111	397
"Q21"	"Q10"	"Congenital malformations of cardiac septa"	"Congenital malform of eyelid, lacrimal apparatus and orbit"	1	70	19	89
"Q21"	"Q23"	"Congenital malformations of cardiac septa"	"Congenital malformations of aortic and mitral valves"	1	567	378	945
"Q21"	"Q53"	"Congenital malformations of cardiac septa"	"Undescended and ectopic testicle"	1	319	122	441
"Q21"	"Q85"	"Congenital malformations of cardiac septa"	"Phakomatoses, not elsewhere classified"	1	55	11	66
"Q21"	"Q93"	"Congenital malformations of cardiac septa"	"Monosomies and deletions from the autosomes, NEC"	1	131	42	173
"Q21"	"Q99"	"Congenital malformations of cardiac septa"	"Other chromosome abnormalities, not elsewhere classified"	1	171	58	229
"Q22"	"A09"	"Congenital malformations of pulmonary and tricuspid valves"	"Infectious gastroenteritis and colitis, unspecified"	1	189	81	270
"Q22"	"E34"	"Congenital malformations of pulmonary and tricuspid valves"	"Other endocrine disorders"	1	43	6	49
"Q22"	"J03"	"Congenital malformations of pulmonary and tricuspid valves"	"Acute tonsillitis"	1	108	33	141
"Q22"	"J18"	"Congenital malformations of pulmonary and tricuspid valves"	"Pneumonia, unspecified organism"	1	223	117	340
"Q22"	"K59"	"Congenital malformations of pulmonary and tricuspid valves"	"Other functional intestinal disorders"	1	125	36	161
"Q24"	"J06"	"Other congenital malformations of heart"	"Acute upper resp infections of multiple and unsp sites"	1	168	65	233
"Q24"	"M79"	"Other congenital malformations of heart"	"Oth and unsp soft tissue disorders, not elsewhere classified"	1	113	34	147
"Q25"	"B01"	"Congenital malformations of great arteries"	"Varicella [chickenpox]"	1	79	18	97
"Q25"	"B34"	"Congenital malformations of great arteries"	"Viral infection of unspecified site"	1	1066	277	1343
"Q25"	"E86"	"Congenital malformations of great arteries"	"Volume depletion"	1	369	75	444
"Q25"	"F43"	"Congenital malformations of great arteries"	"Reaction to severe stress, and adjustment disorders"	1	182	79	261
"Q25"	"F71"	"Congenital malformations of great arteries"	"Moderate intellectual disabilities"	1	24	1	25
"Q25"	"F98"	"Congenital malformations of great arteries"	"Oth behav/emotn disord w onset usly occur in chldhd and adol"	1	108	15	123
"Q25"	"H47"	"Congenital malformations of great arteries"	"Other disorders of optic [2nd] nerve and visual pathways"	1	48	2	50
"Q25"	"H52"	"Congenital malformations of great arteries"	"Disorders of refraction and accommodation"	1	445	25	470
"Q25"	"H65"	"Congenital malformations of great arteries"	"Nonsuppurative otitis media"	1	921	195	1116
"Q25"	"H91"	"Congenital malformations of great arteries"	"Other and unspecified hearing loss"	1	127	47	174
"Q25"	"J04"	"Congenital malformations of great arteries"	"Acute laryngitis and tracheitis"	1	49	11	60
"Q25"	"J05"	"Congenital malformations of great arteries"	"Acute obstructive laryngitis [croup] and epiglottitis"	1	398	90	488
"Q25"	"J06"	"Congenital malformations of great arteries"	"Acute upper resp infections of multiple and unsp sites"	1	560	102	662
"Q25"	"J10"	"Congenital malformations of great arteries"	"Influenza due to other identified influenza virus"	1	37	5	42
"Q25"	"J20"	"Congenital malformations of great arteries"	"Acute bronchitis"	1	904	236	1140
"Q25"	"K02"	"Congenital malformations of great arteries"	"Dental caries"	1	114	3	117
"Q25"	"K21"	"Congenital malformations of great arteries"	"Gastro-esophageal reflux disease"	1	181	81	262
"Q25"	"L20"	"Congenital malformations of great arteries"	"Atopic dermatitis"	1	83	19	102
"Q25"	"M79"	"Congenital malformations of great arteries"	"Oth and unsp soft tissue disorders, not elsewhere classified"	1	131	8	139
"Q25"	"Q53"	"Congenital malformations of great arteries"	"Undescended and ectopic testicle"	1	209	72	281
"Q25"	"Q99"	"Congenital malformations of great arteries"	"Other chromosome abnormalities, not elsewhere classified"	1	103	36	139
"Q27"	"O72"	"Other congenital malformations of peripheral vascular system"	"Postpartum hemorrhage"	1	617	293	910
"Q28"	"C79"	"Other congenital malformations of circulatory system"	"Secondary malignant neoplasm of other and unspecified sites"	1	25	1	26
"Q28"	"D64"	"Other congenital malformations of circulatory system"	"Other anemias"	1	59	5	64
"Q28"	"G44"	"Other congenital malformations of circulatory system"	"Other headache syndromes"	1	95	27	122
"Q28"	"H52"	"Other congenital malformations of circulatory system"	"Disorders of refraction and accommodation"	1	56	13	69
"Q28"	"M79"	"Other congenital malformations of circulatory system"	"Oth and unsp soft tissue disorders, not elsewhere classified"	1	104	42	146
"Q28"	"N31"	"Other congenital malformations of circulatory system"	"Neuromuscular dysfunction of bladder, NEC"	1	61	10	71
"Q28"	"O72"	"Other congenital malformations of circulatory system"	"Postpartum hemorrhage"	1	65	3	68
"Q30"	"E66"	"Congenital malformations of nose"	"Overweight and obesity"	1	37	0	37
"Q31"	"H65"	"Congenital malformations of larynx"	"Nonsuppurative otitis media"	1	169	36	205
"Q31"	"J35"	"Congenital malformations of larynx"	"Chronic diseases of tonsils and adenoids"	1	182	40	222
"Q32"	"H66"	"Congenital malformations of trachea and bronchus"	"Suppurative and unspecified otitis media"	1	83	27	110
"Q32"	"J35"	"Congenital malformations of trachea and bronchus"	"Chronic diseases of tonsils and adenoids"	1	87	26	113
"Q35"	"H65"	"Cleft palate"	"Nonsuppurative otitis media"	1	381	211	592
"Q35"	"M41"	"Cleft palate"	"Scoliosis"	1	35	2	37
"Q37"	"F10"	"Cleft palate with cleft lip"	"Alcohol related disorders"	1	38	1	39
"Q37"	"H65"	"Cleft palate with cleft lip"	"Nonsuppurative otitis media"	1	462	148	610
"Q37"	"I10"	"Cleft palate with cleft lip"	"Essential (primary) hypertension"	1	32	2	34
"Q37"	"J03"	"Cleft palate with cleft lip"	"Acute tonsillitis"	1	74	13	87
"Q37"	"J18"	"Cleft palate with cleft lip"	"Pneumonia, unspecified organism"	1	144	45	189
"Q37"	"K00"	"Cleft palate with cleft lip"	"Disorders of tooth development and eruption"	1	100	18	118
"Q37"	"K01"	"Cleft palate with cleft lip"	"Embedded and impacted teeth"	1	86	15	101
"Q37"	"K35"	"Cleft palate with cleft lip"	"Acute appendicitis"	1	34	4	38
"Q37"	"M23"	"Cleft palate with cleft lip"	"Internal derangement of knee"	1	35	0	35
"Q37"	"M95"	"Cleft palate with cleft lip"	"Oth acquired deformities of ms sys and connective tissue"	1	35	3	38
"Q37"	"O70"	"Cleft palate with cleft lip"	"Perineal laceration during delivery"	1	56	4	60
"Q37"	"O80"	"Cleft palate with cleft lip"	"Encounter for full-term uncomplicated delivery"	1	73	16	89
"Q37"	"O99"	"Cleft palate with cleft lip"	"Oth maternal diseases classd elsw but compl preg/chldbrth"	1	52	7	59
"Q37"	"Q30"	"Cleft palate with cleft lip"	"Congenital malformations of nose"	1	75	7	82
"Q38"	"B34"	"Other congenital malformations of tongue, mouth and pharynx"	"Viral infection of unspecified site"	1	550	140	690
"Q38"	"J18"	"Other congenital malformations of tongue, mouth and pharynx"	"Pneumonia, unspecified organism"	1	226	90	316
"Q38"	"N30"	"Other congenital malformations of tongue, mouth and pharynx"	"Cystitis"	1	48	9	57
"Q38"	"N39"	"Other congenital malformations of tongue, mouth and pharynx"	"Other disorders of urinary system"	1	43	4	47
"Q39"	"A09"	"Congenital malformations of esophagus"	"Infectious gastroenteritis and colitis, unspecified"	1	88	19	107
"Q39"	"B34"	"Congenital malformations of esophagus"	"Viral infection of unspecified site"	1	127	12	139
"Q39"	"J00"	"Congenital malformations of esophagus"	"Acute nasopharyngitis [common cold]"	1	82	11	93
"Q39"	"J03"	"Congenital malformations of esophagus"	"Acute tonsillitis"	1	37	5	42
"Q39"	"J05"	"Congenital malformations of esophagus"	"Acute obstructive laryngitis [croup] and epiglottitis"	1	81	7	88
"Q39"	"J06"	"Congenital malformations of esophagus"	"Acute upper resp infections of multiple and unsp sites"	1	58	4	62
"Q39"	"J18"	"Congenital malformations of esophagus"	"Pneumonia, unspecified organism"	1	223	91	314
"Q39"	"J20"	"Congenital malformations of esophagus"	"Acute bronchitis"	1	118	17	135
"Q39"	"J96"	"Congenital malformations of esophagus"	"Respiratory failure, not elsewhere classified"	1	80	27	107
"Q39"	"K21"	"Congenital malformations of esophagus"	"Gastro-esophageal reflux disease"	1	158	52	210
"Q39"	"K22"	"Congenital malformations of esophagus"	"Other diseases of esophagus"	1	292	153	445
"Q40"	"E86"	"Other congenital malformations of upper alimentary tract"	"Volume depletion"	1	304	146	450
"Q40"	"E87"	"Other congenital malformations of upper alimentary tract"	"Other disorders of fluid, electrolyte and acid-base balance"	1	159	72	231
"Q41"	"A08"	"Congenital absence, atresia and stenosis of small intestine"	"Viral and other specified intestinal infections"	1	36	4	40
"Q41"	"B34"	"Congenital absence, atresia and stenosis of small intestine"	"Viral infection of unspecified site"	1	75	9	84
"Q41"	"H52"	"Congenital absence, atresia and stenosis of small intestine"	"Disorders of refraction and accommodation"	1	30	1	31
"Q41"	"H66"	"Congenital absence, atresia and stenosis of small intestine"	"Suppurative and unspecified otitis media"	1	40	3	43
"Q42"	"A08"	"Congenital absence, atresia and stenosis of large intestine"	"Viral and other specified intestinal infections"	1	49	10	59
"Q42"	"B34"	"Congenital absence, atresia and stenosis of large intestine"	"Viral infection of unspecified site"	1	115	17	132
"Q42"	"F43"	"Congenital absence, atresia and stenosis of large intestine"	"Reaction to severe stress, and adjustment disorders"	1	31	3	34
"Q42"	"H65"	"Congenital absence, atresia and stenosis of large intestine"	"Nonsuppurative otitis media"	1	65	9	74
"Q42"	"J18"	"Congenital absence, atresia and stenosis of large intestine"	"Pneumonia, unspecified organism"	1	79	17	96
"Q42"	"K59"	"Congenital absence, atresia and stenosis of large intestine"	"Other functional intestinal disorders"	1	238	72	310
"Q42"	"K91"	"Congenital absence, atresia and stenosis of large intestine"	"Intraop and postproc comp and disorders of dgstv sys, NEC"	1	37	6	43
"Q42"	"N10"	"Congenital absence, atresia and stenosis of large intestine"	"Acute pyelonephritis"	1	50	3	53
"Q42"	"N30"	"Congenital absence, atresia and stenosis of large intestine"	"Cystitis"	1	47	3	50
"Q43"	"A04"	"Other congenital malformations of intestine"	"Other bacterial intestinal infections"	1	82	18	100
"Q43"	"E64"	"Other congenital malformations of intestine"	"Sequelae of malnutrition and other nutritional deficiencies"	1	41	6	47
"Q43"	"H52"	"Other congenital malformations of intestine"	"Disorders of refraction and accommodation"	1	56	12	68
"Q43"	"K43"	"Other congenital malformations of intestine"	"Ventral hernia"	1	90	31	121
"Q44"	"J18"	"Congenital malform of gallbladder, bile ducts and liver"	"Pneumonia, unspecified organism"	1	109	30	139
"Q44"	"K92"	"Congenital malform of gallbladder, bile ducts and liver"	"Other diseases of digestive system"	1	38	6	44
"Q51"	"C50"	"Congenital malformations of uterus and cervix"	"Malignant neoplasm of breast"	1	37	0	37
"Q52"	"N94"	"Other congenital malformations of female genitalia"	"Pain and oth cond assoc w fem gntl org and menstrual cycle"	1	91	29	120
"Q52"	"O62"	"Other congenital malformations of female genitalia"	"Abnormalities of forces of labor"	1	81	15	96
"Q52"	"O72"	"Other congenital malformations of female genitalia"	"Postpartum hemorrhage"	1	115	0	115
"Q53"	"A46"	"Undescended and ectopic testicle"	"Erysipelas"	1	67	0	67
"Q53"	"A49"	"Undescended and ectopic testicle"	"Bacterial infection of unspecified site"	1	103	14	117
"Q53"	"D12"	"Undescended and ectopic testicle"	"Benign neoplasm of colon, rectum, anus and anal canal"	1	33	0	33
"Q53"	"D17"	"Undescended and ectopic testicle"	"Benign lipomatous neoplasm"	1	56	1	57
"Q53"	"D22"	"Undescended and ectopic testicle"	"Melanocytic nevi"	1	63	0	63
"Q53"	"D23"	"Undescended and ectopic testicle"	"Other benign neoplasms of skin"	1	68	8	76
"Q53"	"D64"	"Undescended and ectopic testicle"	"Other anemias"	1	43	6	49
"Q53"	"D68"	"Undescended and ectopic testicle"	"Other coagulation defects"	1	30	3	33
"Q53"	"E10"	"Undescended and ectopic testicle"	"Type 1 diabetes mellitus"	1	88	6	94
"Q53"	"E11"	"Undescended and ectopic testicle"	"Type 2 diabetes mellitus"	1	49	0	49
"Q53"	"E29"	"Undescended and ectopic testicle"	"Testicular dysfunction"	1	166	24	190
"Q53"	"E30"	"Undescended and ectopic testicle"	"Disorders of puberty, not elsewhere classified"	1	124	2	126
"Q53"	"E34"	"Undescended and ectopic testicle"	"Other endocrine disorders"	1	249	57	306
"Q53"	"F43"	"Undescended and ectopic testicle"	"Reaction to severe stress, and adjustment disorders"	1	75	6	81
"Q53"	"F90"	"Undescended and ectopic testicle"	"Attention-deficit hyperactivity disorders"	1	86	10	96
"Q53"	"H10"	"Undescended and ectopic testicle"	"Conjunctivitis"	1	255	114	369
"Q53"	"H50"	"Undescended and ectopic testicle"	"Other strabismus"	1	219	105	324
"Q53"	"H57"	"Undescended and ectopic testicle"	"Other disorders of eye and adnexa"	1	125	20	145
"Q53"	"H71"	"Undescended and ectopic testicle"	"Cholesteatoma of middle ear"	1	45	0	45
"Q53"	"H92"	"Undescended and ectopic testicle"	"Otalgia and effusion of ear"	1	42	6	48
"Q53"	"I47"	"Undescended and ectopic testicle"	"Paroxysmal tachycardia"	1	42	5	47
"Q53"	"I50"	"Undescended and ectopic testicle"	"Heart failure"	1	57	10	67
"Q53"	"I80"	"Undescended and ectopic testicle"	"Phlebitis and thrombophlebitis"	1	30	0	30
"Q53"	"I83"	"Undescended and ectopic testicle"	"Varicose veins of lower extremities"	1	31	0	31
"Q53"	"J03"	"Undescended and ectopic testicle"	"Acute tonsillitis"	1	488	264	752
"Q53"	"J15"	"Undescended and ectopic testicle"	"Bacterial pneumonia, not elsewhere classified"	1	152	65	217
"Q53"	"J35"	"Undescended and ectopic testicle"	"Chronic diseases of tonsils and adenoids"	1	609	410	1019
"Q53"	"J38"	"Undescended and ectopic testicle"	"Diseases of vocal cords and larynx, not elsewhere classified"	1	41	6	47
"Q53"	"K04"	"Undescended and ectopic testicle"	"Diseases of pulp and periapical tissues"	1	33	0	33
"Q53"	"K80"	"Undescended and ectopic testicle"	"Cholelithiasis"	1	45	0	45
"Q53"	"L02"	"Undescended and ectopic testicle"	"Cutaneous abscess, furuncle and carbuncle"	1	182	16	198
"Q53"	"L08"	"Undescended and ectopic testicle"	"Other local infections of skin and subcutaneous tissue"	1	192	5	197
"Q53"	"L90"	"Undescended and ectopic testicle"	"Atrophic disorders of skin"	1	50	0	50
"Q53"	"L98"	"Undescended and ectopic testicle"	"Oth disorders of skin, subcu, not elsewhere classified"	1	45	0	45
"Q53"	"M17"	"Undescended and ectopic testicle"	"Osteoarthritis of knee"	1	66	1	67
"Q53"	"M19"	"Undescended and ectopic testicle"	"Other and unspecified osteoarthritis"	1	35	0	35
"Q53"	"M23"	"Undescended and ectopic testicle"	"Internal derangement of knee"	1	261	0	261
"Q53"	"M47"	"Undescended and ectopic testicle"	"Spondylosis"	1	25	0	25
"Q53"	"M62"	"Undescended and ectopic testicle"	"Other disorders of muscle"	1	136	4	140
"Q53"	"M65"	"Undescended and ectopic testicle"	"Synovitis and tenosynovitis"	1	111	0	111
"Q53"	"M79"	"Undescended and ectopic testicle"	"Oth and unsp soft tissue disorders, not elsewhere classified"	1	608	35	643
"Q53"	"N20"	"Undescended and ectopic testicle"	"Calculus of kidney and ureter"	1	86	2	88
"Q53"	"N46"	"Undescended and ectopic testicle"	"Male infertility"	1	429	226	655
"Q53"	"N49"	"Undescended and ectopic testicle"	"Inflammatory disorders of male genital organs, NEC"	1	103	14	117
"Q53"	"Q17"	"Undescended and ectopic testicle"	"Other congenital malformations of ear"	1	102	19	121
"Q54"	"A09"	"Hypospadias"	"Infectious gastroenteritis and colitis, unspecified"	1	316	110	426
"Q54"	"A41"	"Hypospadias"	"Other sepsis"	1	111	5	116
"Q54"	"A46"	"Hypospadias"	"Erysipelas"	1	46	4	50
"Q54"	"E87"	"Hypospadias"	"Other disorders of fluid, electrolyte and acid-base balance"	1	57	7	64
"Q54"	"G40"	"Hypospadias"	"Epilepsy and recurrent seizures"	1	98	25	123
"Q54"	"G43"	"Hypospadias"	"Migraine"	1	26	0	26
"Q54"	"G47"	"Hypospadias"	"Sleep disorders"	1	131	19	150
"Q54"	"H26"	"Hypospadias"	"Other cataract"	1	48	2	50
"Q54"	"H52"	"Hypospadias"	"Disorders of refraction and accommodation"	1	106	11	117
"Q54"	"H53"	"Hypospadias"	"Visual disturbances"	1	46	8	54
"Q54"	"H66"	"Hypospadias"	"Suppurative and unspecified otitis media"	1	210	102	312
"Q54"	"I10"	"Hypospadias"	"Essential (primary) hypertension"	1	338	64	402
"Q54"	"I20"	"Hypospadias"	"Angina pectoris"	1	163	76	239
"Q54"	"I21"	"Hypospadias"	"Acute myocardial infarction"	1	109	25	134
"Q54"	"I50"	"Hypospadias"	"Heart failure"	1	120	12	132
"Q54"	"I69"	"Hypospadias"	"Sequelae of cerebrovascular disease"	1	62	2	64
"Q54"	"J03"	"Hypospadias"	"Acute tonsillitis"	1	226	40	266
"Q54"	"J05"	"Hypospadias"	"Acute obstructive laryngitis [croup] and epiglottitis"	1	188	85	273
"Q54"	"J06"	"Hypospadias"	"Acute upper resp infections of multiple and unsp sites"	1	237	65	302
"Q54"	"J15"	"Hypospadias"	"Bacterial pneumonia, not elsewhere classified"	1	107	5	112
"Q54"	"J18"	"Hypospadias"	"Pneumonia, unspecified organism"	1	410	93	503
"Q54"	"J30"	"Hypospadias"	"Vasomotor and allergic rhinitis"	1	64	10	74
"Q54"	"J35"	"Hypospadias"	"Chronic diseases of tonsils and adenoids"	1	211	69	280
"Q54"	"J44"	"Hypospadias"	"Other chronic obstructive pulmonary disease"	1	137	17	154
"Q54"	"J45"	"Hypospadias"	"Asthma"	1	454	147	601
"Q54"	"K04"	"Hypospadias"	"Diseases of pulp and periapical tissues"	1	27	2	29
"Q54"	"K35"	"Hypospadias"	"Acute appendicitis"	1	70	17	87
"Q54"	"K52"	"Hypospadias"	"Other and unsp noninfective gastroenteritis and colitis"	1	87	21	108
"Q54"	"K80"	"Hypospadias"	"Cholelithiasis"	1	52	12	64
"Q54"	"L02"	"Hypospadias"	"Cutaneous abscess, furuncle and carbuncle"	1	77	21	98
"Q54"	"L20"	"Hypospadias"	"Atopic dermatitis"	1	85	22	107
"Q54"	"N36"	"Hypospadias"	"Other disorders of urethra"	1	371	25	396
"Q54"	"N39"	"Hypospadias"	"Other disorders of urinary system"	1	161	27	188
"Q54"	"N99"	"Hypospadias"	"Intraop and postproc comp and disorders of GU sys, NEC"	1	304	54	358
"Q55"	"E29"	"Other congenital malformations of male genital organs"	"Testicular dysfunction"	1	42	8	50
"Q61"	"A49"	"Cystic kidney disease"	"Bacterial infection of unspecified site"	1	261	59	320
"Q61"	"C34"	"Cystic kidney disease"	"Malignant neoplasm of bronchus and lung"	1	116	50	166
"Q61"	"J81"	"Cystic kidney disease"	"Pulmonary edema"	1	80	18	98
"Q61"	"N18"	"Cystic kidney disease"	"Chronic kidney disease (CKD)"	1	1164	529	1693
"Q62"	"E34"	"Congen defects of renal pelvis and congen malform of ureter"	"Other endocrine disorders"	1	65	7	72
"Q62"	"I15"	"Congen defects of renal pelvis and congen malform of ureter"	"Secondary hypertension"	1	54	13	67
"Q62"	"J06"	"Congen defects of renal pelvis and congen malform of ureter"	"Acute upper resp infections of multiple and unsp sites"	1	305	106	411
"Q62"	"J18"	"Congen defects of renal pelvis and congen malform of ureter"	"Pneumonia, unspecified organism"	1	284	124	408
"Q62"	"J35"	"Congen defects of renal pelvis and congen malform of ureter"	"Chronic diseases of tonsils and adenoids"	1	151	68	219
"Q62"	"J45"	"Congen defects of renal pelvis and congen malform of ureter"	"Asthma"	1	262	131	393
"Q62"	"K59"	"Congen defects of renal pelvis and congen malform of ureter"	"Other functional intestinal disorders"	1	240	112	352
"Q62"	"M23"	"Congen defects of renal pelvis and congen malform of ureter"	"Internal derangement of knee"	1	74	14	88
"Q62"	"M79"	"Congen defects of renal pelvis and congen malform of ureter"	"Oth and unsp soft tissue disorders, not elsewhere classified"	1	119	26	145
"Q62"	"N18"	"Congen defects of renal pelvis and congen malform of ureter"	"Chronic kidney disease (CKD)"	1	175	54	229
"Q64"	"I10"	"Other congenital malformations of urinary system"	"Essential (primary) hypertension"	1	69	15	84
"Q64"	"K59"	"Other congenital malformations of urinary system"	"Other functional intestinal disorders"	1	114	36	150
"Q65"	"D12"	"Congenital deformities of hip"	"Benign neoplasm of colon, rectum, anus and anal canal"	1	50	10	60
"Q65"	"E30"	"Congenital deformities of hip"	"Disorders of puberty, not elsewhere classified"	1	38	1	39
"Q65"	"G44"	"Congenital deformities of hip"	"Other headache syndromes"	1	87	29	116
"Q65"	"J03"	"Congenital deformities of hip"	"Acute tonsillitis"	1	323	166	489
"Q65"	"K59"	"Congenital deformities of hip"	"Other functional intestinal disorders"	1	588	289	877
"Q65"	"L89"	"Congenital deformities of hip"	"Pressure ulcer"	1	46	6	52
"Q65"	"N30"	"Congenital deformities of hip"	"Cystitis"	1	346	139	485
"Q65"	"O72"	"Congenital deformities of hip"	"Postpartum hemorrhage"	1	439	110	549
"Q66"	"A41"	"Congenital deformities of feet"	"Other sepsis"	1	169	26	195
"Q66"	"C77"	"Congenital deformities of feet"	"Secondary and unspecified malignant neoplasm of lymph nodes"	1	28	2	30
"Q66"	"C79"	"Congenital deformities of feet"	"Secondary malignant neoplasm of other and unspecified sites"	1	29	0	29
"Q66"	"E78"	"Congenital deformities of feet"	"Disorders of lipoprotein metabolism and other lipidemias"	1	174	65	239
"Q66"	"G43"	"Congenital deformities of feet"	"Migraine"	1	124	21	145
"Q66"	"G47"	"Congenital deformities of feet"	"Sleep disorders"	1	199	52	251
"Q66"	"G62"	"Congenital deformities of feet"	"Other and unspecified polyneuropathies"	1	84	29	113
"Q66"	"I10"	"Congenital deformities of feet"	"Essential (primary) hypertension"	1	391	170	561
"Q66"	"J15"	"Congenital deformities of feet"	"Bacterial pneumonia, not elsewhere classified"	1	184	59	243
"Q66"	"J30"	"Congenital deformities of feet"	"Vasomotor and allergic rhinitis"	1	174	50	224
"Q66"	"K50"	"Congenital deformities of feet"	"Crohn's disease [regional enteritis]"	1	44	4	48
"Q66"	"K51"	"Congenital deformities of feet"	"Ulcerative colitis"	1	50	5	55
"Q66"	"K52"	"Congenital deformities of feet"	"Other and unsp noninfective gastroenteritis and colitis"	1	165	83	248
"Q66"	"K59"	"Congenital deformities of feet"	"Other functional intestinal disorders"	1	683	301	984
"Q66"	"L05"	"Congenital deformities of feet"	"Pilonidal cyst and sinus"	1	60	3	63
"Q66"	"M41"	"Congenital deformities of feet"	"Scoliosis"	1	308	76	384
"Q66"	"M54"	"Congenital deformities of feet"	"Dorsalgia"	1	458	212	670
"Q66"	"M67"	"Congenital deformities of feet"	"Other disorders of synovium and tendon"	1	373	181	554
"Q66"	"M79"	"Congenital deformities of feet"	"Oth and unsp soft tissue disorders, not elsewhere classified"	1	997	434	1431
"Q66"	"M96"	"Congenital deformities of feet"	"Intraop and postproc comp and disorders of ms sys, NEC"	1	66	11	77
"Q66"	"N50"	"Congenital deformities of feet"	"Other and unspecified disorders of male genital organs"	1	68	14	82
"Q66"	"N83"	"Congenital deformities of feet"	"Noninflammatory disord of ovary, fallop and broad ligament"	1	95	37	132
"Q66"	"O68"	"Congenital deformities of feet"	"Labor and delivery comp by abnlt of fetal acid-base balance"	1	115	27	142
"Q66"	"O70"	"Congenital deformities of feet"	"Perineal laceration during delivery"	1	255	49	304
"Q66"	"O72"	"Congenital deformities of feet"	"Postpartum hemorrhage"	1	338	0	338
"Q67"	"E86"	"Congenital ms deformities of head, face, spine and chest"	"Volume depletion"	1	166	77	243
"Q67"	"J93"	"Congenital ms deformities of head, face, spine and chest"	"Pneumothorax and air leak"	1	49	11	60
"Q67"	"M23"	"Congenital ms deformities of head, face, spine and chest"	"Internal derangement of knee"	1	147	63	210
"Q67"	"M67"	"Congenital ms deformities of head, face, spine and chest"	"Other disorders of synovium and tendon"	1	84	19	103
"Q67"	"M75"	"Congenital ms deformities of head, face, spine and chest"	"Shoulder lesions"	1	79	19	98
"Q67"	"M79"	"Congenital ms deformities of head, face, spine and chest"	"Oth and unsp soft tissue disorders, not elsewhere classified"	1	200	106	306
"Q67"	"N30"	"Congenital ms deformities of head, face, spine and chest"	"Cystitis"	1	123	53	176
"Q67"	"O70"	"Congenital ms deformities of head, face, spine and chest"	"Perineal laceration during delivery"	1	100	15	115
"Q67"	"O82"	"Congenital ms deformities of head, face, spine and chest"	"Encounter for cesarean delivery without indication"	1	45	9	54
"Q68"	"E66"	"Other congenital musculoskeletal deformities"	"Overweight and obesity"	1	30	0	30
"Q68"	"K59"	"Other congenital musculoskeletal deformities"	"Other functional intestinal disorders"	1	141	66	207
"Q68"	"N30"	"Other congenital musculoskeletal deformities"	"Cystitis"	1	81	8	89
"Q68"	"O70"	"Other congenital musculoskeletal deformities"	"Perineal laceration during delivery"	1	45	0	45
"Q68"	"O99"	"Other congenital musculoskeletal deformities"	"Oth maternal diseases classd elsw but compl preg/chldbrth"	1	34	0	34
"Q69"	"J45"	"Polydactyly"	"Asthma"	1	101	17	118
"Q70"	"H52"	"Syndactyly"	"Disorders of refraction and accommodation"	1	53	0	53
"Q70"	"J35"	"Syndactyly"	"Chronic diseases of tonsils and adenoids"	1	76	11	87
"Q70"	"Q74"	"Syndactyly"	"Other congenital malformations of limb(s)"	1	125	48	173
"Q74"	"G47"	"Other congenital malformations of limb(s)"	"Sleep disorders"	1	43	7	50
"Q74"	"H52"	"Other congenital malformations of limb(s)"	"Disorders of refraction and accommodation"	1	102	24	126
"Q74"	"M19"	"Other congenital malformations of limb(s)"	"Other and unspecified osteoarthritis"	1	68	3	71
"Q74"	"M79"	"Other congenital malformations of limb(s)"	"Oth and unsp soft tissue disorders, not elsewhere classified"	1	252	68	320
"Q74"	"O62"	"Other congenital malformations of limb(s)"	"Abnormalities of forces of labor"	1	40	3	43
"Q74"	"O82"	"Other congenital malformations of limb(s)"	"Encounter for cesarean delivery without indication"	1	39	1	40
"Q74"	"O99"	"Other congenital malformations of limb(s)"	"Oth maternal diseases classd elsw but compl preg/chldbrth"	1	58	0	58
"Q75"	"H50"	"Other congenital malformations of skull and face bones"	"Other strabismus"	1	155	73	228
"Q75"	"H52"	"Other congenital malformations of skull and face bones"	"Disorders of refraction and accommodation"	1	200	48	248
"Q75"	"H65"	"Other congenital malformations of skull and face bones"	"Nonsuppurative otitis media"	1	253	135	388
"Q75"	"H91"	"Other congenital malformations of skull and face bones"	"Other and unspecified hearing loss"	1	65	14	79
"Q75"	"J35"	"Other congenital malformations of skull and face bones"	"Chronic diseases of tonsils and adenoids"	1	194	73	267
"Q75"	"K01"	"Other congenital malformations of skull and face bones"	"Embedded and impacted teeth"	1	36	1	37
"Q75"	"M21"	"Other congenital malformations of skull and face bones"	"Other acquired deformities of limbs"	1	66	2	68
"Q76"	"J96"	"Congenital malformations of spine and bony thorax"	"Respiratory failure, not elsewhere classified"	1	56	11	67
"Q76"	"M48"	"Congenital malformations of spine and bony thorax"	"Other spondylopathies"	1	98	34	132
"Q76"	"M96"	"Congenital malformations of spine and bony thorax"	"Intraop and postproc comp and disorders of ms sys, NEC"	1	27	2	29
"Q76"	"N39"	"Congenital malformations of spine and bony thorax"	"Other disorders of urinary system"	1	80	12	92
"Q76"	"O72"	"Congenital malformations of spine and bony thorax"	"Postpartum hemorrhage"	1	59	0	59
"Q78"	"E66"	"Other osteochondrodysplasias"	"Overweight and obesity"	1	100	2	102
"Q78"	"H91"	"Other osteochondrodysplasias"	"Other and unspecified hearing loss"	1	96	22	118
"Q78"	"K00"	"Other osteochondrodysplasias"	"Disorders of tooth development and eruption"	1	54	10	64
"Q78"	"K80"	"Other osteochondrodysplasias"	"Cholelithiasis"	1	63	8	71
"Q78"	"M16"	"Other osteochondrodysplasias"	"Osteoarthritis of hip"	1	66	16	82
"Q78"	"M81"	"Other osteochondrodysplasias"	"Osteoporosis without current pathological fracture"	1	106	34	140
"Q78"	"N30"	"Other osteochondrodysplasias"	"Cystitis"	1	78	22	100
"Q78"	"O62"	"Other osteochondrodysplasias"	"Abnormalities of forces of labor"	1	62	15	77
"Q78"	"O80"	"Other osteochondrodysplasias"	"Encounter for full-term uncomplicated delivery"	1	151	35	186
"Q79"	"K08"	"Congenital malformations of musculoskeletal system, NEC"	"Other disorders of teeth and supporting structures"	1	42	2	44
"Q79"	"K59"	"Congenital malformations of musculoskeletal system, NEC"	"Other functional intestinal disorders"	1	210	89	299
"Q79"	"O72"	"Congenital malformations of musculoskeletal system, NEC"	"Postpartum hemorrhage"	1	234	42	276
"Q82"	"A41"	"Other congenital malformations of skin"	"Other sepsis"	1	131	48	179
"Q82"	"D47"	"Other congenital malformations of skin"	"Oth neoplm of uncrt behav of lymphoid, hematpoetc & rel tiss"	1	67	20	87
"Q82"	"E66"	"Other congenital malformations of skin"	"Overweight and obesity"	1	302	125	427
"Q82"	"E78"	"Other congenital malformations of skin"	"Disorders of lipoprotein metabolism and other lipidemias"	1	149	44	193
"Q82"	"G47"	"Other congenital malformations of skin"	"Sleep disorders"	1	106	16	122
"Q82"	"H57"	"Other congenital malformations of skin"	"Other disorders of eye and adnexa"	1	97	32	129
"Q82"	"J44"	"Other congenital malformations of skin"	"Other chronic obstructive pulmonary disease"	1	110	37	147
"Q82"	"L08"	"Other congenital malformations of skin"	"Other local infections of skin and subcutaneous tissue"	1	135	40	175
"Q82"	"L90"	"Other congenital malformations of skin"	"Atrophic disorders of skin"	1	375	203	578
"Q82"	"M67"	"Other congenital malformations of skin"	"Other disorders of synovium and tendon"	1	115	48	163
"Q82"	"N30"	"Other congenital malformations of skin"	"Cystitis"	1	219	110	329
"Q82"	"O72"	"Other congenital malformations of skin"	"Postpartum hemorrhage"	1	447	3	450
"Q82"	"O99"	"Other congenital malformations of skin"	"Oth maternal diseases classd elsw but compl preg/chldbrth"	1	231	85	316
"Q83"	"E66"	"Congenital malformations of breast"	"Overweight and obesity"	1	163	61	224
"Q83"	"N39"	"Congenital malformations of breast"	"Other disorders of urinary system"	1	79	17	96
"Q85"	"D23"	"Phakomatoses, not elsewhere classified"	"Other benign neoplasms of skin"	1	105	44	149
"Q85"	"E66"	"Phakomatoses, not elsewhere classified"	"Overweight and obesity"	1	58	10	68
"Q85"	"H47"	"Phakomatoses, not elsewhere classified"	"Other disorders of optic [2nd] nerve and visual pathways"	1	46	9	55
"Q85"	"H52"	"Phakomatoses, not elsewhere classified"	"Disorders of refraction and accommodation"	1	181	46	227
"Q85"	"H53"	"Phakomatoses, not elsewhere classified"	"Visual disturbances"	1	84	26	110
"Q85"	"K59"	"Phakomatoses, not elsewhere classified"	"Other functional intestinal disorders"	1	115	46	161
"Q85"	"M85"	"Phakomatoses, not elsewhere classified"	"Other disorders of bone density and structure"	1	37	3	40
"Q85"	"N18"	"Phakomatoses, not elsewhere classified"	"Chronic kidney disease (CKD)"	1	30	0	30
"Q87"	"E23"	"Oth congenital malform syndromes affecting multiple systems"	"Hypofunction and other disorders of the pituitary gland"	1	71	22	93
"Q87"	"H57"	"Oth congenital malform syndromes affecting multiple systems"	"Other disorders of eye and adnexa"	1	182	75	257
"Q87"	"I10"	"Oth congenital malform syndromes affecting multiple systems"	"Essential (primary) hypertension"	1	121	49	170
"Q87"	"J15"	"Oth congenital malform syndromes affecting multiple systems"	"Bacterial pneumonia, not elsewhere classified"	1	108	31	139
"Q87"	"K01"	"Oth congenital malform syndromes affecting multiple systems"	"Embedded and impacted teeth"	1	78	9	87
"Q87"	"K05"	"Oth congenital malform syndromes affecting multiple systems"	"Gingivitis and periodontal diseases"	1	63	14	77
"Q87"	"K92"	"Oth congenital malform syndromes affecting multiple systems"	"Other diseases of digestive system"	1	43	5	48
"Q87"	"M23"	"Oth congenital malform syndromes affecting multiple systems"	"Internal derangement of knee"	1	63	16	79
"Q87"	"M85"	"Oth congenital malform syndromes affecting multiple systems"	"Other disorders of bone density and structure"	1	29	2	31
"Q89"	"A09"	"Other congenital malformations, not elsewhere classified"	"Infectious gastroenteritis and colitis, unspecified"	1	201	67	268
"Q89"	"B34"	"Other congenital malformations, not elsewhere classified"	"Viral infection of unspecified site"	1	289	92	381
"Q89"	"H47"	"Other congenital malformations, not elsewhere classified"	"Other disorders of optic [2nd] nerve and visual pathways"	1	28	1	29
"Q89"	"H52"	"Other congenital malformations, not elsewhere classified"	"Disorders of refraction and accommodation"	1	122	23	145
"Q89"	"J06"	"Other congenital malformations, not elsewhere classified"	"Acute upper resp infections of multiple and unsp sites"	1	148	36	184
"Q89"	"J18"	"Other congenital malformations, not elsewhere classified"	"Pneumonia, unspecified organism"	1	227	118	345
"Q89"	"N31"	"Other congenital malformations, not elsewhere classified"	"Neuromuscular dysfunction of bladder, NEC"	1	41	6	47
"Q90"	"A41"	"Down syndrome"	"Other sepsis"	1	125	16	141
"Q90"	"E03"	"Down syndrome"	"Other hypothyroidism"	1	168	24	192
"Q90"	"G30"	"Down syndrome"	"Alzheimer's disease"	1	101	28	129
"Q90"	"G47"	"Down syndrome"	"Sleep disorders"	1	60	0	60
"Q90"	"H04"	"Down syndrome"	"Disorders of lacrimal system"	1	60	13	73
"Q90"	"H53"	"Down syndrome"	"Visual disturbances"	1	38	5	43
"Q90"	"H57"	"Down syndrome"	"Other disorders of eye and adnexa"	1	81	2	83
"Q90"	"I50"	"Down syndrome"	"Heart failure"	1	95	36	131
"Q90"	"J00"	"Down syndrome"	"Acute nasopharyngitis [common cold]"	1	239	38	277
"Q90"	"J05"	"Down syndrome"	"Acute obstructive laryngitis [croup] and epiglottitis"	1	247	42	289
"Q90"	"J14"	"Down syndrome"	"Pneumonia due to Hemophilus influenzae"	1	46	9	55
"Q90"	"J15"	"Down syndrome"	"Bacterial pneumonia, not elsewhere classified"	1	224	25	249
"Q90"	"J39"	"Down syndrome"	"Other diseases of upper respiratory tract"	1	45	3	48
"Q90"	"J45"	"Down syndrome"	"Asthma"	1	239	43	282
"Q90"	"J69"	"Down syndrome"	"Pneumonitis due to solids and liquids"	1	68	3	71
"Q90"	"J98"	"Down syndrome"	"Other respiratory disorders"	1	81	6	87
"Q90"	"K00"	"Down syndrome"	"Disorders of tooth development and eruption"	1	37	0	37
"Q90"	"K90"	"Down syndrome"	"Intestinal malabsorption"	1	83	0	83
"Q90"	"M79"	"Down syndrome"	"Oth and unsp soft tissue disorders, not elsewhere classified"	1	47	5	52
"Q90"	"Q53"	"Down syndrome"	"Undescended and ectopic testicle"	1	58	11	69
"C79"	"A08"	"Secondary malignant neoplasm of other and unspecified sites"	"Viral and other specified intestinal infections"	1	56	130	186
"E83"	"A09"	"Disorders of mineral metabolism"	"Infectious gastroenteritis and colitis, unspecified"	1	302	595	897
"J91"	"A09"	"Pleural effusion in conditions classified elsewhere"	"Infectious gastroenteritis and colitis, unspecified"	1	110	226	336
"K55"	"A09"	"Vascular disorders of intestine"	"Infectious gastroenteritis and colitis, unspecified"	1	248	483	731
"M23"	"A09"	"Internal derangement of knee"	"Infectious gastroenteritis and colitis, unspecified"	1	1216	1765	2981
"O34"	"A09"	"Maternal care for abnormality of pelvic organs"	"Infectious gastroenteritis and colitis, unspecified"	1	121	483	604
"C79"	"A15"	"Secondary malignant neoplasm of other and unspecified sites"	"Respiratory tuberculosis"	1	2	38	40
"J15"	"A15"	"Bacterial pneumonia, not elsewhere classified"	"Respiratory tuberculosis"	1	114	244	358
"B90"	"A18"	"Sequelae of tuberculosis"	"Tuberculosis of other organs"	1	31	95	126
"C78"	"A46"	"Secondary malignant neoplasm of resp and digestive organs"	"Erysipelas"	1	238	881	1119
"J96"	"A46"	"Respiratory failure, not elsewhere classified"	"Erysipelas"	1	1432	3768	5200
"O68"	"A56"	"Labor and delivery comp by abnlt of fetal acid-base balance"	"Other sexually transmitted chlamydial diseases"	1	30	235	265
"O70"	"A56"	"Perineal laceration during delivery"	"Other sexually transmitted chlamydial diseases"	1	67	462	529
"C21"	"A63"	"Malignant neoplasm of anus and anal canal"	"Oth predominantly sexually transmitted diseases, NEC"	1	4	103	107
"C50"	"A63"	"Malignant neoplasm of breast"	"Oth predominantly sexually transmitted diseases, NEC"	1	0	92	92
"D25"	"A63"	"Leiomyoma of uterus"	"Oth predominantly sexually transmitted diseases, NEC"	1	48	262	310
"D50"	"A63"	"Iron deficiency anemia"	"Oth predominantly sexually transmitted diseases, NEC"	1	10	100	110
"E78"	"A63"	"Disorders of lipoprotein metabolism and other lipidemias"	"Oth predominantly sexually transmitted diseases, NEC"	1	23	392	415
"G35"	"A63"	"Multiple sclerosis"	"Oth predominantly sexually transmitted diseases, NEC"	1	10	61	71
"G98"	"A63"	"Other disorders of nervous system not elsewhere classified"	"Oth predominantly sexually transmitted diseases, NEC"	1	0	72	72
"I47"	"A63"	"Paroxysmal tachycardia"	"Oth predominantly sexually transmitted diseases, NEC"	1	59	156	215
"J18"	"A63"	"Pneumonia, unspecified organism"	"Oth predominantly sexually transmitted diseases, NEC"	1	141	575	716
"K22"	"A63"	"Other diseases of esophagus"	"Oth predominantly sexually transmitted diseases, NEC"	1	20	85	105
"K44"	"A63"	"Diaphragmatic hernia"	"Oth predominantly sexually transmitted diseases, NEC"	1	52	208	260
"K85"	"A63"	"Acute pancreatitis"	"Oth predominantly sexually transmitted diseases, NEC"	1	25	76	101
"M51"	"A63"	"Thoracic, thoracolum, and lumbosacral intvrt disc disorders"	"Oth predominantly sexually transmitted diseases, NEC"	1	149	617	766
"M70"	"A63"	"Soft tissue disorders related to use, overuse and pressure"	"Oth predominantly sexually transmitted diseases, NEC"	1	103	249	352
"N30"	"A63"	"Cystitis"	"Oth predominantly sexually transmitted diseases, NEC"	1	375	725	1100
"N87"	"A63"	"Dysplasia of cervix uteri"	"Oth predominantly sexually transmitted diseases, NEC"	1	1059	1646	2705
"O23"	"A63"	"Infections of genitourinary tract in pregnancy"	"Oth predominantly sexually transmitted diseases, NEC"	1	48	574	622
"O68"	"A63"	"Labor and delivery comp by abnlt of fetal acid-base balance"	"Oth predominantly sexually transmitted diseases, NEC"	1	0	2434	2434
"O72"	"A63"	"Postpartum hemorrhage"	"Oth predominantly sexually transmitted diseases, NEC"	1	0	3308	3308
"O80"	"A63"	"Encounter for full-term uncomplicated delivery"	"Oth predominantly sexually transmitted diseases, NEC"	1	0	6499	6499
"G96"	"A87"	"Other disorders of central nervous system"	"Viral meningitis"	1	21	79	100
"I25"	"A88"	"Chronic ischemic heart disease"	"Oth viral infections of central nervous system, NEC"	1	64	184	248
"I50"	"A88"	"Heart failure"	"Oth viral infections of central nervous system, NEC"	1	11	131	142
"J18"	"A88"	"Pneumonia, unspecified organism"	"Oth viral infections of central nervous system, NEC"	1	16	271	287
"O72"	"B00"	"Postpartum hemorrhage"	"Herpesviral [herpes simplex] infections"	1	89	283	372
"C78"	"B02"	"Secondary malignant neoplasm of resp and digestive organs"	"Zoster [herpes zoster]"	1	59	149	208
"G53"	"B02"	"Cranial nerve disorders in diseases classified elsewhere"	"Zoster [herpes zoster]"	1	87	218	305
"C22"	"B18"	"Malignant neoplasm of liver and intrahepatic bile ducts"	"Chronic viral hepatitis"	1	64	364	428
"C34"	"B18"	"Malignant neoplasm of bronchus and lung"	"Chronic viral hepatitis"	1	7	99	106
"D64"	"B18"	"Other anemias"	"Chronic viral hepatitis"	1	227	353	580
"F17"	"B18"	"Nicotine dependence"	"Chronic viral hepatitis"	1	185	362	547
"K59"	"B18"	"Other functional intestinal disorders"	"Chronic viral hepatitis"	1	211	453	664
"K74"	"B18"	"Fibrosis and cirrhosis of liver"	"Chronic viral hepatitis"	1	383	1086	1469
"L29"	"B18"	"Pruritus"	"Chronic viral hepatitis"	1	11	51	62
"E78"	"B20"	"Disorders of lipoprotein metabolism and other lipidemias"	"Human immunodeficiency virus [HIV] disease"	1	13	60	73
"F17"	"B27"	"Nicotine dependence"	"Infectious mononucleosis"	1	0	98	98
"K62"	"B27"	"Other diseases of anus and rectum"	"Infectious mononucleosis"	1	11	106	117
"M75"	"B27"	"Shoulder lesions"	"Infectious mononucleosis"	1	0	224	224
"O04"	"B27"	"Complications following (induced) termination of pregnancy"	"Infectious mononucleosis"	1	62	613	675
"O14"	"B27"	"Pre-eclampsia"	"Infectious mononucleosis"	1	0	42	42
"O30"	"B27"	"Multiple gestation"	"Infectious mononucleosis"	1	0	26	26
"B27"	"B34"	"Infectious mononucleosis"	"Viral infection of unspecified site"	1	261	587	848
"J01"	"B34"	"Acute sinusitis"	"Viral infection of unspecified site"	1	351	597	948
"J09"	"B34"	"Influenza due to certain identified influenza viruses"	"Viral infection of unspecified site"	1	83	320	403
"K35"	"B34"	"Acute appendicitis"	"Viral infection of unspecified site"	1	386	648	1034
"A41"	"B35"	"Other sepsis"	"Dermatophytosis"	1	105	204	309
"J44"	"C00"	"Other chronic obstructive pulmonary disease"	"Malignant neoplasm of lip"	1	20	96	116
"A49"	"C01"	"Bacterial infection of unspecified site"	"Malignant neoplasm of base of tongue"	1	9	49	58
"C79"	"C04"	"Secondary malignant neoplasm of other and unspecified sites"	"Malignant neoplasm of floor of mouth"	1	14	69	83
"E86"	"C04"	"Volume depletion"	"Malignant neoplasm of floor of mouth"	1	61	185	246
"D63"	"C06"	"Anemia in chronic diseases classified elsewhere"	"Malignant neoplasm of other and unspecified parts of mouth"	1	44	111	155
"E64"	"C06"	"Sequelae of malnutrition and other nutritional deficiencies"	"Malignant neoplasm of other and unspecified parts of mouth"	1	101	339	440
"C79"	"C09"	"Secondary malignant neoplasm of other and unspecified sites"	"Malignant neoplasm of tonsil"	1	24	130	154
"E64"	"C09"	"Sequelae of malnutrition and other nutritional deficiencies"	"Malignant neoplasm of tonsil"	1	71	380	451
"E64"	"C10"	"Sequelae of malnutrition and other nutritional deficiencies"	"Malignant neoplasm of oropharynx"	1	156	506	662
"J15"	"C13"	"Bacterial pneumonia, not elsewhere classified"	"Malignant neoplasm of hypopharynx"	1	74	173	247
"K12"	"C13"	"Stomatitis and related lesions"	"Malignant neoplasm of hypopharynx"	1	63	189	252
"K22"	"C13"	"Other diseases of esophagus"	"Malignant neoplasm of hypopharynx"	1	76	155	231
"A04"	"C18"	"Other bacterial intestinal infections"	"Malignant neoplasm of colon"	1	168	420	588
"C77"	"C18"	"Secondary and unspecified malignant neoplasm of lymph nodes"	"Malignant neoplasm of colon"	1	718	2079	2797
"F03"	"C18"	"Unspecified dementia"	"Malignant neoplasm of colon"	1	354	883	1237
"L89"	"C18"	"Pressure ulcer"	"Malignant neoplasm of colon"	1	144	371	515
"E64"	"C20"	"Sequelae of malnutrition and other nutritional deficiencies"	"Malignant neoplasm of rectum"	1	115	271	386
"F33"	"C20"	"Major depressive disorder, recurrent"	"Malignant neoplasm of rectum"	1	69	159	228
"G47"	"C20"	"Sleep disorders"	"Malignant neoplasm of rectum"	1	175	770	945
"G96"	"C20"	"Other disorders of central nervous system"	"Malignant neoplasm of rectum"	1	41	129	170
"I35"	"C20"	"Nonrheumatic aortic valve disorders"	"Malignant neoplasm of rectum"	1	201	409	610
"I95"	"C20"	"Hypotension"	"Malignant neoplasm of rectum"	1	75	256	331
"K61"	"C20"	"Abscess of anal and rectal regions"	"Malignant neoplasm of rectum"	1	256	568	824
"N31"	"C20"	"Neuromuscular dysfunction of bladder, NEC"	"Malignant neoplasm of rectum"	1	85	311	396
"D64"	"C21"	"Other anemias"	"Malignant neoplasm of anus and anal canal"	1	77	161	238
"E86"	"C21"	"Volume depletion"	"Malignant neoplasm of anus and anal canal"	1	57	225	282
"G47"	"C21"	"Sleep disorders"	"Malignant neoplasm of anus and anal canal"	1	28	95	123
"K91"	"C21"	"Intraop and postproc comp and disorders of dgstv sys, NEC"	"Malignant neoplasm of anus and anal canal"	1	19	97	116
"N30"	"C30"	"Cystitis"	"Malignant neoplasm of nasal cavity and middle ear"	1	26	84	110
"N17"	"C32"	"Acute kidney failure"	"Malignant neoplasm of larynx"	1	12	59	71
"J15"	"C34"	"Bacterial pneumonia, not elsewhere classified"	"Malignant neoplasm of bronchus and lung"	1	3268	4292	7560
"J91"	"C34"	"Pleural effusion in conditions classified elsewhere"	"Malignant neoplasm of bronchus and lung"	1	1178	1787	2965
"D18"	"C43"	"Hemangioma and lymphangioma, any site"	"Malignant melanoma of skin"	1	90	250	340
"I46"	"C43"	"Cardiac arrest"	"Malignant melanoma of skin"	1	7	149	156
"K52"	"C43"	"Other and unsp noninfective gastroenteritis and colitis"	"Malignant melanoma of skin"	1	119	233	352
"K57"	"C43"	"Diverticular disease of intestine"	"Malignant melanoma of skin"	1	278	537	815
"N30"	"C43"	"Cystitis"	"Malignant melanoma of skin"	1	453	812	1265
"C79"	"C44"	"Secondary malignant neoplasm of other and unspecified sites"	"Other and unspecified malignant neoplasm of skin"	1	393	1377	1770
"D50"	"C44"	"Iron deficiency anemia"	"Other and unspecified malignant neoplasm of skin"	1	464	708	1172
"E55"	"C44"	"Vitamin D deficiency"	"Other and unspecified malignant neoplasm of skin"	1	113	298	411
"F06"	"C44"	"Other mental disorders due to known physiological condition"	"Other and unspecified malignant neoplasm of skin"	1	76	173	249
"F41"	"C44"	"Other anxiety disorders"	"Other and unspecified malignant neoplasm of skin"	1	172	492	664
"G47"	"C48"	"Sleep disorders"	"Malignant neoplasm of retroperitoneum and peritoneum"	1	38	142	180
"A04"	"C50"	"Other bacterial intestinal infections"	"Malignant neoplasm of breast"	1	38	421	459
"A49"	"C50"	"Bacterial infection of unspecified site"	"Malignant neoplasm of breast"	1	0	1709	1709
"C38"	"C50"	"Malignant neoplasm of heart, mediastinum and pleura"	"Malignant neoplasm of breast"	1	23	73	96
"E78"	"C50"	"Disorders of lipoprotein metabolism and other lipidemias"	"Malignant neoplasm of breast"	1	1170	2008	3178
"E87"	"C50"	"Other disorders of fluid, electrolyte and acid-base balance"	"Malignant neoplasm of breast"	1	0	2162	2162
"F01"	"C50"	"Vascular dementia"	"Malignant neoplasm of breast"	1	8	212	220
"F06"	"C50"	"Other mental disorders due to known physiological condition"	"Malignant neoplasm of breast"	1	15	149	164
"G47"	"C50"	"Sleep disorders"	"Malignant neoplasm of breast"	1	67	1301	1368
"H01"	"C50"	"Other inflammation of eyelid"	"Malignant neoplasm of breast"	1	31	87	118
"I25"	"C50"	"Chronic ischemic heart disease"	"Malignant neoplasm of breast"	1	1328	1918	3246
"I48"	"C50"	"Atrial fibrillation and flutter"	"Malignant neoplasm of breast"	1	1284	3611	4895
"J15"	"C50"	"Bacterial pneumonia, not elsewhere classified"	"Malignant neoplasm of breast"	1	0	2306	2306
"J81"	"C50"	"Pulmonary edema"	"Malignant neoplasm of breast"	1	70	438	508
"J93"	"C50"	"Pneumothorax and air leak"	"Malignant neoplasm of breast"	1	90	525	615
"K59"	"C50"	"Other functional intestinal disorders"	"Malignant neoplasm of breast"	1	0	4764	4764
"K65"	"C50"	"Peritonitis"	"Malignant neoplasm of breast"	1	94	240	334
"K72"	"C50"	"Hepatic failure, not elsewhere classified"	"Malignant neoplasm of breast"	1	34	253	287
"K83"	"C50"	"Other diseases of biliary tract"	"Malignant neoplasm of breast"	1	75	346	421
"L29"	"C50"	"Pruritus"	"Malignant neoplasm of breast"	1	20	86	106
"L81"	"C50"	"Other disorders of pigmentation"	"Malignant neoplasm of breast"	1	64	812	876
"M81"	"C50"	"Osteoporosis without current pathological fracture"	"Malignant neoplasm of breast"	1	0	5549	5549
"N19"	"C50"	"Unspecified kidney failure"	"Malignant neoplasm of breast"	1	68	408	476
"N39"	"C50"	"Other disorders of urinary system"	"Malignant neoplasm of breast"	1	960	3198	4158
"A46"	"C51"	"Erysipelas"	"Malignant neoplasm of vulva"	1	26	79	105
"C79"	"C51"	"Secondary malignant neoplasm of other and unspecified sites"	"Malignant neoplasm of vulva"	1	8	84	92
"F41"	"C51"	"Other anxiety disorders"	"Malignant neoplasm of vulva"	1	11	56	67
"D64"	"C53"	"Other anemias"	"Malignant neoplasm of cervix uteri"	1	137	562	699
"M79"	"C53"	"Oth and unsp soft tissue disorders, not elsewhere classified"	"Malignant neoplasm of cervix uteri"	1	103	193	296
"N18"	"C53"	"Chronic kidney disease (CKD)"	"Malignant neoplasm of cervix uteri"	1	23	184	207
"E83"	"C54"	"Disorders of mineral metabolism"	"Malignant neoplasm of corpus uteri"	1	29	188	217
"G47"	"C54"	"Sleep disorders"	"Malignant neoplasm of corpus uteri"	1	48	286	334
"I73"	"C54"	"Other peripheral vascular diseases"	"Malignant neoplasm of corpus uteri"	1	26	99	125
"J18"	"C54"	"Pneumonia, unspecified organism"	"Malignant neoplasm of corpus uteri"	1	151	930	1081
"J91"	"C54"	"Pleural effusion in conditions classified elsewhere"	"Malignant neoplasm of corpus uteri"	1	15	90	105
"M19"	"C54"	"Other and unspecified osteoarthritis"	"Malignant neoplasm of corpus uteri"	1	93	180	273
"N39"	"C54"	"Other disorders of urinary system"	"Malignant neoplasm of corpus uteri"	1	223	949	1172
"I82"	"C56"	"Other venous embolism and thrombosis"	"Malignant neoplasm of ovary"	1	60	171	231
"J15"	"C56"	"Bacterial pneumonia, not elsewhere classified"	"Malignant neoplasm of ovary"	1	80	275	355
"J91"	"C56"	"Pleural effusion in conditions classified elsewhere"	"Malignant neoplasm of ovary"	1	146	330	476
"J93"	"C56"	"Pneumothorax and air leak"	"Malignant neoplasm of ovary"	1	32	94	126
"N19"	"C56"	"Unspecified kidney failure"	"Malignant neoplasm of ovary"	1	30	105	135
"C77"	"C60"	"Secondary and unspecified malignant neoplasm of lymph nodes"	"Malignant neoplasm of penis"	1	44	139	183
"C79"	"C61"	"Secondary malignant neoplasm of other and unspecified sites"	"Malignant neoplasm of prostate"	1	0	11392	11392
"C90"	"C61"	"Multiple myeloma and malignant plasma cell neoplasms"	"Malignant neoplasm of prostate"	1	62	146	208
"D07"	"C61"	"Carcinoma in situ of other and unspecified genital organs"	"Malignant neoplasm of prostate"	1	119	264	383
"E86"	"C61"	"Volume depletion"	"Malignant neoplasm of prostate"	1	0	4566	4566
"I46"	"C61"	"Cardiac arrest"	"Malignant neoplasm of prostate"	1	113	668	781
"K62"	"C61"	"Other diseases of anus and rectum"	"Malignant neoplasm of prostate"	1	1280	1560	2840
"K65"	"C61"	"Peritonitis"	"Malignant neoplasm of prostate"	1	157	368	525
"N18"	"C61"	"Chronic kidney disease (CKD)"	"Malignant neoplasm of prostate"	1	603	1826	2429
"N30"	"C61"	"Cystitis"	"Malignant neoplasm of prostate"	1	2696	4811	7507
"E66"	"C62"	"Overweight and obesity"	"Malignant neoplasm of testis"	1	0	73	73
"F05"	"C64"	"Delirium due to known physiological condition"	"Malignant neoplasm of kidney, except renal pelvis"	1	42	192	234
"G47"	"C64"	"Sleep disorders"	"Malignant neoplasm of kidney, except renal pelvis"	1	162	394	556
"D63"	"C67"	"Anemia in chronic diseases classified elsewhere"	"Malignant neoplasm of bladder"	1	287	1774	2061
"I89"	"C67"	"Oth noninfective disorders of lymphatic vessels and nodes"	"Malignant neoplasm of bladder"	1	53	218	271
"K59"	"C67"	"Other functional intestinal disorders"	"Malignant neoplasm of bladder"	1	508	1843	2351
"K65"	"C67"	"Peritonitis"	"Malignant neoplasm of bladder"	1	87	267	354
"A41"	"C69"	"Other sepsis"	"Malignant neoplasm of eye and adnexa"	1	33	123	156
"H57"	"C71"	"Other disorders of eye and adnexa"	"Malignant neoplasm of brain"	1	42	109	151
"I89"	"C77"	"Oth noninfective disorders of lymphatic vessels and nodes"	"Secondary and unspecified malignant neoplasm of lymph nodes"	1	263	1287	1550
"I97"	"C77"	"Intraop and postproc comp and disorders of circ sys, NEC"	"Secondary and unspecified malignant neoplasm of lymph nodes"	1	81	303	384
"J69"	"C77"	"Pneumonitis due to solids and liquids"	"Secondary and unspecified malignant neoplasm of lymph nodes"	1	44	134	178
"K12"	"C77"	"Stomatitis and related lesions"	"Secondary and unspecified malignant neoplasm of lymph nodes"	1	173	302	475
"E86"	"C78"	"Volume depletion"	"Secondary malignant neoplasm of resp and digestive organs"	1	3605	4222	7827
"A49"	"C81"	"Bacterial infection of unspecified site"	"Hodgkin lymphoma"	1	42	155	197
"B37"	"C81"	"Candidiasis"	"Hodgkin lymphoma"	1	30	136	166
"E87"	"C81"	"Other disorders of fluid, electrolyte and acid-base balance"	"Hodgkin lymphoma"	1	31	94	125
"E89"	"C81"	"Postproc endocrine and metabolic comp and disorders, NEC"	"Hodgkin lymphoma"	1	9	78	87
"I26"	"C81"	"Pulmonary embolism"	"Hodgkin lymphoma"	1	20	73	93
"N39"	"C81"	"Other disorders of urinary system"	"Hodgkin lymphoma"	1	46	139	185
"A04"	"C83"	"Other bacterial intestinal infections"	"Non-follicular lymphoma"	1	84	339	423
"D61"	"C83"	"Oth aplastic anemias and other bone marrow failure syndromes"	"Non-follicular lymphoma"	1	175	408	583
"D70"	"C83"	"Neutropenia"	"Non-follicular lymphoma"	1	94	198	292
"J69"	"C83"	"Pneumonitis due to solids and liquids"	"Non-follicular lymphoma"	1	8	51	59
"C82"	"C85"	"Follicular lymphoma"	"Oth and unspecified types of non-Hodgkin lymphoma"	1	926	1618	2544
"E29"	"C85"	"Testicular dysfunction"	"Oth and unspecified types of non-Hodgkin lymphoma"	1	1	25	26
"E89"	"C85"	"Postproc endocrine and metabolic comp and disorders, NEC"	"Oth and unspecified types of non-Hodgkin lymphoma"	1	23	84	107
"F03"	"C85"	"Unspecified dementia"	"Oth and unspecified types of non-Hodgkin lymphoma"	1	31	127	158
"N30"	"C85"	"Cystitis"	"Oth and unspecified types of non-Hodgkin lymphoma"	1	329	523	852
"B37"	"C90"	"Candidiasis"	"Multiple myeloma and malignant plasma cell neoplasms"	1	67	248	315
"C96"	"C90"	"Oth & unsp malig neoplm of lymphoid, hematpoetc and rel tiss"	"Multiple myeloma and malignant plasma cell neoplasms"	1	83	256	339
"M90"	"C90"	"Osteopathies in diseases classified elsewhere"	"Multiple myeloma and malignant plasma cell neoplasms"	1	66	180	246
"A41"	"C91"	"Other sepsis"	"Lymphoid leukemia"	1	647	2092	2739
"E89"	"C91"	"Postproc endocrine and metabolic comp and disorders, NEC"	"Lymphoid leukemia"	1	16	179	195
"J10"	"C91"	"Influenza due to other identified influenza virus"	"Lymphoid leukemia"	1	18	116	134
"J18"	"C91"	"Pneumonia, unspecified organism"	"Lymphoid leukemia"	1	1137	2431	3568
"J91"	"C91"	"Pleural effusion in conditions classified elsewhere"	"Lymphoid leukemia"	1	23	89	112
"L30"	"C91"	"Other and unspecified dermatitis"	"Lymphoid leukemia"	1	64	163	227
"H57"	"C92"	"Other disorders of eye and adnexa"	"Myeloid leukemia"	1	17	94	111
"A41"	"D03"	"Other sepsis"	"Melanoma in situ"	1	48	120	168
"D64"	"D05"	"Other anemias"	"Carcinoma in situ of breast"	1	42	117	159
"K59"	"D05"	"Other functional intestinal disorders"	"Carcinoma in situ of breast"	1	75	226	301
"N18"	"D05"	"Chronic kidney disease (CKD)"	"Carcinoma in situ of breast"	1	5	37	42
"A09"	"D06"	"Infectious gastroenteritis and colitis, unspecified"	"Carcinoma in situ of cervix uteri"	1	30	91	121
"E04"	"D06"	"Other nontoxic goiter"	"Carcinoma in situ of cervix uteri"	1	4	136	140
"E86"	"D06"	"Volume depletion"	"Carcinoma in situ of cervix uteri"	1	0	79	79
"I10"	"D06"	"Essential (primary) hypertension"	"Carcinoma in situ of cervix uteri"	1	0	431	431
"I50"	"D06"	"Heart failure"	"Carcinoma in situ of cervix uteri"	1	0	58	58
"K43"	"D06"	"Ventral hernia"	"Carcinoma in situ of cervix uteri"	1	0	71	71
"M23"	"D06"	"Internal derangement of knee"	"Carcinoma in situ of cervix uteri"	1	36	271	307
"M65"	"D06"	"Synovitis and tenosynovitis"	"Carcinoma in situ of cervix uteri"	1	6	136	142
"N39"	"D06"	"Other disorders of urinary system"	"Carcinoma in situ of cervix uteri"	1	0	223	223
"N89"	"D06"	"Other noninflammatory disorders of vagina"	"Carcinoma in situ of cervix uteri"	1	27	119	146
"O72"	"D06"	"Postpartum hemorrhage"	"Carcinoma in situ of cervix uteri"	1	137	630	767
"N39"	"D10"	"Other disorders of urinary system"	"Benign neoplasm of mouth and pharynx"	1	217	393	610
"D63"	"D11"	"Anemia in chronic diseases classified elsewhere"	"Benign neoplasm of major salivary glands"	1	6	91	97
"F41"	"D11"	"Other anxiety disorders"	"Benign neoplasm of major salivary glands"	1	19	78	97
"H25"	"D11"	"Age-related cataract"	"Benign neoplasm of major salivary glands"	1	292	587	879
"I35"	"D11"	"Nonrheumatic aortic valve disorders"	"Benign neoplasm of major salivary glands"	1	36	167	203
"I63"	"D11"	"Cerebral infarction"	"Benign neoplasm of major salivary glands"	1	92	232	324
"I69"	"D11"	"Sequelae of cerebrovascular disease"	"Benign neoplasm of major salivary glands"	1	101	271	372
"J15"	"D11"	"Bacterial pneumonia, not elsewhere classified"	"Benign neoplasm of major salivary glands"	1	46	300	346
"J81"	"D11"	"Pulmonary edema"	"Benign neoplasm of major salivary glands"	1	6	44	50
"C15"	"D12"	"Malignant neoplasm of esophagus"	"Benign neoplasm of colon, rectum, anus and anal canal"	1	109	355	464
"C25"	"D12"	"Malignant neoplasm of pancreas"	"Benign neoplasm of colon, rectum, anus and anal canal"	1	89	870	959
"C78"	"D12"	"Secondary malignant neoplasm of resp and digestive organs"	"Benign neoplasm of colon, rectum, anus and anal canal"	1	0	4658	4658
"D63"	"D12"	"Anemia in chronic diseases classified elsewhere"	"Benign neoplasm of colon, rectum, anus and anal canal"	1	261	1291	1552
"F05"	"D12"	"Delirium due to known physiological condition"	"Benign neoplasm of colon, rectum, anus and anal canal"	1	35	1098	1133
"C17"	"D13"	"Malignant neoplasm of small intestine"	"Benign neoplasm of and ill-defined parts of digestive system"	1	59	141	200
"C25"	"D13"	"Malignant neoplasm of pancreas"	"Benign neoplasm of and ill-defined parts of digestive system"	1	137	284	421
"H26"	"D14"	"Other cataract"	"Benign neoplasm of middle ear and respiratory system"	1	113	211	324
"I69"	"D14"	"Sequelae of cerebrovascular disease"	"Benign neoplasm of middle ear and respiratory system"	1	113	400	513
"L89"	"D14"	"Pressure ulcer"	"Benign neoplasm of middle ear and respiratory system"	1	2	60	62
"N19"	"D14"	"Unspecified kidney failure"	"Benign neoplasm of middle ear and respiratory system"	1	11	105	116
"C49"	"D16"	"Malignant neoplasm of other connective and soft tissue"	"Benign neoplasm of bone and articular cartilage"	1	24	105	129
"E87"	"D16"	"Other disorders of fluid, electrolyte and acid-base balance"	"Benign neoplasm of bone and articular cartilage"	1	3	113	116
"B37"	"D17"	"Candidiasis"	"Benign lipomatous neoplasm"	1	51	135	186
"D63"	"D17"	"Anemia in chronic diseases classified elsewhere"	"Benign lipomatous neoplasm"	1	0	222	222
"E64"	"D17"	"Sequelae of malnutrition and other nutritional deficiencies"	"Benign lipomatous neoplasm"	1	18	111	129
"G30"	"D17"	"Alzheimer's disease"	"Benign lipomatous neoplasm"	1	0	93	93
"H91"	"D17"	"Other and unspecified hearing loss"	"Benign lipomatous neoplasm"	1	920	1304	2224
"I71"	"D17"	"Aortic aneurysm and dissection"	"Benign lipomatous neoplasm"	1	32	326	358
"I73"	"D17"	"Other peripheral vascular diseases"	"Benign lipomatous neoplasm"	1	143	452	595
"J09"	"D17"	"Influenza due to certain identified influenza viruses"	"Benign lipomatous neoplasm"	1	0	35	35
"J84"	"D17"	"Other interstitial pulmonary diseases"	"Benign lipomatous neoplasm"	1	25	121	146
"M19"	"D17"	"Other and unspecified osteoarthritis"	"Benign lipomatous neoplasm"	1	569	1218	1787
"M48"	"D17"	"Other spondylopathies"	"Benign lipomatous neoplasm"	1	265	840	1105
"E34"	"D18"	"Other endocrine disorders"	"Hemangioma and lymphangioma, any site"	1	9	57	66
"O72"	"D18"	"Postpartum hemorrhage"	"Hemangioma and lymphangioma, any site"	1	68	261	329
"E87"	"D21"	"Other disorders of fluid, electrolyte and acid-base balance"	"Other benign neoplasms of connective and other soft tissue"	1	29	142	171
"C61"	"D23"	"Malignant neoplasm of prostate"	"Other benign neoplasms of skin"	1	120	426	546
"E21"	"D23"	"Hyperparathyroidism and other disorders of parathyroid gland"	"Other benign neoplasms of skin"	1	46	128	174
"G45"	"D23"	"Transient cerebral ischemic attacks and related syndromes"	"Other benign neoplasms of skin"	1	324	492	816
"H53"	"D23"	"Visual disturbances"	"Other benign neoplasms of skin"	1	143	273	416
"I10"	"D23"	"Essential (primary) hypertension"	"Other benign neoplasms of skin"	1	2073	2996	5069
"I80"	"D23"	"Phlebitis and thrombophlebitis"	"Other benign neoplasms of skin"	1	286	432	718
"J06"	"D23"	"Acute upper resp infections of multiple and unsp sites"	"Other benign neoplasms of skin"	1	60	140	200
"J18"	"D23"	"Pneumonia, unspecified organism"	"Other benign neoplasms of skin"	1	866	2258	3124
"J44"	"D23"	"Other chronic obstructive pulmonary disease"	"Other benign neoplasms of skin"	1	546	1236	1782
"K22"	"D23"	"Other diseases of esophagus"	"Other benign neoplasms of skin"	1	91	204	295
"L89"	"D23"	"Pressure ulcer"	"Other benign neoplasms of skin"	1	25	187	212
"N30"	"D23"	"Cystitis"	"Other benign neoplasms of skin"	1	675	1335	2010
"C20"	"D24"	"Malignant neoplasm of rectum"	"Benign neoplasm of breast"	1	6	92	98
"C25"	"D24"	"Malignant neoplasm of pancreas"	"Benign neoplasm of breast"	1	0	62	62
"C34"	"D24"	"Malignant neoplasm of bronchus and lung"	"Benign neoplasm of breast"	1	0	352	352
"C77"	"D24"	"Secondary and unspecified malignant neoplasm of lymph nodes"	"Benign neoplasm of breast"	1	30	266	296
"D30"	"D24"	"Benign neoplasm of urinary organs"	"Benign neoplasm of breast"	1	12	61	73
"D63"	"D24"	"Anemia in chronic diseases classified elsewhere"	"Benign neoplasm of breast"	1	0	123	123
"E27"	"D24"	"Other disorders of adrenal gland"	"Benign neoplasm of breast"	1	3	61	64
"E55"	"D24"	"Vitamin D deficiency"	"Benign neoplasm of breast"	1	2	101	103
"G62"	"D24"	"Other and unspecified polyneuropathies"	"Benign neoplasm of breast"	1	8	166	174
"G95"	"D24"	"Other and unspecified diseases of spinal cord"	"Benign neoplasm of breast"	1	0	77	77
"H40"	"D24"	"Glaucoma"	"Benign neoplasm of breast"	1	27	166	193
"J43"	"D24"	"Emphysema"	"Benign neoplasm of breast"	1	4	75	79
"J96"	"D24"	"Respiratory failure, not elsewhere classified"	"Benign neoplasm of breast"	1	0	365	365
"K22"	"D24"	"Other diseases of esophagus"	"Benign neoplasm of breast"	1	13	138	151
"M16"	"D24"	"Osteoarthritis of hip"	"Benign neoplasm of breast"	1	43	631	674
"M43"	"D24"	"Other deforming dorsopathies"	"Benign neoplasm of breast"	1	51	144	195
"M77"	"D24"	"Other enthesopathies"	"Benign neoplasm of breast"	1	160	397	557
"M85"	"D24"	"Other disorders of bone density and structure"	"Benign neoplasm of breast"	1	0	485	485
"N18"	"D24"	"Chronic kidney disease (CKD)"	"Benign neoplasm of breast"	1	1	183	184
"B96"	"D25"	"Oth bacterial agents as the cause of diseases classd elswhr"	"Leiomyoma of uterus"	1	2	33	35
"C43"	"D25"	"Malignant melanoma of skin"	"Leiomyoma of uterus"	1	101	320	421
"C79"	"D25"	"Secondary malignant neoplasm of other and unspecified sites"	"Leiomyoma of uterus"	1	0	491	491
"C85"	"D25"	"Oth and unspecified types of non-Hodgkin lymphoma"	"Leiomyoma of uterus"	1	9	85	94
"C91"	"D25"	"Lymphoid leukemia"	"Leiomyoma of uterus"	1	0	57	57
"D46"	"D25"	"Myelodysplastic syndromes"	"Leiomyoma of uterus"	1	0	34	34
"D61"	"D25"	"Oth aplastic anemias and other bone marrow failure syndromes"	"Leiomyoma of uterus"	1	3	32	35
"D72"	"D25"	"Other disorders of white blood cells"	"Leiomyoma of uterus"	1	8	63	71
"E10"	"D25"	"Type 1 diabetes mellitus"	"Leiomyoma of uterus"	1	292	506	798
"E86"	"D25"	"Volume depletion"	"Leiomyoma of uterus"	1	0	611	611
"G24"	"D25"	"Dystonia"	"Leiomyoma of uterus"	1	9	74	83
"H02"	"D25"	"Other disorders of eyelid"	"Leiomyoma of uterus"	1	109	763	872
"I11"	"D25"	"Hypertensive heart disease"	"Leiomyoma of uterus"	1	12	139	151
"I20"	"D25"	"Angina pectoris"	"Leiomyoma of uterus"	1	189	1404	1593
"I21"	"D25"	"Acute myocardial infarction"	"Leiomyoma of uterus"	1	35	464	499
"I42"	"D25"	"Cardiomyopathy"	"Leiomyoma of uterus"	1	1	131	132
"I48"	"D25"	"Atrial fibrillation and flutter"	"Leiomyoma of uterus"	1	0	1106	1106
"I87"	"D25"	"Other disorders of veins"	"Leiomyoma of uterus"	1	18	112	130
"I95"	"D25"	"Hypotension"	"Leiomyoma of uterus"	1	5	142	147
"I97"	"D25"	"Intraop and postproc comp and disorders of circ sys, NEC"	"Leiomyoma of uterus"	1	0	64	64
"J86"	"D25"	"Pyothorax"	"Leiomyoma of uterus"	1	2	33	35
"J93"	"D25"	"Pneumothorax and air leak"	"Leiomyoma of uterus"	1	25	95	120
"J94"	"D25"	"Other pleural conditions"	"Leiomyoma of uterus"	1	0	58	58
"J95"	"D25"	"Intraop and postproc comp and disorders of resp sys, NEC"	"Leiomyoma of uterus"	1	0	40	40
"J98"	"D25"	"Other respiratory disorders"	"Leiomyoma of uterus"	1	20	169	189
"K05"	"D25"	"Gingivitis and periodontal diseases"	"Leiomyoma of uterus"	1	29	140	169
"K44"	"D25"	"Diaphragmatic hernia"	"Leiomyoma of uterus"	1	206	740	946
"K52"	"D25"	"Other and unsp noninfective gastroenteritis and colitis"	"Leiomyoma of uterus"	1	106	685	791
"K92"	"D25"	"Other diseases of digestive system"	"Leiomyoma of uterus"	1	50	327	377
"L08"	"D25"	"Other local infections of skin and subcutaneous tissue"	"Leiomyoma of uterus"	1	122	407	529
"L60"	"D25"	"Nail disorders"	"Leiomyoma of uterus"	1	41	101	142
"L98"	"D25"	"Oth disorders of skin, subcu, not elsewhere classified"	"Leiomyoma of uterus"	1	57	238	295
"M16"	"D25"	"Osteoarthritis of hip"	"Leiomyoma of uterus"	1	0	1032	1032
"M20"	"D25"	"Acquired deformities of fingers and toes"	"Leiomyoma of uterus"	1	267	1125	1392
"M48"	"D25"	"Other spondylopathies"	"Leiomyoma of uterus"	1	0	818	818
"M67"	"D25"	"Other disorders of synovium and tendon"	"Leiomyoma of uterus"	1	364	759	1123
"C49"	"D27"	"Malignant neoplasm of other connective and soft tissue"	"Benign neoplasm of ovary"	1	2	38	40
"C77"	"D27"	"Secondary and unspecified malignant neoplasm of lymph nodes"	"Benign neoplasm of ovary"	1	20	169	189
"E78"	"D27"	"Disorders of lipoprotein metabolism and other lipidemias"	"Benign neoplasm of ovary"	1	219	950	1169
"H36"	"D27"	"Retinal disorders in diseases classified elsewhere"	"Benign neoplasm of ovary"	1	25	86	111
"I20"	"D27"	"Angina pectoris"	"Benign neoplasm of ovary"	1	302	588	890
"I25"	"D27"	"Chronic ischemic heart disease"	"Benign neoplasm of ovary"	1	288	686	974
"I35"	"D27"	"Nonrheumatic aortic valve disorders"	"Benign neoplasm of ovary"	1	16	325	341
"I69"	"D27"	"Sequelae of cerebrovascular disease"	"Benign neoplasm of ovary"	1	58	431	489
"I89"	"D27"	"Oth noninfective disorders of lymphatic vessels and nodes"	"Benign neoplasm of ovary"	1	16	101	117
"J91"	"D27"	"Pleural effusion in conditions classified elsewhere"	"Benign neoplasm of ovary"	1	12	70	82
"K08"	"D27"	"Other disorders of teeth and supporting structures"	"Benign neoplasm of ovary"	1	31	90	121
"K31"	"D27"	"Other diseases of stomach and duodenum"	"Benign neoplasm of ovary"	1	8	60	68
"L97"	"D27"	"Non-pressure chronic ulcer of lower limb, NEC"	"Benign neoplasm of ovary"	1	3	115	118
"I20"	"D28"	"Angina pectoris"	"Benign neoplasm of other and unsp female genital organs"	1	34	100	134
"C18"	"D30"	"Malignant neoplasm of colon"	"Benign neoplasm of urinary organs"	1	164	411	575
"C34"	"D30"	"Malignant neoplasm of bronchus and lung"	"Benign neoplasm of urinary organs"	1	61	1049	1110
"C65"	"D30"	"Malignant neoplasm of renal pelvis"	"Benign neoplasm of urinary organs"	1	249	431	680
"E64"	"D30"	"Sequelae of malnutrition and other nutritional deficiencies"	"Benign neoplasm of urinary organs"	1	19	136	155
"E83"	"D30"	"Disorders of mineral metabolism"	"Benign neoplasm of urinary organs"	1	14	136	150
"G96"	"D30"	"Other disorders of central nervous system"	"Benign neoplasm of urinary organs"	1	23	180	203
"H25"	"D30"	"Age-related cataract"	"Benign neoplasm of urinary organs"	1	968	1965	2933
"I25"	"D30"	"Chronic ischemic heart disease"	"Benign neoplasm of urinary organs"	1	1120	1447	2567
"I48"	"D30"	"Atrial fibrillation and flutter"	"Benign neoplasm of urinary organs"	1	815	1869	2684
"I63"	"D30"	"Cerebral infarction"	"Benign neoplasm of urinary organs"	1	291	829	1120
"J90"	"D30"	"Pleural effusion, not elsewhere classified"	"Benign neoplasm of urinary organs"	1	24	267	291
"K72"	"D30"	"Hepatic failure, not elsewhere classified"	"Benign neoplasm of urinary organs"	1	7	70	77
"M81"	"D30"	"Osteoporosis without current pathological fracture"	"Benign neoplasm of urinary organs"	1	191	649	840
"M85"	"D30"	"Other disorders of bone density and structure"	"Benign neoplasm of urinary organs"	1	66	168	234
"K59"	"D31"	"Other functional intestinal disorders"	"Benign neoplasm of eye and adnexa"	1	71	162	233
"H57"	"D32"	"Other disorders of eye and adnexa"	"Benign neoplasm of meninges"	1	52	163	215
"C78"	"D33"	"Secondary malignant neoplasm of resp and digestive organs"	"Benign neoplasm of brain and oth prt central nervous system"	1	14	112	126
"H57"	"D33"	"Other disorders of eye and adnexa"	"Benign neoplasm of brain and oth prt central nervous system"	1	36	193	229
"K91"	"D37"	"Intraop and postproc comp and disorders of dgstv sys, NEC"	"Neoplasm of uncrt behavior of oral cavity and dgstv organs"	1	28	92	120
"N18"	"D39"	"Chronic kidney disease (CKD)"	"Neoplasm of uncertain behavior of female genital organs"	1	5	42	47
"C78"	"D41"	"Secondary malignant neoplasm of resp and digestive organs"	"Neoplasm of uncertain behavior of urinary organs"	1	60	279	339
"C46"	"D46"	"Kaposi's sarcoma"	"Myelodysplastic syndromes"	1	14	92	106
"C79"	"D47"	"Secondary malignant neoplasm of other and unspecified sites"	"Oth neoplm of uncrt behav of lymphoid, hematpoetc & rel tiss"	1	37	124	161
"C78"	"D48"	"Secondary malignant neoplasm of resp and digestive organs"	"Neoplasm of uncertain behavior of other and unsp sites"	1	266	588	854
"D22"	"D48"	"Melanocytic nevi"	"Neoplasm of uncertain behavior of other and unsp sites"	1	24	79	103
"F03"	"D48"	"Unspecified dementia"	"Neoplasm of uncertain behavior of other and unsp sites"	1	20	112	132
"H90"	"D48"	"Conductive and sensorineural hearing loss"	"Neoplasm of uncertain behavior of other and unsp sites"	1	24	77	101
"H91"	"D48"	"Other and unspecified hearing loss"	"Neoplasm of uncertain behavior of other and unsp sites"	1	167	381	548
"I20"	"D48"	"Angina pectoris"	"Neoplasm of uncertain behavior of other and unsp sites"	1	100	199	299
"K29"	"D48"	"Gastritis and duodenitis"	"Neoplasm of uncertain behavior of other and unsp sites"	1	66	152	218
"K62"	"D48"	"Other diseases of anus and rectum"	"Neoplasm of uncertain behavior of other and unsp sites"	1	26	145	171
"M19"	"D48"	"Other and unspecified osteoarthritis"	"Neoplasm of uncertain behavior of other and unsp sites"	1	2	132	134
"N39"	"D48"	"Other disorders of urinary system"	"Neoplasm of uncertain behavior of other and unsp sites"	1	28	356	384
"J15"	"D50"	"Bacterial pneumonia, not elsewhere classified"	"Iron deficiency anemia"	1	1999	2395	4394
"N17"	"D50"	"Acute kidney failure"	"Iron deficiency anemia"	1	513	1007	1520
"D63"	"D51"	"Anemia in chronic diseases classified elsewhere"	"Vitamin B12 deficiency anemia"	1	161	342	503
"N39"	"D51"	"Other disorders of urinary system"	"Vitamin B12 deficiency anemia"	1	691	947	1638
"A04"	"D61"	"Other bacterial intestinal infections"	"Oth aplastic anemias and other bone marrow failure syndromes"	1	81	175	256
"J96"	"D63"	"Respiratory failure, not elsewhere classified"	"Anemia in chronic diseases classified elsewhere"	1	949	1325	2274
"A49"	"D64"	"Bacterial infection of unspecified site"	"Other anemias"	1	3376	4711	8087
"J96"	"D64"	"Respiratory failure, not elsewhere classified"	"Other anemias"	1	4588	7800	12388
"C34"	"D68"	"Malignant neoplasm of bronchus and lung"	"Other coagulation defects"	1	85	211	296
"N03"	"D69"	"Chronic nephritic syndrome"	"Purpura and other hemorrhagic conditions"	1	79	157	236
"G96"	"D86"	"Other disorders of central nervous system"	"Sarcoidosis"	1	29	82	111
"H25"	"D86"	"Age-related cataract"	"Sarcoidosis"	1	168	485	653
"I50"	"D86"	"Heart failure"	"Sarcoidosis"	1	153	354	507
"I69"	"D86"	"Sequelae of cerebrovascular disease"	"Sarcoidosis"	1	66	154	220
"J43"	"D86"	"Emphysema"	"Sarcoidosis"	1	42	110	152
"M80"	"D86"	"Osteoporosis with current pathological fracture"	"Sarcoidosis"	1	15	132	147
"L89"	"E03"	"Pressure ulcer"	"Other hypothyroidism"	1	201	574	775
"C18"	"E04"	"Malignant neoplasm of colon"	"Other nontoxic goiter"	1	145	411	556
"D63"	"E04"	"Anemia in chronic diseases classified elsewhere"	"Other nontoxic goiter"	1	26	297	323
"E13"	"E04"	"Other specified diabetes mellitus"	"Other nontoxic goiter"	1	19	97	116
"E34"	"E04"	"Other endocrine disorders"	"Other nontoxic goiter"	1	150	374	524
"E86"	"E04"	"Volume depletion"	"Other nontoxic goiter"	1	105	1465	1570
"F32"	"E04"	"Depressive episode"	"Other nontoxic goiter"	1	237	654	891
"G47"	"E04"	"Sleep disorders"	"Other nontoxic goiter"	1	191	888	1079
"G56"	"E04"	"Mononeuropathies of upper limb"	"Other nontoxic goiter"	1	718	952	1670
"G96"	"E04"	"Other disorders of central nervous system"	"Other nontoxic goiter"	1	65	431	496
"I70"	"E04"	"Atherosclerosis"	"Other nontoxic goiter"	1	297	449	746
"K86"	"E04"	"Other diseases of pancreas"	"Other nontoxic goiter"	1	46	110	156
"M17"	"E04"	"Osteoarthritis of knee"	"Other nontoxic goiter"	1	1003	1579	2582
"M25"	"E04"	"Other joint disorder, not elsewhere classified"	"Other nontoxic goiter"	1	474	742	1216
"M85"	"E04"	"Other disorders of bone density and structure"	"Other nontoxic goiter"	1	168	1019	1187
"N28"	"E04"	"Oth disorders of kidney and ureter, not elsewhere classified"	"Other nontoxic goiter"	1	48	161	209
"C71"	"E05"	"Malignant neoplasm of brain"	"Thyrotoxicosis [hyperthyroidism]"	1	45	138	183
"D62"	"E05"	"Acute posthemorrhagic anemia"	"Thyrotoxicosis [hyperthyroidism]"	1	136	364	500
"E06"	"E05"	"Thyroiditis"	"Thyrotoxicosis [hyperthyroidism]"	1	814	1129	1943
"H02"	"E05"	"Other disorders of eyelid"	"Thyrotoxicosis [hyperthyroidism]"	1	421	821	1242
"H53"	"E05"	"Visual disturbances"	"Thyrotoxicosis [hyperthyroidism]"	1	368	711	1079
"J44"	"E05"	"Other chronic obstructive pulmonary disease"	"Thyrotoxicosis [hyperthyroidism]"	1	2339	2755	5094
"M18"	"E05"	"Osteoarthritis of first carpometacarpal joint"	"Thyrotoxicosis [hyperthyroidism]"	1	105	197	302
"M80"	"E05"	"Osteoporosis with current pathological fracture"	"Thyrotoxicosis [hyperthyroidism]"	1	715	1498	2213
"N39"	"E05"	"Other disorders of urinary system"	"Thyrotoxicosis [hyperthyroidism]"	1	1221	2902	4123
"E86"	"E06"	"Volume depletion"	"Thyroiditis"	1	59	160	219
"A46"	"E10"	"Erysipelas"	"Type 1 diabetes mellitus"	1	1476	2304	3780
"C10"	"E10"	"Malignant neoplasm of oropharynx"	"Type 1 diabetes mellitus"	1	15	61	76
"F01"	"E10"	"Vascular dementia"	"Type 1 diabetes mellitus"	1	153	640	793
"H21"	"E10"	"Other disorders of iris and ciliary body"	"Type 1 diabetes mellitus"	1	19	115	134
"H43"	"E10"	"Disorders of vitreous body"	"Type 1 diabetes mellitus"	1	365	2042	2407
"H44"	"E10"	"Disorders of globe"	"Type 1 diabetes mellitus"	1	96	259	355
"J15"	"E10"	"Bacterial pneumonia, not elsewhere classified"	"Type 1 diabetes mellitus"	1	0	5749	5749
"J86"	"E10"	"Pyothorax"	"Type 1 diabetes mellitus"	1	167	300	467
"L92"	"E10"	"Granulomatous disorders of skin and subcutaneous tissue"	"Type 1 diabetes mellitus"	1	46	198	244
"N48"	"E10"	"Other disorders of penis"	"Type 1 diabetes mellitus"	1	454	838	1292
"O34"	"E10"	"Maternal care for abnormality of pelvic organs"	"Type 1 diabetes mellitus"	1	44	136	180
"O82"	"E10"	"Encounter for cesarean delivery without indication"	"Type 1 diabetes mellitus"	1	327	700	1027
"A09"	"E11"	"Infectious gastroenteritis and colitis, unspecified"	"Type 2 diabetes mellitus"	1	2974	3875	6849
"B37"	"E11"	"Candidiasis"	"Type 2 diabetes mellitus"	1	835	1651	2486
"C45"	"E11"	"Mesothelioma"	"Type 2 diabetes mellitus"	1	32	119	151
"C77"	"E11"	"Secondary and unspecified malignant neoplasm of lymph nodes"	"Type 2 diabetes mellitus"	1	527	1320	1847
"C78"	"E11"	"Secondary malignant neoplasm of resp and digestive organs"	"Type 2 diabetes mellitus"	1	0	5732	5732
"D35"	"E11"	"Benign neoplasm of other and unspecified endocrine glands"	"Type 2 diabetes mellitus"	1	400	600	1000
"D64"	"E11"	"Other anemias"	"Type 2 diabetes mellitus"	1	0	18876	18876
"E50"	"E11"	"Vitamin A deficiency"	"Type 2 diabetes mellitus"	1	103	450	553
"E55"	"E11"	"Vitamin D deficiency"	"Type 2 diabetes mellitus"	1	766	1828	2594
"F05"	"E11"	"Delirium due to known physiological condition"	"Type 2 diabetes mellitus"	1	0	2832	2832
"F06"	"E11"	"Other mental disorders due to known physiological condition"	"Type 2 diabetes mellitus"	1	234	754	988
"H21"	"E11"	"Other disorders of iris and ciliary body"	"Type 2 diabetes mellitus"	1	54	158	212
"H54"	"E11"	"Blindness and low vision"	"Type 2 diabetes mellitus"	1	426	900	1326
"I24"	"E11"	"Other acute ischemic heart diseases"	"Type 2 diabetes mellitus"	1	765	1105	1870
"I27"	"E11"	"Other pulmonary heart diseases"	"Type 2 diabetes mellitus"	1	784	1466	2250
"I63"	"E11"	"Cerebral infarction"	"Type 2 diabetes mellitus"	1	8634	9579	18213
"I82"	"E11"	"Other venous embolism and thrombosis"	"Type 2 diabetes mellitus"	1	434	626	1060
"I85"	"E11"	"Esophageal varices"	"Type 2 diabetes mellitus"	1	585	937	1522
"J95"	"E11"	"Intraop and postproc comp and disorders of resp sys, NEC"	"Type 2 diabetes mellitus"	1	206	410	616
"K65"	"E11"	"Peritonitis"	"Type 2 diabetes mellitus"	1	871	1483	2354
"L85"	"E11"	"Other epidermal thickening"	"Type 2 diabetes mellitus"	1	57	136	193
"L97"	"E11"	"Non-pressure chronic ulcer of lower limb, NEC"	"Type 2 diabetes mellitus"	1	0	8300	8300
"M80"	"E11"	"Osteoporosis with current pathological fracture"	"Type 2 diabetes mellitus"	1	1044	2891	3935
"N12"	"E11"	"Tubulo-interstitial nephritis, not spcf as acute or chronic"	"Type 2 diabetes mellitus"	1	199	456	655
"E86"	"E15"	"Volume depletion"	"Nondiabetic hypoglycemic coma"	1	128	258	386
"A41"	"E16"	"Other sepsis"	"Other disorders of pancreatic internal secretion"	1	861	1939	2800
"G30"	"E16"	"Alzheimer's disease"	"Other disorders of pancreatic internal secretion"	1	55	171	226
"I95"	"E16"	"Hypotension"	"Other disorders of pancreatic internal secretion"	1	302	474	776
"K92"	"E16"	"Other diseases of digestive system"	"Other disorders of pancreatic internal secretion"	1	520	701	1221
"E86"	"E24"	"Volume depletion"	"Cushing's syndrome"	1	18	69	87
"E11"	"E28"	"Type 2 diabetes mellitus"	"Ovarian dysfunction"	1	216	376	592
"G47"	"E28"	"Sleep disorders"	"Ovarian dysfunction"	1	45	153	198
"O13"	"E28"	"Gestational hypertension without significant proteinuria"	"Ovarian dysfunction"	1	129	230	359
"O28"	"E28"	"Abnormal findings on antenatal screening of mother"	"Ovarian dysfunction"	1	75	196	271
"O80"	"E28"	"Encounter for full-term uncomplicated delivery"	"Ovarian dysfunction"	1	1927	2617	4544
"M62"	"E30"	"Other disorders of muscle"	"Disorders of puberty, not elsewhere classified"	1	1	47	48
"M67"	"E30"	"Other disorders of synovium and tendon"	"Disorders of puberty, not elsewhere classified"	1	4	56	60
"C78"	"E51"	"Secondary malignant neoplasm of resp and digestive organs"	"Thiamine deficiency"	1	3	30	33
"E61"	"E65"	"Deficiency of other nutrient elements"	"Localized adiposity"	1	3	37	40
"N64"	"E65"	"Other disorders of breast"	"Localized adiposity"	1	589	830	1419
"A49"	"E66"	"Bacterial infection of unspecified site"	"Overweight and obesity"	1	514	2324	2838
"C15"	"E66"	"Malignant neoplasm of esophagus"	"Overweight and obesity"	1	45	255	300
"C83"	"E66"	"Non-follicular lymphoma"	"Overweight and obesity"	1	59	232	291
"F02"	"E66"	"Dementia in other diseases classified elsewhere"	"Overweight and obesity"	1	17	85	102
"G20"	"E66"	"Parkinson's disease"	"Overweight and obesity"	1	131	304	435
"H36"	"E66"	"Retinal disorders in diseases classified elsewhere"	"Overweight and obesity"	1	1486	2858	4344
"I51"	"E66"	"Complications and ill-defined descriptions of heart disease"	"Overweight and obesity"	1	583	1036	1619
"J69"	"E66"	"Pneumonitis due to solids and liquids"	"Overweight and obesity"	1	92	370	462
"J84"	"E66"	"Other interstitial pulmonary diseases"	"Overweight and obesity"	1	250	524	774
"N28"	"E66"	"Oth disorders of kidney and ureter, not elsewhere classified"	"Overweight and obesity"	1	193	794	987
"A41"	"E78"	"Other sepsis"	"Disorders of lipoprotein metabolism and other lipidemias"	1	0	11901	11901
"C22"	"E78"	"Malignant neoplasm of liver and intrahepatic bile ducts"	"Disorders of lipoprotein metabolism and other lipidemias"	1	26	473	499
"D64"	"E78"	"Other anemias"	"Disorders of lipoprotein metabolism and other lipidemias"	1	0	14674	14674
"F06"	"E78"	"Other mental disorders due to known physiological condition"	"Disorders of lipoprotein metabolism and other lipidemias"	1	448	918	1366
"G21"	"E78"	"Secondary parkinsonism"	"Disorders of lipoprotein metabolism and other lipidemias"	1	73	200	273
"G30"	"E78"	"Alzheimer's disease"	"Disorders of lipoprotein metabolism and other lipidemias"	1	300	1678	1978
"G95"	"E78"	"Other and unspecified diseases of spinal cord"	"Disorders of lipoprotein metabolism and other lipidemias"	1	188	725	913
"H25"	"E78"	"Age-related cataract"	"Disorders of lipoprotein metabolism and other lipidemias"	1	10053	12777	22830
"J13"	"E78"	"Pneumonia due to Streptococcus pneumoniae"	"Disorders of lipoprotein metabolism and other lipidemias"	1	228	373	601
"K65"	"E78"	"Peritonitis"	"Disorders of lipoprotein metabolism and other lipidemias"	1	519	886	1405
"M85"	"E78"	"Other disorders of bone density and structure"	"Disorders of lipoprotein metabolism and other lipidemias"	1	1083	2468	3551
"M90"	"E78"	"Osteopathies in diseases classified elsewhere"	"Disorders of lipoprotein metabolism and other lipidemias"	1	20	92	112
"J15"	"E84"	"Bacterial pneumonia, not elsewhere classified"	"Cystic fibrosis"	1	0	181	181
"C34"	"E89"	"Malignant neoplasm of bronchus and lung"	"Postproc endocrine and metabolic comp and disorders, NEC"	1	34	92	126
"O72"	"F07"	"Postpartum hemorrhage"	"Personality & behavrl disorders due to known physiol cond"	1	9	67	76
"A26"	"F10"	"Erysipeloid"	"Alcohol related disorders"	1	2	148	150
"C05"	"F10"	"Malignant neoplasm of palate"	"Alcohol related disorders"	1	5	50	55
"C09"	"F10"	"Malignant neoplasm of tonsil"	"Alcohol related disorders"	1	16	318	334
"C22"	"F10"	"Malignant neoplasm of liver and intrahepatic bile ducts"	"Alcohol related disorders"	1	19	668	687
"C41"	"F10"	"Malignant neoplasm of bone/artic cartl of and unsp sites"	"Alcohol related disorders"	1	8	52	60
"D22"	"F10"	"Melanocytic nevi"	"Alcohol related disorders"	1	103	363	466
"D69"	"F10"	"Purpura and other hemorrhagic conditions"	"Alcohol related disorders"	1	444	884	1328
"E66"	"F10"	"Overweight and obesity"	"Alcohol related disorders"	1	1792	3776	5568
"F21"	"F10"	"Schizotypal disorder"	"Alcohol related disorders"	1	36	159	195
"G45"	"F10"	"Transient cerebral ischemic attacks and related syndromes"	"Alcohol related disorders"	1	1260	1688	2948
"I49"	"F10"	"Other cardiac arrhythmias"	"Alcohol related disorders"	1	521	1155	1676
"I62"	"F10"	"Other and unspecified nontraumatic intracranial hemorrhage"	"Alcohol related disorders"	1	88	306	394
"I72"	"F10"	"Other aneurysm"	"Alcohol related disorders"	1	84	252	336
"I87"	"F10"	"Other disorders of veins"	"Alcohol related disorders"	1	130	382	512
"I99"	"F10"	"Other and unspecified disorders of circulatory system"	"Alcohol related disorders"	1	207	451	658
"J09"	"F10"	"Influenza due to certain identified influenza viruses"	"Alcohol related disorders"	1	3	148	151
"K63"	"F10"	"Other diseases of intestine"	"Alcohol related disorders"	1	187	932	1119
"L97"	"F10"	"Non-pressure chronic ulcer of lower limb, NEC"	"Alcohol related disorders"	1	244	1631	1875
"M16"	"F10"	"Osteoarthritis of hip"	"Alcohol related disorders"	1	891	1354	2245
"N98"	"F10"	"Complications associated with artificial fertilization"	"Alcohol related disorders"	1	0	43	43
"O21"	"F10"	"Excessive vomiting in pregnancy"	"Alcohol related disorders"	1	5	266	271
"O82"	"F10"	"Encounter for cesarean delivery without indication"	"Alcohol related disorders"	1	141	1161	1302
"O86"	"F10"	"Other puerperal infections"	"Alcohol related disorders"	1	20	144	164
"E87"	"F11"	"Other disorders of fluid, electrolyte and acid-base balance"	"Opioid related disorders"	1	141	243	384
"C79"	"F17"	"Secondary malignant neoplasm of other and unspecified sites"	"Nicotine dependence"	1	138	560	698
"E86"	"F17"	"Volume depletion"	"Nicotine dependence"	1	1312	2362	3674
"K72"	"F19"	"Hepatic failure, not elsewhere classified"	"Other psychoactive substance related disorders"	1	20	72	92
"J15"	"F22"	"Bacterial pneumonia, not elsewhere classified"	"Delusional disorders"	1	86	206	292
"O72"	"F23"	"Postpartum hemorrhage"	"Brief psychotic disorder"	1	6	47	53
"F20"	"F29"	"Schizophrenia"	"Unsp psychosis not due to a substance or known physiol cond"	1	64	175	239
"G23"	"F32"	"Other degenerative diseases of basal ganglia"	"Depressive episode"	1	56	132	188
"N97"	"F50"	"Female infertility"	"Eating disorders"	1	13	88	101
"O20"	"F50"	"Hemorrhage in early pregnancy"	"Eating disorders"	1	33	99	132
"O70"	"F50"	"Perineal laceration during delivery"	"Eating disorders"	1	57	458	515
"O72"	"F50"	"Postpartum hemorrhage"	"Eating disorders"	1	4	632	636
"O72"	"F68"	"Postpartum hemorrhage"	"Other disorders of adult personality and behavior"	1	0	33	33
"J44"	"F99"	"Other chronic obstructive pulmonary disease"	"Mental disorder, not otherwise specified"	1	106	280	386
"G35"	"G04"	"Multiple sclerosis"	"Encephalitis, myelitis and encephalomyelitis"	1	59	154	213
"N31"	"G06"	"Neuromuscular dysfunction of bladder, NEC"	"Intracranial and intraspinal abscess and granuloma"	1	21	67	88
"G24"	"G20"	"Dystonia"	"Parkinson's disease"	1	129	273	402
"J69"	"G20"	"Pneumonitis due to solids and liquids"	"Parkinson's disease"	1	80	676	756
"J69"	"G21"	"Pneumonitis due to solids and liquids"	"Secondary parkinsonism"	1	37	157	194
"L89"	"G31"	"Pressure ulcer"	"Oth degenerative diseases of nervous system, NEC"	1	84	210	294
"C61"	"G35"	"Malignant neoplasm of prostate"	"Multiple sclerosis"	1	2	42	44
"C78"	"G35"	"Secondary malignant neoplasm of resp and digestive organs"	"Multiple sclerosis"	1	0	71	71
"F17"	"G35"	"Nicotine dependence"	"Multiple sclerosis"	1	36	110	146
"F41"	"G35"	"Other anxiety disorders"	"Multiple sclerosis"	1	22	76	98
"G24"	"G35"	"Dystonia"	"Multiple sclerosis"	1	11	51	62
"H57"	"G37"	"Other disorders of eye and adnexa"	"Other demyelinating diseases of central nervous system"	1	36	106	142
"N30"	"G37"	"Cystitis"	"Other demyelinating diseases of central nervous system"	1	133	251	384
"D09"	"G40"	"Carcinoma in situ of other and unspecified sites"	"Epilepsy and recurrent seizures"	1	5	38	43
"D50"	"G40"	"Iron deficiency anemia"	"Epilepsy and recurrent seizures"	1	364	878	1242
"E64"	"G40"	"Sequelae of malnutrition and other nutritional deficiencies"	"Epilepsy and recurrent seizures"	1	121	372	493
"E86"	"G40"	"Volume depletion"	"Epilepsy and recurrent seizures"	1	1580	4248	5828
"E87"	"G40"	"Other disorders of fluid, electrolyte and acid-base balance"	"Epilepsy and recurrent seizures"	1	1188	2763	3951
"I26"	"G40"	"Pulmonary embolism"	"Epilepsy and recurrent seizures"	1	343	641	984
"J18"	"G40"	"Pneumonia, unspecified organism"	"Epilepsy and recurrent seizures"	1	4393	8473	12866
"K92"	"G40"	"Other diseases of digestive system"	"Epilepsy and recurrent seizures"	1	840	1626	2466
"M25"	"G40"	"Other joint disorder, not elsewhere classified"	"Epilepsy and recurrent seizures"	1	265	554	819
"N13"	"G40"	"Obstructive and reflux uropathy"	"Epilepsy and recurrent seizures"	1	165	335	500
"C20"	"G43"	"Malignant neoplasm of rectum"	"Migraine"	1	9	55	64
"C78"	"G43"	"Secondary malignant neoplasm of resp and digestive organs"	"Migraine"	1	0	185	185
"E78"	"G43"	"Disorders of lipoprotein metabolism and other lipidemias"	"Migraine"	1	734	1615	2349
"F41"	"G43"	"Other anxiety disorders"	"Migraine"	1	260	555	815
"I26"	"G43"	"Pulmonary embolism"	"Migraine"	1	57	239	296
"J44"	"G43"	"Other chronic obstructive pulmonary disease"	"Migraine"	1	264	709	973
"J69"	"G43"	"Pneumonitis due to solids and liquids"	"Migraine"	1	3	50	53
"L90"	"G43"	"Atrophic disorders of skin"	"Migraine"	1	166	293	459
"E11"	"G44"	"Type 2 diabetes mellitus"	"Other headache syndromes"	1	426	700	1126
"J44"	"G44"	"Other chronic obstructive pulmonary disease"	"Other headache syndromes"	1	370	743	1113
"K56"	"G44"	"Paralytic ileus and intestinal obstruction without hernia"	"Other headache syndromes"	1	110	215	325
"L97"	"G44"	"Non-pressure chronic ulcer of lower limb, NEC"	"Other headache syndromes"	1	11	94	105
"C44"	"G45"	"Other and unspecified malignant neoplasm of skin"	"Transient cerebral ischemic attacks and related syndromes"	1	699	1406	2105
"C83"	"G45"	"Non-follicular lymphoma"	"Transient cerebral ischemic attacks and related syndromes"	1	89	179	268
"D68"	"G45"	"Other coagulation defects"	"Transient cerebral ischemic attacks and related syndromes"	1	386	1134	1520
"E13"	"G45"	"Other specified diabetes mellitus"	"Transient cerebral ischemic attacks and related syndromes"	1	71	186	257
"E86"	"G45"	"Volume depletion"	"Transient cerebral ischemic attacks and related syndromes"	1	0	8901	8901
"G40"	"G45"	"Epilepsy and recurrent seizures"	"Transient cerebral ischemic attacks and related syndromes"	1	2270	3976	6246
"I85"	"G45"	"Esophageal varices"	"Transient cerebral ischemic attacks and related syndromes"	1	58	141	199
"I87"	"G45"	"Other disorders of veins"	"Transient cerebral ischemic attacks and related syndromes"	1	104	193	297
"K22"	"G45"	"Other diseases of esophagus"	"Transient cerebral ischemic attacks and related syndromes"	1	377	618	995
"L97"	"G45"	"Non-pressure chronic ulcer of lower limb, NEC"	"Transient cerebral ischemic attacks and related syndromes"	1	239	1058	1297
"C34"	"G51"	"Malignant neoplasm of bronchus and lung"	"Facial nerve disorders"	1	30	197	227
"E86"	"G51"	"Volume depletion"	"Facial nerve disorders"	1	110	467	577
"I35"	"G51"	"Nonrheumatic aortic valve disorders"	"Facial nerve disorders"	1	40	212	252
"J15"	"G51"	"Bacterial pneumonia, not elsewhere classified"	"Facial nerve disorders"	1	70	304	374
"J96"	"G51"	"Respiratory failure, not elsewhere classified"	"Facial nerve disorders"	1	69	333	402
"N39"	"G51"	"Other disorders of urinary system"	"Facial nerve disorders"	1	193	508	701
"G96"	"G54"	"Other disorders of central nervous system"	"Nerve root and plexus disorders"	1	98	186	284
"D12"	"G56"	"Benign neoplasm of colon, rectum, anus and anal canal"	"Mononeuropathies of upper limb"	1	0	3819	3819
"D22"	"G56"	"Melanocytic nevi"	"Mononeuropathies of upper limb"	1	228	394	622
"E64"	"G56"	"Sequelae of malnutrition and other nutritional deficiencies"	"Mononeuropathies of upper limb"	1	21	289	310
"F03"	"G56"	"Unspecified dementia"	"Mononeuropathies of upper limb"	1	0	859	859
"I45"	"G56"	"Other conduction disorders"	"Mononeuropathies of upper limb"	1	149	263	412
"I63"	"G56"	"Cerebral infarction"	"Mononeuropathies of upper limb"	1	574	2321	2895
"I70"	"G56"	"Atherosclerosis"	"Mononeuropathies of upper limb"	1	725	1297	2022
"I89"	"G56"	"Oth noninfective disorders of lymphatic vessels and nodes"	"Mononeuropathies of upper limb"	1	86	263	349
"J43"	"G56"	"Emphysema"	"Mononeuropathies of upper limb"	1	74	298	372
"J44"	"G56"	"Other chronic obstructive pulmonary disease"	"Mononeuropathies of upper limb"	1	1251	3383	4634
"J90"	"G56"	"Pleural effusion, not elsewhere classified"	"Mononeuropathies of upper limb"	1	48	606	654
"K04"	"G56"	"Diseases of pulp and periapical tissues"	"Mononeuropathies of upper limb"	1	250	396	646
"K55"	"G56"	"Vascular disorders of intestine"	"Mononeuropathies of upper limb"	1	15	245	260
"K57"	"G56"	"Diverticular disease of intestine"	"Mononeuropathies of upper limb"	1	872	2908	3780
"M06"	"G56"	"Other rheumatoid arthritis"	"Mononeuropathies of upper limb"	1	684	1197	1881
"M75"	"G56"	"Shoulder lesions"	"Mononeuropathies of upper limb"	1	5223	6354	11577
"M81"	"G56"	"Osteoporosis without current pathological fracture"	"Mononeuropathies of upper limb"	1	712	2759	3471
"N17"	"G56"	"Acute kidney failure"	"Mononeuropathies of upper limb"	1	41	636	677
"A41"	"G57"	"Other sepsis"	"Mononeuropathies of lower limb"	1	73	379	452
"I25"	"G57"	"Chronic ischemic heart disease"	"Mononeuropathies of lower limb"	1	309	452	761
"I46"	"G57"	"Cardiac arrest"	"Mononeuropathies of lower limb"	1	4	90	94
"N30"	"G60"	"Cystitis"	"Hereditary and idiopathic neuropathy"	1	109	200	309
"A41"	"G62"	"Other sepsis"	"Other and unspecified polyneuropathies"	1	840	2155	2995
"D64"	"G62"	"Other anemias"	"Other and unspecified polyneuropathies"	1	1048	1641	2689
"J18"	"G62"	"Pneumonia, unspecified organism"	"Other and unspecified polyneuropathies"	1	2242	3302	5544
"E86"	"G71"	"Volume depletion"	"Primary disorders of muscles"	1	33	101	134
"I51"	"G71"	"Complications and ill-defined descriptions of heart disease"	"Primary disorders of muscles"	1	0	44	44
"G47"	"G80"	"Sleep disorders"	"Cerebral palsy"	1	30	177	207
"G96"	"G80"	"Other disorders of central nervous system"	"Cerebral palsy"	1	65	137	202
"H53"	"G80"	"Visual disturbances"	"Cerebral palsy"	1	116	262	378
"H57"	"G80"	"Other disorders of eye and adnexa"	"Cerebral palsy"	1	53	193	246
"M53"	"G80"	"Other and unspecified dorsopathies, not elsewhere classified"	"Cerebral palsy"	1	2	33	35
"M81"	"G80"	"Osteoporosis without current pathological fracture"	"Cerebral palsy"	1	15	93	108
"Q65"	"G80"	"Congenital deformities of hip"	"Cerebral palsy"	1	66	204	270
"K92"	"G82"	"Other diseases of digestive system"	"Paraplegia (paraparesis) and quadriplegia (quadriparesis)"	1	137	266	403
"H51"	"G91"	"Other disorders of binocular movement"	"Hydrocephalus"	1	17	72	89
"H55"	"G91"	"Nystagmus and other irregular eye movements"	"Hydrocephalus"	1	21	80	101
"J06"	"G91"	"Acute upper resp infections of multiple and unsp sites"	"Hydrocephalus"	1	59	143	202
"D63"	"G95"	"Anemia in chronic diseases classified elsewhere"	"Other and unspecified diseases of spinal cord"	1	464	791	1255
"G35"	"G97"	"Multiple sclerosis"	"Intraop and postproc comp and disorders of nervous sys, NEC"	1	42	168	210
"G35"	"G99"	"Multiple sclerosis"	"Oth disorders of nervous system in diseases classd elswhr"	1	23	82	105
"D64"	"H00"	"Other anemias"	"Hordeolum and chalazion"	1	19	152	171
"I50"	"H00"	"Heart failure"	"Hordeolum and chalazion"	1	31	203	234
"O99"	"H00"	"Oth maternal diseases classd elsw but compl preg/chldbrth"	"Hordeolum and chalazion"	1	87	181	268
"C16"	"H02"	"Malignant neoplasm of stomach"	"Other disorders of eyelid"	1	21	119	140
"I50"	"H02"	"Heart failure"	"Other disorders of eyelid"	1	952	1872	2824
"J91"	"H02"	"Pleural effusion in conditions classified elsewhere"	"Other disorders of eyelid"	1	41	117	158
"M48"	"H02"	"Other spondylopathies"	"Other disorders of eyelid"	1	635	832	1467
"N19"	"H02"	"Unspecified kidney failure"	"Other disorders of eyelid"	1	130	339	469
"C79"	"H04"	"Secondary malignant neoplasm of other and unspecified sites"	"Disorders of lacrimal system"	1	14	88	102
"F03"	"H04"	"Unspecified dementia"	"Disorders of lacrimal system"	1	2	158	160
"L89"	"H04"	"Pressure ulcer"	"Disorders of lacrimal system"	1	2	31	33
"B18"	"H10"	"Chronic viral hepatitis"	"Conjunctivitis"	1	24	157	181
"C18"	"H10"	"Malignant neoplasm of colon"	"Conjunctivitis"	1	8	279	287
"C20"	"H10"	"Malignant neoplasm of rectum"	"Conjunctivitis"	1	8	139	147
"F10"	"H10"	"Alcohol related disorders"	"Conjunctivitis"	1	748	1190	1938
"G47"	"H10"	"Sleep disorders"	"Conjunctivitis"	1	22	1078	1100
"I70"	"H10"	"Atherosclerosis"	"Conjunctivitis"	1	144	507	651
"I99"	"H10"	"Other and unspecified disorders of circulatory system"	"Conjunctivitis"	1	9	67	76
"J91"	"H10"	"Pleural effusion in conditions classified elsewhere"	"Conjunctivitis"	1	2	72	74
"K57"	"H10"	"Diverticular disease of intestine"	"Conjunctivitis"	1	56	946	1002
"K64"	"H10"	"Hemorrhoids and perianal venous thrombosis"	"Conjunctivitis"	1	0	368	368
"K83"	"H10"	"Other diseases of biliary tract"	"Conjunctivitis"	1	9	140	149
"M23"	"H10"	"Internal derangement of knee"	"Conjunctivitis"	1	773	2485	3258
"M54"	"H10"	"Dorsalgia"	"Conjunctivitis"	1	1370	3176	4546
"N50"	"H10"	"Other and unspecified disorders of male genital organs"	"Conjunctivitis"	1	40	305	345
"O36"	"H10"	"Maternal care for other fetal problems"	"Conjunctivitis"	1	175	373	548
"O82"	"H10"	"Encounter for cesarean delivery without indication"	"Conjunctivitis"	1	533	747	1280
"I69"	"H11"	"Sequelae of cerebrovascular disease"	"Other disorders of conjunctiva"	1	116	377	493
"J15"	"H11"	"Bacterial pneumonia, not elsewhere classified"	"Other disorders of conjunctiva"	1	42	383	425
"K59"	"H11"	"Other functional intestinal disorders"	"Other disorders of conjunctiva"	1	193	469	662
"L97"	"H11"	"Non-pressure chronic ulcer of lower limb, NEC"	"Other disorders of conjunctiva"	1	24	91	115
"N30"	"H11"	"Cystitis"	"Other disorders of conjunctiva"	1	253	616	869
"E78"	"H16"	"Disorders of lipoprotein metabolism and other lipidemias"	"Keratitis"	1	226	389	615
"N39"	"H16"	"Other disorders of urinary system"	"Keratitis"	1	257	500	757
"C34"	"H17"	"Malignant neoplasm of bronchus and lung"	"Corneal scars and opacities"	1	8	54	62
"C78"	"H17"	"Secondary malignant neoplasm of resp and digestive organs"	"Corneal scars and opacities"	1	4	45	49
"J96"	"H18"	"Respiratory failure, not elsewhere classified"	"Other disorders of cornea"	1	112	387	499
"I35"	"H20"	"Nonrheumatic aortic valve disorders"	"Iridocyclitis"	1	23	176	199
"M25"	"H20"	"Other joint disorder, not elsewhere classified"	"Iridocyclitis"	1	150	292	442
"A09"	"H25"	"Infectious gastroenteritis and colitis, unspecified"	"Age-related cataract"	1	3136	4739	7875
"B02"	"H25"	"Zoster [herpes zoster]"	"Age-related cataract"	1	786	1057	1843
"C15"	"H25"	"Malignant neoplasm of esophagus"	"Age-related cataract"	1	132	977	1109
"C18"	"H25"	"Malignant neoplasm of colon"	"Age-related cataract"	1	2582	4351	6933
"D64"	"H25"	"Other anemias"	"Age-related cataract"	1	0	24159	24159
"G20"	"H25"	"Parkinson's disease"	"Age-related cataract"	1	1267	2382	3649
"I89"	"H25"	"Oth noninfective disorders of lymphatic vessels and nodes"	"Age-related cataract"	1	371	535	906
"J91"	"H25"	"Pleural effusion in conditions classified elsewhere"	"Age-related cataract"	1	291	1202	1493
"E03"	"H26"	"Other hypothyroidism"	"Other cataract"	1	771	988	1759
"E83"	"H26"	"Disorders of mineral metabolism"	"Other cataract"	1	97	423	520
"G30"	"H26"	"Alzheimer's disease"	"Other cataract"	1	19	771	790
"J90"	"H26"	"Pleural effusion, not elsewhere classified"	"Other cataract"	1	155	764	919
"M10"	"H26"	"Gout"	"Other cataract"	1	482	691	1173
"M80"	"H26"	"Osteoporosis with current pathological fracture"	"Other cataract"	1	745	2226	2971
"N19"	"H26"	"Unspecified kidney failure"	"Other cataract"	1	310	987	1297
"C61"	"H27"	"Malignant neoplasm of prostate"	"Other disorders of lens"	1	22	98	120
"D64"	"H27"	"Other anemias"	"Other disorders of lens"	1	3	371	374
"F32"	"H27"	"Depressive episode"	"Other disorders of lens"	1	7	125	132
"I70"	"H27"	"Atherosclerosis"	"Other disorders of lens"	1	63	256	319
"A41"	"H28"	"Other sepsis"	"Cataract in diseases classified elsewhere"	1	12	124	136
"A04"	"H33"	"Other bacterial intestinal infections"	"Retinal detachments and breaks"	1	9	99	108
"C64"	"H33"	"Malignant neoplasm of kidney, except renal pelvis"	"Retinal detachments and breaks"	1	19	70	89
"C77"	"H33"	"Secondary and unspecified malignant neoplasm of lymph nodes"	"Retinal detachments and breaks"	1	39	149	188
"I67"	"H33"	"Other cerebrovascular diseases"	"Retinal detachments and breaks"	1	16	78	94
"M10"	"H33"	"Gout"	"Retinal detachments and breaks"	1	73	159	232
"N17"	"H33"	"Acute kidney failure"	"Retinal detachments and breaks"	1	7	196	203
"A41"	"H34"	"Other sepsis"	"Retinal vascular occlusions"	1	156	765	921
"C80"	"H34"	"Malignant neoplasm without specification of site"	"Retinal vascular occlusions"	1	1	30	31
"E83"	"H34"	"Disorders of mineral metabolism"	"Retinal vascular occlusions"	1	16	75	91
"G20"	"H34"	"Parkinson's disease"	"Retinal vascular occlusions"	1	41	113	154
"H54"	"H34"	"Blindness and low vision"	"Retinal vascular occlusions"	1	281	447	728
"M81"	"H34"	"Osteoporosis without current pathological fracture"	"Retinal vascular occlusions"	1	338	489	827
"C77"	"H35"	"Secondary and unspecified malignant neoplasm of lymph nodes"	"Other retinal disorders"	1	243	584	827
"C79"	"H35"	"Secondary malignant neoplasm of other and unspecified sites"	"Other retinal disorders"	1	214	1309	1523
"E64"	"H35"	"Sequelae of malnutrition and other nutritional deficiencies"	"Other retinal disorders"	1	90	404	494
"I27"	"H35"	"Other pulmonary heart diseases"	"Other retinal disorders"	1	250	558	808
"I71"	"H35"	"Aortic aneurysm and dissection"	"Other retinal disorders"	1	615	1196	1811
"N17"	"H35"	"Acute kidney failure"	"Other retinal disorders"	1	246	1255	1501
"C15"	"H36"	"Malignant neoplasm of esophagus"	"Retinal disorders in diseases classified elsewhere"	1	8	60	68
"C79"	"H36"	"Secondary malignant neoplasm of other and unspecified sites"	"Retinal disorders in diseases classified elsewhere"	1	40	228	268
"D12"	"H36"	"Benign neoplasm of colon, rectum, anus and anal canal"	"Retinal disorders in diseases classified elsewhere"	1	256	576	832
"E25"	"H36"	"Adrenogenital disorders"	"Retinal disorders in diseases classified elsewhere"	1	8	59	67
"H43"	"H36"	"Disorders of vitreous body"	"Retinal disorders in diseases classified elsewhere"	1	1315	2895	4210
"K31"	"H36"	"Other diseases of stomach and duodenum"	"Retinal disorders in diseases classified elsewhere"	1	43	128	171
"K56"	"H36"	"Paralytic ileus and intestinal obstruction without hernia"	"Retinal disorders in diseases classified elsewhere"	1	96	292	388
"N08"	"H36"	"Glomerular disorders in diseases classified elsewhere"	"Retinal disorders in diseases classified elsewhere"	1	48	310	358
"C76"	"H40"	"Malignant neoplasm of other and ill-defined sites"	"Glaucoma"	1	13	61	74
"D47"	"H40"	"Oth neoplm of uncrt behav of lymphoid, hematpoetc & rel tiss"	"Glaucoma"	1	54	149	203
"I25"	"H40"	"Chronic ischemic heart disease"	"Glaucoma"	1	1676	2337	4013
"I50"	"H40"	"Heart failure"	"Glaucoma"	1	977	2973	3950
"I71"	"H40"	"Aortic aneurysm and dissection"	"Glaucoma"	1	127	387	514
"J91"	"H40"	"Pleural effusion in conditions classified elsewhere"	"Glaucoma"	1	13	148	161
"K64"	"H40"	"Hemorrhoids and perianal venous thrombosis"	"Glaucoma"	1	16	276	292
"M10"	"H40"	"Gout"	"Glaucoma"	1	173	370	543
"G20"	"H43"	"Parkinson's disease"	"Disorders of vitreous body"	1	21	137	158
"I48"	"H43"	"Atrial fibrillation and flutter"	"Disorders of vitreous body"	1	889	1518	2407
"J22"	"H43"	"Unspecified acute lower respiratory infection"	"Disorders of vitreous body"	1	15	93	108
"C61"	"H44"	"Malignant neoplasm of prostate"	"Disorders of globe"	1	12	56	68
"D12"	"H44"	"Benign neoplasm of colon, rectum, anus and anal canal"	"Disorders of globe"	1	53	146	199
"I48"	"H44"	"Atrial fibrillation and flutter"	"Disorders of globe"	1	165	393	558
"J18"	"H44"	"Pneumonia, unspecified organism"	"Disorders of globe"	1	244	586	830
"K57"	"H44"	"Diverticular disease of intestine"	"Disorders of globe"	1	84	212	296
"J44"	"H46"	"Other chronic obstructive pulmonary disease"	"Optic neuritis"	1	13	56	69
"I50"	"H49"	"Heart failure"	"Paralytic strabismus"	1	106	259	365
"N18"	"H49"	"Chronic kidney disease (CKD)"	"Paralytic strabismus"	1	33	114	147
"F17"	"H50"	"Nicotine dependence"	"Other strabismus"	1	16	164	180
"H16"	"H50"	"Keratitis"	"Other strabismus"	1	52	119	171
"I49"	"H50"	"Other cardiac arrhythmias"	"Other strabismus"	1	61	156	217
"K80"	"H50"	"Cholelithiasis"	"Other strabismus"	1	178	288	466
"K92"	"H50"	"Other diseases of digestive system"	"Other strabismus"	1	53	173	226
"M67"	"H50"	"Other disorders of synovium and tendon"	"Other strabismus"	1	94	293	387
"N30"	"H50"	"Cystitis"	"Other strabismus"	1	273	731	1004
"A46"	"H52"	"Erysipelas"	"Disorders of refraction and accommodation"	1	170	348	518
"C18"	"H52"	"Malignant neoplasm of colon"	"Disorders of refraction and accommodation"	1	41	190	231
"C20"	"H52"	"Malignant neoplasm of rectum"	"Disorders of refraction and accommodation"	1	18	99	117
"I80"	"H52"	"Phlebitis and thrombophlebitis"	"Disorders of refraction and accommodation"	1	191	321	512
"K72"	"H52"	"Hepatic failure, not elsewhere classified"	"Disorders of refraction and accommodation"	1	7	47	54
"L89"	"H52"	"Pressure ulcer"	"Disorders of refraction and accommodation"	1	18	97	115
"L97"	"H52"	"Non-pressure chronic ulcer of lower limb, NEC"	"Disorders of refraction and accommodation"	1	29	127	156
"N18"	"H52"	"Chronic kidney disease (CKD)"	"Disorders of refraction and accommodation"	1	57	273	330
"N39"	"H52"	"Other disorders of urinary system"	"Disorders of refraction and accommodation"	1	412	984	1396
"I71"	"H53"	"Aortic aneurysm and dissection"	"Visual disturbances"	1	113	216	329
"K64"	"H53"	"Hemorrhoids and perianal venous thrombosis"	"Visual disturbances"	1	39	297	336
"J69"	"H54"	"Pneumonitis due to solids and liquids"	"Blindness and low vision"	1	56	175	231
"M75"	"H60"	"Shoulder lesions"	"Otitis externa"	1	241	419	660
"I50"	"H61"	"Heart failure"	"Other disorders of external ear"	1	230	481	711
"O72"	"H61"	"Postpartum hemorrhage"	"Other disorders of external ear"	1	31	148	179
"A41"	"H65"	"Other sepsis"	"Nonsuppurative otitis media"	1	119	642	761
"D83"	"H65"	"Common variable immunodeficiency"	"Nonsuppurative otitis media"	1	31	98	129
"E11"	"H65"	"Type 2 diabetes mellitus"	"Nonsuppurative otitis media"	1	188	621	809
"G40"	"H65"	"Epilepsy and recurrent seizures"	"Nonsuppurative otitis media"	1	511	841	1352
"K21"	"H65"	"Gastro-esophageal reflux disease"	"Nonsuppurative otitis media"	1	267	469	736
"K56"	"H65"	"Paralytic ileus and intestinal obstruction without hernia"	"Nonsuppurative otitis media"	1	61	196	257
"K62"	"H65"	"Other diseases of anus and rectum"	"Nonsuppurative otitis media"	1	104	505	609
"M16"	"H65"	"Osteoarthritis of hip"	"Nonsuppurative otitis media"	1	98	298	396
"M67"	"H65"	"Other disorders of synovium and tendon"	"Nonsuppurative otitis media"	1	6	460	466
"N80"	"H65"	"Endometriosis"	"Nonsuppurative otitis media"	1	9	63	72
"O04"	"H65"	"Complications following (induced) termination of pregnancy"	"Nonsuppurative otitis media"	1	37	410	447
"C78"	"H66"	"Secondary malignant neoplasm of resp and digestive organs"	"Suppurative and unspecified otitis media"	1	0	156	156
"D24"	"H66"	"Benign neoplasm of breast"	"Suppurative and unspecified otitis media"	1	35	95	130
"E83"	"H66"	"Disorders of mineral metabolism"	"Suppurative and unspecified otitis media"	1	0	62	62
"H61"	"H66"	"Other disorders of external ear"	"Suppurative and unspecified otitis media"	1	169	397	566
"H91"	"H66"	"Other and unspecified hearing loss"	"Suppurative and unspecified otitis media"	1	1564	2552	4116
"I20"	"H66"	"Angina pectoris"	"Suppurative and unspecified otitis media"	1	211	584	795
"J35"	"H66"	"Chronic diseases of tonsils and adenoids"	"Suppurative and unspecified otitis media"	1	2214	3934	6148
"K30"	"H66"	"Functional dyspepsia"	"Suppurative and unspecified otitis media"	1	89	352	441
"K40"	"H66"	"Inguinal hernia"	"Suppurative and unspecified otitis media"	1	484	818	1302
"K72"	"H66"	"Hepatic failure, not elsewhere classified"	"Suppurative and unspecified otitis media"	1	6	44	50
"L05"	"H66"	"Pilonidal cyst and sinus"	"Suppurative and unspecified otitis media"	1	0	97	97
"L50"	"H66"	"Urticaria"	"Suppurative and unspecified otitis media"	1	343	853	1196
"L60"	"H66"	"Nail disorders"	"Suppurative and unspecified otitis media"	1	0	152	152
"L98"	"H66"	"Oth disorders of skin, subcu, not elsewhere classified"	"Suppurative and unspecified otitis media"	1	16	163	179
"M06"	"H66"	"Other rheumatoid arthritis"	"Suppurative and unspecified otitis media"	1	26	77	103
"M24"	"H66"	"Other specific joint derangements"	"Suppurative and unspecified otitis media"	1	68	387	455
"M51"	"H66"	"Thoracic, thoracolum, and lumbosacral intvrt disc disorders"	"Suppurative and unspecified otitis media"	1	142	361	503
"M75"	"H66"	"Shoulder lesions"	"Suppurative and unspecified otitis media"	1	34	544	578
"N18"	"H66"	"Chronic kidney disease (CKD)"	"Suppurative and unspecified otitis media"	1	5	234	239
"N35"	"H66"	"Urethral stricture"	"Suppurative and unspecified otitis media"	1	6	48	54
"N50"	"H66"	"Other and unspecified disorders of male genital organs"	"Suppurative and unspecified otitis media"	1	0	150	150
"N97"	"H66"	"Female infertility"	"Suppurative and unspecified otitis media"	1	34	101	135
"O42"	"H66"	"Premature rupture of membranes"	"Suppurative and unspecified otitis media"	1	30	111	141
"O72"	"H66"	"Postpartum hemorrhage"	"Suppurative and unspecified otitis media"	1	0	469	469
"Q17"	"H66"	"Other congenital malformations of ear"	"Suppurative and unspecified otitis media"	1	17	180	197
"F41"	"H71"	"Other anxiety disorders"	"Cholesteatoma of middle ear"	1	2	43	45
"I49"	"H71"	"Other cardiac arrhythmias"	"Cholesteatoma of middle ear"	1	10	74	84
"I73"	"H71"	"Other peripheral vascular diseases"	"Cholesteatoma of middle ear"	1	9	85	94
"K52"	"H71"	"Other and unsp noninfective gastroenteritis and colitis"	"Cholesteatoma of middle ear"	1	11	62	73
"L90"	"H71"	"Atrophic disorders of skin"	"Cholesteatoma of middle ear"	1	5	53	58
"N18"	"H71"	"Chronic kidney disease (CKD)"	"Cholesteatoma of middle ear"	1	0	88	88
"N19"	"H71"	"Unspecified kidney failure"	"Cholesteatoma of middle ear"	1	3	37	40
"N46"	"H71"	"Male infertility"	"Cholesteatoma of middle ear"	1	2	28	30
"A46"	"H72"	"Erysipelas"	"Perforation of tympanic membrane"	1	34	135	169
"E87"	"H72"	"Other disorders of fluid, electrolyte and acid-base balance"	"Perforation of tympanic membrane"	1	8	161	169
"G47"	"H72"	"Sleep disorders"	"Perforation of tympanic membrane"	1	50	210	260
"G96"	"H72"	"Other disorders of central nervous system"	"Perforation of tympanic membrane"	1	8	104	112
"I50"	"H72"	"Heart failure"	"Perforation of tympanic membrane"	1	68	238	306
"I80"	"H72"	"Phlebitis and thrombophlebitis"	"Perforation of tympanic membrane"	1	45	111	156
"K01"	"H72"	"Embedded and impacted teeth"	"Perforation of tympanic membrane"	1	22	72	94
"M54"	"H72"	"Dorsalgia"	"Perforation of tympanic membrane"	1	281	476	757
"N46"	"H72"	"Male infertility"	"Perforation of tympanic membrane"	1	9	70	79
"C44"	"H80"	"Other and unspecified malignant neoplasm of skin"	"Otosclerosis"	1	0	174	174
"I11"	"H80"	"Hypertensive heart disease"	"Otosclerosis"	1	0	73	73
"I21"	"H80"	"Acute myocardial infarction"	"Otosclerosis"	1	36	440	476
"I27"	"H80"	"Other pulmonary heart diseases"	"Otosclerosis"	1	0	48	48
"I82"	"H80"	"Other venous embolism and thrombosis"	"Otosclerosis"	1	0	26	26
"K76"	"H80"	"Other diseases of liver"	"Otosclerosis"	1	4	53	57
"L08"	"H80"	"Other local infections of skin and subcutaneous tissue"	"Otosclerosis"	1	8	65	73
"M51"	"H80"	"Thoracic, thoracolum, and lumbosacral intvrt disc disorders"	"Otosclerosis"	1	112	308	420
"C34"	"H81"	"Malignant neoplasm of bronchus and lung"	"Disorders of vestibular function"	1	85	850	935
"C90"	"H81"	"Multiple myeloma and malignant plasma cell neoplasms"	"Disorders of vestibular function"	1	19	68	87
"F17"	"H81"	"Nicotine dependence"	"Disorders of vestibular function"	1	126	436	562
"I74"	"H81"	"Arterial embolism and thrombosis"	"Disorders of vestibular function"	1	67	151	218
"I80"	"H81"	"Phlebitis and thrombophlebitis"	"Disorders of vestibular function"	1	504	683	1187
"J94"	"H81"	"Other pleural conditions"	"Disorders of vestibular function"	1	28	127	155
"J96"	"H81"	"Respiratory failure, not elsewhere classified"	"Disorders of vestibular function"	1	0	1584	1584
"L98"	"H81"	"Oth disorders of skin, subcu, not elsewhere classified"	"Disorders of vestibular function"	1	114	284	398
"C22"	"H83"	"Malignant neoplasm of liver and intrahepatic bile ducts"	"Other diseases of inner ear"	1	0	122	122
"C25"	"H83"	"Malignant neoplasm of pancreas"	"Other diseases of inner ear"	1	0	222	222
"C67"	"H83"	"Malignant neoplasm of bladder"	"Other diseases of inner ear"	1	65	413	478
"C80"	"H83"	"Malignant neoplasm without specification of site"	"Other diseases of inner ear"	1	0	71	71
"C88"	"H83"	"Malig immunoproliferative dis and certain oth B-cell lymph"	"Other diseases of inner ear"	1	1	46	47
"E50"	"H83"	"Vitamin A deficiency"	"Other diseases of inner ear"	1	0	26	26
"F10"	"H83"	"Alcohol related disorders"	"Other diseases of inner ear"	1	328	613	941
"G56"	"H83"	"Mononeuropathies of upper limb"	"Other diseases of inner ear"	1	357	801	1158
"H26"	"H83"	"Other cataract"	"Other diseases of inner ear"	1	135	1024	1159
"H61"	"H83"	"Other disorders of external ear"	"Other diseases of inner ear"	1	334	620	954
"I25"	"H83"	"Chronic ischemic heart disease"	"Other diseases of inner ear"	1	0	5117	5117
"I46"	"H83"	"Cardiac arrest"	"Other diseases of inner ear"	1	0	484	484
"I71"	"H83"	"Aortic aneurysm and dissection"	"Other diseases of inner ear"	1	0	844	844
"I77"	"H83"	"Other disorders of arteries and arterioles"	"Other diseases of inner ear"	1	10	48	58
"J98"	"H83"	"Other respiratory disorders"	"Other diseases of inner ear"	1	39	267	306
"K30"	"H83"	"Functional dyspepsia"	"Other diseases of inner ear"	1	460	704	1164
"K42"	"H83"	"Umbilical hernia"	"Other diseases of inner ear"	1	146	326	472
"M17"	"H83"	"Osteoarthritis of knee"	"Other diseases of inner ear"	1	826	1978	2804
"M81"	"H83"	"Osteoporosis without current pathological fracture"	"Other diseases of inner ear"	1	0	800	800
"N21"	"H83"	"Calculus of lower urinary tract"	"Other diseases of inner ear"	1	44	154	198
"N40"	"H83"	"Benign prostatic hyperplasia"	"Other diseases of inner ear"	1	1381	3360	4741
"A49"	"H90"	"Bacterial infection of unspecified site"	"Conductive and sensorineural hearing loss"	1	83	809	892
"C15"	"H90"	"Malignant neoplasm of esophagus"	"Conductive and sensorineural hearing loss"	1	16	139	155
"C71"	"H90"	"Malignant neoplasm of brain"	"Conductive and sensorineural hearing loss"	1	64	144	208
"D09"	"H90"	"Carcinoma in situ of other and unspecified sites"	"Conductive and sensorineural hearing loss"	1	9	135	144
"E13"	"H90"	"Other specified diabetes mellitus"	"Conductive and sensorineural hearing loss"	1	11	100	111
"E66"	"H90"	"Overweight and obesity"	"Conductive and sensorineural hearing loss"	1	794	1061	1855
"F05"	"H90"	"Delirium due to known physiological condition"	"Conductive and sensorineural hearing loss"	1	0	471	471
"F41"	"H90"	"Other anxiety disorders"	"Conductive and sensorineural hearing loss"	1	71	418	489
"G31"	"H90"	"Oth degenerative diseases of nervous system, NEC"	"Conductive and sensorineural hearing loss"	1	14	175	189
"H26"	"H90"	"Other cataract"	"Conductive and sensorineural hearing loss"	1	829	1539	2368
"H54"	"H90"	"Blindness and low vision"	"Conductive and sensorineural hearing loss"	1	182	335	517
"H57"	"H90"	"Other disorders of eye and adnexa"	"Conductive and sensorineural hearing loss"	1	177	450	627
"I63"	"H90"	"Cerebral infarction"	"Conductive and sensorineural hearing loss"	1	626	2064	2690
"I87"	"H90"	"Other disorders of veins"	"Conductive and sensorineural hearing loss"	1	51	119	170
"J44"	"H90"	"Other chronic obstructive pulmonary disease"	"Conductive and sensorineural hearing loss"	1	1132	3220	4352
"J91"	"H90"	"Pleural effusion in conditions classified elsewhere"	"Conductive and sensorineural hearing loss"	1	27	204	231
"K57"	"H90"	"Diverticular disease of intestine"	"Conductive and sensorineural hearing loss"	1	838	1658	2496
"C45"	"H91"	"Mesothelioma"	"Other and unspecified hearing loss"	1	26	191	217
"C78"	"H91"	"Secondary malignant neoplasm of resp and digestive organs"	"Other and unspecified hearing loss"	1	0	5163	5163
"C91"	"H91"	"Lymphoid leukemia"	"Other and unspecified hearing loss"	1	277	664	941
"C92"	"H91"	"Myeloid leukemia"	"Other and unspecified hearing loss"	1	56	492	548
"D09"	"H91"	"Carcinoma in situ of other and unspecified sites"	"Other and unspecified hearing loss"	1	31	492	523
"D50"	"H91"	"Iron deficiency anemia"	"Other and unspecified hearing loss"	1	0	4549	4549
"D62"	"H91"	"Acute posthemorrhagic anemia"	"Other and unspecified hearing loss"	1	0	2279	2279
"D69"	"H91"	"Purpura and other hemorrhagic conditions"	"Other and unspecified hearing loss"	1	271	934	1205
"D75"	"H91"	"Other and unsp diseases of blood and blood-forming organs"	"Other and unspecified hearing loss"	1	159	337	496
"E10"	"H91"	"Type 1 diabetes mellitus"	"Other and unspecified hearing loss"	1	2397	3589	5986
"E13"	"H91"	"Other specified diabetes mellitus"	"Other and unspecified hearing loss"	1	74	381	455
"E15"	"H91"	"Nondiabetic hypoglycemic coma"	"Other and unspecified hearing loss"	1	65	140	205
"E46"	"H91"	"Unspecified protein-calorie malnutrition"	"Other and unspecified hearing loss"	1	6	163	169
"E70"	"H91"	"Disorders of aromatic amino-acid metabolism"	"Other and unspecified hearing loss"	1	22	107	129
"E87"	"H91"	"Other disorders of fluid, electrolyte and acid-base balance"	"Other and unspecified hearing loss"	1	0	7409	7409
"E89"	"H91"	"Postproc endocrine and metabolic comp and disorders, NEC"	"Other and unspecified hearing loss"	1	191	423	614
"G63"	"H91"	"Polyneuropathy in diseases classified elsewhere"	"Other and unspecified hearing loss"	1	112	267	379
"H82"	"H91"	"Vertiginous syndromes in diseases classified elsewhere"	"Other and unspecified hearing loss"	1	73	216	289
"I12"	"H91"	"Hypertensive chronic kidney disease"	"Other and unspecified hearing loss"	1	132	387	519
"I50"	"H91"	"Heart failure"	"Other and unspecified hearing loss"	1	0	26484	26484
"I61"	"H91"	"Nontraumatic intracerebral hemorrhage"	"Other and unspecified hearing loss"	1	0	3302	3302
"J94"	"H91"	"Other pleural conditions"	"Other and unspecified hearing loss"	1	111	713	824
"K08"	"H91"	"Other disorders of teeth and supporting structures"	"Other and unspecified hearing loss"	1	530	741	1271
"M13"	"H91"	"Other arthritis"	"Other and unspecified hearing loss"	1	667	1125	1792
"M35"	"H91"	"Other systemic involvement of connective tissue"	"Other and unspecified hearing loss"	1	1522	1959	3481
"M86"	"H91"	"Osteomyelitis"	"Other and unspecified hearing loss"	1	196	387	583
"M90"	"H91"	"Osteopathies in diseases classified elsewhere"	"Other and unspecified hearing loss"	1	19	118	137
"N39"	"H91"	"Other disorders of urinary system"	"Other and unspecified hearing loss"	1	0	15432	15432
"A41"	"H93"	"Other sepsis"	"Other disorders of ear, not elsewhere classified"	1	0	1787	1787
"A49"	"H93"	"Bacterial infection of unspecified site"	"Other disorders of ear, not elsewhere classified"	1	0	761	761
"B95"	"H93"	"Strep as the cause of diseases classified elsewhere"	"Other disorders of ear, not elsewhere classified"	1	3	52	55
"C90"	"H93"	"Multiple myeloma and malignant plasma cell neoplasms"	"Other disorders of ear, not elsewhere classified"	1	12	106	118
"G91"	"H93"	"Hydrocephalus"	"Other disorders of ear, not elsewhere classified"	1	42	124	166
"I34"	"H93"	"Nonrheumatic mitral valve disorders"	"Other disorders of ear, not elsewhere classified"	1	101	438	539
"J13"	"H93"	"Pneumonia due to Streptococcus pneumoniae"	"Other disorders of ear, not elsewhere classified"	1	23	111	134
"J95"	"H93"	"Intraop and postproc comp and disorders of resp sys, NEC"	"Other disorders of ear, not elsewhere classified"	1	4	94	98
"J98"	"H93"	"Other respiratory disorders"	"Other disorders of ear, not elsewhere classified"	1	96	321	417
"K31"	"H93"	"Other diseases of stomach and duodenum"	"Other disorders of ear, not elsewhere classified"	1	26	179	205
"L98"	"H93"	"Oth disorders of skin, subcu, not elsewhere classified"	"Other disorders of ear, not elsewhere classified"	1	122	324	446
"N19"	"H93"	"Unspecified kidney failure"	"Other disorders of ear, not elsewhere classified"	1	10	519	529
"E78"	"H94"	"Disorders of lipoprotein metabolism and other lipidemias"	"Other disorders of ear in diseases classified elsewhere"	1	4	135	139
"I46"	"I05"	"Cardiac arrest"	"Rheumatic mitral valve diseases"	1	10	67	77
"I69"	"I05"	"Sequelae of cerebrovascular disease"	"Rheumatic mitral valve diseases"	1	74	153	227
"B37"	"I10"	"Candidiasis"	"Essential (primary) hypertension"	1	1937	4159	6096
"C22"	"I10"	"Malignant neoplasm of liver and intrahepatic bile ducts"	"Essential (primary) hypertension"	1	220	1563	1783
"C57"	"I10"	"Malignant neoplasm of other and unsp female genital organs"	"Essential (primary) hypertension"	1	102	221	323
"C77"	"I10"	"Secondary and unspecified malignant neoplasm of lymph nodes"	"Essential (primary) hypertension"	1	1607	4474	6081
"C85"	"I10"	"Oth and unspecified types of non-Hodgkin lymphoma"	"Essential (primary) hypertension"	1	737	1036	1773
"D63"	"I10"	"Anemia in chronic diseases classified elsewhere"	"Essential (primary) hypertension"	1	0	8177	8177
"E50"	"I10"	"Vitamin A deficiency"	"Essential (primary) hypertension"	1	151	560	711
"E72"	"I10"	"Other disorders of amino-acid metabolism"	"Essential (primary) hypertension"	1	135	233	368
"F01"	"I10"	"Vascular dementia"	"Essential (primary) hypertension"	1	0	6111	6111
"G30"	"I10"	"Alzheimer's disease"	"Essential (primary) hypertension"	1	0	5495	5495
"I42"	"I10"	"Cardiomyopathy"	"Essential (primary) hypertension"	1	3934	4805	8739
"K04"	"I10"	"Diseases of pulp and periapical tissues"	"Essential (primary) hypertension"	1	1976	2448	4424
"K59"	"I10"	"Other functional intestinal disorders"	"Essential (primary) hypertension"	1	0	41157	41157
"M85"	"I10"	"Other disorders of bone density and structure"	"Essential (primary) hypertension"	1	0	9548	9548
"A41"	"I12"	"Other sepsis"	"Hypertensive chronic kidney disease"	1	288	870	1158
"B07"	"I12"	"Viral warts"	"Hypertensive chronic kidney disease"	1	0	60	60
"I35"	"I12"	"Nonrheumatic aortic valve disorders"	"Hypertensive chronic kidney disease"	1	138	253	391
"K02"	"I12"	"Dental caries"	"Hypertensive chronic kidney disease"	1	29	93	122
"A49"	"I15"	"Bacterial infection of unspecified site"	"Secondary hypertension"	1	198	739	937
"C44"	"I15"	"Other and unspecified malignant neoplasm of skin"	"Secondary hypertension"	1	159	345	504
"D22"	"I15"	"Melanocytic nevi"	"Secondary hypertension"	1	31	104	135
"J81"	"I15"	"Pulmonary edema"	"Secondary hypertension"	1	242	409	651
"K65"	"I15"	"Peritonitis"	"Secondary hypertension"	1	278	488	766
"B48"	"I20"	"Other mycoses, not elsewhere classified"	"Angina pectoris"	1	4	39	43
"C76"	"I20"	"Malignant neoplasm of other and ill-defined sites"	"Angina pectoris"	1	63	263	326
"D51"	"I20"	"Vitamin B12 deficiency anemia"	"Angina pectoris"	1	338	815	1153
"D71"	"I20"	"Functional disorders of polymorphonuclear neutrophils"	"Angina pectoris"	1	1	30	31
"E20"	"I20"	"Hypoparathyroidism"	"Angina pectoris"	1	182	760	942
"E23"	"I20"	"Hypofunction and other disorders of the pituitary gland"	"Angina pectoris"	1	80	245	325
"G30"	"I20"	"Alzheimer's disease"	"Angina pectoris"	1	0	864	864
"G55"	"I20"	"Nerve root and plexus compressions in diseases classd elswhr"	"Angina pectoris"	1	98	196	294
"G90"	"I20"	"Disorders of autonomic nervous system"	"Angina pectoris"	1	117	445	562
"H40"	"I20"	"Glaucoma"	"Angina pectoris"	1	1146	1506	2652
"I52"	"I20"	"Other heart disorders in diseases classified elsewhere"	"Angina pectoris"	1	12	110	122
"I73"	"I20"	"Other peripheral vascular diseases"	"Angina pectoris"	1	0	10027	10027
"I97"	"I20"	"Intraop and postproc comp and disorders of circ sys, NEC"	"Angina pectoris"	1	180	677	857
"K64"	"I20"	"Hemorrhoids and perianal venous thrombosis"	"Angina pectoris"	1	0	1898	1898
"K75"	"I20"	"Other inflammatory liver diseases"	"Angina pectoris"	1	51	217	268
"M00"	"I20"	"Pyogenic arthritis"	"Angina pectoris"	1	152	384	536
"M54"	"I20"	"Dorsalgia"	"Angina pectoris"	1	7013	7815	14828
"M86"	"I20"	"Osteomyelitis"	"Angina pectoris"	1	168	490	658
"N48"	"I20"	"Other disorders of penis"	"Angina pectoris"	1	688	956	1644
"Q40"	"I20"	"Other congenital malformations of upper alimentary tract"	"Angina pectoris"	1	145	367	512
"A26"	"I21"	"Erysipeloid"	"Acute myocardial infarction"	1	5	118	123
"A40"	"I21"	"Streptococcal sepsis"	"Acute myocardial infarction"	1	183	361	544
"B95"	"I21"	"Strep as the cause of diseases classified elsewhere"	"Acute myocardial infarction"	1	39	154	193
"C15"	"I21"	"Malignant neoplasm of esophagus"	"Acute myocardial infarction"	1	33	419	452
"C80"	"I21"	"Malignant neoplasm without specification of site"	"Acute myocardial infarction"	1	38	341	379
"D46"	"I21"	"Myelodysplastic syndromes"	"Acute myocardial infarction"	1	92	289	381
"E50"	"I21"	"Vitamin A deficiency"	"Acute myocardial infarction"	1	88	364	452
"E61"	"I21"	"Deficiency of other nutrient elements"	"Acute myocardial infarction"	1	34	96	130
"E87"	"I21"	"Other disorders of fluid, electrolyte and acid-base balance"	"Acute myocardial infarction"	1	0	6852	6852
"H57"	"I21"	"Other disorders of eye and adnexa"	"Acute myocardial infarction"	1	166	386	552
"I50"	"I21"	"Heart failure"	"Acute myocardial infarction"	1	31209	35634	66843
"K76"	"I21"	"Other diseases of liver"	"Acute myocardial infarction"	1	336	530	866
"M85"	"I21"	"Other disorders of bone density and structure"	"Acute myocardial infarction"	1	319	892	1211
"N13"	"I21"	"Obstructive and reflux uropathy"	"Acute myocardial infarction"	1	602	942	1544
"N39"	"I21"	"Other disorders of urinary system"	"Acute myocardial infarction"	1	0	10477	10477
"A08"	"I25"	"Viral and other specified intestinal infections"	"Chronic ischemic heart disease"	1	867	1221	2088
"C34"	"I25"	"Malignant neoplasm of bronchus and lung"	"Chronic ischemic heart disease"	1	0	7003	7003
"D35"	"I25"	"Benign neoplasm of other and unspecified endocrine glands"	"Chronic ischemic heart disease"	1	229	439	668
"E70"	"I25"	"Disorders of aromatic amino-acid metabolism"	"Chronic ischemic heart disease"	1	100	293	393
"F01"	"I25"	"Vascular dementia"	"Chronic ischemic heart disease"	1	520	1864	2384
"I33"	"I25"	"Acute and subacute endocarditis"	"Chronic ischemic heart disease"	1	599	1023	1622
"I45"	"I25"	"Other conduction disorders"	"Chronic ischemic heart disease"	1	2234	2676	4910
"I51"	"I25"	"Complications and ill-defined descriptions of heart disease"	"Chronic ischemic heart disease"	1	1410	3620	5030
"I73"	"I25"	"Other peripheral vascular diseases"	"Chronic ischemic heart disease"	1	4687	7587	12274
"I97"	"I25"	"Intraop and postproc comp and disorders of circ sys, NEC"	"Chronic ischemic heart disease"	1	410	737	1147
"K28"	"I25"	"Gastrojejunal ulcer"	"Chronic ischemic heart disease"	1	279	415	694
"K52"	"I25"	"Other and unsp noninfective gastroenteritis and colitis"	"Chronic ischemic heart disease"	1	1929	4219	6148
"K72"	"I25"	"Hepatic failure, not elsewhere classified"	"Chronic ischemic heart disease"	1	169	627	796
"M13"	"I25"	"Other arthritis"	"Chronic ischemic heart disease"	1	881	1252	2133
"N28"	"I25"	"Oth disorders of kidney and ureter, not elsewhere classified"	"Chronic ischemic heart disease"	1	601	2061	2662
"N39"	"I25"	"Other disorders of urinary system"	"Chronic ischemic heart disease"	1	0	18976	18976
"D68"	"I26"	"Other coagulation defects"	"Pulmonary embolism"	1	582	2555	3137
"K64"	"I26"	"Hemorrhoids and perianal venous thrombosis"	"Pulmonary embolism"	1	98	363	461
"O72"	"I26"	"Postpartum hemorrhage"	"Pulmonary embolism"	1	167	277	444
"I46"	"I27"	"Cardiac arrest"	"Other pulmonary heart diseases"	1	201	559	760
"K59"	"I30"	"Other functional intestinal disorders"	"Acute pericarditis"	1	120	347	467
"C34"	"I34"	"Malignant neoplasm of bronchus and lung"	"Nonrheumatic mitral valve disorders"	1	148	418	566
"D59"	"I34"	"Acquired hemolytic anemia"	"Nonrheumatic mitral valve disorders"	1	28	181	209
"G30"	"I34"	"Alzheimer's disease"	"Nonrheumatic mitral valve disorders"	1	10	164	174
"I31"	"I34"	"Other diseases of pericardium"	"Nonrheumatic mitral valve disorders"	1	220	386	606
"I95"	"I34"	"Hypotension"	"Nonrheumatic mitral valve disorders"	1	277	561	838
"J90"	"I34"	"Pleural effusion, not elsewhere classified"	"Nonrheumatic mitral valve disorders"	1	475	679	1154
"N17"	"I34"	"Acute kidney failure"	"Nonrheumatic mitral valve disorders"	1	410	767	1177
"C71"	"I35"	"Malignant neoplasm of brain"	"Nonrheumatic aortic valve disorders"	1	47	122	169
"E35"	"I35"	"Disorders of endocrine glands in diseases classd elswhr"	"Nonrheumatic aortic valve disorders"	1	135	446	581
"G30"	"I35"	"Alzheimer's disease"	"Nonrheumatic aortic valve disorders"	1	116	572	688
"I31"	"I35"	"Other diseases of pericardium"	"Nonrheumatic aortic valve disorders"	1	369	1225	1594
"E87"	"I42"	"Other disorders of fluid, electrolyte and acid-base balance"	"Cardiomyopathy"	1	561	1126	1687
"C22"	"I44"	"Malignant neoplasm of liver and intrahepatic bile ducts"	"Atrioventricular and left bundle-branch block"	1	21	79	100
"A49"	"I45"	"Bacterial infection of unspecified site"	"Other conduction disorders"	1	115	385	500
"C25"	"I45"	"Malignant neoplasm of pancreas"	"Other conduction disorders"	1	10	71	81
"B96"	"I47"	"Oth bacterial agents as the cause of diseases classd elswhr"	"Paroxysmal tachycardia"	1	27	118	145
"C18"	"I47"	"Malignant neoplasm of colon"	"Paroxysmal tachycardia"	1	298	685	983
"D64"	"I47"	"Other anemias"	"Paroxysmal tachycardia"	1	1171	3520	4691
"E16"	"I47"	"Other disorders of pancreatic internal secretion"	"Paroxysmal tachycardia"	1	208	397	605
"F41"	"I47"	"Other anxiety disorders"	"Paroxysmal tachycardia"	1	310	1000	1310
"H36"	"I47"	"Retinal disorders in diseases classified elsewhere"	"Paroxysmal tachycardia"	1	219	347	566
"K22"	"I47"	"Other diseases of esophagus"	"Paroxysmal tachycardia"	1	221	472	693
"K76"	"I47"	"Other diseases of liver"	"Paroxysmal tachycardia"	1	143	355	498
"A26"	"I48"	"Erysipeloid"	"Atrial fibrillation and flutter"	1	90	320	410
"A46"	"I48"	"Erysipelas"	"Atrial fibrillation and flutter"	1	5005	5573	10578
"C78"	"I48"	"Secondary malignant neoplasm of resp and digestive organs"	"Atrial fibrillation and flutter"	1	0	6182	6182
"E64"	"I48"	"Sequelae of malnutrition and other nutritional deficiencies"	"Atrial fibrillation and flutter"	1	669	1234	1903
"I69"	"I48"	"Sequelae of cerebrovascular disease"	"Atrial fibrillation and flutter"	1	13282	17761	31043
"I72"	"I48"	"Other aneurysm"	"Atrial fibrillation and flutter"	1	626	861	1487
"J22"	"I48"	"Unspecified acute lower respiratory infection"	"Atrial fibrillation and flutter"	1	1366	2028	3394
"C34"	"I49"	"Malignant neoplasm of bronchus and lung"	"Other cardiac arrhythmias"	1	220	1014	1234
"D50"	"I49"	"Iron deficiency anemia"	"Other cardiac arrhythmias"	1	549	967	1516
"E83"	"I49"	"Disorders of mineral metabolism"	"Other cardiac arrhythmias"	1	131	300	431
"J96"	"I49"	"Respiratory failure, not elsewhere classified"	"Other cardiac arrhythmias"	1	1477	2747	4224
"K52"	"I49"	"Other and unsp noninfective gastroenteritis and colitis"	"Other cardiac arrhythmias"	1	586	923	1509
"M85"	"I49"	"Other disorders of bone density and structure"	"Other cardiac arrhythmias"	1	259	668	927
"D63"	"I50"	"Anemia in chronic diseases classified elsewhere"	"Heart failure"	1	1563	2856	4419
"E50"	"I50"	"Vitamin A deficiency"	"Heart failure"	1	322	1119	1441
"E83"	"I50"	"Disorders of mineral metabolism"	"Heart failure"	1	597	950	1547
"J22"	"I50"	"Unspecified acute lower respiratory infection"	"Heart failure"	1	1143	1626	2769
"K72"	"I50"	"Hepatic failure, not elsewhere classified"	"Heart failure"	1	559	808	1367
"N28"	"I50"	"Oth disorders of kidney and ureter, not elsewhere classified"	"Heart failure"	1	999	2067	3066
"K59"	"I60"	"Other functional intestinal disorders"	"Nontraumatic subarachnoid hemorrhage"	1	213	399	612
"G81"	"I61"	"Hemiplegia and hemiparesis"	"Nontraumatic intracerebral hemorrhage"	1	281	483	764
"K64"	"I61"	"Hemorrhoids and perianal venous thrombosis"	"Nontraumatic intracerebral hemorrhage"	1	24	103	127
"C15"	"I63"	"Malignant neoplasm of esophagus"	"Cerebral infarction"	1	97	331	428
"C34"	"I63"	"Malignant neoplasm of bronchus and lung"	"Cerebral infarction"	1	827	2370	3197
"K55"	"I63"	"Vascular disorders of intestine"	"Cerebral infarction"	1	231	563	794
"C79"	"I65"	"Secondary malignant neoplasm of other and unspecified sites"	"Occls and stenosis of precerb art, not rslt in cereb infrc"	1	1	193	194
"J44"	"I65"	"Other chronic obstructive pulmonary disease"	"Occls and stenosis of precerb art, not rslt in cereb infrc"	1	464	1022	1486
"C16"	"I69"	"Malignant neoplasm of stomach"	"Sequelae of cerebrovascular disease"	1	173	317	490
"C79"	"I69"	"Secondary malignant neoplasm of other and unspecified sites"	"Sequelae of cerebrovascular disease"	1	495	1214	1709
"J90"	"I69"	"Pleural effusion, not elsewhere classified"	"Sequelae of cerebrovascular disease"	1	734	1102	1836
"C25"	"I70"	"Malignant neoplasm of pancreas"	"Atherosclerosis"	1	83	494	577
"C80"	"I70"	"Malignant neoplasm without specification of site"	"Atherosclerosis"	1	23	273	296
"D46"	"I70"	"Myelodysplastic syndromes"	"Atherosclerosis"	1	79	237	316
"D50"	"I70"	"Iron deficiency anemia"	"Atherosclerosis"	1	849	1871	2720
"I51"	"I70"	"Complications and ill-defined descriptions of heart disease"	"Atherosclerosis"	1	518	789	1307
"I79"	"I70"	"Disord of art, arterioles and capilare in dis classd elswhr"	"Atherosclerosis"	1	48	140	188
"I97"	"I70"	"Intraop and postproc comp and disorders of circ sys, NEC"	"Atherosclerosis"	1	215	491	706
"J18"	"I70"	"Pneumonia, unspecified organism"	"Atherosclerosis"	1	0	19735	19735
"C78"	"I72"	"Secondary malignant neoplasm of resp and digestive organs"	"Other aneurysm"	1	24	141	165
"B95"	"I73"	"Strep as the cause of diseases classified elsewhere"	"Other peripheral vascular diseases"	1	33	113	146
"C24"	"I73"	"Malignant neoplasm of other and unsp parts of biliary tract"	"Other peripheral vascular diseases"	1	10	66	76
"C77"	"I73"	"Secondary and unspecified malignant neoplasm of lymph nodes"	"Other peripheral vascular diseases"	1	116	574	690
"D62"	"I73"	"Acute posthemorrhagic anemia"	"Other peripheral vascular diseases"	1	311	669	980
"D63"	"I73"	"Anemia in chronic diseases classified elsewhere"	"Other peripheral vascular diseases"	1	213	790	1003
"G31"	"I73"	"Oth degenerative diseases of nervous system, NEC"	"Other peripheral vascular diseases"	1	55	152	207
"I26"	"I73"	"Pulmonary embolism"	"Other peripheral vascular diseases"	1	514	795	1309
"I44"	"I73"	"Atrioventricular and left bundle-branch block"	"Other peripheral vascular diseases"	1	534	741	1275
"I46"	"I73"	"Cardiac arrest"	"Other peripheral vascular diseases"	1	142	1478	1620
"N30"	"I73"	"Cystitis"	"Other peripheral vascular diseases"	1	2097	3555	5652
"A49"	"I74"	"Bacterial infection of unspecified site"	"Arterial embolism and thrombosis"	1	130	371	501
"G47"	"I74"	"Sleep disorders"	"Arterial embolism and thrombosis"	1	51	159	210
"C61"	"I78"	"Malignant neoplasm of prostate"	"Diseases of capillaries"	1	28	92	120
"G96"	"I78"	"Other disorders of central nervous system"	"Diseases of capillaries"	1	39	136	175
"I42"	"I80"	"Cardiomyopathy"	"Phlebitis and thrombophlebitis"	1	277	446	723
"J81"	"I80"	"Pulmonary edema"	"Phlebitis and thrombophlebitis"	1	163	565	728
"C06"	"I83"	"Malignant neoplasm of other and unspecified parts of mouth"	"Varicose veins of lower extremities"	1	5	61	66
"C15"	"I83"	"Malignant neoplasm of esophagus"	"Varicose veins of lower extremities"	1	0	170	170
"C49"	"I83"	"Malignant neoplasm of other connective and soft tissue"	"Varicose veins of lower extremities"	1	13	119	132
"C65"	"I83"	"Malignant neoplasm of renal pelvis"	"Varicose veins of lower extremities"	1	1	57	58
"C79"	"I83"	"Secondary malignant neoplasm of other and unspecified sites"	"Varicose veins of lower extremities"	1	0	867	867
"E21"	"I83"	"Hyperparathyroidism and other disorders of parathyroid gland"	"Varicose veins of lower extremities"	1	52	399	451
"F41"	"I83"	"Other anxiety disorders"	"Varicose veins of lower extremities"	1	43	476	519
"G70"	"I83"	"Myasthenia gravis and other myoneural disorders"	"Varicose veins of lower extremities"	1	6	43	49
"H02"	"I83"	"Other disorders of eyelid"	"Varicose veins of lower extremities"	1	369	1264	1633
"H35"	"I83"	"Other retinal disorders"	"Varicose veins of lower extremities"	1	563	1961	2524
"H36"	"I83"	"Retinal disorders in diseases classified elsewhere"	"Varicose veins of lower extremities"	1	247	433	680
"I46"	"I83"	"Cardiac arrest"	"Varicose veins of lower extremities"	1	0	859	859
"I74"	"I83"	"Arterial embolism and thrombosis"	"Varicose veins of lower extremities"	1	164	272	436
"K02"	"I83"	"Dental caries"	"Varicose veins of lower extremities"	1	100	200	300
"K72"	"I83"	"Hepatic failure, not elsewhere classified"	"Varicose veins of lower extremities"	1	55	347	402
"M51"	"I83"	"Thoracic, thoracolum, and lumbosacral intvrt disc disorders"	"Varicose veins of lower extremities"	1	1853	2219	4072
"M75"	"I83"	"Shoulder lesions"	"Varicose veins of lower extremities"	1	1628	3948	5576
"M99"	"I83"	"Biomechanical lesions, not elsewhere classified"	"Varicose veins of lower extremities"	1	84	405	489
"N13"	"I83"	"Obstructive and reflux uropathy"	"Varicose veins of lower extremities"	1	113	522	635
"A49"	"I85"	"Bacterial infection of unspecified site"	"Esophageal varices"	1	124	259	383
"J96"	"I85"	"Respiratory failure, not elsewhere classified"	"Esophageal varices"	1	359	737	1096
"C79"	"I86"	"Secondary malignant neoplasm of other and unspecified sites"	"Varicose veins of other sites"	1	0	50	50
"C25"	"I87"	"Malignant neoplasm of pancreas"	"Other disorders of veins"	1	1	24	25
"O72"	"I88"	"Postpartum hemorrhage"	"Nonspecific lymphadenitis"	1	40	426	466
"C79"	"I95"	"Secondary malignant neoplasm of other and unspecified sites"	"Hypotension"	1	152	274	426
"I89"	"I97"	"Oth noninfective disorders of lymphatic vessels and nodes"	"Intraop and postproc comp and disorders of circ sys, NEC"	1	166	283	449
"A08"	"J00"	"Viral and other specified intestinal infections"	"Acute nasopharyngitis [common cold]"	1	654	883	1537
"H10"	"J00"	"Conjunctivitis"	"Acute nasopharyngitis [common cold]"	1	812	1243	2055
"J15"	"J00"	"Bacterial pneumonia, not elsewhere classified"	"Acute nasopharyngitis [common cold]"	1	230	801	1031
"J44"	"J00"	"Other chronic obstructive pulmonary disease"	"Acute nasopharyngitis [common cold]"	1	328	643	971
"D12"	"J01"	"Benign neoplasm of colon, rectum, anus and anal canal"	"Acute sinusitis"	1	58	210	268
"D17"	"J03"	"Benign lipomatous neoplasm"	"Acute tonsillitis"	1	96	216	312
"D64"	"J03"	"Other anemias"	"Acute tonsillitis"	1	168	360	528
"F60"	"J03"	"Specific personality disorders"	"Acute tonsillitis"	1	17	108	125
"G56"	"J03"	"Mononeuropathies of upper limb"	"Acute tonsillitis"	1	187	466	653
"H93"	"J03"	"Other disorders of ear, not elsewhere classified"	"Acute tonsillitis"	1	129	228	357
"I35"	"J03"	"Nonrheumatic aortic valve disorders"	"Acute tonsillitis"	1	28	148	176
"I50"	"J03"	"Heart failure"	"Acute tonsillitis"	1	100	243	343
"I83"	"J03"	"Varicose veins of lower extremities"	"Acute tonsillitis"	1	120	316	436
"J84"	"J03"	"Other interstitial pulmonary diseases"	"Acute tonsillitis"	1	19	64	83
"K43"	"J03"	"Ventral hernia"	"Acute tonsillitis"	1	60	150	210
"K44"	"J03"	"Diaphragmatic hernia"	"Acute tonsillitis"	1	98	226	324
"K62"	"J03"	"Other diseases of anus and rectum"	"Acute tonsillitis"	1	204	494	698
"L90"	"J03"	"Atrophic disorders of skin"	"Acute tonsillitis"	1	105	306	411
"M48"	"J03"	"Other spondylopathies"	"Acute tonsillitis"	1	50	158	208
"M50"	"J03"	"Cervical disc disorders"	"Acute tonsillitis"	1	102	261	363
"M70"	"J03"	"Soft tissue disorders related to use, overuse and pressure"	"Acute tonsillitis"	1	201	333	534
"M80"	"J03"	"Osteoporosis with current pathological fracture"	"Acute tonsillitis"	1	11	83	94
"N46"	"J03"	"Male infertility"	"Acute tonsillitis"	1	44	161	205
"N92"	"J03"	"Excessive, frequent and irregular menstruation"	"Acute tonsillitis"	1	361	739	1100
"N93"	"J03"	"Other abnormal uterine and vaginal bleeding"	"Acute tonsillitis"	1	65	210	275
"O08"	"J03"	"Complications following ectopic and molar pregnancy"	"Acute tonsillitis"	1	177	287	464
"C79"	"J04"	"Secondary malignant neoplasm of other and unspecified sites"	"Acute laryngitis and tracheitis"	1	1	28	29
"O99"	"J04"	"Oth maternal diseases classd elsw but compl preg/chldbrth"	"Acute laryngitis and tracheitis"	1	70	149	219
"D14"	"J05"	"Benign neoplasm of middle ear and respiratory system"	"Acute obstructive laryngitis [croup] and epiglottitis"	1	11	70	81
"E27"	"J05"	"Other disorders of adrenal gland"	"Acute obstructive laryngitis [croup] and epiglottitis"	1	0	30	30
"F43"	"J05"	"Reaction to severe stress, and adjustment disorders"	"Acute obstructive laryngitis [croup] and epiglottitis"	1	0	135	135
"G47"	"J05"	"Sleep disorders"	"Acute obstructive laryngitis [croup] and epiglottitis"	1	64	250	314
"H72"	"J05"	"Perforation of tympanic membrane"	"Acute obstructive laryngitis [croup] and epiglottitis"	1	0	194	194
"K00"	"J05"	"Disorders of tooth development and eruption"	"Acute obstructive laryngitis [croup] and epiglottitis"	1	0	78	78
"K62"	"J05"	"Other diseases of anus and rectum"	"Acute obstructive laryngitis [croup] and epiglottitis"	1	33	156	189
"M21"	"J05"	"Other acquired deformities of limbs"	"Acute obstructive laryngitis [croup] and epiglottitis"	1	0	255	255
"N30"	"J11"	"Cystitis"	"Influenza due to unidentified influenza virus"	1	666	982	1648
"A49"	"J18"	"Bacterial infection of unspecified site"	"Pneumonia, unspecified organism"	1	6280	9649	15929
"B95"	"J18"	"Strep as the cause of diseases classified elsewhere"	"Pneumonia, unspecified organism"	1	386	656	1042
"D84"	"J18"	"Other immunodeficiencies"	"Pneumonia, unspecified organism"	1	187	713	900
"J09"	"J18"	"Influenza due to certain identified influenza viruses"	"Pneumonia, unspecified organism"	1	846	1402	2248
"J10"	"J18"	"Influenza due to other identified influenza virus"	"Pneumonia, unspecified organism"	1	760	1451	2211
"J14"	"J18"	"Pneumonia due to Hemophilus influenzae"	"Pneumonia, unspecified organism"	1	1506	2185	3691
"K55"	"J18"	"Vascular disorders of intestine"	"Pneumonia, unspecified organism"	1	916	1155	2071
"A09"	"J20"	"Infectious gastroenteritis and colitis, unspecified"	"Acute bronchitis"	1	2696	3811	6507
"C79"	"J20"	"Secondary malignant neoplasm of other and unspecified sites"	"Acute bronchitis"	1	37	277	314
"D80"	"J20"	"Immunodeficiency with predominantly antibody defects"	"Acute bronchitis"	1	51	129	180
"E66"	"J20"	"Overweight and obesity"	"Acute bronchitis"	1	500	1458	1958
"J31"	"J20"	"Chronic rhinitis, nasopharyngitis and pharyngitis"	"Acute bronchitis"	1	49	127	176
"J44"	"J20"	"Other chronic obstructive pulmonary disease"	"Acute bronchitis"	1	4786	5333	10119
"K00"	"J20"	"Disorders of tooth development and eruption"	"Acute bronchitis"	1	0	76	76
"M20"	"J20"	"Acquired deformities of fingers and toes"	"Acute bronchitis"	1	97	221	318
"M84"	"J20"	"Disorder of continuity of bone"	"Acute bronchitis"	1	5	68	73
"N20"	"J20"	"Calculus of kidney and ureter"	"Acute bronchitis"	1	163	278	441
"Q82"	"J20"	"Other congenital malformations of skin"	"Acute bronchitis"	1	28	122	150
"J45"	"J21"	"Asthma"	"Acute bronchiolitis"	1	1223	2124	3347
"I46"	"J22"	"Cardiac arrest"	"Unspecified acute lower respiratory infection"	1	213	480	693
"A49"	"J30"	"Bacterial infection of unspecified site"	"Vasomotor and allergic rhinitis"	1	43	195	238
"C50"	"J30"	"Malignant neoplasm of breast"	"Vasomotor and allergic rhinitis"	1	31	220	251
"D25"	"J30"	"Leiomyoma of uterus"	"Vasomotor and allergic rhinitis"	1	197	336	533
"E03"	"J30"	"Other hypothyroidism"	"Vasomotor and allergic rhinitis"	1	70	341	411
"E04"	"J30"	"Other nontoxic goiter"	"Vasomotor and allergic rhinitis"	1	135	281	416
"E68"	"J30"	"Sequelae of hyperalimentation"	"Vasomotor and allergic rhinitis"	1	3	75	78
"G47"	"J30"	"Sleep disorders"	"Vasomotor and allergic rhinitis"	1	395	807	1202
"I25"	"J30"	"Chronic ischemic heart disease"	"Vasomotor and allergic rhinitis"	1	84	414	498
"I35"	"J30"	"Nonrheumatic aortic valve disorders"	"Vasomotor and allergic rhinitis"	1	1	167	168
"K05"	"J30"	"Gingivitis and periodontal diseases"	"Vasomotor and allergic rhinitis"	1	26	95	121
"K42"	"J30"	"Umbilical hernia"	"Vasomotor and allergic rhinitis"	1	82	175	257
"K70"	"J30"	"Alcoholic liver disease"	"Vasomotor and allergic rhinitis"	1	6	70	76
"M24"	"J30"	"Other specific joint derangements"	"Vasomotor and allergic rhinitis"	1	120	228	348
"M47"	"J30"	"Spondylosis"	"Vasomotor and allergic rhinitis"	1	62	379	441
"M65"	"J30"	"Synovitis and tenosynovitis"	"Vasomotor and allergic rhinitis"	1	321	529	850
"C78"	"J31"	"Secondary malignant neoplasm of resp and digestive organs"	"Chronic rhinitis, nasopharyngitis and pharyngitis"	1	4	62	66
"C79"	"J31"	"Secondary malignant neoplasm of other and unspecified sites"	"Chronic rhinitis, nasopharyngitis and pharyngitis"	1	3	44	47
"C78"	"J32"	"Secondary malignant neoplasm of resp and digestive organs"	"Chronic sinusitis"	1	0	161	161
"E11"	"J32"	"Type 2 diabetes mellitus"	"Chronic sinusitis"	1	234	504	738
"F17"	"J32"	"Nicotine dependence"	"Chronic sinusitis"	1	73	189	262
"I25"	"J32"	"Chronic ischemic heart disease"	"Chronic sinusitis"	1	260	526	786
"N18"	"J32"	"Chronic kidney disease (CKD)"	"Chronic sinusitis"	1	31	169	200
"C44"	"J33"	"Other and unspecified malignant neoplasm of skin"	"Nasal polyp"	1	28	102	130
"G95"	"J33"	"Other and unspecified diseases of spinal cord"	"Nasal polyp"	1	0	29	29
"I35"	"J33"	"Nonrheumatic aortic valve disorders"	"Nasal polyp"	1	20	132	152
"I49"	"J33"	"Other cardiac arrhythmias"	"Nasal polyp"	1	31	138	169
"H35"	"J34"	"Other retinal disorders"	"Other and unspecified disorders of nose and nasal sinuses"	1	46	289	335
"I25"	"J34"	"Chronic ischemic heart disease"	"Other and unspecified disorders of nose and nasal sinuses"	1	159	838	997
"J44"	"J34"	"Other chronic obstructive pulmonary disease"	"Other and unspecified disorders of nose and nasal sinuses"	1	114	791	905
"J91"	"J34"	"Pleural effusion in conditions classified elsewhere"	"Other and unspecified disorders of nose and nasal sinuses"	1	1	39	40
"M20"	"J34"	"Acquired deformities of fingers and toes"	"Other and unspecified disorders of nose and nasal sinuses"	1	172	356	528
"N40"	"J34"	"Benign prostatic hyperplasia"	"Other and unspecified disorders of nose and nasal sinuses"	1	166	484	650
"C77"	"J35"	"Secondary and unspecified malignant neoplasm of lymph nodes"	"Chronic diseases of tonsils and adenoids"	1	15	71	86
"C78"	"J35"	"Secondary malignant neoplasm of resp and digestive organs"	"Chronic diseases of tonsils and adenoids"	1	0	101	101
"D35"	"J35"	"Benign neoplasm of other and unspecified endocrine glands"	"Chronic diseases of tonsils and adenoids"	1	9	88	97
"D63"	"J35"	"Anemia in chronic diseases classified elsewhere"	"Chronic diseases of tonsils and adenoids"	1	3	52	55
"D64"	"J35"	"Other anemias"	"Chronic diseases of tonsils and adenoids"	1	38	268	306
"E05"	"J35"	"Thyrotoxicosis [hyperthyroidism]"	"Chronic diseases of tonsils and adenoids"	1	24	397	421
"E66"	"J35"	"Overweight and obesity"	"Chronic diseases of tonsils and adenoids"	1	0	4445	4445
"F14"	"J35"	"Cocaine related disorders"	"Chronic diseases of tonsils and adenoids"	1	0	50	50
"F70"	"J35"	"Mild intellectual disabilities"	"Chronic diseases of tonsils and adenoids"	1	5	121	126
"G43"	"J35"	"Migraine"	"Chronic diseases of tonsils and adenoids"	1	99	1180	1279
"G54"	"J35"	"Nerve root and plexus disorders"	"Chronic diseases of tonsils and adenoids"	1	6	72	78
"G82"	"J35"	"Paraplegia (paraparesis) and quadriplegia (quadriparesis)"	"Chronic diseases of tonsils and adenoids"	1	41	108	149
"H16"	"J35"	"Keratitis"	"Chronic diseases of tonsils and adenoids"	1	8	240	248
"H54"	"J35"	"Blindness and low vision"	"Chronic diseases of tonsils and adenoids"	1	23	113	136
"H90"	"J35"	"Conductive and sensorineural hearing loss"	"Chronic diseases of tonsils and adenoids"	1	278	963	1241
"I78"	"J35"	"Diseases of capillaries"	"Chronic diseases of tonsils and adenoids"	1	17	86	103
"J95"	"J35"	"Intraop and postproc comp and disorders of resp sys, NEC"	"Chronic diseases of tonsils and adenoids"	1	9	53	62
"K22"	"J35"	"Other diseases of esophagus"	"Chronic diseases of tonsils and adenoids"	1	38	193	231
"K70"	"J35"	"Alcoholic liver disease"	"Chronic diseases of tonsils and adenoids"	1	0	35	35
"K81"	"J35"	"Cholecystitis"	"Chronic diseases of tonsils and adenoids"	1	5	151	156
"M13"	"J35"	"Other arthritis"	"Chronic diseases of tonsils and adenoids"	1	114	360	474
"M16"	"J35"	"Osteoarthritis of hip"	"Chronic diseases of tonsils and adenoids"	1	0	258	258
"M41"	"J35"	"Scoliosis"	"Chronic diseases of tonsils and adenoids"	1	79	444	523
"M75"	"J35"	"Shoulder lesions"	"Chronic diseases of tonsils and adenoids"	1	0	1809	1809
"M99"	"J35"	"Biomechanical lesions, not elsewhere classified"	"Chronic diseases of tonsils and adenoids"	1	0	145	145
"N10"	"J35"	"Acute pyelonephritis"	"Chronic diseases of tonsils and adenoids"	1	254	452	706
"N97"	"J35"	"Female infertility"	"Chronic diseases of tonsils and adenoids"	1	0	1154	1154
"O04"	"J35"	"Complications following (induced) termination of pregnancy"	"Chronic diseases of tonsils and adenoids"	1	985	3322	4307
"O26"	"J35"	"Maternal care for oth conditions predom related to pregnancy"	"Chronic diseases of tonsils and adenoids"	1	71	1357	1428
"O63"	"J35"	"Long labor"	"Chronic diseases of tonsils and adenoids"	1	25	511	536
"O66"	"J35"	"Other obstructed labor"	"Chronic diseases of tonsils and adenoids"	1	21	250	271
"O85"	"J35"	"Puerperal sepsis"	"Chronic diseases of tonsils and adenoids"	1	5	131	136
"O91"	"J35"	"Infect of breast assoc w pregnancy, the puerp and lactation"	"Chronic diseases of tonsils and adenoids"	1	0	204	204
"C61"	"J36"	"Malignant neoplasm of prostate"	"Peritonsillar abscess"	1	0	57	57
"D17"	"J36"	"Benign lipomatous neoplasm"	"Peritonsillar abscess"	1	21	119	140
"D68"	"J36"	"Other coagulation defects"	"Peritonsillar abscess"	1	11	70	81
"E03"	"J36"	"Other hypothyroidism"	"Peritonsillar abscess"	1	1	135	136
"E55"	"J36"	"Vitamin D deficiency"	"Peritonsillar abscess"	1	0	29	29
"E66"	"J36"	"Overweight and obesity"	"Peritonsillar abscess"	1	42	672	714
"E78"	"J36"	"Disorders of lipoprotein metabolism and other lipidemias"	"Peritonsillar abscess"	1	33	285	318
"E83"	"J36"	"Disorders of mineral metabolism"	"Peritonsillar abscess"	1	0	28	28
"G96"	"J36"	"Other disorders of central nervous system"	"Peritonsillar abscess"	1	0	88	88
"I25"	"J36"	"Chronic ischemic heart disease"	"Peritonsillar abscess"	1	59	207	266
"I26"	"J36"	"Pulmonary embolism"	"Peritonsillar abscess"	1	3	66	69
"I34"	"J36"	"Nonrheumatic mitral valve disorders"	"Peritonsillar abscess"	1	3	30	33
"I46"	"J36"	"Cardiac arrest"	"Peritonsillar abscess"	1	0	44	44
"J35"	"J36"	"Chronic diseases of tonsils and adenoids"	"Peritonsillar abscess"	1	1589	2913	4502
"J90"	"J36"	"Pleural effusion, not elsewhere classified"	"Peritonsillar abscess"	1	1	38	39
"K25"	"J36"	"Gastric ulcer"	"Peritonsillar abscess"	1	19	77	96
"K29"	"J36"	"Gastritis and duodenitis"	"Peritonsillar abscess"	1	80	193	273
"K43"	"J36"	"Ventral hernia"	"Peritonsillar abscess"	1	4	65	69
"L73"	"J36"	"Other follicular disorders"	"Peritonsillar abscess"	1	8	45	53
"M13"	"J36"	"Other arthritis"	"Peritonsillar abscess"	1	21	72	93
"M80"	"J36"	"Osteoporosis with current pathological fracture"	"Peritonsillar abscess"	1	0	45	45
"O02"	"J36"	"Other abnormal products of conception"	"Peritonsillar abscess"	1	85	231	316
"O36"	"J36"	"Maternal care for other fetal problems"	"Peritonsillar abscess"	1	40	149	189
"A41"	"J37"	"Other sepsis"	"Chronic laryngitis and laryngotracheitis"	1	0	266	266
"I21"	"J37"	"Acute myocardial infarction"	"Chronic laryngitis and laryngotracheitis"	1	85	254	339
"A41"	"J38"	"Other sepsis"	"Diseases of vocal cords and larynx, not elsewhere classified"	1	110	683	793
"C25"	"J38"	"Malignant neoplasm of pancreas"	"Diseases of vocal cords and larynx, not elsewhere classified"	1	0	81	81
"E11"	"J38"	"Type 2 diabetes mellitus"	"Diseases of vocal cords and larynx, not elsewhere classified"	1	460	632	1092
"H26"	"J38"	"Other cataract"	"Diseases of vocal cords and larynx, not elsewhere classified"	1	127	266	393
"I50"	"J38"	"Heart failure"	"Diseases of vocal cords and larynx, not elsewhere classified"	1	280	752	1032
"K63"	"J38"	"Other diseases of intestine"	"Diseases of vocal cords and larynx, not elsewhere classified"	1	22	94	116
"K72"	"J38"	"Hepatic failure, not elsewhere classified"	"Diseases of vocal cords and larynx, not elsewhere classified"	1	12	57	69
"M19"	"J38"	"Other and unspecified osteoarthritis"	"Diseases of vocal cords and larynx, not elsewhere classified"	1	157	430	587
"I46"	"J41"	"Cardiac arrest"	"Simple and mucopurulent chronic bronchitis"	1	13	282	295
"I63"	"J41"	"Cerebral infarction"	"Simple and mucopurulent chronic bronchitis"	1	141	295	436
"B37"	"J42"	"Candidiasis"	"Unspecified chronic bronchitis"	1	253	638	891
"E64"	"J42"	"Sequelae of malnutrition and other nutritional deficiencies"	"Unspecified chronic bronchitis"	1	71	259	330
"G25"	"J42"	"Other extrapyramidal and movement disorders"	"Unspecified chronic bronchitis"	1	54	140	194
"M10"	"J42"	"Gout"	"Unspecified chronic bronchitis"	1	385	702	1087
"N39"	"J43"	"Other disorders of urinary system"	"Emphysema"	1	458	803	1261
"A40"	"J44"	"Streptococcal sepsis"	"Other chronic obstructive pulmonary disease"	1	559	759	1318
"D38"	"J44"	"Neoplm of uncrt behav of mid ear & resp and intrathorac org"	"Other chronic obstructive pulmonary disease"	1	422	590	1012
"E16"	"J44"	"Other disorders of pancreatic internal secretion"	"Other chronic obstructive pulmonary disease"	1	877	1261	2138
"E21"	"J44"	"Hyperparathyroidism and other disorders of parathyroid gland"	"Other chronic obstructive pulmonary disease"	1	505	682	1187
"G30"	"J44"	"Alzheimer's disease"	"Other chronic obstructive pulmonary disease"	1	224	1093	1317
"G95"	"J44"	"Other and unspecified diseases of spinal cord"	"Other chronic obstructive pulmonary disease"	1	331	680	1011
"J96"	"J44"	"Respiratory failure, not elsewhere classified"	"Other chronic obstructive pulmonary disease"	1	0	52919	52919
"N28"	"J44"	"Oth disorders of kidney and ureter, not elsewhere classified"	"Other chronic obstructive pulmonary disease"	1	657	1334	1991
"C16"	"J45"	"Malignant neoplasm of stomach"	"Asthma"	1	35	209	244
"C18"	"J45"	"Malignant neoplasm of colon"	"Asthma"	1	386	948	1334
"C49"	"J45"	"Malignant neoplasm of other connective and soft tissue"	"Asthma"	1	26	85	111
"C56"	"J45"	"Malignant neoplasm of ovary"	"Asthma"	1	117	222	339
"C78"	"J45"	"Secondary malignant neoplasm of resp and digestive organs"	"Asthma"	1	103	1476	1579
"E23"	"J45"	"Hypofunction and other disorders of the pituitary gland"	"Asthma"	1	71	378	449
"F31"	"J45"	"Bipolar disorder"	"Asthma"	1	117	226	343
"G03"	"J45"	"Meningitis due to other and unspecified causes"	"Asthma"	1	16	60	76
"G30"	"J45"	"Alzheimer's disease"	"Asthma"	1	0	294	294
"G56"	"J45"	"Mononeuropathies of upper limb"	"Asthma"	1	1276	1895	3171
"H33"	"J45"	"Retinal detachments and breaks"	"Asthma"	1	183	373	556
"H60"	"J45"	"Otitis externa"	"Asthma"	1	307	549	856
"I11"	"J45"	"Hypertensive heart disease"	"Asthma"	1	351	768	1119
"I46"	"J45"	"Cardiac arrest"	"Asthma"	1	0	1477	1477
"I48"	"J45"	"Atrial fibrillation and flutter"	"Asthma"	1	2747	5517	8264
"I50"	"J45"	"Heart failure"	"Asthma"	1	3518	6355	9873
"I70"	"J45"	"Atherosclerosis"	"Asthma"	1	946	1445	2391
"K44"	"J45"	"Diaphragmatic hernia"	"Asthma"	1	1290	1666	2956
"K57"	"J45"	"Diverticular disease of intestine"	"Asthma"	1	1312	2832	4144
"K76"	"J45"	"Other diseases of liver"	"Asthma"	1	260	659	919
"L05"	"J45"	"Pilonidal cyst and sinus"	"Asthma"	1	197	452	649
"M23"	"J45"	"Internal derangement of knee"	"Asthma"	1	2348	3948	6296
"Q17"	"J45"	"Other congenital malformations of ear"	"Asthma"	1	131	299	430
"Q99"	"J45"	"Other chromosome abnormalities, not elsewhere classified"	"Asthma"	1	35	125	160
"I46"	"J85"	"Cardiac arrest"	"Abscess of lung and mediastinum"	1	45	107	152
"G47"	"J91"	"Sleep disorders"	"Pleural effusion in conditions classified elsewhere"	1	144	346	490
"N46"	"J93"	"Male infertility"	"Pneumothorax and air leak"	1	17	61	78
"O72"	"J93"	"Postpartum hemorrhage"	"Pneumothorax and air leak"	1	32	119	151
"C79"	"J95"	"Secondary malignant neoplasm of other and unspecified sites"	"Intraop and postproc comp and disorders of resp sys, NEC"	1	90	210	300
"O72"	"J98"	"Postpartum hemorrhage"	"Other respiratory disorders"	1	27	122	149
"I99"	"J99"	"Other and unspecified disorders of circulatory system"	"Respiratory disorders in diseases classified elsewhere"	1	47	128	175
"K44"	"K00"	"Diaphragmatic hernia"	"Disorders of tooth development and eruption"	1	0	48	48
"M77"	"K00"	"Other enthesopathies"	"Disorders of tooth development and eruption"	1	7	82	89
"O64"	"K00"	"Obstructed labor due to malposition and malpresent of fetus"	"Disorders of tooth development and eruption"	1	6	72	78
"O75"	"K00"	"Oth complications of labor and delivery, NEC"	"Disorders of tooth development and eruption"	1	0	89	89
"K59"	"K01"	"Other functional intestinal disorders"	"Embedded and impacted teeth"	1	146	413	559
"M48"	"K01"	"Other spondylopathies"	"Embedded and impacted teeth"	1	17	83	100
"M75"	"K01"	"Shoulder lesions"	"Embedded and impacted teeth"	1	70	319	389
"C15"	"K02"	"Malignant neoplasm of esophagus"	"Dental caries"	1	32	100	132
"E86"	"K02"	"Volume depletion"	"Dental caries"	1	443	1012	1455
"F41"	"K02"	"Other anxiety disorders"	"Dental caries"	1	121	415	536
"J18"	"K02"	"Pneumonia, unspecified organism"	"Dental caries"	1	1290	1618	2908
"J44"	"K04"	"Other chronic obstructive pulmonary disease"	"Diseases of pulp and periapical tissues"	1	529	853	1382
"J69"	"K05"	"Pneumonitis due to solids and liquids"	"Gingivitis and periodontal diseases"	1	6	186	192
"J98"	"K05"	"Other respiratory disorders"	"Gingivitis and periodontal diseases"	1	116	214	330
"A41"	"K08"	"Other sepsis"	"Other disorders of teeth and supporting structures"	1	289	1001	1290
"N39"	"K09"	"Other disorders of urinary system"	"Cysts of oral region, not elsewhere classified"	1	34	110	144
"D64"	"K11"	"Other anemias"	"Diseases of salivary glands"	1	191	357	548
"E87"	"K11"	"Other disorders of fluid, electrolyte and acid-base balance"	"Diseases of salivary glands"	1	99	264	363
"M19"	"K11"	"Other and unspecified osteoarthritis"	"Diseases of salivary glands"	1	134	240	374
"C34"	"K13"	"Malignant neoplasm of bronchus and lung"	"Other diseases of lip and oral mucosa"	1	9	254	263
"E11"	"K13"	"Type 2 diabetes mellitus"	"Other diseases of lip and oral mucosa"	1	216	357	573
"I10"	"K13"	"Essential (primary) hypertension"	"Other diseases of lip and oral mucosa"	1	512	913	1425
"I44"	"K13"	"Atrioventricular and left bundle-branch block"	"Other diseases of lip and oral mucosa"	1	9	51	60
"M48"	"K13"	"Other spondylopathies"	"Other diseases of lip and oral mucosa"	1	92	194	286
"F41"	"K14"	"Other anxiety disorders"	"Diseases of tongue"	1	20	67	87
"C15"	"K20"	"Malignant neoplasm of esophagus"	"Esophagitis"	1	170	411	581
"C79"	"K20"	"Secondary malignant neoplasm of other and unspecified sites"	"Esophagitis"	1	77	424	501
"D12"	"K20"	"Benign neoplasm of colon, rectum, anus and anal canal"	"Esophagitis"	1	643	1064	1707
"E87"	"K20"	"Other disorders of fluid, electrolyte and acid-base balance"	"Esophagitis"	1	466	1275	1741
"F33"	"K20"	"Major depressive disorder, recurrent"	"Esophagitis"	1	184	420	604
"J69"	"K20"	"Pneumonitis due to solids and liquids"	"Esophagitis"	1	59	311	370
"K55"	"K20"	"Vascular disorders of intestine"	"Esophagitis"	1	84	244	328
"K57"	"K20"	"Diverticular disease of intestine"	"Esophagitis"	1	896	1223	2119
"K72"	"K20"	"Hepatic failure, not elsewhere classified"	"Esophagitis"	1	119	420	539
"K81"	"K20"	"Cholecystitis"	"Esophagitis"	1	162	280	442
"K91"	"K20"	"Intraop and postproc comp and disorders of dgstv sys, NEC"	"Esophagitis"	1	97	198	295
"M48"	"K20"	"Other spondylopathies"	"Esophagitis"	1	246	482	728
"M80"	"K20"	"Osteoporosis with current pathological fracture"	"Esophagitis"	1	323	675	998
"D72"	"K21"	"Other disorders of white blood cells"	"Gastro-esophageal reflux disease"	1	64	158	222
"I27"	"K21"	"Other pulmonary heart diseases"	"Gastro-esophageal reflux disease"	1	86	303	389
"I34"	"K21"	"Nonrheumatic mitral valve disorders"	"Gastro-esophageal reflux disease"	1	213	500	713
"I46"	"K21"	"Cardiac arrest"	"Gastro-esophageal reflux disease"	1	0	842	842
"I61"	"K21"	"Nontraumatic intracerebral hemorrhage"	"Gastro-esophageal reflux disease"	1	122	526	648
"J47"	"K21"	"Bronchiectasis"	"Gastro-esophageal reflux disease"	1	86	340	426
"J93"	"K21"	"Pneumothorax and air leak"	"Gastro-esophageal reflux disease"	1	163	287	450
"N17"	"K21"	"Acute kidney failure"	"Gastro-esophageal reflux disease"	1	95	776	871
"C79"	"K22"	"Secondary malignant neoplasm of other and unspecified sites"	"Other diseases of esophagus"	1	112	441	553
"G47"	"K22"	"Sleep disorders"	"Other diseases of esophagus"	1	279	554	833
"N19"	"K22"	"Unspecified kidney failure"	"Other diseases of esophagus"	1	178	303	481
"C45"	"K25"	"Mesothelioma"	"Gastric ulcer"	1	5	44	49
"E63"	"K25"	"Other nutritional deficiencies"	"Gastric ulcer"	1	58	155	213
"J18"	"K25"	"Pneumonia, unspecified organism"	"Gastric ulcer"	1	5820	9174	14994
"K31"	"K25"	"Other diseases of stomach and duodenum"	"Gastric ulcer"	1	907	1254	2161
"A41"	"K26"	"Other sepsis"	"Duodenal ulcer"	1	1161	3501	4662
"C92"	"K26"	"Myeloid leukemia"	"Duodenal ulcer"	1	19	77	96
"E46"	"K26"	"Unspecified protein-calorie malnutrition"	"Duodenal ulcer"	1	22	76	98
"G95"	"K26"	"Other and unspecified diseases of spinal cord"	"Duodenal ulcer"	1	62	172	234
"H35"	"K26"	"Other retinal disorders"	"Duodenal ulcer"	1	575	845	1420
"J96"	"K26"	"Respiratory failure, not elsewhere classified"	"Duodenal ulcer"	1	843	2814	3657
"M75"	"K26"	"Shoulder lesions"	"Duodenal ulcer"	1	370	852	1222
"C78"	"K27"	"Secondary malignant neoplasm of resp and digestive organs"	"Peptic ulcer, site unspecified"	1	119	330	449
"K30"	"K27"	"Functional dyspepsia"	"Peptic ulcer, site unspecified"	1	655	881	1536
"C71"	"K29"	"Malignant neoplasm of brain"	"Gastritis and duodenitis"	1	35	206	241
"E66"	"K29"	"Overweight and obesity"	"Gastritis and duodenitis"	1	2176	3108	5284
"E73"	"K29"	"Lactose intolerance"	"Gastritis and duodenitis"	1	202	376	578
"E87"	"K29"	"Other disorders of fluid, electrolyte and acid-base balance"	"Gastritis and duodenitis"	1	0	4966	4966
"F43"	"K29"	"Reaction to severe stress, and adjustment disorders"	"Gastritis and duodenitis"	1	358	734	1092
"H43"	"K29"	"Disorders of vitreous body"	"Gastritis and duodenitis"	1	281	479	760
"I11"	"K29"	"Hypertensive heart disease"	"Gastritis and duodenitis"	1	427	844	1271
"I34"	"K29"	"Nonrheumatic mitral valve disorders"	"Gastritis and duodenitis"	1	504	747	1251
"I35"	"K29"	"Nonrheumatic aortic valve disorders"	"Gastritis and duodenitis"	1	908	2062	2970
"I89"	"K29"	"Oth noninfective disorders of lymphatic vessels and nodes"	"Gastritis and duodenitis"	1	66	249	315
"K58"	"K29"	"Irritable bowel syndrome"	"Gastritis and duodenitis"	1	2070	2429	4499
"K91"	"K29"	"Intraop and postproc comp and disorders of dgstv sys, NEC"	"Gastritis and duodenitis"	1	223	532	755
"M80"	"K29"	"Osteoporosis with current pathological fracture"	"Gastritis and duodenitis"	1	731	2113	2844
"N39"	"K29"	"Other disorders of urinary system"	"Gastritis and duodenitis"	1	0	7589	7589
"D63"	"K30"	"Anemia in chronic diseases classified elsewhere"	"Functional dyspepsia"	1	65	700	765
"I42"	"K30"	"Cardiomyopathy"	"Functional dyspepsia"	1	155	401	556
"I89"	"K30"	"Oth noninfective disorders of lymphatic vessels and nodes"	"Functional dyspepsia"	1	47	215	262
"K81"	"K30"	"Cholecystitis"	"Functional dyspepsia"	1	385	765	1150
"K82"	"K30"	"Other diseases of gallbladder"	"Functional dyspepsia"	1	55	169	224
"L08"	"K30"	"Other local infections of skin and subcutaneous tissue"	"Functional dyspepsia"	1	415	594	1009
"L98"	"K30"	"Oth disorders of skin, subcu, not elsewhere classified"	"Functional dyspepsia"	1	182	594	776
"A63"	"K35"	"Oth predominantly sexually transmitted diseases, NEC"	"Acute appendicitis"	1	197	452	649
"B18"	"K35"	"Chronic viral hepatitis"	"Acute appendicitis"	1	27	88	115
"B37"	"K35"	"Candidiasis"	"Acute appendicitis"	1	130	286	416
"B96"	"K35"	"Oth bacterial agents as the cause of diseases classd elswhr"	"Acute appendicitis"	1	5	76	81
"C56"	"K35"	"Malignant neoplasm of ovary"	"Acute appendicitis"	1	14	98	112
"C64"	"K35"	"Malignant neoplasm of kidney, except renal pelvis"	"Acute appendicitis"	1	17	104	121
"C67"	"K35"	"Malignant neoplasm of bladder"	"Acute appendicitis"	1	26	85	111
"C90"	"K35"	"Multiple myeloma and malignant plasma cell neoplasms"	"Acute appendicitis"	1	5	43	48
"D17"	"K35"	"Benign lipomatous neoplasm"	"Acute appendicitis"	1	133	481	614
"D50"	"K35"	"Iron deficiency anemia"	"Acute appendicitis"	1	61	405	466
"E05"	"K35"	"Thyrotoxicosis [hyperthyroidism]"	"Acute appendicitis"	1	197	493	690
"E61"	"K35"	"Deficiency of other nutrient elements"	"Acute appendicitis"	1	0	30	30
"G03"	"K35"	"Meningitis due to other and unspecified causes"	"Acute appendicitis"	1	6	44	50
"H43"	"K35"	"Disorders of vitreous body"	"Acute appendicitis"	1	48	190	238
"H53"	"K35"	"Visual disturbances"	"Acute appendicitis"	1	91	361	452
"H91"	"K35"	"Other and unspecified hearing loss"	"Acute appendicitis"	1	696	1134	1830
"I20"	"K35"	"Angina pectoris"	"Acute appendicitis"	1	694	1006	1700
"J91"	"K35"	"Pleural effusion in conditions classified elsewhere"	"Acute appendicitis"	1	13	87	100
"K00"	"K35"	"Disorders of tooth development and eruption"	"Acute appendicitis"	1	121	247	368
"K56"	"K35"	"Paralytic ileus and intestinal obstruction without hernia"	"Acute appendicitis"	1	1027	2075	3102
"K59"	"K35"	"Other functional intestinal disorders"	"Acute appendicitis"	1	1170	3337	4507
"K91"	"K35"	"Intraop and postproc comp and disorders of dgstv sys, NEC"	"Acute appendicitis"	1	88	379	467
"M05"	"K35"	"Rheumatoid arthritis with rheumatoid factor"	"Acute appendicitis"	1	70	148	218
"M67"	"K35"	"Other disorders of synovium and tendon"	"Acute appendicitis"	1	419	1093	1512
"N17"	"K35"	"Acute kidney failure"	"Acute appendicitis"	1	125	325	450
"N30"	"K35"	"Cystitis"	"Acute appendicitis"	1	1440	2627	4067
"N45"	"K35"	"Orchitis and epididymitis"	"Acute appendicitis"	1	131	369	500
"N49"	"K35"	"Inflammatory disorders of male genital organs, NEC"	"Acute appendicitis"	1	16	60	76
"N61"	"K35"	"Inflammatory disorders of breast"	"Acute appendicitis"	1	24	120	144
"O28"	"K35"	"Abnormal findings on antenatal screening of mother"	"Acute appendicitis"	1	39	160	199
"O30"	"K35"	"Multiple gestation"	"Acute appendicitis"	1	69	196	265
"O91"	"K35"	"Infect of breast assoc w pregnancy, the puerp and lactation"	"Acute appendicitis"	1	13	187	200
"A31"	"K40"	"Infection due to other mycobacteria"	"Inguinal hernia"	1	2	42	44
"B96"	"K40"	"Oth bacterial agents as the cause of diseases classd elswhr"	"Inguinal hernia"	1	5	209	214
"C06"	"K40"	"Malignant neoplasm of other and unspecified parts of mouth"	"Inguinal hernia"	1	27	119	146
"C17"	"K40"	"Malignant neoplasm of small intestine"	"Inguinal hernia"	1	3	59	62
"C65"	"K40"	"Malignant neoplasm of renal pelvis"	"Inguinal hernia"	1	26	109	135
"C79"	"K40"	"Secondary malignant neoplasm of other and unspecified sites"	"Inguinal hernia"	1	0	1672	1672
"C92"	"K40"	"Myeloid leukemia"	"Inguinal hernia"	1	14	235	249
"D32"	"K40"	"Benign neoplasm of meninges"	"Inguinal hernia"	1	26	126	152
"D59"	"K40"	"Acquired hemolytic anemia"	"Inguinal hernia"	1	20	74	94
"E23"	"K40"	"Hypofunction and other disorders of the pituitary gland"	"Inguinal hernia"	1	14	150	164
"E50"	"K40"	"Vitamin A deficiency"	"Inguinal hernia"	1	11	86	97
"G64"	"K40"	"Other disorders of peripheral nervous system"	"Inguinal hernia"	1	40	324	364
"G93"	"K40"	"Other disorders of brain"	"Inguinal hernia"	1	41	256	297
"H26"	"K40"	"Other cataract"	"Inguinal hernia"	1	730	2085	2815
"H72"	"K40"	"Perforation of tympanic membrane"	"Inguinal hernia"	1	119	255	374
"I85"	"K40"	"Esophageal varices"	"Inguinal hernia"	1	153	264	417
"I87"	"K40"	"Other disorders of veins"	"Inguinal hernia"	1	68	292	360
"J47"	"K40"	"Bronchiectasis"	"Inguinal hernia"	1	21	279	300
"K03"	"K40"	"Other diseases of hard tissues of teeth"	"Inguinal hernia"	1	26	80	106
"K43"	"K40"	"Ventral hernia"	"Inguinal hernia"	1	1911	2653	4564
"K65"	"K40"	"Peritonitis"	"Inguinal hernia"	1	270	708	978
"K71"	"K40"	"Toxic liver disease"	"Inguinal hernia"	1	39	100	139
"K83"	"K40"	"Other diseases of biliary tract"	"Inguinal hernia"	1	86	543	629
"L90"	"K40"	"Atrophic disorders of skin"	"Inguinal hernia"	1	169	443	612
"M25"	"K40"	"Other joint disorder, not elsewhere classified"	"Inguinal hernia"	1	502	1098	1600
"M70"	"K40"	"Soft tissue disorders related to use, overuse and pressure"	"Inguinal hernia"	1	829	1307	2136
"N47"	"K40"	"Disorders of prepuce"	"Inguinal hernia"	1	787	1618	2405
"N62"	"K40"	"Hypertrophy of breast"	"Inguinal hernia"	1	263	659	922
"G47"	"K41"	"Sleep disorders"	"Femoral hernia"	1	9	67	76
"I50"	"K41"	"Heart failure"	"Femoral hernia"	1	174	358	532
"N30"	"K41"	"Cystitis"	"Femoral hernia"	1	168	356	524
"N39"	"K41"	"Other disorders of urinary system"	"Femoral hernia"	1	100	273	373
"A49"	"K42"	"Bacterial infection of unspecified site"	"Umbilical hernia"	1	109	541	650
"C15"	"K42"	"Malignant neoplasm of esophagus"	"Umbilical hernia"	1	5	89	94
"C25"	"K42"	"Malignant neoplasm of pancreas"	"Umbilical hernia"	1	11	148	159
"F01"	"K42"	"Vascular dementia"	"Umbilical hernia"	1	1	54	55
"G47"	"K42"	"Sleep disorders"	"Umbilical hernia"	1	467	904	1371
"K31"	"K42"	"Other diseases of stomach and duodenum"	"Umbilical hernia"	1	26	81	107
"L57"	"K42"	"Skin changes due to chronic expsr to nonionizing radiation"	"Umbilical hernia"	1	27	107	134
"F33"	"K43"	"Major depressive disorder, recurrent"	"Ventral hernia"	1	204	405	609
"G20"	"K43"	"Parkinson's disease"	"Ventral hernia"	1	45	135	180
"G30"	"K43"	"Alzheimer's disease"	"Ventral hernia"	1	0	137	137
"G31"	"K43"	"Oth degenerative diseases of nervous system, NEC"	"Ventral hernia"	1	17	88	105
"H36"	"K43"	"Retinal disorders in diseases classified elsewhere"	"Ventral hernia"	1	102	199	301
"I42"	"K43"	"Cardiomyopathy"	"Ventral hernia"	1	90	207	297
"J44"	"K43"	"Other chronic obstructive pulmonary disease"	"Ventral hernia"	1	1496	2144	3640
"C06"	"K44"	"Malignant neoplasm of other and unspecified parts of mouth"	"Diaphragmatic hernia"	1	18	82	100
"C78"	"K44"	"Secondary malignant neoplasm of resp and digestive organs"	"Diaphragmatic hernia"	1	0	1523	1523
"C92"	"K44"	"Myeloid leukemia"	"Diaphragmatic hernia"	1	16	105	121
"D50"	"K44"	"Iron deficiency anemia"	"Diaphragmatic hernia"	1	1301	1752	3053
"E66"	"K44"	"Overweight and obesity"	"Diaphragmatic hernia"	1	1776	2313	4089
"G30"	"K44"	"Alzheimer's disease"	"Diaphragmatic hernia"	1	0	237	237
"G96"	"K44"	"Other disorders of central nervous system"	"Diaphragmatic hernia"	1	59	512	571
"I15"	"K44"	"Secondary hypertension"	"Diaphragmatic hernia"	1	177	287	464
"K52"	"K44"	"Other and unsp noninfective gastroenteritis and colitis"	"Diaphragmatic hernia"	1	852	1600	2452
"L97"	"K44"	"Non-pressure chronic ulcer of lower limb, NEC"	"Diaphragmatic hernia"	1	154	589	743
"M99"	"K44"	"Biomechanical lesions, not elsewhere classified"	"Diaphragmatic hernia"	1	192	394	586
"D50"	"K45"	"Iron deficiency anemia"	"Other abdominal hernia"	1	107	223	330
"J18"	"K45"	"Pneumonia, unspecified organism"	"Other abdominal hernia"	1	333	517	850
"C79"	"K46"	"Secondary malignant neoplasm of other and unspecified sites"	"Unspecified abdominal hernia"	1	6	41	47
"E87"	"K50"	"Other disorders of fluid, electrolyte and acid-base balance"	"Crohn's disease [regional enteritis]"	1	76	424	500
"F17"	"K50"	"Nicotine dependence"	"Crohn's disease [regional enteritis]"	1	202	417	619
"G56"	"K50"	"Mononeuropathies of upper limb"	"Crohn's disease [regional enteritis]"	1	132	230	362
"G62"	"K50"	"Other and unspecified polyneuropathies"	"Crohn's disease [regional enteritis]"	1	43	146	189
"H57"	"K50"	"Other disorders of eye and adnexa"	"Crohn's disease [regional enteritis]"	1	26	133	159
"I26"	"K50"	"Pulmonary embolism"	"Crohn's disease [regional enteritis]"	1	56	209	265
"J84"	"K50"	"Other interstitial pulmonary diseases"	"Crohn's disease [regional enteritis]"	1	21	71	92
"K56"	"K50"	"Paralytic ileus and intestinal obstruction without hernia"	"Crohn's disease [regional enteritis]"	1	589	1559	2148
"M07"	"K50"	"Enteropathic arthropathies"	"Crohn's disease [regional enteritis]"	1	66	456	522
"N17"	"K50"	"Acute kidney failure"	"Crohn's disease [regional enteritis]"	1	40	215	255
"B37"	"K51"	"Candidiasis"	"Ulcerative colitis"	1	76	301	377
"E61"	"K51"	"Deficiency of other nutrient elements"	"Ulcerative colitis"	1	10	50	60
"F17"	"K51"	"Nicotine dependence"	"Ulcerative colitis"	1	172	357	529
"H02"	"K51"	"Other disorders of eyelid"	"Ulcerative colitis"	1	74	213	287
"I27"	"K51"	"Other pulmonary heart diseases"	"Ulcerative colitis"	1	28	84	112
"I34"	"K51"	"Nonrheumatic mitral valve disorders"	"Ulcerative colitis"	1	52	142	194
"I73"	"K51"	"Other peripheral vascular diseases"	"Ulcerative colitis"	1	136	305	441
"I80"	"K51"	"Phlebitis and thrombophlebitis"	"Ulcerative colitis"	1	242	557	799
"K74"	"K51"	"Fibrosis and cirrhosis of liver"	"Ulcerative colitis"	1	61	148	209
"K91"	"K51"	"Intraop and postproc comp and disorders of dgstv sys, NEC"	"Ulcerative colitis"	1	82	862	944
"L71"	"K51"	"Rosacea"	"Ulcerative colitis"	1	35	128	163
"E55"	"K52"	"Vitamin D deficiency"	"Other and unsp noninfective gastroenteritis and colitis"	1	279	420	699
"E64"	"K52"	"Sequelae of malnutrition and other nutritional deficiencies"	"Other and unsp noninfective gastroenteritis and colitis"	1	326	535	861
"E83"	"K56"	"Disorders of mineral metabolism"	"Paralytic ileus and intestinal obstruction without hernia"	1	271	506	777
"C78"	"K57"	"Secondary malignant neoplasm of resp and digestive organs"	"Diverticular disease of intestine"	1	0	3217	3217
"E41"	"K57"	"Nutritional marasmus"	"Diverticular disease of intestine"	1	12	206	218
"F01"	"K57"	"Vascular dementia"	"Diverticular disease of intestine"	1	79	560	639
"F41"	"K57"	"Other anxiety disorders"	"Diverticular disease of intestine"	1	457	1108	1565
"I46"	"K57"	"Cardiac arrest"	"Diverticular disease of intestine"	1	133	1302	1435
"J90"	"K57"	"Pleural effusion, not elsewhere classified"	"Diverticular disease of intestine"	1	341	979	1320
"A46"	"K58"	"Erysipelas"	"Irritable bowel syndrome"	1	100	454	554
"F32"	"K58"	"Depressive episode"	"Irritable bowel syndrome"	1	381	933	1314
"I50"	"K58"	"Heart failure"	"Irritable bowel syndrome"	1	328	1209	1537
"I85"	"K58"	"Esophageal varices"	"Irritable bowel syndrome"	1	8	64	72
"J96"	"K58"	"Respiratory failure, not elsewhere classified"	"Irritable bowel syndrome"	1	0	970	970
"K55"	"K58"	"Vascular disorders of intestine"	"Irritable bowel syndrome"	1	51	260	311
"K57"	"K58"	"Diverticular disease of intestine"	"Irritable bowel syndrome"	1	1685	2056	3741
"L29"	"K58"	"Pruritus"	"Irritable bowel syndrome"	1	47	139	186
"M79"	"K58"	"Oth and unsp soft tissue disorders, not elsewhere classified"	"Irritable bowel syndrome"	1	1699	2153	3852
"A49"	"K59"	"Bacterial infection of unspecified site"	"Other functional intestinal disorders"	1	2821	3395	6216
"B96"	"K59"	"Oth bacterial agents as the cause of diseases classd elswhr"	"Other functional intestinal disorders"	1	283	457	740
"F01"	"K59"	"Vascular dementia"	"Other functional intestinal disorders"	1	558	802	1360
"A49"	"K60"	"Bacterial infection of unspecified site"	"Fissure and fistula of anal and rectal regions"	1	121	418	539
"C44"	"K60"	"Other and unspecified malignant neoplasm of skin"	"Fissure and fistula of anal and rectal regions"	1	39	286	325
"C78"	"K60"	"Secondary malignant neoplasm of resp and digestive organs"	"Fissure and fistula of anal and rectal regions"	1	45	324	369
"D12"	"K60"	"Benign neoplasm of colon, rectum, anus and anal canal"	"Fissure and fistula of anal and rectal regions"	1	1101	1394	2495
"E27"	"K60"	"Other disorders of adrenal gland"	"Fissure and fistula of anal and rectal regions"	1	9	51	60
"E66"	"K60"	"Overweight and obesity"	"Fissure and fistula of anal and rectal regions"	1	1079	1359	2438
"G31"	"K60"	"Oth degenerative diseases of nervous system, NEC"	"Fissure and fistula of anal and rectal regions"	1	0	34	34
"H36"	"K60"	"Retinal disorders in diseases classified elsewhere"	"Fissure and fistula of anal and rectal regions"	1	36	135	171
"I46"	"K60"	"Cardiac arrest"	"Fissure and fistula of anal and rectal regions"	1	0	171	171
"I95"	"K60"	"Hypotension"	"Fissure and fistula of anal and rectal regions"	1	28	164	192
"J15"	"K60"	"Bacterial pneumonia, not elsewhere classified"	"Fissure and fistula of anal and rectal regions"	1	73	524	597
"M48"	"K60"	"Other spondylopathies"	"Fissure and fistula of anal and rectal regions"	1	111	464	575
"M75"	"K60"	"Shoulder lesions"	"Fissure and fistula of anal and rectal regions"	1	613	1331	1944
"C79"	"K61"	"Secondary malignant neoplasm of other and unspecified sites"	"Abscess of anal and rectal regions"	1	8	231	239
"D22"	"K61"	"Melanocytic nevi"	"Abscess of anal and rectal regions"	1	35	92	127
"H43"	"K61"	"Disorders of vitreous body"	"Abscess of anal and rectal regions"	1	28	122	150
"I10"	"K61"	"Essential (primary) hypertension"	"Abscess of anal and rectal regions"	1	974	2051	3025
"I71"	"K61"	"Aortic aneurysm and dissection"	"Abscess of anal and rectal regions"	1	15	174	189
"K21"	"K61"	"Gastro-esophageal reflux disease"	"Abscess of anal and rectal regions"	1	234	377	611
"K63"	"K61"	"Other diseases of intestine"	"Abscess of anal and rectal regions"	1	123	334	457
"C34"	"K62"	"Malignant neoplasm of bronchus and lung"	"Other diseases of anus and rectum"	1	294	1572	1866
"C71"	"K62"	"Malignant neoplasm of brain"	"Other diseases of anus and rectum"	1	65	149	214
"D09"	"K62"	"Carcinoma in situ of other and unspecified sites"	"Other diseases of anus and rectum"	1	40	133	173
"K59"	"K62"	"Other functional intestinal disorders"	"Other diseases of anus and rectum"	1	6052	7357	13409
"K63"	"K62"	"Other diseases of intestine"	"Other diseases of anus and rectum"	1	1128	1645	2773
"A49"	"K65"	"Bacterial infection of unspecified site"	"Peritonitis"	1	536	749	1285
"C78"	"K66"	"Secondary malignant neoplasm of resp and digestive organs"	"Other disorders of peritoneum"	1	49	153	202
"N30"	"K66"	"Cystitis"	"Other disorders of peritoneum"	1	177	294	471
"A41"	"K70"	"Other sepsis"	"Alcoholic liver disease"	1	1640	3081	4721
"C78"	"K70"	"Secondary malignant neoplasm of resp and digestive organs"	"Alcoholic liver disease"	1	116	519	635
"E86"	"K70"	"Volume depletion"	"Alcoholic liver disease"	1	1263	2615	3878
"A41"	"K73"	"Other sepsis"	"Chronic hepatitis, not elsewhere classified"	1	82	252	334
"I46"	"K74"	"Cardiac arrest"	"Fibrosis and cirrhosis of liver"	1	87	246	333
"C24"	"K80"	"Malignant neoplasm of other and unsp parts of biliary tract"	"Cholelithiasis"	1	214	877	1091
"D43"	"K80"	"Neoplasm of uncertain behavior of brain and cnsl"	"Cholelithiasis"	1	39	122	161
"E64"	"K80"	"Sequelae of malnutrition and other nutritional deficiencies"	"Cholelithiasis"	1	96	529	625
"E73"	"K80"	"Lactose intolerance"	"Cholelithiasis"	1	134	239	373
"E89"	"K80"	"Postproc endocrine and metabolic comp and disorders, NEC"	"Cholelithiasis"	1	140	268	408
"G23"	"K80"	"Other degenerative diseases of basal ganglia"	"Cholelithiasis"	1	1	27	28
"G47"	"K80"	"Sleep disorders"	"Cholelithiasis"	1	489	2337	2826
"H43"	"K80"	"Disorders of vitreous body"	"Cholelithiasis"	1	302	630	932
"H57"	"K80"	"Other disorders of eye and adnexa"	"Cholelithiasis"	1	129	640	769
"I62"	"K80"	"Other and unspecified nontraumatic intracranial hemorrhage"	"Cholelithiasis"	1	22	84	106
"I63"	"K80"	"Cerebral infarction"	"Cholelithiasis"	1	1007	2992	3999
"I80"	"K80"	"Phlebitis and thrombophlebitis"	"Cholelithiasis"	1	1274	2003	3277
"I82"	"K80"	"Other venous embolism and thrombosis"	"Cholelithiasis"	1	167	554	721
"I97"	"K80"	"Intraop and postproc comp and disorders of circ sys, NEC"	"Cholelithiasis"	1	43	138	181
"J91"	"K80"	"Pleural effusion in conditions classified elsewhere"	"Cholelithiasis"	1	98	409	507
"K43"	"K80"	"Ventral hernia"	"Cholelithiasis"	1	1365	3981	5346
"K58"	"K80"	"Irritable bowel syndrome"	"Cholelithiasis"	1	2012	2452	4464
"M16"	"K80"	"Osteoarthritis of hip"	"Cholelithiasis"	1	1604	2129	3733
"M25"	"K80"	"Other joint disorder, not elsewhere classified"	"Cholelithiasis"	1	981	1579	2560
"M46"	"K80"	"Other inflammatory spondylopathies"	"Cholelithiasis"	1	144	274	418
"M48"	"K80"	"Other spondylopathies"	"Cholelithiasis"	1	897	2027	2924
"M76"	"K80"	"Enthesopathies, lower limb, excluding foot"	"Cholelithiasis"	1	505	751	1256
"M81"	"K80"	"Osteoporosis without current pathological fracture"	"Cholelithiasis"	1	1125	3683	4808
"N39"	"K80"	"Other disorders of urinary system"	"Cholelithiasis"	1	0	8218	8218
"F41"	"K81"	"Other anxiety disorders"	"Cholecystitis"	1	118	242	360
"N39"	"K81"	"Other disorders of urinary system"	"Cholecystitis"	1	683	1046	1729
"G47"	"K83"	"Sleep disorders"	"Other diseases of biliary tract"	1	200	509	709
"C61"	"K85"	"Malignant neoplasm of prostate"	"Acute pancreatitis"	1	97	239	336
"I61"	"K85"	"Nontraumatic intracerebral hemorrhage"	"Acute pancreatitis"	1	63	178	241
"K91"	"K85"	"Intraop and postproc comp and disorders of dgstv sys, NEC"	"Acute pancreatitis"	1	112	267	379
"E86"	"K86"	"Volume depletion"	"Other diseases of pancreas"	1	534	1177	1711
"J96"	"K86"	"Respiratory failure, not elsewhere classified"	"Other diseases of pancreas"	1	382	995	1377
"K72"	"K86"	"Hepatic failure, not elsewhere classified"	"Other diseases of pancreas"	1	165	420	585
"N18"	"K86"	"Chronic kidney disease (CKD)"	"Other diseases of pancreas"	1	167	404	571
"A41"	"K90"	"Other sepsis"	"Intestinal malabsorption"	1	168	326	494
"N18"	"K90"	"Chronic kidney disease (CKD)"	"Intestinal malabsorption"	1	45	159	204
"F41"	"K91"	"Other anxiety disorders"	"Intraop and postproc comp and disorders of dgstv sys, NEC"	1	82	171	253
"F41"	"K92"	"Other anxiety disorders"	"Other diseases of digestive system"	1	496	847	1343
"J15"	"K92"	"Bacterial pneumonia, not elsewhere classified"	"Other diseases of digestive system"	1	2611	3433	6044
"K64"	"K92"	"Hemorrhoids and perianal venous thrombosis"	"Other diseases of digestive system"	1	302	910	1212
"O72"	"K92"	"Postpartum hemorrhage"	"Other diseases of digestive system"	1	102	527	629
"D69"	"L02"	"Purpura and other hemorrhagic conditions"	"Cutaneous abscess, furuncle and carbuncle"	1	223	350	573
"E05"	"L02"	"Thyrotoxicosis [hyperthyroidism]"	"Cutaneous abscess, furuncle and carbuncle"	1	394	550	944
"E83"	"L02"	"Disorders of mineral metabolism"	"Cutaneous abscess, furuncle and carbuncle"	1	51	371	422
"F14"	"L02"	"Cocaine related disorders"	"Cutaneous abscess, furuncle and carbuncle"	1	51	132	183
"G45"	"L02"	"Transient cerebral ischemic attacks and related syndromes"	"Cutaneous abscess, furuncle and carbuncle"	1	522	770	1292
"G51"	"L02"	"Facial nerve disorders"	"Cutaneous abscess, furuncle and carbuncle"	1	107	200	307
"J22"	"L02"	"Unspecified acute lower respiratory infection"	"Cutaneous abscess, furuncle and carbuncle"	1	32	335	367
"M47"	"L02"	"Spondylosis"	"Cutaneous abscess, furuncle and carbuncle"	1	505	842	1347
"M48"	"L02"	"Other spondylopathies"	"Cutaneous abscess, furuncle and carbuncle"	1	406	964	1370
"C15"	"L03"	"Malignant neoplasm of esophagus"	"Cellulitis and acute lymphangitis"	1	0	69	69
"C18"	"L03"	"Malignant neoplasm of colon"	"Cellulitis and acute lymphangitis"	1	24	200	224
"C78"	"L03"	"Secondary malignant neoplasm of resp and digestive organs"	"Cellulitis and acute lymphangitis"	1	0	359	359
"E05"	"L03"	"Thyrotoxicosis [hyperthyroidism]"	"Cellulitis and acute lymphangitis"	1	111	256	367
"E86"	"L03"	"Volume depletion"	"Cellulitis and acute lymphangitis"	1	128	1192	1320
"G91"	"L03"	"Hydrocephalus"	"Cellulitis and acute lymphangitis"	1	16	63	79
"I20"	"L03"	"Angina pectoris"	"Cellulitis and acute lymphangitis"	1	604	1030	1634
"I25"	"L03"	"Chronic ischemic heart disease"	"Cellulitis and acute lymphangitis"	1	517	1243	1760
"K57"	"L03"	"Diverticular disease of intestine"	"Cellulitis and acute lymphangitis"	1	77	678	755
"K59"	"L03"	"Other functional intestinal disorders"	"Cellulitis and acute lymphangitis"	1	264	1380	1644
"K70"	"L03"	"Alcoholic liver disease"	"Cellulitis and acute lymphangitis"	1	58	311	369
"L97"	"L03"	"Non-pressure chronic ulcer of lower limb, NEC"	"Cellulitis and acute lymphangitis"	1	297	828	1125
"M54"	"L03"	"Dorsalgia"	"Cellulitis and acute lymphangitis"	1	904	1747	2651
"N13"	"L03"	"Obstructive and reflux uropathy"	"Cellulitis and acute lymphangitis"	1	51	171	222
"E11"	"L04"	"Type 2 diabetes mellitus"	"Acute lymphadenitis"	1	46	167	213
"E87"	"L04"	"Other disorders of fluid, electrolyte and acid-base balance"	"Acute lymphadenitis"	1	1	75	76
"K80"	"L04"	"Cholelithiasis"	"Acute lymphadenitis"	1	57	126	183
"N18"	"L04"	"Chronic kidney disease (CKD)"	"Acute lymphadenitis"	1	5	50	55
"A46"	"L05"	"Erysipelas"	"Pilonidal cyst and sinus"	1	22	166	188
"C43"	"L05"	"Malignant melanoma of skin"	"Pilonidal cyst and sinus"	1	3	36	39
"E04"	"L05"	"Other nontoxic goiter"	"Pilonidal cyst and sinus"	1	8	85	93
"F17"	"L05"	"Nicotine dependence"	"Pilonidal cyst and sinus"	1	903	1268	2171
"G56"	"L05"	"Mononeuropathies of upper limb"	"Pilonidal cyst and sinus"	1	57	351	408
"H26"	"L05"	"Other cataract"	"Pilonidal cyst and sinus"	1	15	71	86
"I21"	"L05"	"Acute myocardial infarction"	"Pilonidal cyst and sinus"	1	15	168	183
"I25"	"L05"	"Chronic ischemic heart disease"	"Pilonidal cyst and sinus"	1	40	252	292
"I46"	"L05"	"Cardiac arrest"	"Pilonidal cyst and sinus"	1	0	52	52
"I95"	"L05"	"Hypotension"	"Pilonidal cyst and sinus"	1	0	26	26
"J01"	"L05"	"Acute sinusitis"	"Pilonidal cyst and sinus"	1	21	72	93
"J32"	"L05"	"Chronic sinusitis"	"Pilonidal cyst and sinus"	1	24	74	98
"K05"	"L05"	"Gingivitis and periodontal diseases"	"Pilonidal cyst and sinus"	1	17	69	86
"M19"	"L05"	"Other and unspecified osteoarthritis"	"Pilonidal cyst and sinus"	1	21	221	242
"M54"	"L05"	"Dorsalgia"	"Pilonidal cyst and sinus"	1	378	772	1150
"N17"	"L05"	"Acute kidney failure"	"Pilonidal cyst and sinus"	1	2	56	58
"N39"	"L05"	"Other disorders of urinary system"	"Pilonidal cyst and sinus"	1	47	201	248
"O02"	"L05"	"Other abnormal products of conception"	"Pilonidal cyst and sinus"	1	47	191	238
"O20"	"L05"	"Hemorrhage in early pregnancy"	"Pilonidal cyst and sinus"	1	79	201	280
"O26"	"L05"	"Maternal care for oth conditions predom related to pregnancy"	"Pilonidal cyst and sinus"	1	54	235	289
"O48"	"L05"	"Late pregnancy"	"Pilonidal cyst and sinus"	1	34	161	195
"C25"	"L08"	"Malignant neoplasm of pancreas"	"Other local infections of skin and subcutaneous tissue"	1	8	99	107
"C34"	"L08"	"Malignant neoplasm of bronchus and lung"	"Other local infections of skin and subcutaneous tissue"	1	64	448	512
"I69"	"L08"	"Sequelae of cerebrovascular disease"	"Other local infections of skin and subcutaneous tissue"	1	598	794	1392
"L97"	"L08"	"Non-pressure chronic ulcer of lower limb, NEC"	"Other local infections of skin and subcutaneous tissue"	1	827	1242	2069
"M19"	"L08"	"Other and unspecified osteoarthritis"	"Other local infections of skin and subcutaneous tissue"	1	596	873	1469
"E89"	"L20"	"Postproc endocrine and metabolic comp and disorders, NEC"	"Atopic dermatitis"	1	0	28	28
"G44"	"L20"	"Other headache syndromes"	"Atopic dermatitis"	1	16	143	159
"M17"	"L20"	"Osteoarthritis of knee"	"Atopic dermatitis"	1	24	164	188
"M21"	"L20"	"Other acquired deformities of limbs"	"Atopic dermatitis"	1	57	158	215
"M41"	"L20"	"Scoliosis"	"Atopic dermatitis"	1	15	103	118
"M92"	"L20"	"Other juvenile osteochondrosis"	"Atopic dermatitis"	1	8	47	55
"C78"	"L21"	"Secondary malignant neoplasm of resp and digestive organs"	"Seborrheic dermatitis"	1	8	66	74
"G56"	"L23"	"Mononeuropathies of upper limb"	"Allergic contact dermatitis"	1	141	261	402
"I50"	"L23"	"Heart failure"	"Allergic contact dermatitis"	1	52	310	362
"M17"	"L24"	"Osteoarthritis of knee"	"Irritant contact dermatitis"	1	19	152	171
"M51"	"L25"	"Thoracic, thoracolum, and lumbosacral intvrt disc disorders"	"Unspecified contact dermatitis"	1	26	110	136
"A49"	"L27"	"Bacterial infection of unspecified site"	"Dermatitis due to substances taken internally"	1	66	141	207
"E86"	"L30"	"Volume depletion"	"Other and unspecified dermatitis"	1	688	1362	2050
"C61"	"L40"	"Malignant neoplasm of prostate"	"Psoriasis"	1	52	166	218
"C78"	"L40"	"Secondary malignant neoplasm of resp and digestive organs"	"Psoriasis"	1	3	288	291
"E55"	"L40"	"Vitamin D deficiency"	"Psoriasis"	1	74	155	229
"F33"	"L40"	"Major depressive disorder, recurrent"	"Psoriasis"	1	126	243	369
"G95"	"L40"	"Other and unspecified diseases of spinal cord"	"Psoriasis"	1	13	85	98
"N13"	"L40"	"Obstructive and reflux uropathy"	"Psoriasis"	1	47	118	165
"G47"	"L50"	"Sleep disorders"	"Urticaria"	1	126	538	664
"K74"	"L50"	"Fibrosis and cirrhosis of liver"	"Urticaria"	1	9	59	68
"O99"	"L52"	"Oth maternal diseases classd elsw but compl preg/chldbrth"	"Erythema nodosum"	1	48	127	175
"D63"	"L60"	"Anemia in chronic diseases classified elsewhere"	"Nail disorders"	1	14	62	76
"E66"	"L60"	"Overweight and obesity"	"Nail disorders"	1	352	787	1139
"E68"	"L68"	"Sequelae of hyperalimentation"	"Hypertrichosis"	1	0	93	93
"J96"	"L68"	"Respiratory failure, not elsewhere classified"	"Hypertrichosis"	1	0	57	57
"K56"	"L68"	"Paralytic ileus and intestinal obstruction without hernia"	"Hypertrichosis"	1	0	55	55
"M65"	"L68"	"Synovitis and tenosynovitis"	"Hypertrichosis"	1	37	211	248
"M67"	"L68"	"Other disorders of synovium and tendon"	"Hypertrichosis"	1	63	171	234
"O72"	"L68"	"Postpartum hemorrhage"	"Hypertrichosis"	1	52	782	834
"O70"	"L70"	"Perineal laceration during delivery"	"Acne"	1	84	281	365
"C34"	"L71"	"Malignant neoplasm of bronchus and lung"	"Rosacea"	1	7	76	83
"D64"	"L72"	"Other anemias"	"Follicular cysts of skin and subcutaneous tissue"	1	65	292	357
"F05"	"L72"	"Delirium due to known physiological condition"	"Follicular cysts of skin and subcutaneous tissue"	1	1	47	48
"G95"	"L72"	"Other and unspecified diseases of spinal cord"	"Follicular cysts of skin and subcutaneous tissue"	1	4	35	39
"J90"	"L72"	"Pleural effusion, not elsewhere classified"	"Follicular cysts of skin and subcutaneous tissue"	1	9	53	62
"K57"	"L72"	"Diverticular disease of intestine"	"Follicular cysts of skin and subcutaneous tissue"	1	103	299	402
"C78"	"L73"	"Secondary malignant neoplasm of resp and digestive organs"	"Other follicular disorders"	1	5	92	97
"J22"	"L85"	"Unspecified acute lower respiratory infection"	"Other epidermal thickening"	1	3	30	33
"F03"	"L90"	"Unspecified dementia"	"Atrophic disorders of skin"	1	20	139	159
"I46"	"L90"	"Cardiac arrest"	"Atrophic disorders of skin"	1	6	106	112
"A18"	"L93"	"Tuberculosis of other organs"	"Lupus erythematosus"	1	13	64	77
"I69"	"L93"	"Sequelae of cerebrovascular disease"	"Lupus erythematosus"	1	22	94	116
"A41"	"L97"	"Other sepsis"	"Non-pressure chronic ulcer of lower limb, NEC"	1	1763	2857	4620
"K55"	"L98"	"Vascular disorders of intestine"	"Oth disorders of skin, subcu, not elsewhere classified"	1	55	140	195
"C64"	"M02"	"Malignant neoplasm of kidney, except renal pelvis"	"Postinfective and reactive arthropathies"	1	2	36	38
"C71"	"M02"	"Malignant neoplasm of brain"	"Postinfective and reactive arthropathies"	1	0	26	26
"E66"	"M02"	"Overweight and obesity"	"Postinfective and reactive arthropathies"	1	146	548	694
"G47"	"M02"	"Sleep disorders"	"Postinfective and reactive arthropathies"	1	21	297	318
"H91"	"M02"	"Other and unspecified hearing loss"	"Postinfective and reactive arthropathies"	1	239	367	606
"J15"	"M02"	"Bacterial pneumonia, not elsewhere classified"	"Postinfective and reactive arthropathies"	1	116	387	503
"K00"	"M02"	"Disorders of tooth development and eruption"	"Postinfective and reactive arthropathies"	1	4	36	40
"M08"	"M02"	"Juvenile arthritis"	"Postinfective and reactive arthropathies"	1	244	807	1051
"M45"	"M02"	"Ankylosing spondylitis"	"Postinfective and reactive arthropathies"	1	68	246	314
"B02"	"M05"	"Zoster [herpes zoster]"	"Rheumatoid arthritis with rheumatoid factor"	1	52	180	232
"C78"	"M05"	"Secondary malignant neoplasm of resp and digestive organs"	"Rheumatoid arthritis with rheumatoid factor"	1	28	467	495
"C79"	"M05"	"Secondary malignant neoplasm of other and unspecified sites"	"Rheumatoid arthritis with rheumatoid factor"	1	15	314	329
"J13"	"M05"	"Pneumonia due to Streptococcus pneumoniae"	"Rheumatoid arthritis with rheumatoid factor"	1	39	101	140
"J15"	"M05"	"Bacterial pneumonia, not elsewhere classified"	"Rheumatoid arthritis with rheumatoid factor"	1	212	1237	1449
"K52"	"M05"	"Other and unsp noninfective gastroenteritis and colitis"	"Rheumatoid arthritis with rheumatoid factor"	1	176	474	650
"N10"	"M05"	"Acute pyelonephritis"	"Rheumatoid arthritis with rheumatoid factor"	1	97	183	280
"A40"	"M06"	"Streptococcal sepsis"	"Other rheumatoid arthritis"	1	33	96	129
"B96"	"M06"	"Oth bacterial agents as the cause of diseases classd elswhr"	"Other rheumatoid arthritis"	1	11	96	107
"D62"	"M06"	"Acute posthemorrhagic anemia"	"Other rheumatoid arthritis"	1	96	303	399
"E27"	"M06"	"Other disorders of adrenal gland"	"Other rheumatoid arthritis"	1	27	122	149
"J15"	"M06"	"Bacterial pneumonia, not elsewhere classified"	"Other rheumatoid arthritis"	1	275	1571	1846
"J86"	"M06"	"Pyothorax"	"Other rheumatoid arthritis"	1	40	112	152
"L57"	"M06"	"Skin changes due to chronic expsr to nonionizing radiation"	"Other rheumatoid arthritis"	1	27	192	219
"M19"	"M06"	"Other and unspecified osteoarthritis"	"Other rheumatoid arthritis"	1	1078	1635	2713
"C34"	"M07"	"Malignant neoplasm of bronchus and lung"	"Enteropathic arthropathies"	1	11	107	118
"C78"	"M07"	"Secondary malignant neoplasm of resp and digestive organs"	"Enteropathic arthropathies"	1	0	120	120
"C79"	"M07"	"Secondary malignant neoplasm of other and unspecified sites"	"Enteropathic arthropathies"	1	0	69	69
"O04"	"M08"	"Complications following (induced) termination of pregnancy"	"Juvenile arthritis"	1	0	73	73
"C34"	"M10"	"Malignant neoplasm of bronchus and lung"	"Gout"	1	138	618	756
"N17"	"M10"	"Acute kidney failure"	"Gout"	1	623	1113	1736
"C25"	"M13"	"Malignant neoplasm of pancreas"	"Other arthritis"	1	10	112	122
"C34"	"M13"	"Malignant neoplasm of bronchus and lung"	"Other arthritis"	1	97	461	558
"D64"	"M13"	"Other anemias"	"Other arthritis"	1	786	1122	1908
"J22"	"M13"	"Unspecified acute lower respiratory infection"	"Other arthritis"	1	63	173	236
"J96"	"M14"	"Respiratory failure, not elsewhere classified"	"Arthropathies in other diseases classified elsewhere"	1	31	116	147
"E27"	"M16"	"Other disorders of adrenal gland"	"Osteoarthritis of hip"	1	68	221	289
"E55"	"M16"	"Vitamin D deficiency"	"Osteoarthritis of hip"	1	97	798	895
"F02"	"M16"	"Dementia in other diseases classified elsewhere"	"Osteoarthritis of hip"	1	7	174	181
"F05"	"M16"	"Delirium due to known physiological condition"	"Osteoarthritis of hip"	1	0	1114	1114
"G25"	"M16"	"Other extrapyramidal and movement disorders"	"Osteoarthritis of hip"	1	102	358	460
"H26"	"M16"	"Other cataract"	"Osteoarthritis of hip"	1	1495	2955	4450
"I45"	"M16"	"Other conduction disorders"	"Osteoarthritis of hip"	1	231	545	776
"I72"	"M16"	"Other aneurysm"	"Osteoarthritis of hip"	1	100	315	415
"J06"	"M16"	"Acute upper resp infections of multiple and unsp sites"	"Osteoarthritis of hip"	1	45	285	330
"K62"	"M16"	"Other diseases of anus and rectum"	"Osteoarthritis of hip"	1	1333	2137	3470
"L29"	"M16"	"Pruritus"	"Osteoarthritis of hip"	1	83	204	287
"M85"	"M16"	"Other disorders of bone density and structure"	"Osteoarthritis of hip"	1	812	1552	2364
"M99"	"M16"	"Biomechanical lesions, not elsewhere classified"	"Osteoarthritis of hip"	1	652	885	1537
"B95"	"M17"	"Strep as the cause of diseases classified elsewhere"	"Osteoarthritis of knee"	1	16	181	197
"C10"	"M17"	"Malignant neoplasm of oropharynx"	"Osteoarthritis of knee"	1	12	122	134
"C14"	"M17"	"Malig neoplasm of sites in the lip, oral cavity and pharynx"	"Osteoarthritis of knee"	1	2	46	48
"C65"	"M17"	"Malignant neoplasm of renal pelvis"	"Osteoarthritis of knee"	1	14	87	101
"C71"	"M17"	"Malignant neoplasm of brain"	"Osteoarthritis of knee"	1	14	406	420
"C77"	"M17"	"Secondary and unspecified malignant neoplasm of lymph nodes"	"Osteoarthritis of knee"	1	99	1029	1128
"C92"	"M17"	"Myeloid leukemia"	"Osteoarthritis of knee"	1	16	255	271
"C94"	"M17"	"Other leukemias of specified cell type"	"Osteoarthritis of knee"	1	2	37	39
"D13"	"M17"	"Benign neoplasm of and ill-defined parts of digestive system"	"Osteoarthritis of knee"	1	197	375	572
"D38"	"M17"	"Neoplm of uncrt behav of mid ear & resp and intrathorac org"	"Osteoarthritis of knee"	1	32	100	132
"D59"	"M17"	"Acquired hemolytic anemia"	"Osteoarthritis of knee"	1	32	113	145
"E10"	"M17"	"Type 1 diabetes mellitus"	"Osteoarthritis of knee"	1	1563	2620	4183
"E34"	"M17"	"Other endocrine disorders"	"Osteoarthritis of knee"	1	65	287	352
"E87"	"M17"	"Other disorders of fluid, electrolyte and acid-base balance"	"Osteoarthritis of knee"	1	0	4546	4546
"F06"	"M17"	"Other mental disorders due to known physiological condition"	"Osteoarthritis of knee"	1	22	496	518
"G82"	"M17"	"Paraplegia (paraparesis) and quadriplegia (quadriparesis)"	"Osteoarthritis of knee"	1	66	255	321
"H43"	"M17"	"Disorders of vitreous body"	"Osteoarthritis of knee"	1	670	1031	1701
"H53"	"M17"	"Visual disturbances"	"Osteoarthritis of knee"	1	522	916	1438
"I38"	"M17"	"Endocarditis, valve unspecified"	"Osteoarthritis of knee"	1	8	161	169
"I73"	"M17"	"Other peripheral vascular diseases"	"Osteoarthritis of knee"	1	721	2395	3116
"I74"	"M17"	"Arterial embolism and thrombosis"	"Osteoarthritis of knee"	1	154	452	606
"J47"	"M17"	"Bronchiectasis"	"Osteoarthritis of knee"	1	59	391	450
"J90"	"M17"	"Pleural effusion, not elsewhere classified"	"Osteoarthritis of knee"	1	43	1042	1085
"K52"	"M17"	"Other and unsp noninfective gastroenteritis and colitis"	"Osteoarthritis of knee"	1	852	2487	3339
"K85"	"M17"	"Acute pancreatitis"	"Osteoarthritis of knee"	1	517	772	1289
"L97"	"M17"	"Non-pressure chronic ulcer of lower limb, NEC"	"Osteoarthritis of knee"	1	0	1783	1783
"M49"	"M17"	"Spondylopathies in diseases classified elsewhere"	"Osteoarthritis of knee"	1	12	62	74
"M85"	"M17"	"Other disorders of bone density and structure"	"Osteoarthritis of knee"	1	804	2664	3468
"N30"	"M17"	"Cystitis"	"Osteoarthritis of knee"	1	0	12867	12867
"G96"	"M18"	"Other disorders of central nervous system"	"Osteoarthritis of first carpometacarpal joint"	1	50	134	184
"L97"	"M18"	"Non-pressure chronic ulcer of lower limb, NEC"	"Osteoarthritis of first carpometacarpal joint"	1	24	97	121
"A49"	"M19"	"Bacterial infection of unspecified site"	"Other and unspecified osteoarthritis"	1	430	1476	1906
"C83"	"M19"	"Non-follicular lymphoma"	"Other and unspecified osteoarthritis"	1	76	189	265
"D63"	"M19"	"Anemia in chronic diseases classified elsewhere"	"Other and unspecified osteoarthritis"	1	146	613	759
"E64"	"M19"	"Sequelae of malnutrition and other nutritional deficiencies"	"Other and unspecified osteoarthritis"	1	93	243	336
"F02"	"M19"	"Dementia in other diseases classified elsewhere"	"Other and unspecified osteoarthritis"	1	24	91	115
"I61"	"M19"	"Nontraumatic intracerebral hemorrhage"	"Other and unspecified osteoarthritis"	1	198	611	809
"J90"	"M19"	"Pleural effusion, not elsewhere classified"	"Other and unspecified osteoarthritis"	1	132	524	656
"M96"	"M19"	"Intraop and postproc comp and disorders of ms sys, NEC"	"Other and unspecified osteoarthritis"	1	293	431	724
"C20"	"M20"	"Malignant neoplasm of rectum"	"Acquired deformities of fingers and toes"	1	37	177	214
"C67"	"M20"	"Malignant neoplasm of bladder"	"Acquired deformities of fingers and toes"	1	19	120	139
"D50"	"M20"	"Iron deficiency anemia"	"Acquired deformities of fingers and toes"	1	88	585	673
"D68"	"M20"	"Other coagulation defects"	"Acquired deformities of fingers and toes"	1	90	194	284
"D69"	"M20"	"Purpura and other hemorrhagic conditions"	"Acquired deformities of fingers and toes"	1	70	153	223
"E87"	"M20"	"Other disorders of fluid, electrolyte and acid-base balance"	"Acquired deformities of fingers and toes"	1	20	1157	1177
"H25"	"M20"	"Age-related cataract"	"Acquired deformities of fingers and toes"	1	0	5189	5189
"I80"	"M20"	"Phlebitis and thrombophlebitis"	"Acquired deformities of fingers and toes"	1	438	751	1189
"I82"	"M20"	"Other venous embolism and thrombosis"	"Acquired deformities of fingers and toes"	1	45	173	218
"J09"	"M20"	"Influenza due to certain identified influenza viruses"	"Acquired deformities of fingers and toes"	1	0	50	50
"J95"	"M20"	"Intraop and postproc comp and disorders of resp sys, NEC"	"Acquired deformities of fingers and toes"	1	0	59	59
"K74"	"M20"	"Fibrosis and cirrhosis of liver"	"Acquired deformities of fingers and toes"	1	36	122	158
"L82"	"M20"	"Seborrheic keratosis"	"Acquired deformities of fingers and toes"	1	54	166	220
"E78"	"M21"	"Disorders of lipoprotein metabolism and other lipidemias"	"Other acquired deformities of limbs"	1	510	930	1440
"B18"	"M22"	"Chronic viral hepatitis"	"Disorder of patella"	1	9	53	62
"C34"	"M22"	"Malignant neoplasm of bronchus and lung"	"Disorder of patella"	1	0	96	96
"C56"	"M22"	"Malignant neoplasm of ovary"	"Disorder of patella"	1	1	36	37
"D11"	"M22"	"Benign neoplasm of major salivary glands"	"Disorder of patella"	1	4	45	49
"D21"	"M22"	"Other benign neoplasms of connective and other soft tissue"	"Disorder of patella"	1	27	125	152
"D50"	"M22"	"Iron deficiency anemia"	"Disorder of patella"	1	0	213	213
"E23"	"M22"	"Hypofunction and other disorders of the pituitary gland"	"Disorder of patella"	1	6	71	77
"F10"	"M22"	"Alcohol related disorders"	"Disorder of patella"	1	660	1038	1698
"F32"	"M22"	"Depressive episode"	"Disorder of patella"	1	31	361	392
"H57"	"M22"	"Other disorders of eye and adnexa"	"Disorder of patella"	1	11	265	276
"H81"	"M22"	"Disorders of vestibular function"	"Disorder of patella"	1	40	319	359
"I50"	"M22"	"Heart failure"	"Disorder of patella"	1	0	217	217
"I69"	"M22"	"Sequelae of cerebrovascular disease"	"Disorder of patella"	1	0	197	197
"J96"	"M22"	"Respiratory failure, not elsewhere classified"	"Disorder of patella"	1	0	185	185
"J98"	"M22"	"Other respiratory disorders"	"Disorder of patella"	1	16	80	96
"K04"	"M22"	"Diseases of pulp and periapical tissues"	"Disorder of patella"	1	12	144	156
"K12"	"M22"	"Stomatitis and related lesions"	"Disorder of patella"	1	19	81	100
"K51"	"M22"	"Ulcerative colitis"	"Disorder of patella"	1	51	292	343
"K56"	"M22"	"Paralytic ileus and intestinal obstruction without hernia"	"Disorder of patella"	1	0	184	184
"K63"	"M22"	"Other diseases of intestine"	"Disorder of patella"	1	0	111	111
"K74"	"M22"	"Fibrosis and cirrhosis of liver"	"Disorder of patella"	1	0	33	33
"L02"	"M22"	"Cutaneous abscess, furuncle and carbuncle"	"Disorder of patella"	1	226	777	1003
"L30"	"M22"	"Other and unspecified dermatitis"	"Disorder of patella"	1	30	293	323
"L73"	"M22"	"Other follicular disorders"	"Disorder of patella"	1	24	155	179
"L98"	"M22"	"Oth disorders of skin, subcu, not elsewhere classified"	"Disorder of patella"	1	15	205	220
"M17"	"M22"	"Osteoarthritis of knee"	"Disorder of patella"	1	0	5875	5875
"N13"	"M22"	"Obstructive and reflux uropathy"	"Disorder of patella"	1	17	130	147
"N63"	"M22"	"Unspecified lump in breast"	"Disorder of patella"	1	18	458	476
"N85"	"M22"	"Other noninflammatory disorders of uterus, except cervix"	"Disorder of patella"	1	7	64	71
"N87"	"M22"	"Dysplasia of cervix uteri"	"Disorder of patella"	1	91	712	803
"O60"	"M22"	"Preterm labor"	"Disorder of patella"	1	37	156	193
"A40"	"M23"	"Streptococcal sepsis"	"Internal derangement of knee"	1	36	167	203
"C14"	"M23"	"Malig neoplasm of sites in the lip, oral cavity and pharynx"	"Internal derangement of knee"	1	0	37	37
"C22"	"M23"	"Malignant neoplasm of liver and intrahepatic bile ducts"	"Internal derangement of knee"	1	0	141	141
"C45"	"M23"	"Mesothelioma"	"Internal derangement of knee"	1	0	53	53
"C78"	"M23"	"Secondary malignant neoplasm of resp and digestive organs"	"Internal derangement of knee"	1	0	1310	1310
"C84"	"M23"	"Mature T/NK-cell lymphomas"	"Internal derangement of knee"	1	6	46	52
"D30"	"M23"	"Benign neoplasm of urinary organs"	"Internal derangement of knee"	1	145	356	501
"D59"	"M23"	"Acquired hemolytic anemia"	"Internal derangement of knee"	1	17	74	91
"D70"	"M23"	"Neutropenia"	"Internal derangement of knee"	1	18	85	103
"E28"	"M23"	"Ovarian dysfunction"	"Internal derangement of knee"	1	202	456	658
"E66"	"M23"	"Overweight and obesity"	"Internal derangement of knee"	1	0	12177	12177
"E68"	"M23"	"Sequelae of hyperalimentation"	"Internal derangement of knee"	1	105	557	662
"E86"	"M23"	"Volume depletion"	"Internal derangement of knee"	1	0	2112	2112
"E88"	"M23"	"Other and unspecified metabolic disorders"	"Internal derangement of knee"	1	103	237	340
"F20"	"M23"	"Schizophrenia"	"Internal derangement of knee"	1	93	216	309
"F51"	"M23"	"Sleep disorders not due to a substance or known physiol cond"	"Internal derangement of knee"	1	32	99	131
"G24"	"M23"	"Dystonia"	"Internal derangement of knee"	1	66	196	262
"G51"	"M23"	"Facial nerve disorders"	"Internal derangement of knee"	1	276	465	741
"H17"	"M23"	"Corneal scars and opacities"	"Internal derangement of knee"	1	34	97	131
"H35"	"M23"	"Other retinal disorders"	"Internal derangement of knee"	1	548	2235	2783
"H49"	"M23"	"Paralytic strabismus"	"Internal derangement of knee"	1	73	168	241
"I51"	"M23"	"Complications and ill-defined descriptions of heart disease"	"Internal derangement of knee"	1	72	554	626
"I81"	"M23"	"Portal vein thrombosis"	"Internal derangement of knee"	1	7	57	64
"K28"	"M23"	"Gastrojejunal ulcer"	"Internal derangement of knee"	1	21	101	122
"K31"	"M23"	"Other diseases of stomach and duodenum"	"Internal derangement of knee"	1	51	251	302
"L29"	"M23"	"Pruritus"	"Internal derangement of knee"	1	138	290	428
"L40"	"M23"	"Psoriasis"	"Internal derangement of knee"	1	520	779	1299
"L89"	"M23"	"Pressure ulcer"	"Internal derangement of knee"	1	0	295	295
"M05"	"M23"	"Rheumatoid arthritis with rheumatoid factor"	"Internal derangement of knee"	1	395	891	1286
"M35"	"M23"	"Other systemic involvement of connective tissue"	"Internal derangement of knee"	1	940	1366	2306
"M80"	"M23"	"Osteoporosis with current pathological fracture"	"Internal derangement of knee"	1	34	1036	1070
"N20"	"M23"	"Calculus of kidney and ureter"	"Internal derangement of knee"	1	1427	1912	3339
"C18"	"M24"	"Malignant neoplasm of colon"	"Other specific joint derangements"	1	19	81	100
"E11"	"M24"	"Type 2 diabetes mellitus"	"Other specific joint derangements"	1	202	488	690
"E87"	"M24"	"Other disorders of fluid, electrolyte and acid-base balance"	"Other specific joint derangements"	1	79	327	406
"F05"	"M24"	"Delirium due to known physiological condition"	"Other specific joint derangements"	1	7	84	91
"I10"	"M24"	"Essential (primary) hypertension"	"Other specific joint derangements"	1	652	1579	2231
"K64"	"M24"	"Hemorrhoids and perianal venous thrombosis"	"Other specific joint derangements"	1	0	384	384
"K70"	"M24"	"Alcoholic liver disease"	"Other specific joint derangements"	1	36	106	142
"C22"	"M25"	"Malignant neoplasm of liver and intrahepatic bile ducts"	"Other joint disorder, not elsewhere classified"	1	0	62	62
"G95"	"M25"	"Other and unspecified diseases of spinal cord"	"Other joint disorder, not elsewhere classified"	1	43	176	219
"K92"	"M25"	"Other diseases of digestive system"	"Other joint disorder, not elsewhere classified"	1	376	549	925
"B37"	"M31"	"Candidiasis"	"Other necrotizing vasculopathies"	1	114	230	344
"D47"	"M31"	"Oth neoplm of uncrt behav of lymphoid, hematpoetc & rel tiss"	"Other necrotizing vasculopathies"	1	59	143	202
"F41"	"M31"	"Other anxiety disorders"	"Other necrotizing vasculopathies"	1	32	105	137
"I95"	"M31"	"Hypotension"	"Other necrotizing vasculopathies"	1	53	256	309
"J10"	"M31"	"Influenza due to other identified influenza virus"	"Other necrotizing vasculopathies"	1	3	52	55
"J18"	"M31"	"Pneumonia, unspecified organism"	"Other necrotizing vasculopathies"	1	1115	2185	3300
"K65"	"M31"	"Peritonitis"	"Other necrotizing vasculopathies"	1	62	164	226
"M85"	"M31"	"Other disorders of bone density and structure"	"Other necrotizing vasculopathies"	1	380	1053	1433
"C44"	"M32"	"Other and unspecified malignant neoplasm of skin"	"Systemic lupus erythematosus (SLE)"	1	0	42	42
"I69"	"M32"	"Sequelae of cerebrovascular disease"	"Systemic lupus erythematosus (SLE)"	1	24	123	147
"J84"	"M32"	"Other interstitial pulmonary diseases"	"Systemic lupus erythematosus (SLE)"	1	34	110	144
"K05"	"M32"	"Gingivitis and periodontal diseases"	"Systemic lupus erythematosus (SLE)"	1	10	49	59
"L98"	"M32"	"Oth disorders of skin, subcu, not elsewhere classified"	"Systemic lupus erythematosus (SLE)"	1	41	122	163
"N18"	"M32"	"Chronic kidney disease (CKD)"	"Systemic lupus erythematosus (SLE)"	1	50	199	249
"A49"	"M33"	"Bacterial infection of unspecified site"	"Dermatopolymyositis"	1	9	58	67
"M80"	"M33"	"Osteoporosis with current pathological fracture"	"Dermatopolymyositis"	1	11	56	67
"J18"	"M34"	"Pneumonia, unspecified organism"	"Systemic sclerosis [scleroderma]"	1	115	316	431
"J84"	"M34"	"Other interstitial pulmonary diseases"	"Systemic sclerosis [scleroderma]"	1	88	185	273
"D47"	"M35"	"Oth neoplm of uncrt behav of lymphoid, hematpoetc & rel tiss"	"Other systemic involvement of connective tissue"	1	164	351	515
"N18"	"M35"	"Chronic kidney disease (CKD)"	"Other systemic involvement of connective tissue"	1	354	1246	1600
"A63"	"M41"	"Oth predominantly sexually transmitted diseases, NEC"	"Scoliosis"	1	11	99	110
"O42"	"M41"	"Premature rupture of membranes"	"Scoliosis"	1	0	77	77
"O99"	"M41"	"Oth maternal diseases classd elsw but compl preg/chldbrth"	"Scoliosis"	1	0	352	352
"M16"	"M42"	"Osteoarthritis of hip"	"Spinal osteochondrosis"	1	72	174	246
"C64"	"M43"	"Malignant neoplasm of kidney, except renal pelvis"	"Other deforming dorsopathies"	1	12	57	69
"N17"	"M45"	"Acute kidney failure"	"Ankylosing spondylitis"	1	3	46	49
"C34"	"M46"	"Malignant neoplasm of bronchus and lung"	"Other inflammatory spondylopathies"	1	33	102	135
"C18"	"M47"	"Malignant neoplasm of colon"	"Spondylosis"	1	217	578	795
"C22"	"M47"	"Malignant neoplasm of liver and intrahepatic bile ducts"	"Spondylosis"	1	0	146	146
"C67"	"M47"	"Malignant neoplasm of bladder"	"Spondylosis"	1	88	221	309
"C85"	"M47"	"Oth and unspecified types of non-Hodgkin lymphoma"	"Spondylosis"	1	50	118	168
"C90"	"M47"	"Multiple myeloma and malignant plasma cell neoplasms"	"Spondylosis"	1	50	155	205
"G96"	"M47"	"Other disorders of central nervous system"	"Spondylosis"	1	256	712	968
"I21"	"M47"	"Acute myocardial infarction"	"Spondylosis"	1	1198	1900	3098
"I49"	"M47"	"Other cardiac arrhythmias"	"Spondylosis"	1	571	883	1454
"I82"	"M47"	"Other venous embolism and thrombosis"	"Spondylosis"	1	79	206	285
"K70"	"M47"	"Alcoholic liver disease"	"Spondylosis"	1	151	305	456
"N19"	"M47"	"Unspecified kidney failure"	"Spondylosis"	1	72	579	651
"C25"	"M48"	"Malignant neoplasm of pancreas"	"Other spondylopathies"	1	17	400	417
"F41"	"M48"	"Other anxiety disorders"	"Other spondylopathies"	1	266	687	953
"C18"	"M50"	"Malignant neoplasm of colon"	"Cervical disc disorders"	1	14	248	262
"E11"	"M50"	"Type 2 diabetes mellitus"	"Cervical disc disorders"	1	601	1378	1979
"G24"	"M50"	"Dystonia"	"Cervical disc disorders"	1	60	147	207
"I21"	"M50"	"Acute myocardial infarction"	"Cervical disc disorders"	1	360	1047	1407
"I48"	"M50"	"Atrial fibrillation and flutter"	"Cervical disc disorders"	1	227	1575	1802
"J44"	"M50"	"Other chronic obstructive pulmonary disease"	"Cervical disc disorders"	1	327	1644	1971
"J98"	"M50"	"Other respiratory disorders"	"Cervical disc disorders"	1	66	199	265
"K43"	"M50"	"Ventral hernia"	"Cervical disc disorders"	1	169	331	500
"K65"	"M50"	"Peritonitis"	"Cervical disc disorders"	1	47	124	171
"K70"	"M50"	"Alcoholic liver disease"	"Cervical disc disorders"	1	32	229	261
"K92"	"M50"	"Other diseases of digestive system"	"Cervical disc disorders"	1	143	468	611
"B44"	"M51"	"Aspergillosis"	"Thoracic, thoracolum, and lumbosacral intvrt disc disorders"	1	0	43	43
"B99"	"M51"	"Other and unspecified infectious diseases"	"Thoracic, thoracolum, and lumbosacral intvrt disc disorders"	1	20	71	91
"C17"	"M51"	"Malignant neoplasm of small intestine"	"Thoracic, thoracolum, and lumbosacral intvrt disc disorders"	1	0	52	52
"C22"	"M51"	"Malignant neoplasm of liver and intrahepatic bile ducts"	"Thoracic, thoracolum, and lumbosacral intvrt disc disorders"	1	0	209	209
"C49"	"M51"	"Malignant neoplasm of other connective and soft tissue"	"Thoracic, thoracolum, and lumbosacral intvrt disc disorders"	1	26	150	176
"C56"	"M51"	"Malignant neoplasm of ovary"	"Thoracic, thoracolum, and lumbosacral intvrt disc disorders"	1	67	234	301
"C77"	"M51"	"Secondary and unspecified malignant neoplasm of lymph nodes"	"Thoracic, thoracolum, and lumbosacral intvrt disc disorders"	1	30	822	852
"C83"	"M51"	"Non-follicular lymphoma"	"Thoracic, thoracolum, and lumbosacral intvrt disc disorders"	1	30	311	341
"C91"	"M51"	"Lymphoid leukemia"	"Thoracic, thoracolum, and lumbosacral intvrt disc disorders"	1	29	199	228
"D12"	"M51"	"Benign neoplasm of colon, rectum, anus and anal canal"	"Thoracic, thoracolum, and lumbosacral intvrt disc disorders"	1	0	4870	4870
"D68"	"M51"	"Other coagulation defects"	"Thoracic, thoracolum, and lumbosacral intvrt disc disorders"	1	182	437	619
"D75"	"M51"	"Other and unsp diseases of blood and blood-forming organs"	"Thoracic, thoracolum, and lumbosacral intvrt disc disorders"	1	73	226	299
"E34"	"M51"	"Other endocrine disorders"	"Thoracic, thoracolum, and lumbosacral intvrt disc disorders"	1	46	225	271
"G45"	"M51"	"Transient cerebral ischemic attacks and related syndromes"	"Thoracic, thoracolum, and lumbosacral intvrt disc disorders"	1	736	2307	3043
"G93"	"M51"	"Other disorders of brain"	"Thoracic, thoracolum, and lumbosacral intvrt disc disorders"	1	90	304	394
"H40"	"M51"	"Glaucoma"	"Thoracic, thoracolum, and lumbosacral intvrt disc disorders"	1	406	834	1240
"I06"	"M51"	"Rheumatic aortic valve diseases"	"Thoracic, thoracolum, and lumbosacral intvrt disc disorders"	1	8	52	60
"I10"	"M51"	"Essential (primary) hypertension"	"Thoracic, thoracolum, and lumbosacral intvrt disc disorders"	1	0	20199	20199
"I26"	"M51"	"Pulmonary embolism"	"Thoracic, thoracolum, and lumbosacral intvrt disc disorders"	1	191	1444	1635
"I27"	"M51"	"Other pulmonary heart diseases"	"Thoracic, thoracolum, and lumbosacral intvrt disc disorders"	1	46	415	461
"I38"	"M51"	"Endocarditis, valve unspecified"	"Thoracic, thoracolum, and lumbosacral intvrt disc disorders"	1	4	109	113
"I44"	"M51"	"Atrioventricular and left bundle-branch block"	"Thoracic, thoracolum, and lumbosacral intvrt disc disorders"	1	86	836	922
"I51"	"M51"	"Complications and ill-defined descriptions of heart disease"	"Thoracic, thoracolum, and lumbosacral intvrt disc disorders"	1	67	678	745
"I65"	"M51"	"Occls and stenosis of precerb art, not rslt in cereb infrc"	"Thoracic, thoracolum, and lumbosacral intvrt disc disorders"	1	159	468	627
"J81"	"M51"	"Pulmonary edema"	"Thoracic, thoracolum, and lumbosacral intvrt disc disorders"	1	0	462	462
"J85"	"M51"	"Abscess of lung and mediastinum"	"Thoracic, thoracolum, and lumbosacral intvrt disc disorders"	1	17	100	117
"J86"	"M51"	"Pyothorax"	"Thoracic, thoracolum, and lumbosacral intvrt disc disorders"	1	46	201	247
"K12"	"M51"	"Stomatitis and related lesions"	"Thoracic, thoracolum, and lumbosacral intvrt disc disorders"	1	121	267	388
"K44"	"M51"	"Diaphragmatic hernia"	"Thoracic, thoracolum, and lumbosacral intvrt disc disorders"	1	1465	2120	3585
"K63"	"M51"	"Other diseases of intestine"	"Thoracic, thoracolum, and lumbosacral intvrt disc disorders"	1	71	669	740
"K70"	"M51"	"Alcoholic liver disease"	"Thoracic, thoracolum, and lumbosacral intvrt disc disorders"	1	121	765	886
"M87"	"M51"	"Osteonecrosis"	"Thoracic, thoracolum, and lumbosacral intvrt disc disorders"	1	57	213	270
"C34"	"M53"	"Malignant neoplasm of bronchus and lung"	"Other and unspecified dorsopathies, not elsewhere classified"	1	25	339	364
"M19"	"M53"	"Other and unspecified osteoarthritis"	"Other and unspecified dorsopathies, not elsewhere classified"	1	556	841	1397
"C09"	"M54"	"Malignant neoplasm of tonsil"	"Dorsalgia"	1	12	91	103
"C34"	"M54"	"Malignant neoplasm of bronchus and lung"	"Dorsalgia"	1	0	4304	4304
"C43"	"M54"	"Malignant melanoma of skin"	"Dorsalgia"	1	414	602	1016
"C64"	"M54"	"Malignant neoplasm of kidney, except renal pelvis"	"Dorsalgia"	1	210	520	730
"D62"	"M54"	"Acute posthemorrhagic anemia"	"Dorsalgia"	1	400	1175	1575
"E03"	"M54"	"Other hypothyroidism"	"Dorsalgia"	1	1590	2949	4539
"E11"	"M54"	"Type 2 diabetes mellitus"	"Dorsalgia"	1	4241	6211	10452
"E16"	"M54"	"Other disorders of pancreatic internal secretion"	"Dorsalgia"	1	482	802	1284
"E34"	"M54"	"Other endocrine disorders"	"Dorsalgia"	1	154	349	503
"G96"	"M54"	"Other disorders of central nervous system"	"Dorsalgia"	1	0	3261	3261
"I34"	"M54"	"Nonrheumatic mitral valve disorders"	"Dorsalgia"	1	465	940	1405
"I42"	"M54"	"Cardiomyopathy"	"Dorsalgia"	1	322	870	1192
"I89"	"M54"	"Oth noninfective disorders of lymphatic vessels and nodes"	"Dorsalgia"	1	180	553	733
"I95"	"M54"	"Hypotension"	"Dorsalgia"	1	658	1992	2650
"J18"	"M54"	"Pneumonia, unspecified organism"	"Dorsalgia"	1	0	23479	23479
"J84"	"M54"	"Other interstitial pulmonary diseases"	"Dorsalgia"	1	249	758	1007
"J98"	"M54"	"Other respiratory disorders"	"Dorsalgia"	1	494	986	1480
"M14"	"M54"	"Arthropathies in other diseases classified elsewhere"	"Dorsalgia"	1	36	124	160
"M25"	"M54"	"Other joint disorder, not elsewhere classified"	"Dorsalgia"	1	3564	4692	8256
"N84"	"M54"	"Polyp of female genital tract"	"Dorsalgia"	1	947	1322	2269
"Q40"	"M54"	"Other congenital malformations of upper alimentary tract"	"Dorsalgia"	1	151	300	451
"C64"	"M62"	"Malignant neoplasm of kidney, except renal pelvis"	"Other disorders of muscle"	1	12	256	268
"C82"	"M62"	"Follicular lymphoma"	"Other disorders of muscle"	1	12	66	78
"C90"	"M62"	"Multiple myeloma and malignant plasma cell neoplasms"	"Other disorders of muscle"	1	19	199	218
"F41"	"M62"	"Other anxiety disorders"	"Other disorders of muscle"	1	396	1827	2223
"I83"	"M62"	"Varicose veins of lower extremities"	"Other disorders of muscle"	1	1027	1740	2767
"J06"	"M62"	"Acute upper resp infections of multiple and unsp sites"	"Other disorders of muscle"	1	42	907	949
"K27"	"M62"	"Peptic ulcer, site unspecified"	"Other disorders of muscle"	1	211	616	827
"K85"	"M62"	"Acute pancreatitis"	"Other disorders of muscle"	1	253	740	993
"K92"	"M62"	"Other diseases of digestive system"	"Other disorders of muscle"	1	419	2052	2471
"N39"	"M62"	"Other disorders of urinary system"	"Other disorders of muscle"	1	0	6630	6630
"B02"	"M65"	"Zoster [herpes zoster]"	"Synovitis and tenosynovitis"	1	54	179	233
"C43"	"M65"	"Malignant melanoma of skin"	"Synovitis and tenosynovitis"	1	138	248	386
"D09"	"M65"	"Carcinoma in situ of other and unspecified sites"	"Synovitis and tenosynovitis"	1	0	111	111
"E41"	"M65"	"Nutritional marasmus"	"Synovitis and tenosynovitis"	1	0	40	40
"E66"	"M65"	"Overweight and obesity"	"Synovitis and tenosynovitis"	1	1640	2904	4544
"E83"	"M65"	"Disorders of mineral metabolism"	"Synovitis and tenosynovitis"	1	12	272	284
"F17"	"M65"	"Nicotine dependence"	"Synovitis and tenosynovitis"	1	180	862	1042
"F60"	"M65"	"Specific personality disorders"	"Synovitis and tenosynovitis"	1	23	100	123
"H36"	"M65"	"Retinal disorders in diseases classified elsewhere"	"Synovitis and tenosynovitis"	1	356	525	881
"I25"	"M65"	"Chronic ischemic heart disease"	"Synovitis and tenosynovitis"	1	1166	2116	3282
"I61"	"M65"	"Nontraumatic intracerebral hemorrhage"	"Synovitis and tenosynovitis"	1	24	306	330
"I72"	"M65"	"Other aneurysm"	"Synovitis and tenosynovitis"	1	34	116	150
"J09"	"M65"	"Influenza due to certain identified influenza viruses"	"Synovitis and tenosynovitis"	1	0	92	92
"K04"	"M65"	"Diseases of pulp and periapical tissues"	"Synovitis and tenosynovitis"	1	192	331	523
"M06"	"M65"	"Other rheumatoid arthritis"	"Synovitis and tenosynovitis"	1	695	998	1693
"N17"	"M65"	"Acute kidney failure"	"Synovitis and tenosynovitis"	1	0	368	368
"N30"	"M65"	"Cystitis"	"Synovitis and tenosynovitis"	1	1071	2428	3499
"A41"	"M67"	"Other sepsis"	"Other disorders of synovium and tendon"	1	44	754	798
"D62"	"M67"	"Acute posthemorrhagic anemia"	"Other disorders of synovium and tendon"	1	32	126	158
"E68"	"M67"	"Sequelae of hyperalimentation"	"Other disorders of synovium and tendon"	1	65	200	265
"E87"	"M67"	"Other disorders of fluid, electrolyte and acid-base balance"	"Other disorders of synovium and tendon"	1	30	609	639
"F06"	"M67"	"Other mental disorders due to known physiological condition"	"Other disorders of synovium and tendon"	1	6	77	83
"G20"	"M67"	"Parkinson's disease"	"Other disorders of synovium and tendon"	1	8	89	97
"G93"	"M67"	"Other disorders of brain"	"Other disorders of synovium and tendon"	1	44	117	161
"G95"	"M67"	"Other and unspecified diseases of spinal cord"	"Other disorders of synovium and tendon"	1	11	114	125
"G96"	"M67"	"Other disorders of central nervous system"	"Other disorders of synovium and tendon"	1	61	415	476
"I44"	"M67"	"Atrioventricular and left bundle-branch block"	"Other disorders of synovium and tendon"	1	50	203	253
"J15"	"M67"	"Bacterial pneumonia, not elsewhere classified"	"Other disorders of synovium and tendon"	1	87	808	895
"J47"	"M67"	"Bronchiectasis"	"Other disorders of synovium and tendon"	1	9	126	135
"L89"	"M67"	"Pressure ulcer"	"Other disorders of synovium and tendon"	1	8	95	103
"M85"	"M67"	"Other disorders of bone density and structure"	"Other disorders of synovium and tendon"	1	175	857	1032
"O92"	"M67"	"Oth disord of brst/lactatn assoc w pregnancy and the puerp"	"Other disorders of synovium and tendon"	1	77	235	312
"C09"	"M70"	"Malignant neoplasm of tonsil"	"Soft tissue disorders related to use, overuse and pressure"	1	1	32	33
"C64"	"M70"	"Malignant neoplasm of kidney, except renal pelvis"	"Soft tissue disorders related to use, overuse and pressure"	1	38	133	171
"C67"	"M70"	"Malignant neoplasm of bladder"	"Soft tissue disorders related to use, overuse and pressure"	1	53	128	181
"C77"	"M70"	"Secondary and unspecified malignant neoplasm of lymph nodes"	"Soft tissue disorders related to use, overuse and pressure"	1	50	332	382
"D09"	"M70"	"Carcinoma in situ of other and unspecified sites"	"Soft tissue disorders related to use, overuse and pressure"	1	9	70	79
"D50"	"M70"	"Iron deficiency anemia"	"Soft tissue disorders related to use, overuse and pressure"	1	184	573	757
"E64"	"M70"	"Sequelae of malnutrition and other nutritional deficiencies"	"Soft tissue disorders related to use, overuse and pressure"	1	20	106	126
"K92"	"M70"	"Other diseases of digestive system"	"Soft tissue disorders related to use, overuse and pressure"	1	309	751	1060
"C25"	"M71"	"Malignant neoplasm of pancreas"	"Other bursopathies"	1	0	78	78
"C34"	"M71"	"Malignant neoplasm of bronchus and lung"	"Other bursopathies"	1	0	257	257
"D64"	"M71"	"Other anemias"	"Other bursopathies"	1	109	631	740
"I25"	"M71"	"Chronic ischemic heart disease"	"Other bursopathies"	1	360	654	1014
"I49"	"M71"	"Other cardiac arrhythmias"	"Other bursopathies"	1	90	241	331
"J44"	"M71"	"Other chronic obstructive pulmonary disease"	"Other bursopathies"	1	234	629	863
"K22"	"M71"	"Other diseases of esophagus"	"Other bursopathies"	1	38	111	149
"K59"	"M71"	"Other functional intestinal disorders"	"Other bursopathies"	1	165	709	874
"K63"	"M71"	"Other diseases of intestine"	"Other bursopathies"	1	8	75	83
"K70"	"M71"	"Alcoholic liver disease"	"Other bursopathies"	1	27	81	108
"C25"	"M72"	"Malignant neoplasm of pancreas"	"Fibroblastic disorders"	1	0	178	178
"C77"	"M72"	"Secondary and unspecified malignant neoplasm of lymph nodes"	"Fibroblastic disorders"	1	23	355	378
"C83"	"M72"	"Non-follicular lymphoma"	"Fibroblastic disorders"	1	18	121	139
"D09"	"M72"	"Carcinoma in situ of other and unspecified sites"	"Fibroblastic disorders"	1	3	102	105
"D47"	"M72"	"Oth neoplm of uncrt behav of lymphoid, hematpoetc & rel tiss"	"Fibroblastic disorders"	1	13	157	170
"E21"	"M72"	"Hyperparathyroidism and other disorders of parathyroid gland"	"Fibroblastic disorders"	1	25	96	121
"E86"	"M72"	"Volume depletion"	"Fibroblastic disorders"	1	0	1231	1231
"F02"	"M72"	"Dementia in other diseases classified elsewhere"	"Fibroblastic disorders"	1	0	40	40
"F33"	"M72"	"Major depressive disorder, recurrent"	"Fibroblastic disorders"	1	43	277	320
"G62"	"M72"	"Other and unspecified polyneuropathies"	"Fibroblastic disorders"	1	201	536	737
"H25"	"M72"	"Age-related cataract"	"Fibroblastic disorders"	1	871	3104	3975
"H40"	"M72"	"Glaucoma"	"Fibroblastic disorders"	1	155	277	432
"I44"	"M72"	"Atrioventricular and left bundle-branch block"	"Fibroblastic disorders"	1	50	401	451
"K62"	"M72"	"Other diseases of anus and rectum"	"Fibroblastic disorders"	1	421	732	1153
"L82"	"M72"	"Seborrheic keratosis"	"Fibroblastic disorders"	1	49	121	170
"M80"	"M72"	"Osteoporosis with current pathological fracture"	"Fibroblastic disorders"	1	17	418	435
"C56"	"M75"	"Malignant neoplasm of ovary"	"Shoulder lesions"	1	91	193	284
"C64"	"M75"	"Malignant neoplasm of kidney, except renal pelvis"	"Shoulder lesions"	1	93	392	485
"C78"	"M75"	"Secondary malignant neoplasm of resp and digestive organs"	"Shoulder lesions"	1	0	1867	1867
"F06"	"M75"	"Other mental disorders due to known physiological condition"	"Shoulder lesions"	1	40	315	355
"G95"	"M75"	"Other and unspecified diseases of spinal cord"	"Shoulder lesions"	1	111	491	602
"H18"	"M75"	"Other disorders of cornea"	"Shoulder lesions"	1	242	374	616
"H90"	"M75"	"Conductive and sensorineural hearing loss"	"Shoulder lesions"	1	1345	1634	2979
"I81"	"M75"	"Portal vein thrombosis"	"Shoulder lesions"	1	8	54	62
"I85"	"M75"	"Esophageal varices"	"Shoulder lesions"	1	54	212	266
"J15"	"M75"	"Bacterial pneumonia, not elsewhere classified"	"Shoulder lesions"	1	0	3423	3423
"J22"	"M75"	"Unspecified acute lower respiratory infection"	"Shoulder lesions"	1	78	422	500
"J47"	"M75"	"Bronchiectasis"	"Shoulder lesions"	1	87	460	547
"J84"	"M75"	"Other interstitial pulmonary diseases"	"Shoulder lesions"	1	120	524	644
"J85"	"M75"	"Abscess of lung and mediastinum"	"Shoulder lesions"	1	29	84	113
"K74"	"M75"	"Fibrosis and cirrhosis of liver"	"Shoulder lesions"	1	90	331	421
"L89"	"M75"	"Pressure ulcer"	"Shoulder lesions"	1	58	471	529
"M80"	"M75"	"Osteoporosis with current pathological fracture"	"Shoulder lesions"	1	254	1458	1712
"M81"	"M75"	"Osteoporosis without current pathological fracture"	"Shoulder lesions"	1	1462	3792	5254
"M99"	"M75"	"Biomechanical lesions, not elsewhere classified"	"Shoulder lesions"	1	705	1153	1858
"N30"	"M75"	"Cystitis"	"Shoulder lesions"	1	2682	4296	6978
"N39"	"M75"	"Other disorders of urinary system"	"Shoulder lesions"	1	2372	4511	6883
"C15"	"M76"	"Malignant neoplasm of esophagus"	"Enthesopathies, lower limb, excluding foot"	1	0	40	40
"E78"	"M76"	"Disorders of lipoprotein metabolism and other lipidemias"	"Enthesopathies, lower limb, excluding foot"	1	523	1070	1593
"F03"	"M76"	"Unspecified dementia"	"Enthesopathies, lower limb, excluding foot"	1	5	170	175
"G96"	"M76"	"Other disorders of central nervous system"	"Enthesopathies, lower limb, excluding foot"	1	39	280	319
"I50"	"M76"	"Heart failure"	"Enthesopathies, lower limb, excluding foot"	1	139	582	721
"J18"	"M76"	"Pneumonia, unspecified organism"	"Enthesopathies, lower limb, excluding foot"	1	572	1163	1735
"J81"	"M76"	"Pulmonary edema"	"Enthesopathies, lower limb, excluding foot"	1	1	63	64
"K59"	"M76"	"Other functional intestinal disorders"	"Enthesopathies, lower limb, excluding foot"	1	566	1145	1711
"K62"	"M76"	"Other diseases of anus and rectum"	"Enthesopathies, lower limb, excluding foot"	1	337	508	845
"C18"	"M77"	"Malignant neoplasm of colon"	"Other enthesopathies"	1	25	199	224
"C25"	"M77"	"Malignant neoplasm of pancreas"	"Other enthesopathies"	1	0	97	97
"C71"	"M77"	"Malignant neoplasm of brain"	"Other enthesopathies"	1	0	52	52
"D32"	"M77"	"Benign neoplasm of meninges"	"Other enthesopathies"	1	13	65	78
"D35"	"M77"	"Benign neoplasm of other and unspecified endocrine glands"	"Other enthesopathies"	1	21	92	113
"E83"	"M77"	"Disorders of mineral metabolism"	"Other enthesopathies"	1	16	126	142
"J84"	"M77"	"Other interstitial pulmonary diseases"	"Other enthesopathies"	1	13	112	125
"K31"	"M77"	"Other diseases of stomach and duodenum"	"Other enthesopathies"	1	18	74	92
"K62"	"M77"	"Other diseases of anus and rectum"	"Other enthesopathies"	1	383	680	1063
"K91"	"M77"	"Intraop and postproc comp and disorders of dgstv sys, NEC"	"Other enthesopathies"	1	25	85	110
"M17"	"M77"	"Osteoarthritis of knee"	"Other enthesopathies"	1	1349	2147	3496
"N30"	"M77"	"Cystitis"	"Other enthesopathies"	1	683	1211	1894
"C18"	"M79"	"Malignant neoplasm of colon"	"Oth and unsp soft tissue disorders, not elsewhere classified"	1	502	1001	1503
"C22"	"M79"	"Malignant neoplasm of liver and intrahepatic bile ducts"	"Oth and unsp soft tissue disorders, not elsewhere classified"	1	7	292	299
"C48"	"M79"	"Malignant neoplasm of retroperitoneum and peritoneum"	"Oth and unsp soft tissue disorders, not elsewhere classified"	1	9	49	58
"C78"	"M79"	"Secondary malignant neoplasm of resp and digestive organs"	"Oth and unsp soft tissue disorders, not elsewhere classified"	1	0	2129	2129
"I27"	"M79"	"Other pulmonary heart diseases"	"Oth and unsp soft tissue disorders, not elsewhere classified"	1	182	478	660
"I34"	"M79"	"Nonrheumatic mitral valve disorders"	"Oth and unsp soft tissue disorders, not elsewhere classified"	1	452	724	1176
"I35"	"M79"	"Nonrheumatic aortic valve disorders"	"Oth and unsp soft tissue disorders, not elsewhere classified"	1	858	2550	3408
"I85"	"M79"	"Esophageal varices"	"Oth and unsp soft tissue disorders, not elsewhere classified"	1	106	256	362
"J18"	"M79"	"Pneumonia, unspecified organism"	"Oth and unsp soft tissue disorders, not elsewhere classified"	1	6311	10770	17081
"K65"	"M79"	"Peritonitis"	"Oth and unsp soft tissue disorders, not elsewhere classified"	1	352	555	907
"K91"	"M79"	"Intraop and postproc comp and disorders of dgstv sys, NEC"	"Oth and unsp soft tissue disorders, not elsewhere classified"	1	179	338	517
"M13"	"M79"	"Other arthritis"	"Oth and unsp soft tissue disorders, not elsewhere classified"	1	1868	2533	4401
"J96"	"M80"	"Respiratory failure, not elsewhere classified"	"Osteoporosis with current pathological fracture"	1	1893	3408	5301
"A49"	"M81"	"Bacterial infection of unspecified site"	"Osteoporosis without current pathological fracture"	1	1196	2537	3733
"C24"	"M81"	"Malignant neoplasm of other and unsp parts of biliary tract"	"Osteoporosis without current pathological fracture"	1	29	113	142
"C78"	"M81"	"Secondary malignant neoplasm of resp and digestive organs"	"Osteoporosis without current pathological fracture"	1	380	1977	2357
"I35"	"M81"	"Nonrheumatic aortic valve disorders"	"Osteoporosis without current pathological fracture"	1	1983	2637	4620
"A41"	"M83"	"Other sepsis"	"Adult osteomalacia"	1	52	190	242
"E86"	"M83"	"Volume depletion"	"Adult osteomalacia"	1	122	279	401
"J18"	"M84"	"Pneumonia, unspecified organism"	"Disorder of continuity of bone"	1	390	583	973
"J96"	"M84"	"Respiratory failure, not elsewhere classified"	"Disorder of continuity of bone"	1	75	288	363
"A49"	"M85"	"Bacterial infection of unspecified site"	"Other disorders of bone density and structure"	1	338	795	1133
"G96"	"M85"	"Other disorders of central nervous system"	"Other disorders of bone density and structure"	1	179	302	481
"M80"	"M85"	"Osteoporosis with current pathological fracture"	"Other disorders of bone density and structure"	1	736	1502	2238
"E66"	"M89"	"Overweight and obesity"	"Other disorders of bone"	1	180	493	673
"O82"	"M92"	"Encounter for cesarean delivery without indication"	"Other juvenile osteochondrosis"	1	1	58	59
"I50"	"M93"	"Heart failure"	"Other osteochondropathies"	1	0	57	57
"K52"	"M93"	"Other and unsp noninfective gastroenteritis and colitis"	"Other osteochondropathies"	1	9	48	57
"K92"	"M93"	"Other diseases of digestive system"	"Other osteochondropathies"	1	5	48	53
"M54"	"M93"	"Dorsalgia"	"Other osteochondropathies"	1	142	358	500
"D64"	"M95"	"Other anemias"	"Oth acquired deformities of ms sys and connective tissue"	1	35	157	192
"E66"	"M95"	"Overweight and obesity"	"Oth acquired deformities of ms sys and connective tissue"	1	131	318	449
"O99"	"M95"	"Oth maternal diseases classd elsw but compl preg/chldbrth"	"Oth acquired deformities of ms sys and connective tissue"	1	145	263	408
"B07"	"N00"	"Viral warts"	"Acute nephritic syndrome"	1	2	38	40
"H25"	"N03"	"Age-related cataract"	"Chronic nephritic syndrome"	1	110	220	330
"I48"	"N03"	"Atrial fibrillation and flutter"	"Chronic nephritic syndrome"	1	152	299	451
"K59"	"N03"	"Other functional intestinal disorders"	"Chronic nephritic syndrome"	1	77	227	304
"K64"	"N03"	"Hemorrhoids and perianal venous thrombosis"	"Chronic nephritic syndrome"	1	0	34	34
"L82"	"N03"	"Seborrheic keratosis"	"Chronic nephritic syndrome"	1	0	47	47
"M81"	"N03"	"Osteoporosis without current pathological fracture"	"Chronic nephritic syndrome"	1	23	126	149
"E21"	"N04"	"Hyperparathyroidism and other disorders of parathyroid gland"	"Nephrotic syndrome"	1	4	34	38
"E86"	"N10"	"Volume depletion"	"Acute pyelonephritis"	1	1536	1861	3397
"G98"	"N10"	"Other disorders of nervous system not elsewhere classified"	"Acute pyelonephritis"	1	20	106	126
"N11"	"N10"	"Chronic tubulo-interstitial nephritis"	"Acute pyelonephritis"	1	433	1165	1598
"O72"	"N10"	"Postpartum hemorrhage"	"Acute pyelonephritis"	1	0	1672	1672
"O90"	"N10"	"Complications of the puerperium, not elsewhere classified"	"Acute pyelonephritis"	1	34	103	137
"H57"	"N13"	"Other disorders of eye and adnexa"	"Obstructive and reflux uropathy"	1	50	121	171
"J96"	"N13"	"Respiratory failure, not elsewhere classified"	"Obstructive and reflux uropathy"	1	486	1108	1594
"N18"	"N13"	"Chronic kidney disease (CKD)"	"Obstructive and reflux uropathy"	1	1701	2694	4395
"A49"	"N14"	"Bacterial infection of unspecified site"	"Drug- & heavy-metal-induced tubulo-interstitial & tublr cond"	1	9	60	69
"A04"	"N19"	"Other bacterial intestinal infections"	"Unspecified kidney failure"	1	511	779	1290
"J06"	"N19"	"Acute upper resp infections of multiple and unsp sites"	"Unspecified kidney failure"	1	48	132	180
"C44"	"N20"	"Other and unspecified malignant neoplasm of skin"	"Calculus of kidney and ureter"	1	173	790	963
"C45"	"N20"	"Mesothelioma"	"Calculus of kidney and ureter"	1	2	42	44
"E66"	"N20"	"Overweight and obesity"	"Calculus of kidney and ureter"	1	1517	1949	3466
"E74"	"N20"	"Other disorders of carbohydrate metabolism"	"Calculus of kidney and ureter"	1	8	64	72
"G25"	"N20"	"Other extrapyramidal and movement disorders"	"Calculus of kidney and ureter"	1	29	103	132
"H18"	"N20"	"Other disorders of cornea"	"Calculus of kidney and ureter"	1	48	130	178
"H57"	"N20"	"Other disorders of eye and adnexa"	"Calculus of kidney and ureter"	1	111	367	478
"I11"	"N20"	"Hypertensive heart disease"	"Calculus of kidney and ureter"	1	110	326	436
"I63"	"N20"	"Cerebral infarction"	"Calculus of kidney and ureter"	1	411	1332	1743
"J81"	"N20"	"Pulmonary edema"	"Calculus of kidney and ureter"	1	38	283	321
"K72"	"N20"	"Hepatic failure, not elsewhere classified"	"Calculus of kidney and ureter"	1	29	142	171
"M13"	"N20"	"Other arthritis"	"Calculus of kidney and ureter"	1	181	326	507
"M81"	"N20"	"Osteoporosis without current pathological fracture"	"Calculus of kidney and ureter"	1	268	1277	1545
"C25"	"N21"	"Malignant neoplasm of pancreas"	"Calculus of lower urinary tract"	1	2	29	31
"E87"	"N21"	"Other disorders of fluid, electrolyte and acid-base balance"	"Calculus of lower urinary tract"	1	49	255	304
"C34"	"N30"	"Malignant neoplasm of bronchus and lung"	"Cystitis"	1	1596	2682	4278
"F17"	"N30"	"Nicotine dependence"	"Cystitis"	1	1625	2019	3644
"J90"	"N30"	"Pleural effusion, not elsewhere classified"	"Cystitis"	1	1137	1740	2877
"B96"	"N31"	"Oth bacterial agents as the cause of diseases classd elswhr"	"Neuromuscular dysfunction of bladder, NEC"	1	14	77	91
"E86"	"N31"	"Volume depletion"	"Neuromuscular dysfunction of bladder, NEC"	1	189	994	1183
"E87"	"N31"	"Other disorders of fluid, electrolyte and acid-base balance"	"Neuromuscular dysfunction of bladder, NEC"	1	105	473	578
"K56"	"N31"	"Paralytic ileus and intestinal obstruction without hernia"	"Neuromuscular dysfunction of bladder, NEC"	1	132	329	461
"L97"	"N31"	"Non-pressure chronic ulcer of lower limb, NEC"	"Neuromuscular dysfunction of bladder, NEC"	1	55	279	334
"M81"	"N31"	"Osteoporosis without current pathological fracture"	"Neuromuscular dysfunction of bladder, NEC"	1	160	499	659
"N18"	"N32"	"Chronic kidney disease (CKD)"	"Other disorders of bladder"	1	177	319	496
"A49"	"N35"	"Bacterial infection of unspecified site"	"Urethral stricture"	1	29	190	219
"J84"	"N35"	"Other interstitial pulmonary diseases"	"Urethral stricture"	1	13	56	69
"L98"	"N35"	"Oth disorders of skin, subcu, not elsewhere classified"	"Urethral stricture"	1	31	87	118
"C34"	"N39"	"Malignant neoplasm of bronchus and lung"	"Other disorders of urinary system"	1	1306	1902	3208
"C79"	"N39"	"Secondary malignant neoplasm of other and unspecified sites"	"Other disorders of urinary system"	1	1292	1603	2895
"E41"	"N39"	"Nutritional marasmus"	"Other disorders of urinary system"	1	350	569	919
"G30"	"N39"	"Alzheimer's disease"	"Other disorders of urinary system"	1	1005	1483	2488
"B59"	"N40"	"Pneumocystosis"	"Benign prostatic hyperplasia"	1	3	32	35
"C15"	"N40"	"Malignant neoplasm of esophagus"	"Benign prostatic hyperplasia"	1	39	471	510
"C44"	"N40"	"Other and unspecified malignant neoplasm of skin"	"Benign prostatic hyperplasia"	1	719	2658	3377
"C67"	"N40"	"Malignant neoplasm of bladder"	"Benign prostatic hyperplasia"	1	887	2243	3130
"C92"	"N40"	"Myeloid leukemia"	"Benign prostatic hyperplasia"	1	16	289	305
"D63"	"N40"	"Anemia in chronic diseases classified elsewhere"	"Benign prostatic hyperplasia"	1	0	2485	2485
"E86"	"N40"	"Volume depletion"	"Benign prostatic hyperplasia"	1	0	8988	8988
"F32"	"N40"	"Depressive episode"	"Benign prostatic hyperplasia"	1	813	2455	3268
"H54"	"N40"	"Blindness and low vision"	"Benign prostatic hyperplasia"	1	193	443	636
"I25"	"N40"	"Chronic ischemic heart disease"	"Benign prostatic hyperplasia"	1	6981	8273	15254
"I27"	"N40"	"Other pulmonary heart diseases"	"Benign prostatic hyperplasia"	1	188	644	832
"I61"	"N40"	"Nontraumatic intracerebral hemorrhage"	"Benign prostatic hyperplasia"	1	357	1340	1697
"K92"	"N40"	"Other diseases of digestive system"	"Benign prostatic hyperplasia"	1	0	4076	4076
"L98"	"N40"	"Oth disorders of skin, subcu, not elsewhere classified"	"Benign prostatic hyperplasia"	1	192	733	925
"N35"	"N40"	"Urethral stricture"	"Benign prostatic hyperplasia"	1	1208	3491	4699
"A49"	"N43"	"Bacterial infection of unspecified site"	"Hydrocele and spermatocele"	1	20	340	360
"C77"	"N43"	"Secondary and unspecified malignant neoplasm of lymph nodes"	"Hydrocele and spermatocele"	1	10	154	164
"E64"	"N43"	"Sequelae of malnutrition and other nutritional deficiencies"	"Hydrocele and spermatocele"	1	4	53	57
"E87"	"N43"	"Other disorders of fluid, electrolyte and acid-base balance"	"Hydrocele and spermatocele"	1	24	380	404
"G44"	"N43"	"Other headache syndromes"	"Hydrocele and spermatocele"	1	47	113	160
"G47"	"N43"	"Sleep disorders"	"Hydrocele and spermatocele"	1	139	557	696
"G62"	"N43"	"Other and unspecified polyneuropathies"	"Hydrocele and spermatocele"	1	55	213	268
"G98"	"N43"	"Other disorders of nervous system not elsewhere classified"	"Hydrocele and spermatocele"	1	7	56	63
"I70"	"N43"	"Atherosclerosis"	"Hydrocele and spermatocele"	1	162	391	553
"J15"	"N43"	"Bacterial pneumonia, not elsewhere classified"	"Hydrocele and spermatocele"	1	38	686	724
"J84"	"N43"	"Other interstitial pulmonary diseases"	"Hydrocele and spermatocele"	1	8	104	112
"K80"	"N43"	"Cholelithiasis"	"Hydrocele and spermatocele"	1	187	369	556
"K92"	"N43"	"Other diseases of digestive system"	"Hydrocele and spermatocele"	1	99	385	484
"M25"	"N43"	"Other joint disorder, not elsewhere classified"	"Hydrocele and spermatocele"	1	107	247	354
"M81"	"N43"	"Osteoporosis without current pathological fracture"	"Hydrocele and spermatocele"	1	25	276	301
"I48"	"N45"	"Atrial fibrillation and flutter"	"Orchitis and epididymitis"	1	618	978	1596
"J15"	"N45"	"Bacterial pneumonia, not elsewhere classified"	"Orchitis and epididymitis"	1	176	666	842
"J44"	"N45"	"Other chronic obstructive pulmonary disease"	"Orchitis and epididymitis"	1	405	692	1097
"N17"	"N45"	"Acute kidney failure"	"Orchitis and epididymitis"	1	70	197	267
"I25"	"N46"	"Chronic ischemic heart disease"	"Male infertility"	1	0	171	171
"I35"	"N46"	"Nonrheumatic aortic valve disorders"	"Male infertility"	1	13	54	67
"I73"	"N46"	"Other peripheral vascular diseases"	"Male infertility"	1	3	56	59
"J18"	"N46"	"Pneumonia, unspecified organism"	"Male infertility"	1	158	328	486
"K62"	"N46"	"Other diseases of anus and rectum"	"Male infertility"	1	89	257	346
"M10"	"N46"	"Gout"	"Male infertility"	1	25	83	108
"N18"	"N46"	"Chronic kidney disease (CKD)"	"Male infertility"	1	23	83	106
"I48"	"N47"	"Atrial fibrillation and flutter"	"Disorders of prepuce"	1	655	949	1604
"K72"	"N47"	"Hepatic failure, not elsewhere classified"	"Disorders of prepuce"	1	20	66	86
"M46"	"N47"	"Other inflammatory spondylopathies"	"Disorders of prepuce"	1	18	66	84
"A41"	"N48"	"Other sepsis"	"Other disorders of penis"	1	142	577	719
"C79"	"N48"	"Secondary malignant neoplasm of other and unspecified sites"	"Other disorders of penis"	1	2	196	198
"E86"	"N48"	"Volume depletion"	"Other disorders of penis"	1	86	426	512
"N39"	"N48"	"Other disorders of urinary system"	"Other disorders of penis"	1	319	625	944
"K59"	"N49"	"Other functional intestinal disorders"	"Inflammatory disorders of male genital organs, NEC"	1	96	218	314
"E29"	"N50"	"Testicular dysfunction"	"Other and unspecified disorders of male genital organs"	1	85	171	256
"G47"	"N50"	"Sleep disorders"	"Other and unspecified disorders of male genital organs"	1	258	502	760
"J18"	"N50"	"Pneumonia, unspecified organism"	"Other and unspecified disorders of male genital organs"	1	472	648	1120
"C20"	"N60"	"Malignant neoplasm of rectum"	"Benign mammary dysplasia"	1	6	66	72
"C54"	"N60"	"Malignant neoplasm of corpus uteri"	"Benign mammary dysplasia"	1	14	97	111
"E21"	"N60"	"Hyperparathyroidism and other disorders of parathyroid gland"	"Benign mammary dysplasia"	1	0	149	149
"E83"	"N60"	"Disorders of mineral metabolism"	"Benign mammary dysplasia"	1	0	93	93
"H36"	"N60"	"Retinal disorders in diseases classified elsewhere"	"Benign mammary dysplasia"	1	37	100	137
"I35"	"N60"	"Nonrheumatic aortic valve disorders"	"Benign mammary dysplasia"	1	0	270	270
"I74"	"N60"	"Arterial embolism and thrombosis"	"Benign mammary dysplasia"	1	1	47	48
"I89"	"N60"	"Oth noninfective disorders of lymphatic vessels and nodes"	"Benign mammary dysplasia"	1	5	130	135
"J81"	"N60"	"Pulmonary edema"	"Benign mammary dysplasia"	1	2	32	34
"K72"	"N60"	"Hepatic failure, not elsewhere classified"	"Benign mammary dysplasia"	1	0	47	47
"M20"	"N60"	"Acquired deformities of fingers and toes"	"Benign mammary dysplasia"	1	259	712	971
"M25"	"N60"	"Other joint disorder, not elsewhere classified"	"Benign mammary dysplasia"	1	188	652	840
"M71"	"N60"	"Other bursopathies"	"Benign mammary dysplasia"	1	42	108	150
"M99"	"N60"	"Biomechanical lesions, not elsewhere classified"	"Benign mammary dysplasia"	1	25	124	149
"N30"	"N60"	"Cystitis"	"Benign mammary dysplasia"	1	288	985	1273
"C78"	"N62"	"Secondary malignant neoplasm of resp and digestive organs"	"Hypertrophy of breast"	1	11	387	398
"H26"	"N62"	"Other cataract"	"Hypertrophy of breast"	1	104	295	399
"J90"	"N62"	"Pleural effusion, not elsewhere classified"	"Hypertrophy of breast"	1	22	139	161
"N83"	"N62"	"Noninflammatory disord of ovary, fallop and broad ligament"	"Hypertrophy of breast"	1	155	335	490
"O82"	"N62"	"Encounter for cesarean delivery without indication"	"Hypertrophy of breast"	1	248	453	701
"C18"	"N63"	"Malignant neoplasm of colon"	"Unspecified lump in breast"	1	22	197	219
"C50"	"N63"	"Malignant neoplasm of breast"	"Unspecified lump in breast"	1	4165	8089	12254
"C54"	"N63"	"Malignant neoplasm of corpus uteri"	"Unspecified lump in breast"	1	34	100	134
"F43"	"N63"	"Reaction to severe stress, and adjustment disorders"	"Unspecified lump in breast"	1	72	203	275
"H26"	"N63"	"Other cataract"	"Unspecified lump in breast"	1	113	465	578
"H53"	"N63"	"Visual disturbances"	"Unspecified lump in breast"	1	68	193	261
"H91"	"N63"	"Other and unspecified hearing loss"	"Unspecified lump in breast"	1	512	882	1394
"I34"	"N63"	"Nonrheumatic mitral valve disorders"	"Unspecified lump in breast"	1	24	126	150
"I46"	"N63"	"Cardiac arrest"	"Unspecified lump in breast"	1	0	127	127
"K70"	"N63"	"Alcoholic liver disease"	"Unspecified lump in breast"	1	44	125	169
"K74"	"N63"	"Fibrosis and cirrhosis of liver"	"Unspecified lump in breast"	1	17	86	103
"K83"	"N63"	"Other diseases of biliary tract"	"Unspecified lump in breast"	1	22	113	135
"K92"	"N63"	"Other diseases of digestive system"	"Unspecified lump in breast"	1	91	317	408
"L89"	"N63"	"Pressure ulcer"	"Unspecified lump in breast"	1	2	103	105
"M05"	"N63"	"Rheumatoid arthritis with rheumatoid factor"	"Unspecified lump in breast"	1	65	147	212
"M85"	"N63"	"Other disorders of bone density and structure"	"Unspecified lump in breast"	1	14	755	769
"N19"	"N63"	"Unspecified kidney failure"	"Unspecified lump in breast"	1	30	136	166
"I35"	"N64"	"Nonrheumatic aortic valve disorders"	"Other disorders of breast"	1	35	157	192
"I48"	"N64"	"Atrial fibrillation and flutter"	"Other disorders of breast"	1	174	389	563
"M81"	"N64"	"Osteoporosis without current pathological fracture"	"Other disorders of breast"	1	134	375	509
"C78"	"N70"	"Secondary malignant neoplasm of resp and digestive organs"	"Salpingitis and oophoritis"	1	0	97	97
"I83"	"N70"	"Varicose veins of lower extremities"	"Salpingitis and oophoritis"	1	21	286	307
"J15"	"N70"	"Bacterial pneumonia, not elsewhere classified"	"Salpingitis and oophoritis"	1	0	130	130
"K86"	"N70"	"Other diseases of pancreas"	"Salpingitis and oophoritis"	1	2	35	37
"O36"	"N70"	"Maternal care for other fetal problems"	"Salpingitis and oophoritis"	1	169	527	696
"E11"	"N71"	"Type 2 diabetes mellitus"	"Inflammatory disease of uterus, except cervix"	1	40	187	227
"I25"	"N71"	"Chronic ischemic heart disease"	"Inflammatory disease of uterus, except cervix"	1	51	135	186
"M85"	"N71"	"Other disorders of bone density and structure"	"Inflammatory disease of uterus, except cervix"	1	0	74	74
"C50"	"N72"	"Malignant neoplasm of breast"	"Inflammatory disease of cervix uteri"	1	0	31	31
"O72"	"N72"	"Postpartum hemorrhage"	"Inflammatory disease of cervix uteri"	1	68	228	296
"H35"	"N73"	"Other retinal disorders"	"Other female pelvic inflammatory diseases"	1	1	28	29
"J15"	"N73"	"Bacterial pneumonia, not elsewhere classified"	"Other female pelvic inflammatory diseases"	1	2	69	71
"J44"	"N73"	"Other chronic obstructive pulmonary disease"	"Other female pelvic inflammatory diseases"	1	3	114	117
"N18"	"N73"	"Chronic kidney disease (CKD)"	"Other female pelvic inflammatory diseases"	1	1	27	28
"E05"	"N75"	"Thyrotoxicosis [hyperthyroidism]"	"Diseases of Bartholin's gland"	1	40	110	150
"E66"	"N75"	"Overweight and obesity"	"Diseases of Bartholin's gland"	1	322	541	863
"I21"	"N75"	"Acute myocardial infarction"	"Diseases of Bartholin's gland"	1	5	57	62
"C34"	"N76"	"Malignant neoplasm of bronchus and lung"	"Other inflammation of vagina and vulva"	1	0	159	159
"C79"	"N76"	"Secondary malignant neoplasm of other and unspecified sites"	"Other inflammation of vagina and vulva"	1	10	119	129
"G96"	"N76"	"Other disorders of central nervous system"	"Other inflammation of vagina and vulva"	1	11	131	142
"I48"	"N76"	"Atrial fibrillation and flutter"	"Other inflammation of vagina and vulva"	1	123	328	451
"J15"	"N76"	"Bacterial pneumonia, not elsewhere classified"	"Other inflammation of vagina and vulva"	1	57	303	360
"J18"	"N76"	"Pneumonia, unspecified organism"	"Other inflammation of vagina and vulva"	1	302	773	1075
"J96"	"N76"	"Respiratory failure, not elsewhere classified"	"Other inflammation of vagina and vulva"	1	10	316	326
"C18"	"N80"	"Malignant neoplasm of colon"	"Endometriosis"	1	3	41	44
"E23"	"N80"	"Hypofunction and other disorders of the pituitary gland"	"Endometriosis"	1	3	35	38
"E83"	"N80"	"Disorders of mineral metabolism"	"Endometriosis"	1	0	37	37
"F41"	"N80"	"Other anxiety disorders"	"Endometriosis"	1	37	162	199
"H33"	"N80"	"Retinal detachments and breaks"	"Endometriosis"	1	0	39	39
"J32"	"N80"	"Chronic sinusitis"	"Endometriosis"	1	42	107	149
"K52"	"N80"	"Other and unsp noninfective gastroenteritis and colitis"	"Endometriosis"	1	97	221	318
"K92"	"N80"	"Other diseases of digestive system"	"Endometriosis"	1	39	121	160
"L98"	"N80"	"Oth disorders of skin, subcu, not elsewhere classified"	"Endometriosis"	1	25	77	102
"N98"	"N80"	"Complications associated with artificial fertilization"	"Endometriosis"	1	119	235	354
"A09"	"N81"	"Infectious gastroenteritis and colitis, unspecified"	"Female genital prolapse"	1	449	850	1299
"C34"	"N81"	"Malignant neoplasm of bronchus and lung"	"Female genital prolapse"	1	0	888	888
"C77"	"N81"	"Secondary and unspecified malignant neoplasm of lymph nodes"	"Female genital prolapse"	1	60	469	529
"D04"	"N81"	"Carcinoma in situ of skin"	"Female genital prolapse"	1	14	63	77
"D10"	"N81"	"Benign neoplasm of mouth and pharynx"	"Female genital prolapse"	1	65	147	212
"E21"	"N81"	"Hyperparathyroidism and other disorders of parathyroid gland"	"Female genital prolapse"	1	95	383	478
"F41"	"N81"	"Other anxiety disorders"	"Female genital prolapse"	1	89	487	576
"G40"	"N81"	"Epilepsy and recurrent seizures"	"Female genital prolapse"	1	266	406	672
"H40"	"N81"	"Glaucoma"	"Female genital prolapse"	1	319	613	932
"H53"	"N81"	"Visual disturbances"	"Female genital prolapse"	1	168	433	601
"H90"	"N81"	"Conductive and sensorineural hearing loss"	"Female genital prolapse"	1	570	815	1385
"I35"	"N81"	"Nonrheumatic aortic valve disorders"	"Female genital prolapse"	1	0	1661	1661
"J10"	"N81"	"Influenza due to other identified influenza virus"	"Female genital prolapse"	1	0	74	74
"J93"	"N81"	"Pneumothorax and air leak"	"Female genital prolapse"	1	30	130	160
"J96"	"N81"	"Respiratory failure, not elsewhere classified"	"Female genital prolapse"	1	0	1294	1294
"K56"	"N81"	"Paralytic ileus and intestinal obstruction without hernia"	"Female genital prolapse"	1	105	957	1062
"M16"	"N81"	"Osteoarthritis of hip"	"Female genital prolapse"	1	1130	2523	3653
"M48"	"N81"	"Other spondylopathies"	"Female genital prolapse"	1	478	1735	2213
"M70"	"N81"	"Soft tissue disorders related to use, overuse and pressure"	"Female genital prolapse"	1	374	778	1152
"N30"	"N81"	"Cystitis"	"Female genital prolapse"	1	0	9093	9093
"K43"	"N82"	"Ventral hernia"	"Fistulae involving female genital tract"	1	54	203	257
"C79"	"N83"	"Secondary malignant neoplasm of other and unspecified sites"	"Noninflammatory disord of ovary, fallop and broad ligament"	1	19	418	437
"D63"	"N83"	"Anemia in chronic diseases classified elsewhere"	"Noninflammatory disord of ovary, fallop and broad ligament"	1	24	200	224
"E13"	"N83"	"Other specified diabetes mellitus"	"Noninflammatory disord of ovary, fallop and broad ligament"	1	6	41	47
"F17"	"N83"	"Nicotine dependence"	"Noninflammatory disord of ovary, fallop and broad ligament"	1	756	1095	1851
"G57"	"N83"	"Mononeuropathies of lower limb"	"Noninflammatory disord of ovary, fallop and broad ligament"	1	80	158	238
"I20"	"N83"	"Angina pectoris"	"Noninflammatory disord of ovary, fallop and broad ligament"	1	452	776	1228
"I80"	"N83"	"Phlebitis and thrombophlebitis"	"Noninflammatory disord of ovary, fallop and broad ligament"	1	337	541	878
"K56"	"N83"	"Paralytic ileus and intestinal obstruction without hernia"	"Noninflammatory disord of ovary, fallop and broad ligament"	1	351	854	1205
"K72"	"N83"	"Hepatic failure, not elsewhere classified"	"Noninflammatory disord of ovary, fallop and broad ligament"	1	14	80	94
"M54"	"N83"	"Dorsalgia"	"Noninflammatory disord of ovary, fallop and broad ligament"	1	1859	2251	4110
"M65"	"N83"	"Synovitis and tenosynovitis"	"Noninflammatory disord of ovary, fallop and broad ligament"	1	591	828	1419
"N80"	"N83"	"Endometriosis"	"Noninflammatory disord of ovary, fallop and broad ligament"	1	3165	3945	7110
"N99"	"N83"	"Intraop and postproc comp and disorders of GU sys, NEC"	"Noninflammatory disord of ovary, fallop and broad ligament"	1	396	851	1247
"C90"	"N84"	"Multiple myeloma and malignant plasma cell neoplasms"	"Polyp of female genital tract"	1	5	45	50
"D35"	"N84"	"Benign neoplasm of other and unspecified endocrine glands"	"Polyp of female genital tract"	1	40	112	152
"E34"	"N84"	"Other endocrine disorders"	"Polyp of female genital tract"	1	17	76	93
"F33"	"N84"	"Major depressive disorder, recurrent"	"Polyp of female genital tract"	1	126	320	446
"G47"	"N84"	"Sleep disorders"	"Polyp of female genital tract"	1	108	504	612
"K57"	"N84"	"Diverticular disease of intestine"	"Polyp of female genital tract"	1	310	1073	1383
"K64"	"N84"	"Hemorrhoids and perianal venous thrombosis"	"Polyp of female genital tract"	1	13	657	670
"M19"	"N84"	"Other and unspecified osteoarthritis"	"Polyp of female genital tract"	1	279	767	1046
"K59"	"N85"	"Other functional intestinal disorders"	"Other noninflammatory disorders of uterus, except cervix"	1	50	328	378
"D32"	"N87"	"Benign neoplasm of meninges"	"Dysplasia of cervix uteri"	1	0	26	26
"E11"	"N87"	"Type 2 diabetes mellitus"	"Dysplasia of cervix uteri"	1	27	488	515
"E55"	"N87"	"Vitamin D deficiency"	"Dysplasia of cervix uteri"	1	3	75	78
"G56"	"N87"	"Mononeuropathies of upper limb"	"Dysplasia of cervix uteri"	1	156	871	1027
"I48"	"N87"	"Atrial fibrillation and flutter"	"Dysplasia of cervix uteri"	1	0	287	287
"J18"	"N87"	"Pneumonia, unspecified organism"	"Dysplasia of cervix uteri"	1	111	826	937
"J38"	"N87"	"Diseases of vocal cords and larynx, not elsewhere classified"	"Dysplasia of cervix uteri"	1	38	125	163
"J44"	"N87"	"Other chronic obstructive pulmonary disease"	"Dysplasia of cervix uteri"	1	0	533	533
"K08"	"N87"	"Other disorders of teeth and supporting structures"	"Dysplasia of cervix uteri"	1	33	96	129
"K20"	"N87"	"Esophagitis"	"Dysplasia of cervix uteri"	1	27	96	123
"K44"	"N87"	"Diaphragmatic hernia"	"Dysplasia of cervix uteri"	1	69	294	363
"K76"	"N87"	"Other diseases of liver"	"Dysplasia of cervix uteri"	1	13	138	151
"K81"	"N87"	"Cholecystitis"	"Dysplasia of cervix uteri"	1	33	122	155
"L89"	"N87"	"Pressure ulcer"	"Dysplasia of cervix uteri"	1	0	30	30
"M06"	"N87"	"Other rheumatoid arthritis"	"Dysplasia of cervix uteri"	1	52	160	212
"M47"	"N87"	"Spondylosis"	"Dysplasia of cervix uteri"	1	3	404	407
"O99"	"N87"	"Oth maternal diseases classd elsw but compl preg/chldbrth"	"Dysplasia of cervix uteri"	1	2016	2494	4510
"E86"	"N88"	"Volume depletion"	"Other noninflammatory disorders of cervix uteri"	1	0	40	40
"E87"	"N90"	"Other disorders of fluid, electrolyte and acid-base balance"	"Other noninflammatory disorders of vulva and perineum"	1	12	110	122
"M80"	"N90"	"Osteoporosis with current pathological fracture"	"Other noninflammatory disorders of vulva and perineum"	1	15	85	100
"M81"	"N90"	"Osteoporosis without current pathological fracture"	"Other noninflammatory disorders of vulva and perineum"	1	63	185	248
"A04"	"N92"	"Other bacterial intestinal infections"	"Excessive, frequent and irregular menstruation"	1	33	257	290
"C25"	"N92"	"Malignant neoplasm of pancreas"	"Excessive, frequent and irregular menstruation"	1	0	93	93
"D10"	"N92"	"Benign neoplasm of mouth and pharynx"	"Excessive, frequent and irregular menstruation"	1	35	294	329
"D69"	"N92"	"Purpura and other hemorrhagic conditions"	"Excessive, frequent and irregular menstruation"	1	305	567	872
"D70"	"N92"	"Neutropenia"	"Excessive, frequent and irregular menstruation"	1	10	49	59
"E10"	"N92"	"Type 1 diabetes mellitus"	"Excessive, frequent and irregular menstruation"	1	435	906	1341
"E16"	"N92"	"Other disorders of pancreatic internal secretion"	"Excessive, frequent and irregular menstruation"	1	110	202	312
"E34"	"N92"	"Other endocrine disorders"	"Excessive, frequent and irregular menstruation"	1	37	226	263
"E89"	"N92"	"Postproc endocrine and metabolic comp and disorders, NEC"	"Excessive, frequent and irregular menstruation"	1	55	366	421
"G50"	"N92"	"Disorders of trigeminal nerve"	"Excessive, frequent and irregular menstruation"	1	60	324	384
"G51"	"N92"	"Facial nerve disorders"	"Excessive, frequent and irregular menstruation"	1	103	296	399
"G72"	"N92"	"Other and unspecified myopathies"	"Excessive, frequent and irregular menstruation"	1	19	77	96
"H61"	"N92"	"Other disorders of external ear"	"Excessive, frequent and irregular menstruation"	1	49	122	171
"I10"	"N92"	"Essential (primary) hypertension"	"Excessive, frequent and irregular menstruation"	1	0	13965	13965
"I50"	"N92"	"Heart failure"	"Excessive, frequent and irregular menstruation"	1	0	864	864
"I63"	"N92"	"Cerebral infarction"	"Excessive, frequent and irregular menstruation"	1	0	1019	1019
"J44"	"N92"	"Other chronic obstructive pulmonary disease"	"Excessive, frequent and irregular menstruation"	1	0	1914	1914
"J90"	"N92"	"Pleural effusion, not elsewhere classified"	"Excessive, frequent and irregular menstruation"	1	0	204	204
"K21"	"N92"	"Gastro-esophageal reflux disease"	"Excessive, frequent and irregular menstruation"	1	564	2422	2986
"K57"	"N92"	"Diverticular disease of intestine"	"Excessive, frequent and irregular menstruation"	1	0	2155	2155
"K66"	"N92"	"Other disorders of peritoneum"	"Excessive, frequent and irregular menstruation"	1	257	451	708
"K72"	"N92"	"Hepatic failure, not elsewhere classified"	"Excessive, frequent and irregular menstruation"	1	0	139	139
"L81"	"N92"	"Other disorders of pigmentation"	"Excessive, frequent and irregular menstruation"	1	81	180	261
"M06"	"N92"	"Other rheumatoid arthritis"	"Excessive, frequent and irregular menstruation"	1	145	727	872
"M75"	"N92"	"Shoulder lesions"	"Excessive, frequent and irregular menstruation"	1	0	8412	8412
"N19"	"N92"	"Unspecified kidney failure"	"Excessive, frequent and irregular menstruation"	1	36	237	273
"C34"	"N93"	"Malignant neoplasm of bronchus and lung"	"Other abnormal uterine and vaginal bleeding"	1	0	59	59
"H35"	"N93"	"Other retinal disorders"	"Other abnormal uterine and vaginal bleeding"	1	33	92	125
"I63"	"N93"	"Cerebral infarction"	"Other abnormal uterine and vaginal bleeding"	1	45	107	152
"M85"	"N93"	"Other disorders of bone density and structure"	"Other abnormal uterine and vaginal bleeding"	1	20	141	161
"C49"	"N94"	"Malignant neoplasm of other connective and soft tissue"	"Pain and oth cond assoc w fem gntl org and menstrual cycle"	1	1	28	29
"E06"	"N94"	"Thyroiditis"	"Pain and oth cond assoc w fem gntl org and menstrual cycle"	1	40	152	192
"E87"	"N94"	"Other disorders of fluid, electrolyte and acid-base balance"	"Pain and oth cond assoc w fem gntl org and menstrual cycle"	1	0	224	224
"M20"	"N94"	"Acquired deformities of fingers and toes"	"Pain and oth cond assoc w fem gntl org and menstrual cycle"	1	224	523	747
"N99"	"N94"	"Intraop and postproc comp and disorders of GU sys, NEC"	"Pain and oth cond assoc w fem gntl org and menstrual cycle"	1	231	359	590
"C79"	"N95"	"Secondary malignant neoplasm of other and unspecified sites"	"Menopausal and other perimenopausal disorders"	1	20	755	775
"D32"	"N95"	"Benign neoplasm of meninges"	"Menopausal and other perimenopausal disorders"	1	41	110	151
"D63"	"N95"	"Anemia in chronic diseases classified elsewhere"	"Menopausal and other perimenopausal disorders"	1	29	464	493
"D64"	"N95"	"Other anemias"	"Menopausal and other perimenopausal disorders"	1	453	1446	1899
"G47"	"N95"	"Sleep disorders"	"Menopausal and other perimenopausal disorders"	1	163	729	892
"H26"	"N95"	"Other cataract"	"Menopausal and other perimenopausal disorders"	1	327	952	1279
"I48"	"N95"	"Atrial fibrillation and flutter"	"Menopausal and other perimenopausal disorders"	1	759	2121	2880
"J69"	"N95"	"Pneumonitis due to solids and liquids"	"Menopausal and other perimenopausal disorders"	1	0	98	98
"K52"	"N95"	"Other and unsp noninfective gastroenteritis and colitis"	"Menopausal and other perimenopausal disorders"	1	293	710	1003
"K83"	"N95"	"Other diseases of biliary tract"	"Menopausal and other perimenopausal disorders"	1	71	205	276
"N39"	"N96"	"Other disorders of urinary system"	"Recurrent pregnancy loss"	1	6	92	98
"O13"	"N96"	"Gestational hypertension without significant proteinuria"	"Recurrent pregnancy loss"	1	47	114	161
"O23"	"N96"	"Infections of genitourinary tract in pregnancy"	"Recurrent pregnancy loss"	1	122	233	355
"O24"	"N96"	"Diabetes in pregnancy, childbirth, and the puerperium"	"Recurrent pregnancy loss"	1	75	206	281
"O44"	"N96"	"Placenta previa"	"Recurrent pregnancy loss"	1	21	80	101
"D24"	"N97"	"Benign neoplasm of breast"	"Female infertility"	1	259	593	852
"D64"	"N97"	"Other anemias"	"Female infertility"	1	19	389	408
"E04"	"N97"	"Other nontoxic goiter"	"Female infertility"	1	60	702	762
"E64"	"N97"	"Sequelae of malnutrition and other nutritional deficiencies"	"Female infertility"	1	6	48	54
"E78"	"N97"	"Disorders of lipoprotein metabolism and other lipidemias"	"Female infertility"	1	0	266	266
"I26"	"N97"	"Pulmonary embolism"	"Female infertility"	1	23	161	184
"I34"	"N97"	"Nonrheumatic mitral valve disorders"	"Female infertility"	1	3	51	54
"I63"	"N97"	"Cerebral infarction"	"Female infertility"	1	0	98	98
"I69"	"N97"	"Sequelae of cerebrovascular disease"	"Female infertility"	1	0	77	77
"J15"	"N97"	"Bacterial pneumonia, not elsewhere classified"	"Female infertility"	1	2	234	236
"J98"	"N97"	"Other respiratory disorders"	"Female infertility"	1	13	65	78
"K04"	"N97"	"Diseases of pulp and periapical tissues"	"Female infertility"	1	34	111	145
"K29"	"N97"	"Gastritis and duodenitis"	"Female infertility"	1	187	349	536
"K31"	"N97"	"Other diseases of stomach and duodenum"	"Female infertility"	1	0	26	26
"K41"	"N97"	"Femoral hernia"	"Female infertility"	1	0	25	25
"K62"	"N97"	"Other diseases of anus and rectum"	"Female infertility"	1	71	520	591
"M05"	"N97"	"Rheumatoid arthritis with rheumatoid factor"	"Female infertility"	1	4	119	123
"M16"	"N97"	"Osteoarthritis of hip"	"Female infertility"	1	0	126	126
"O42"	"N97"	"Premature rupture of membranes"	"Female infertility"	1	0	9383	9383
"O21"	"N98"	"Excessive vomiting in pregnancy"	"Complications associated with artificial fertilization"	1	42	150	192
"O34"	"N98"	"Maternal care for abnormality of pelvic organs"	"Complications associated with artificial fertilization"	1	47	303	350
"O41"	"N98"	"Other disorders of amniotic fluid and membranes"	"Complications associated with artificial fertilization"	1	17	70	87
"O72"	"N98"	"Postpartum hemorrhage"	"Complications associated with artificial fertilization"	1	193	1320	1513
"M81"	"N99"	"Osteoporosis without current pathological fracture"	"Intraop and postproc comp and disorders of GU sys, NEC"	1	152	338	490
"A49"	"O00"	"Bacterial infection of unspecified site"	"Ectopic pregnancy"	1	3	64	67
"E04"	"O00"	"Other nontoxic goiter"	"Ectopic pregnancy"	1	0	189	189
"F43"	"O00"	"Reaction to severe stress, and adjustment disorders"	"Ectopic pregnancy"	1	8	132	140
"G43"	"O00"	"Migraine"	"Ectopic pregnancy"	1	44	279	323
"I80"	"O00"	"Phlebitis and thrombophlebitis"	"Ectopic pregnancy"	1	1	107	108
"K57"	"O00"	"Diverticular disease of intestine"	"Ectopic pregnancy"	1	0	28	28
"M67"	"O00"	"Other disorders of synovium and tendon"	"Ectopic pregnancy"	1	56	253	309
"O34"	"O00"	"Maternal care for abnormality of pelvic organs"	"Ectopic pregnancy"	1	203	1027	1230
"O47"	"O00"	"False labor"	"Ectopic pregnancy"	1	446	930	1376
"E65"	"O02"	"Localized adiposity"	"Other abnormal products of conception"	1	31	371	402
"E66"	"O02"	"Overweight and obesity"	"Other abnormal products of conception"	1	0	10705	10705
"I35"	"O02"	"Nonrheumatic aortic valve disorders"	"Other abnormal products of conception"	1	1	66	67
"I48"	"O02"	"Atrial fibrillation and flutter"	"Other abnormal products of conception"	1	0	125	125
"J44"	"O02"	"Other chronic obstructive pulmonary disease"	"Other abnormal products of conception"	1	0	126	126
"K05"	"O02"	"Gingivitis and periodontal diseases"	"Other abnormal products of conception"	1	7	57	64
"K22"	"O02"	"Other diseases of esophagus"	"Other abnormal products of conception"	1	8	73	81
"K25"	"O02"	"Gastric ulcer"	"Other abnormal products of conception"	1	14	133	147
"K30"	"O02"	"Functional dyspepsia"	"Other abnormal products of conception"	1	205	634	839
"M43"	"O02"	"Other deforming dorsopathies"	"Other abnormal products of conception"	1	32	114	146
"M62"	"O02"	"Other disorders of muscle"	"Other abnormal products of conception"	1	1023	1589	2612
"N31"	"O02"	"Neuromuscular dysfunction of bladder, NEC"	"Other abnormal products of conception"	1	15	56	71
"N81"	"O02"	"Female genital prolapse"	"Other abnormal products of conception"	1	0	1060	1060
"N83"	"O02"	"Noninflammatory disord of ovary, fallop and broad ligament"	"Other abnormal products of conception"	1	994	2012	3006
"O12"	"O02"	"Gestational edema and proteinuria without hypertension"	"Other abnormal products of conception"	1	275	587	862
"O21"	"O02"	"Excessive vomiting in pregnancy"	"Other abnormal products of conception"	1	1025	1499	2524
"O32"	"O02"	"Maternal care for malpresentation of fetus"	"Other abnormal products of conception"	1	1695	3952	5647
"A49"	"O03"	"Bacterial infection of unspecified site"	"Spontaneous abortion"	1	7	225	232
"C44"	"O03"	"Other and unspecified malignant neoplasm of skin"	"Spontaneous abortion"	1	0	76	76
"C78"	"O03"	"Secondary malignant neoplasm of resp and digestive organs"	"Spontaneous abortion"	1	0	44	44
"E64"	"O03"	"Sequelae of malnutrition and other nutritional deficiencies"	"Spontaneous abortion"	1	0	31	31
"E88"	"O03"	"Other and unspecified metabolic disorders"	"Spontaneous abortion"	1	0	52	52
"E89"	"O03"	"Postproc endocrine and metabolic comp and disorders, NEC"	"Spontaneous abortion"	1	0	120	120
"H01"	"O03"	"Other inflammation of eyelid"	"Spontaneous abortion"	1	0	48	48
"H43"	"O03"	"Disorders of vitreous body"	"Spontaneous abortion"	1	0	62	62
"H54"	"O03"	"Blindness and low vision"	"Spontaneous abortion"	1	4	59	63
"I10"	"O03"	"Essential (primary) hypertension"	"Spontaneous abortion"	1	0	898	898
"I70"	"O03"	"Atherosclerosis"	"Spontaneous abortion"	1	0	47	47
"J38"	"O03"	"Diseases of vocal cords and larynx, not elsewhere classified"	"Spontaneous abortion"	1	30	115	145
"K02"	"O03"	"Dental caries"	"Spontaneous abortion"	1	20	116	136
"K56"	"O03"	"Paralytic ileus and intestinal obstruction without hernia"	"Spontaneous abortion"	1	0	199	199
"K85"	"O03"	"Acute pancreatitis"	"Spontaneous abortion"	1	14	248	262
"M07"	"O03"	"Enteropathic arthropathies"	"Spontaneous abortion"	1	0	121	121
"M10"	"O03"	"Gout"	"Spontaneous abortion"	1	1	24	25
"M18"	"O03"	"Osteoarthritis of first carpometacarpal joint"	"Spontaneous abortion"	1	0	35	35
"M24"	"O03"	"Other specific joint derangements"	"Spontaneous abortion"	1	94	222	316
"M75"	"O03"	"Shoulder lesions"	"Spontaneous abortion"	1	0	1205	1205
"N12"	"O03"	"Tubulo-interstitial nephritis, not spcf as acute or chronic"	"Spontaneous abortion"	1	24	125	149
"N75"	"O03"	"Diseases of Bartholin's gland"	"Spontaneous abortion"	1	101	288	389
"N97"	"O03"	"Female infertility"	"Spontaneous abortion"	1	2888	3398	6286
"O14"	"O03"	"Pre-eclampsia"	"Spontaneous abortion"	1	1210	1878	3088
"Q65"	"O03"	"Congenital deformities of hip"	"Spontaneous abortion"	1	11	89	100
"A69"	"O04"	"Other spirochetal infections"	"Complications following (induced) termination of pregnancy"	1	15	77	92
"B02"	"O04"	"Zoster [herpes zoster]"	"Complications following (induced) termination of pregnancy"	1	0	105	105
"B25"	"O04"	"Cytomegaloviral disease"	"Complications following (induced) termination of pregnancy"	1	6	42	48
"B37"	"O04"	"Candidiasis"	"Complications following (induced) termination of pregnancy"	1	104	447	551
"C34"	"O04"	"Malignant neoplasm of bronchus and lung"	"Complications following (induced) termination of pregnancy"	1	0	39	39
"C77"	"O04"	"Secondary and unspecified malignant neoplasm of lymph nodes"	"Complications following (induced) termination of pregnancy"	1	0	110	110
"D13"	"O04"	"Benign neoplasm of and ill-defined parts of digestive system"	"Complications following (induced) termination of pregnancy"	1	0	93	93
"E04"	"O04"	"Other nontoxic goiter"	"Complications following (induced) termination of pregnancy"	1	0	1473	1473
"E64"	"O04"	"Sequelae of malnutrition and other nutritional deficiencies"	"Complications following (induced) termination of pregnancy"	1	0	69	69
"E83"	"O04"	"Disorders of mineral metabolism"	"Complications following (induced) termination of pregnancy"	1	0	76	76
"F13"	"O04"	"Sedative, hypnotic, or anxiolytic related disorders"	"Complications following (induced) termination of pregnancy"	1	9	128	137
"G43"	"O04"	"Migraine"	"Complications following (induced) termination of pregnancy"	1	0	2408	2408
"H05"	"O04"	"Disorders of orbit"	"Complications following (induced) termination of pregnancy"	1	5	101	106
"H36"	"O04"	"Retinal disorders in diseases classified elsewhere"	"Complications following (induced) termination of pregnancy"	1	0	217	217
"H47"	"O04"	"Other disorders of optic [2nd] nerve and visual pathways"	"Complications following (induced) termination of pregnancy"	1	4	98	102
"I21"	"O04"	"Acute myocardial infarction"	"Complications following (induced) termination of pregnancy"	1	0	150	150
"I33"	"O04"	"Acute and subacute endocarditis"	"Complications following (induced) termination of pregnancy"	1	0	31	31
"I51"	"O04"	"Complications and ill-defined descriptions of heart disease"	"Complications following (induced) termination of pregnancy"	1	0	142	142
"I63"	"O04"	"Cerebral infarction"	"Complications following (induced) termination of pregnancy"	1	0	197	197
"I69"	"O04"	"Sequelae of cerebrovascular disease"	"Complications following (induced) termination of pregnancy"	1	0	163	163
"J15"	"O04"	"Bacterial pneumonia, not elsewhere classified"	"Complications following (induced) termination of pregnancy"	1	0	449	449
"J32"	"O04"	"Chronic sinusitis"	"Complications following (induced) termination of pregnancy"	1	13	437	450
"J43"	"O04"	"Emphysema"	"Complications following (induced) termination of pregnancy"	1	0	34	34
"J98"	"O04"	"Other respiratory disorders"	"Complications following (induced) termination of pregnancy"	1	6	129	135
"K52"	"O04"	"Other and unsp noninfective gastroenteritis and colitis"	"Complications following (induced) termination of pregnancy"	1	93	967	1060
"K62"	"O04"	"Other diseases of anus and rectum"	"Complications following (induced) termination of pregnancy"	1	0	1017	1017
"L24"	"O04"	"Irritant contact dermatitis"	"Complications following (induced) termination of pregnancy"	1	54	204	258
"M13"	"O04"	"Other arthritis"	"Complications following (induced) termination of pregnancy"	1	0	480	480
"M15"	"O04"	"Polyosteoarthritis"	"Complications following (induced) termination of pregnancy"	1	0	42	42
"M20"	"O04"	"Acquired deformities of fingers and toes"	"Complications following (induced) termination of pregnancy"	1	0	1533	1533
"M31"	"O04"	"Other necrotizing vasculopathies"	"Complications following (induced) termination of pregnancy"	1	0	48	48
"M45"	"O04"	"Ankylosing spondylitis"	"Complications following (induced) termination of pregnancy"	1	0	108	108
"M62"	"O04"	"Other disorders of muscle"	"Complications following (induced) termination of pregnancy"	1	0	6481	6481
"M84"	"O04"	"Disorder of continuity of bone"	"Complications following (induced) termination of pregnancy"	1	0	118	118
"N36"	"O04"	"Other disorders of urethra"	"Complications following (induced) termination of pregnancy"	1	6	85	91
"N70"	"O04"	"Salpingitis and oophoritis"	"Complications following (induced) termination of pregnancy"	1	949	1524	2473
"N81"	"O04"	"Female genital prolapse"	"Complications following (induced) termination of pregnancy"	1	0	885	885
"N82"	"O04"	"Fistulae involving female genital tract"	"Complications following (induced) termination of pregnancy"	1	0	64	64
"O12"	"O04"	"Gestational edema and proteinuria without hypertension"	"Complications following (induced) termination of pregnancy"	1	198	438	636
"O35"	"O04"	"Maternal care for known or suspected fetal abnlt and damage"	"Complications following (induced) termination of pregnancy"	1	196	741	937
"O45"	"O04"	"Premature separation of placenta [abruptio placentae]"	"Complications following (induced) termination of pregnancy"	1	246	373	619
"G56"	"O08"	"Mononeuropathies of upper limb"	"Complications following ectopic and molar pregnancy"	1	61	325	386
"I10"	"O08"	"Essential (primary) hypertension"	"Complications following ectopic and molar pregnancy"	1	10	247	257
"K80"	"O08"	"Cholelithiasis"	"Complications following ectopic and molar pregnancy"	1	230	468	698
"M51"	"O08"	"Thoracic, thoracolum, and lumbosacral intvrt disc disorders"	"Complications following ectopic and molar pregnancy"	1	67	392	459
"M54"	"O08"	"Dorsalgia"	"Complications following ectopic and molar pregnancy"	1	443	710	1153
"K21"	"O12"	"Gastro-esophageal reflux disease"	"Gestational edema and proteinuria without hypertension"	1	5	44	49
"O70"	"O12"	"Perineal laceration during delivery"	"Gestational edema and proteinuria without hypertension"	1	1554	2038	3592
"O75"	"O12"	"Oth complications of labor and delivery, NEC"	"Gestational edema and proteinuria without hypertension"	1	307	506	813
"A49"	"O13"	"Bacterial infection of unspecified site"	"Gestational hypertension without significant proteinuria"	1	9	44	53
"M77"	"O13"	"Other enthesopathies"	"Gestational hypertension without significant proteinuria"	1	18	102	120
"N92"	"O13"	"Excessive, frequent and irregular menstruation"	"Gestational hypertension without significant proteinuria"	1	3	695	698
"O86"	"O13"	"Other puerperal infections"	"Gestational hypertension without significant proteinuria"	1	257	432	689
"A49"	"O14"	"Bacterial infection of unspecified site"	"Pre-eclampsia"	1	15	116	131
"D24"	"O14"	"Benign neoplasm of breast"	"Pre-eclampsia"	1	52	157	209
"D25"	"O14"	"Leiomyoma of uterus"	"Pre-eclampsia"	1	0	233	233
"D50"	"O14"	"Iron deficiency anemia"	"Pre-eclampsia"	1	0	171	171
"G35"	"O14"	"Multiple sclerosis"	"Pre-eclampsia"	1	5	53	58
"H52"	"O14"	"Disorders of refraction and accommodation"	"Pre-eclampsia"	1	49	165	214
"H57"	"O14"	"Other disorders of eye and adnexa"	"Pre-eclampsia"	1	6	75	81
"I83"	"O14"	"Varicose veins of lower extremities"	"Pre-eclampsia"	1	0	527	527
"K21"	"O14"	"Gastro-esophageal reflux disease"	"Pre-eclampsia"	1	17	200	217
"K57"	"O14"	"Diverticular disease of intestine"	"Pre-eclampsia"	1	0	44	44
"M25"	"O14"	"Other joint disorder, not elsewhere classified"	"Pre-eclampsia"	1	37	322	359
"M54"	"O14"	"Dorsalgia"	"Pre-eclampsia"	1	257	791	1048
"F31"	"O20"	"Bipolar disorder"	"Hemorrhage in early pregnancy"	1	0	38	38
"F32"	"O20"	"Depressive episode"	"Hemorrhage in early pregnancy"	1	36	481	517
"G62"	"O20"	"Other and unspecified polyneuropathies"	"Hemorrhage in early pregnancy"	1	0	59	59
"H36"	"O20"	"Retinal disorders in diseases classified elsewhere"	"Hemorrhage in early pregnancy"	1	2	98	100
"H40"	"O20"	"Glaucoma"	"Hemorrhage in early pregnancy"	1	0	45	45
"H81"	"O20"	"Disorders of vestibular function"	"Hemorrhage in early pregnancy"	1	21	363	384
"H93"	"O20"	"Other disorders of ear, not elsewhere classified"	"Hemorrhage in early pregnancy"	1	0	270	270
"I63"	"O20"	"Cerebral infarction"	"Hemorrhage in early pregnancy"	1	0	89	89
"I89"	"O20"	"Oth noninfective disorders of lymphatic vessels and nodes"	"Hemorrhage in early pregnancy"	1	0	67	67
"J38"	"O20"	"Diseases of vocal cords and larynx, not elsewhere classified"	"Hemorrhage in early pregnancy"	1	25	126	151
"K04"	"O20"	"Diseases of pulp and periapical tissues"	"Hemorrhage in early pregnancy"	1	10	176	186
"K05"	"O20"	"Gingivitis and periodontal diseases"	"Hemorrhage in early pregnancy"	1	1	77	78
"K12"	"O20"	"Stomatitis and related lesions"	"Hemorrhage in early pregnancy"	1	26	91	117
"K44"	"O20"	"Diaphragmatic hernia"	"Hemorrhage in early pregnancy"	1	3	349	352
"K66"	"O20"	"Other disorders of peritoneum"	"Hemorrhage in early pregnancy"	1	21	90	111
"K86"	"O20"	"Other diseases of pancreas"	"Hemorrhage in early pregnancy"	1	0	39	39
"L02"	"O20"	"Cutaneous abscess, furuncle and carbuncle"	"Hemorrhage in early pregnancy"	1	291	781	1072
"O45"	"O20"	"Premature separation of placenta [abruptio placentae]"	"Hemorrhage in early pregnancy"	1	386	1155	1541
"O65"	"O20"	"Obstructed labor due to maternal pelvic abnormality"	"Hemorrhage in early pregnancy"	1	1892	2378	4270
"O67"	"O20"	"Labor and delivery comp by intrapartum hemorrhage, NEC"	"Hemorrhage in early pregnancy"	1	148	540	688
"O80"	"O20"	"Encounter for full-term uncomplicated delivery"	"Hemorrhage in early pregnancy"	1	0	53573	53573
"O91"	"O20"	"Infect of breast assoc w pregnancy, the puerp and lactation"	"Hemorrhage in early pregnancy"	1	447	1439	1886
"Q65"	"O20"	"Congenital deformities of hip"	"Hemorrhage in early pregnancy"	1	9	87	96
"A41"	"O21"	"Other sepsis"	"Excessive vomiting in pregnancy"	1	4	59	63
"D25"	"O21"	"Leiomyoma of uterus"	"Excessive vomiting in pregnancy"	1	0	136	136
"E55"	"O21"	"Vitamin D deficiency"	"Excessive vomiting in pregnancy"	1	36	248	284
"N63"	"O21"	"Unspecified lump in breast"	"Excessive vomiting in pregnancy"	1	44	154	198
"O22"	"O21"	"Venous complications and hemorrhoids in pregnancy"	"Excessive vomiting in pregnancy"	1	42	105	147
"N92"	"O22"	"Excessive, frequent and irregular menstruation"	"Venous complications and hemorrhoids in pregnancy"	1	3	118	121
"C53"	"O23"	"Malignant neoplasm of cervix uteri"	"Infections of genitourinary tract in pregnancy"	1	7	50	57
"D12"	"O23"	"Benign neoplasm of colon, rectum, anus and anal canal"	"Infections of genitourinary tract in pregnancy"	1	0	73	73
"I80"	"O23"	"Phlebitis and thrombophlebitis"	"Infections of genitourinary tract in pregnancy"	1	78	199	277
"K04"	"O23"	"Diseases of pulp and periapical tissues"	"Infections of genitourinary tract in pregnancy"	1	13	71	84
"K30"	"O23"	"Functional dyspepsia"	"Infections of genitourinary tract in pregnancy"	1	158	304	462
"M54"	"O23"	"Dorsalgia"	"Infections of genitourinary tract in pregnancy"	1	567	1162	1729
"N61"	"O23"	"Inflammatory disorders of breast"	"Infections of genitourinary tract in pregnancy"	1	25	124	149
"O90"	"O23"	"Complications of the puerperium, not elsewhere classified"	"Infections of genitourinary tract in pregnancy"	1	593	1418	2011
"D25"	"O24"	"Leiomyoma of uterus"	"Diabetes in pregnancy, childbirth, and the puerperium"	1	28	190	218
"E05"	"O24"	"Thyrotoxicosis [hyperthyroidism]"	"Diabetes in pregnancy, childbirth, and the puerperium"	1	146	281	427
"I69"	"O24"	"Sequelae of cerebrovascular disease"	"Diabetes in pregnancy, childbirth, and the puerperium"	1	0	39	39
"J06"	"O24"	"Acute upper resp infections of multiple and unsp sites"	"Diabetes in pregnancy, childbirth, and the puerperium"	1	20	96	116
"K21"	"O24"	"Gastro-esophageal reflux disease"	"Diabetes in pregnancy, childbirth, and the puerperium"	1	69	157	226
"K56"	"O24"	"Paralytic ileus and intestinal obstruction without hernia"	"Diabetes in pregnancy, childbirth, and the puerperium"	1	12	89	101
"N18"	"O24"	"Chronic kidney disease (CKD)"	"Diabetes in pregnancy, childbirth, and the puerperium"	1	0	53	53
"O73"	"O24"	"Retained placenta and membranes, without hemorrhage"	"Diabetes in pregnancy, childbirth, and the puerperium"	1	152	310	462
"E04"	"O26"	"Other nontoxic goiter"	"Maternal care for oth conditions predom related to pregnancy"	1	36	688	724
"E78"	"O26"	"Disorders of lipoprotein metabolism and other lipidemias"	"Maternal care for oth conditions predom related to pregnancy"	1	0	203	203
"H02"	"O26"	"Other disorders of eyelid"	"Maternal care for oth conditions predom related to pregnancy"	1	0	136	136
"K56"	"O26"	"Paralytic ileus and intestinal obstruction without hernia"	"Maternal care for oth conditions predom related to pregnancy"	1	8	253	261
"L08"	"O26"	"Other local infections of skin and subcutaneous tissue"	"Maternal care for oth conditions predom related to pregnancy"	1	98	283	381
"M53"	"O26"	"Other and unspecified dorsopathies, not elsewhere classified"	"Maternal care for oth conditions predom related to pregnancy"	1	52	586	638
"N12"	"O26"	"Tubulo-interstitial nephritis, not spcf as acute or chronic"	"Maternal care for oth conditions predom related to pregnancy"	1	40	105	145
"N81"	"O26"	"Female genital prolapse"	"Maternal care for oth conditions predom related to pregnancy"	1	0	1206	1206
"G47"	"O28"	"Sleep disorders"	"Abnormal findings on antenatal screening of mother"	1	0	44	44
"N60"	"O28"	"Benign mammary dysplasia"	"Abnormal findings on antenatal screening of mother"	1	22	91	113
"A49"	"O30"	"Bacterial infection of unspecified site"	"Multiple gestation"	1	7	62	69
"D24"	"O30"	"Benign neoplasm of breast"	"Multiple gestation"	1	54	165	219
"F41"	"O30"	"Other anxiety disorders"	"Multiple gestation"	1	16	91	107
"G96"	"O30"	"Other disorders of central nervous system"	"Multiple gestation"	1	0	63	63
"I20"	"O30"	"Angina pectoris"	"Multiple gestation"	1	0	49	49
"K21"	"O30"	"Gastro-esophageal reflux disease"	"Multiple gestation"	1	9	107	116
"K62"	"O30"	"Other diseases of anus and rectum"	"Multiple gestation"	1	11	143	154
"M75"	"O30"	"Shoulder lesions"	"Multiple gestation"	1	0	294	294
"N64"	"O30"	"Other disorders of breast"	"Multiple gestation"	1	126	295	421
"N94"	"O30"	"Pain and oth cond assoc w fem gntl org and menstrual cycle"	"Multiple gestation"	1	143	243	386
"O32"	"O30"	"Maternal care for malpresentation of fetus"	"Multiple gestation"	1	2017	2944	4961
"O67"	"O30"	"Labor and delivery comp by intrapartum hemorrhage, NEC"	"Multiple gestation"	1	75	183	258
"D23"	"O32"	"Other benign neoplasms of skin"	"Maternal care for malpresentation of fetus"	1	49	202	251
"D64"	"O32"	"Other anemias"	"Maternal care for malpresentation of fetus"	1	0	164	164
"E21"	"O32"	"Hyperparathyroidism and other disorders of parathyroid gland"	"Maternal care for malpresentation of fetus"	1	0	29	29
"G98"	"O32"	"Other disorders of nervous system not elsewhere classified"	"Maternal care for malpresentation of fetus"	1	0	52	52
"H43"	"O32"	"Disorders of vitreous body"	"Maternal care for malpresentation of fetus"	1	0	29	29
"I47"	"O32"	"Paroxysmal tachycardia"	"Maternal care for malpresentation of fetus"	1	48	113	161
"J44"	"O32"	"Other chronic obstructive pulmonary disease"	"Maternal care for malpresentation of fetus"	1	0	45	45
"K05"	"O32"	"Gingivitis and periodontal diseases"	"Maternal care for malpresentation of fetus"	1	2	28	30
"K57"	"O32"	"Diverticular disease of intestine"	"Maternal care for malpresentation of fetus"	1	0	39	39
"K65"	"O32"	"Peritonitis"	"Maternal care for malpresentation of fetus"	1	6	68	74
"K90"	"O32"	"Intestinal malabsorption"	"Maternal care for malpresentation of fetus"	1	5	53	58
"L90"	"O32"	"Atrophic disorders of skin"	"Maternal care for malpresentation of fetus"	1	60	329	389
"L98"	"O32"	"Oth disorders of skin, subcu, not elsewhere classified"	"Maternal care for malpresentation of fetus"	1	18	105	123
"M19"	"O32"	"Other and unspecified osteoarthritis"	"Maternal care for malpresentation of fetus"	1	0	97	97
"M85"	"O32"	"Other disorders of bone density and structure"	"Maternal care for malpresentation of fetus"	1	0	49	49
"N39"	"O32"	"Other disorders of urinary system"	"Maternal care for malpresentation of fetus"	1	18	427	445
"N61"	"O32"	"Inflammatory disorders of breast"	"Maternal care for malpresentation of fetus"	1	13	143	156
"N94"	"O32"	"Pain and oth cond assoc w fem gntl org and menstrual cycle"	"Maternal care for malpresentation of fetus"	1	193	466	659
"O86"	"O32"	"Other puerperal infections"	"Maternal care for malpresentation of fetus"	1	655	946	1601
"O91"	"O32"	"Infect of breast assoc w pregnancy, the puerp and lactation"	"Maternal care for malpresentation of fetus"	1	247	877	1124
"D64"	"O34"	"Other anemias"	"Maternal care for abnormality of pelvic organs"	1	52	220	272
"E21"	"O34"	"Hyperparathyroidism and other disorders of parathyroid gland"	"Maternal care for abnormality of pelvic organs"	1	0	35	35
"G47"	"O34"	"Sleep disorders"	"Maternal care for abnormality of pelvic organs"	1	4	154	158
"I21"	"O34"	"Acute myocardial infarction"	"Maternal care for abnormality of pelvic organs"	1	0	45	45
"I35"	"O34"	"Nonrheumatic aortic valve disorders"	"Maternal care for abnormality of pelvic organs"	1	3	31	34
"I48"	"O34"	"Atrial fibrillation and flutter"	"Maternal care for abnormality of pelvic organs"	1	4	56	60
"I83"	"O34"	"Varicose veins of lower extremities"	"Maternal care for abnormality of pelvic organs"	1	106	756	862
"M07"	"O34"	"Enteropathic arthropathies"	"Maternal care for abnormality of pelvic organs"	1	4	72	76
"M13"	"O34"	"Other arthritis"	"Maternal care for abnormality of pelvic organs"	1	34	103	137
"M19"	"O34"	"Other and unspecified osteoarthritis"	"Maternal care for abnormality of pelvic organs"	1	0	129	129
"M77"	"O34"	"Other enthesopathies"	"Maternal care for abnormality of pelvic organs"	1	64	235	299
"M81"	"O34"	"Osteoporosis without current pathological fracture"	"Maternal care for abnormality of pelvic organs"	1	0	54	54
"N61"	"O34"	"Inflammatory disorders of breast"	"Maternal care for abnormality of pelvic organs"	1	32	110	142
"A46"	"O36"	"Erysipelas"	"Maternal care for other fetal problems"	1	16	123	139
"C77"	"O36"	"Secondary and unspecified malignant neoplasm of lymph nodes"	"Maternal care for other fetal problems"	1	0	42	42
"E04"	"O36"	"Other nontoxic goiter"	"Maternal care for other fetal problems"	1	83	531	614
"E06"	"O36"	"Thyroiditis"	"Maternal care for other fetal problems"	1	104	255	359
"E64"	"O36"	"Sequelae of malnutrition and other nutritional deficiencies"	"Maternal care for other fetal problems"	1	6	43	49
"E68"	"O36"	"Sequelae of hyperalimentation"	"Maternal care for other fetal problems"	1	0	301	301
"H91"	"O36"	"Other and unspecified hearing loss"	"Maternal care for other fetal problems"	1	40	180	220
"I67"	"O36"	"Other cerebrovascular diseases"	"Maternal care for other fetal problems"	1	0	35	35
"I69"	"O36"	"Sequelae of cerebrovascular disease"	"Maternal care for other fetal problems"	1	0	54	54
"K83"	"O36"	"Other diseases of biliary tract"	"Maternal care for other fetal problems"	1	18	71	89
"M20"	"O36"	"Acquired deformities of fingers and toes"	"Maternal care for other fetal problems"	1	110	221	331
"O85"	"O36"	"Puerperal sepsis"	"Maternal care for other fetal problems"	1	412	728	1140
"I10"	"O40"	"Essential (primary) hypertension"	"Polyhydramnios"	1	11	78	89
"D25"	"O41"	"Leiomyoma of uterus"	"Other disorders of amniotic fluid and membranes"	1	0	106	106
"K80"	"O41"	"Cholelithiasis"	"Other disorders of amniotic fluid and membranes"	1	99	438	537
"M25"	"O41"	"Other joint disorder, not elsewhere classified"	"Other disorders of amniotic fluid and membranes"	1	9	117	126
"M50"	"O41"	"Cervical disc disorders"	"Other disorders of amniotic fluid and membranes"	1	0	40	40
"A46"	"O42"	"Erysipelas"	"Premature rupture of membranes"	1	10	111	121
"E21"	"O42"	"Hyperparathyroidism and other disorders of parathyroid gland"	"Premature rupture of membranes"	1	0	43	43
"E55"	"O42"	"Vitamin D deficiency"	"Premature rupture of membranes"	1	44	166	210
"G50"	"O42"	"Disorders of trigeminal nerve"	"Premature rupture of membranes"	1	1	53	54
"H26"	"O42"	"Other cataract"	"Premature rupture of membranes"	1	0	44	44
"H52"	"O42"	"Disorders of refraction and accommodation"	"Premature rupture of membranes"	1	172	285	457
"I67"	"O42"	"Other cerebrovascular diseases"	"Premature rupture of membranes"	1	0	37	37
"K57"	"O42"	"Diverticular disease of intestine"	"Premature rupture of membranes"	1	0	74	74
"K62"	"O42"	"Other diseases of anus and rectum"	"Premature rupture of membranes"	1	39	330	369
"K90"	"O42"	"Intestinal malabsorption"	"Premature rupture of membranes"	1	15	72	87
"L98"	"O42"	"Oth disorders of skin, subcu, not elsewhere classified"	"Premature rupture of membranes"	1	41	135	176
"N32"	"O42"	"Other disorders of bladder"	"Premature rupture of membranes"	1	3	31	34
"N39"	"O42"	"Other disorders of urinary system"	"Premature rupture of membranes"	1	86	943	1029
"N60"	"O42"	"Benign mammary dysplasia"	"Premature rupture of membranes"	1	110	385	495
"N61"	"O42"	"Inflammatory disorders of breast"	"Premature rupture of membranes"	1	38	210	248
"K59"	"O45"	"Other functional intestinal disorders"	"Premature separation of placenta [abruptio placentae]"	1	6	96	102
"O34"	"O45"	"Maternal care for abnormality of pelvic organs"	"Premature separation of placenta [abruptio placentae]"	1	412	711	1123
"D24"	"O46"	"Benign neoplasm of breast"	"Antepartum hemorrhage, not elsewhere classified"	1	42	127	169
"H91"	"O46"	"Other and unspecified hearing loss"	"Antepartum hemorrhage, not elsewhere classified"	1	8	52	60
"J18"	"O46"	"Pneumonia, unspecified organism"	"Antepartum hemorrhage, not elsewhere classified"	1	48	268	316
"M79"	"O46"	"Oth and unsp soft tissue disorders, not elsewhere classified"	"Antepartum hemorrhage, not elsewhere classified"	1	128	360	488
"N94"	"O46"	"Pain and oth cond assoc w fem gntl org and menstrual cycle"	"Antepartum hemorrhage, not elsewhere classified"	1	141	301	442
"O68"	"O46"	"Labor and delivery comp by abnlt of fetal acid-base balance"	"Antepartum hemorrhage, not elsewhere classified"	1	2229	2714	4943
"O92"	"O46"	"Oth disord of brst/lactatn assoc w pregnancy and the puerp"	"Antepartum hemorrhage, not elsewhere classified"	1	341	790	1131
"C53"	"O47"	"Malignant neoplasm of cervix uteri"	"False labor"	1	12	69	81
"D23"	"O47"	"Other benign neoplasms of skin"	"False labor"	1	99	217	316
"D33"	"O47"	"Benign neoplasm of brain and oth prt central nervous system"	"False labor"	1	3	35	38
"D35"	"O47"	"Benign neoplasm of other and unspecified endocrine glands"	"False labor"	1	1	33	34
"E21"	"O47"	"Hyperparathyroidism and other disorders of parathyroid gland"	"False labor"	1	0	37	37
"E78"	"O47"	"Disorders of lipoprotein metabolism and other lipidemias"	"False labor"	1	0	135	135
"G95"	"O47"	"Other and unspecified diseases of spinal cord"	"False labor"	1	0	25	25
"H26"	"O47"	"Other cataract"	"False labor"	1	0	38	38
"I20"	"O47"	"Angina pectoris"	"False labor"	1	0	158	158
"I83"	"O47"	"Varicose veins of lower extremities"	"False labor"	1	20	839	859
"I89"	"O47"	"Oth noninfective disorders of lymphatic vessels and nodes"	"False labor"	1	0	37	37
"J18"	"O47"	"Pneumonia, unspecified organism"	"False labor"	1	153	740	893
"K85"	"O47"	"Acute pancreatitis"	"False labor"	1	26	144	170
"M20"	"O47"	"Acquired deformities of fingers and toes"	"False labor"	1	89	218	307
"M54"	"O47"	"Dorsalgia"	"False labor"	1	676	1617	2293
"M81"	"O47"	"Osteoporosis without current pathological fracture"	"False labor"	1	0	57	57
"N93"	"O47"	"Other abnormal uterine and vaginal bleeding"	"False labor"	1	251	873	1124
"C53"	"O48"	"Malignant neoplasm of cervix uteri"	"Late pregnancy"	1	0	69	69
"D12"	"O48"	"Benign neoplasm of colon, rectum, anus and anal canal"	"Late pregnancy"	1	0	83	83
"D25"	"O48"	"Leiomyoma of uterus"	"Late pregnancy"	1	0	258	258
"D50"	"O48"	"Iron deficiency anemia"	"Late pregnancy"	1	0	165	165
"E21"	"O48"	"Hyperparathyroidism and other disorders of parathyroid gland"	"Late pregnancy"	1	0	35	35
"H53"	"O48"	"Visual disturbances"	"Late pregnancy"	1	0	105	105
"H60"	"O48"	"Otitis externa"	"Late pregnancy"	1	15	68	83
"H90"	"O48"	"Conductive and sensorineural hearing loss"	"Late pregnancy"	1	20	117	137
"H93"	"O48"	"Other disorders of ear, not elsewhere classified"	"Late pregnancy"	1	0	131	131
"I48"	"O48"	"Atrial fibrillation and flutter"	"Late pregnancy"	1	0	57	57
"I80"	"O48"	"Phlebitis and thrombophlebitis"	"Late pregnancy"	1	0	207	207
"J34"	"O48"	"Other and unspecified disorders of nose and nasal sinuses"	"Late pregnancy"	1	36	110	146
"K40"	"O48"	"Inguinal hernia"	"Late pregnancy"	1	12	99	111
"M06"	"O48"	"Other rheumatoid arthritis"	"Late pregnancy"	1	0	73	73
"M17"	"O48"	"Osteoarthritis of knee"	"Late pregnancy"	1	0	164	164
"M45"	"O48"	"Ankylosing spondylitis"	"Late pregnancy"	1	0	35	35
"M50"	"O48"	"Cervical disc disorders"	"Late pregnancy"	1	0	149	149
"M51"	"O48"	"Thoracic, thoracolum, and lumbosacral intvrt disc disorders"	"Late pregnancy"	1	0	629	629
"M67"	"O48"	"Other disorders of synovium and tendon"	"Late pregnancy"	1	85	442	527
"M81"	"O48"	"Osteoporosis without current pathological fracture"	"Late pregnancy"	1	0	35	35
"N64"	"O48"	"Other disorders of breast"	"Late pregnancy"	1	84	526	610
"N75"	"O48"	"Diseases of Bartholin's gland"	"Late pregnancy"	1	46	153	199
"O08"	"O48"	"Complications following ectopic and molar pregnancy"	"Late pregnancy"	1	252	548	800
"Q65"	"O48"	"Congenital deformities of hip"	"Late pregnancy"	1	0	43	43
"A41"	"O60"	"Other sepsis"	"Preterm labor"	1	1	38	39
"I10"	"O60"	"Essential (primary) hypertension"	"Preterm labor"	1	0	140	140
"N94"	"O60"	"Pain and oth cond assoc w fem gntl org and menstrual cycle"	"Preterm labor"	1	45	169	214
"C49"	"O62"	"Malignant neoplasm of other connective and soft tissue"	"Abnormalities of forces of labor"	1	0	64	64
"D12"	"O62"	"Benign neoplasm of colon, rectum, anus and anal canal"	"Abnormalities of forces of labor"	1	0	391	391
"D22"	"O62"	"Melanocytic nevi"	"Abnormalities of forces of labor"	1	174	1461	1635
"D24"	"O62"	"Benign neoplasm of breast"	"Abnormalities of forces of labor"	1	427	1874	2301
"D33"	"O62"	"Benign neoplasm of brain and oth prt central nervous system"	"Abnormalities of forces of labor"	1	3	119	122
"E11"	"O62"	"Type 2 diabetes mellitus"	"Abnormalities of forces of labor"	1	0	753	753
"E72"	"O62"	"Other disorders of amino-acid metabolism"	"Abnormalities of forces of labor"	1	1	32	33
"F43"	"O62"	"Reaction to severe stress, and adjustment disorders"	"Abnormalities of forces of labor"	1	0	1203	1203
"H20"	"O62"	"Iridocyclitis"	"Abnormalities of forces of labor"	1	71	287	358
"H81"	"O62"	"Disorders of vestibular function"	"Abnormalities of forces of labor"	1	29	857	886
"I20"	"O62"	"Angina pectoris"	"Abnormalities of forces of labor"	1	0	386	386
"I35"	"O62"	"Nonrheumatic aortic valve disorders"	"Abnormalities of forces of labor"	1	0	110	110
"I42"	"O62"	"Cardiomyopathy"	"Abnormalities of forces of labor"	1	0	98	98
"I51"	"O62"	"Complications and ill-defined descriptions of heart disease"	"Abnormalities of forces of labor"	1	64	172	236
"I65"	"O62"	"Occls and stenosis of precerb art, not rslt in cereb infrc"	"Abnormalities of forces of labor"	1	0	25	25
"J01"	"O62"	"Acute sinusitis"	"Abnormalities of forces of labor"	1	81	1239	1320
"J09"	"O62"	"Influenza due to certain identified influenza viruses"	"Abnormalities of forces of labor"	1	0	66	66
"J32"	"O62"	"Chronic sinusitis"	"Abnormalities of forces of labor"	1	63	689	752
"J39"	"O62"	"Other diseases of upper respiratory tract"	"Abnormalities of forces of labor"	1	24	107	131
"K46"	"O62"	"Unspecified abdominal hernia"	"Abnormalities of forces of labor"	1	0	77	77
"K63"	"O62"	"Other diseases of intestine"	"Abnormalities of forces of labor"	1	1	188	189
"L40"	"O62"	"Psoriasis"	"Abnormalities of forces of labor"	1	66	468	534
"L50"	"O62"	"Urticaria"	"Abnormalities of forces of labor"	1	376	1021	1397
"L81"	"O62"	"Other disorders of pigmentation"	"Abnormalities of forces of labor"	1	46	187	233
"M15"	"O62"	"Polyosteoarthritis"	"Abnormalities of forces of labor"	1	0	25	25
"M75"	"O62"	"Shoulder lesions"	"Abnormalities of forces of labor"	1	0	2355	2355
"M79"	"O62"	"Oth and unsp soft tissue disorders, not elsewhere classified"	"Abnormalities of forces of labor"	1	0	4983	4983
"N30"	"O62"	"Cystitis"	"Abnormalities of forces of labor"	1	1911	2828	4739
"N85"	"O62"	"Other noninflammatory disorders of uterus, except cervix"	"Abnormalities of forces of labor"	1	10	471	481
"C77"	"O63"	"Secondary and unspecified malignant neoplasm of lymph nodes"	"Long labor"	1	0	26	26
"D64"	"O63"	"Other anemias"	"Long labor"	1	5	142	147
"E65"	"O63"	"Localized adiposity"	"Long labor"	1	0	178	178
"E78"	"O63"	"Disorders of lipoprotein metabolism and other lipidemias"	"Long labor"	1	0	63	63
"J32"	"O63"	"Chronic sinusitis"	"Long labor"	1	16	87	103
"M25"	"O63"	"Other joint disorder, not elsewhere classified"	"Long labor"	1	43	278	321
"G56"	"O64"	"Mononeuropathies of upper limb"	"Obstructed labor due to malposition and malpresent of fetus"	1	18	650	668
"G96"	"O64"	"Other disorders of central nervous system"	"Obstructed labor due to malposition and malpresent of fetus"	1	0	81	81
"H52"	"O64"	"Disorders of refraction and accommodation"	"Obstructed labor due to malposition and malpresent of fetus"	1	47	208	255
"H53"	"O64"	"Visual disturbances"	"Obstructed labor due to malposition and malpresent of fetus"	1	3	60	63
"H57"	"O64"	"Other disorders of eye and adnexa"	"Obstructed labor due to malposition and malpresent of fetus"	1	1	75	76
"H93"	"O64"	"Other disorders of ear, not elsewhere classified"	"Obstructed labor due to malposition and malpresent of fetus"	1	0	86	86
"I80"	"O64"	"Phlebitis and thrombophlebitis"	"Obstructed labor due to malposition and malpresent of fetus"	1	15	163	178
"K29"	"O64"	"Gastritis and duodenitis"	"Obstructed labor due to malposition and malpresent of fetus"	1	63	165	228
"M19"	"O64"	"Other and unspecified osteoarthritis"	"Obstructed labor due to malposition and malpresent of fetus"	1	0	84	84
"M53"	"O64"	"Other and unspecified dorsopathies, not elsewhere classified"	"Obstructed labor due to malposition and malpresent of fetus"	1	5	194	199
"M67"	"O64"	"Other disorders of synovium and tendon"	"Obstructed labor due to malposition and malpresent of fetus"	1	116	343	459
"N20"	"O64"	"Calculus of kidney and ureter"	"Obstructed labor due to malposition and malpresent of fetus"	1	44	250	294
"E86"	"O65"	"Volume depletion"	"Obstructed labor due to maternal pelvic abnormality"	1	0	73	73
"J38"	"O65"	"Diseases of vocal cords and larynx, not elsewhere classified"	"Obstructed labor due to maternal pelvic abnormality"	1	3	49	52
"J45"	"O65"	"Asthma"	"Obstructed labor due to maternal pelvic abnormality"	1	62	453	515
"K05"	"O65"	"Gingivitis and periodontal diseases"	"Obstructed labor due to maternal pelvic abnormality"	1	0	25	25
"K58"	"O65"	"Irritable bowel syndrome"	"Obstructed labor due to maternal pelvic abnormality"	1	6	223	229
"K76"	"O65"	"Other diseases of liver"	"Obstructed labor due to maternal pelvic abnormality"	1	0	50	50
"N13"	"O65"	"Obstructive and reflux uropathy"	"Obstructed labor due to maternal pelvic abnormality"	1	18	83	101
"N82"	"O65"	"Fistulae involving female genital tract"	"Obstructed labor due to maternal pelvic abnormality"	1	0	33	33
"I80"	"O66"	"Phlebitis and thrombophlebitis"	"Other obstructed labor"	1	20	69	89
"M54"	"O66"	"Dorsalgia"	"Other obstructed labor"	1	126	479	605
"N20"	"O66"	"Calculus of kidney and ureter"	"Other obstructed labor"	1	33	118	151
"N39"	"O67"	"Other disorders of urinary system"	"Labor and delivery comp by intrapartum hemorrhage, NEC"	1	9	55	64
"C71"	"O68"	"Malignant neoplasm of brain"	"Labor and delivery comp by abnlt of fetal acid-base balance"	1	0	44	44
"D12"	"O68"	"Benign neoplasm of colon, rectum, anus and anal canal"	"Labor and delivery comp by abnlt of fetal acid-base balance"	1	0	257	257
"D21"	"O68"	"Other benign neoplasms of connective and other soft tissue"	"Labor and delivery comp by abnlt of fetal acid-base balance"	1	34	188	222
"G45"	"O68"	"Transient cerebral ischemic attacks and related syndromes"	"Labor and delivery comp by abnlt of fetal acid-base balance"	1	0	203	203
"G47"	"O68"	"Sleep disorders"	"Labor and delivery comp by abnlt of fetal acid-base balance"	1	0	382	382
"G55"	"O68"	"Nerve root and plexus compressions in diseases classd elswhr"	"Labor and delivery comp by abnlt of fetal acid-base balance"	1	0	37	37
"H02"	"O68"	"Other disorders of eyelid"	"Labor and delivery comp by abnlt of fetal acid-base balance"	1	13	320	333
"H04"	"O68"	"Disorders of lacrimal system"	"Labor and delivery comp by abnlt of fetal acid-base balance"	1	12	85	97
"H20"	"O68"	"Iridocyclitis"	"Labor and delivery comp by abnlt of fetal acid-base balance"	1	62	166	228
"H47"	"O68"	"Other disorders of optic [2nd] nerve and visual pathways"	"Labor and delivery comp by abnlt of fetal acid-base balance"	1	15	59	74
"I26"	"O68"	"Pulmonary embolism"	"Labor and delivery comp by abnlt of fetal acid-base balance"	1	34	194	228
"I70"	"O68"	"Atherosclerosis"	"Labor and delivery comp by abnlt of fetal acid-base balance"	1	0	44	44
"I83"	"O68"	"Varicose veins of lower extremities"	"Labor and delivery comp by abnlt of fetal acid-base balance"	1	0	2297	2297
"J90"	"O68"	"Pleural effusion, not elsewhere classified"	"Labor and delivery comp by abnlt of fetal acid-base balance"	1	0	48	48
"J93"	"O68"	"Pneumothorax and air leak"	"Labor and delivery comp by abnlt of fetal acid-base balance"	1	29	84	113
"K28"	"O68"	"Gastrojejunal ulcer"	"Labor and delivery comp by abnlt of fetal acid-base balance"	1	0	28	28
"K45"	"O68"	"Other abdominal hernia"	"Labor and delivery comp by abnlt of fetal acid-base balance"	1	0	243	243
"K52"	"O68"	"Other and unsp noninfective gastroenteritis and colitis"	"Labor and delivery comp by abnlt of fetal acid-base balance"	1	265	506	771
"K56"	"O68"	"Paralytic ileus and intestinal obstruction without hernia"	"Labor and delivery comp by abnlt of fetal acid-base balance"	1	91	350	441
"K61"	"O68"	"Abscess of anal and rectal regions"	"Labor and delivery comp by abnlt of fetal acid-base balance"	1	133	299	432
"K82"	"O68"	"Other diseases of gallbladder"	"Labor and delivery comp by abnlt of fetal acid-base balance"	1	0	48	48
"K86"	"O68"	"Other diseases of pancreas"	"Labor and delivery comp by abnlt of fetal acid-base balance"	1	3	54	57
"L97"	"O68"	"Non-pressure chronic ulcer of lower limb, NEC"	"Labor and delivery comp by abnlt of fetal acid-base balance"	1	0	25	25
"M17"	"O68"	"Osteoarthritis of knee"	"Labor and delivery comp by abnlt of fetal acid-base balance"	1	0	461	461
"N85"	"O68"	"Other noninflammatory disorders of uterus, except cervix"	"Labor and delivery comp by abnlt of fetal acid-base balance"	1	24	258	282
"K59"	"O69"	"Other functional intestinal disorders"	"Labor and delivery complicated by umbilical cord comp"	1	0	25	25
"D05"	"O70"	"Carcinoma in situ of breast"	"Perineal laceration during delivery"	1	0	81	81
"D07"	"O70"	"Carcinoma in situ of other and unspecified genital organs"	"Perineal laceration during delivery"	1	0	48	48
"D12"	"O70"	"Benign neoplasm of colon, rectum, anus and anal canal"	"Perineal laceration during delivery"	1	0	445	445
"D23"	"O70"	"Other benign neoplasms of skin"	"Perineal laceration during delivery"	1	458	1091	1549
"D86"	"O70"	"Sarcoidosis"	"Perineal laceration during delivery"	1	103	338	441
"E55"	"O70"	"Vitamin D deficiency"	"Perineal laceration during delivery"	1	125	554	679
"G57"	"O70"	"Mononeuropathies of lower limb"	"Perineal laceration during delivery"	1	38	336	374
"H11"	"O70"	"Other disorders of conjunctiva"	"Perineal laceration during delivery"	1	60	178	238
"H33"	"O70"	"Retinal detachments and breaks"	"Perineal laceration during delivery"	1	0	115	115
"H52"	"O70"	"Disorders of refraction and accommodation"	"Perineal laceration during delivery"	1	606	1300	1906
"H91"	"O70"	"Other and unspecified hearing loss"	"Perineal laceration during delivery"	1	143	612	755
"I34"	"O70"	"Nonrheumatic mitral valve disorders"	"Perineal laceration during delivery"	1	13	90	103
"I42"	"O70"	"Cardiomyopathy"	"Perineal laceration during delivery"	1	1	99	100
"I47"	"O70"	"Paroxysmal tachycardia"	"Perineal laceration during delivery"	1	350	608	958
"I69"	"O70"	"Sequelae of cerebrovascular disease"	"Perineal laceration during delivery"	1	0	169	169
"I80"	"O70"	"Phlebitis and thrombophlebitis"	"Perineal laceration during delivery"	1	226	842	1068
"J22"	"O70"	"Unspecified acute lower respiratory infection"	"Perineal laceration during delivery"	1	13	93	106
"J44"	"O70"	"Other chronic obstructive pulmonary disease"	"Perineal laceration during delivery"	1	0	169	169
"K13"	"O70"	"Other diseases of lip and oral mucosa"	"Perineal laceration during delivery"	1	35	94	129
"K45"	"O70"	"Other abdominal hernia"	"Perineal laceration during delivery"	1	0	436	436
"K74"	"O70"	"Fibrosis and cirrhosis of liver"	"Perineal laceration during delivery"	1	0	29	29
"L30"	"O70"	"Other and unspecified dermatitis"	"Perineal laceration during delivery"	1	293	718	1011
"L72"	"O70"	"Follicular cysts of skin and subcutaneous tissue"	"Perineal laceration during delivery"	1	39	364	403
"M31"	"O70"	"Other necrotizing vasculopathies"	"Perineal laceration during delivery"	1	6	65	71
"M77"	"O70"	"Other enthesopathies"	"Perineal laceration during delivery"	1	117	1269	1386
"N71"	"O70"	"Inflammatory disease of uterus, except cervix"	"Perineal laceration during delivery"	1	985	1821	2806
"N82"	"O70"	"Fistulae involving female genital tract"	"Perineal laceration during delivery"	1	17	209	226
"N84"	"O70"	"Polyp of female genital tract"	"Perineal laceration during delivery"	1	0	1663	1663
"N85"	"O70"	"Other noninflammatory disorders of uterus, except cervix"	"Perineal laceration during delivery"	1	56	427	483
"D25"	"O71"	"Leiomyoma of uterus"	"Other obstetric trauma"	1	0	228	228
"D68"	"O71"	"Other coagulation defects"	"Other obstetric trauma"	1	54	165	219
"E83"	"O71"	"Disorders of mineral metabolism"	"Other obstetric trauma"	1	0	26	26
"G57"	"O71"	"Mononeuropathies of lower limb"	"Other obstetric trauma"	1	5	62	67
"I15"	"O71"	"Secondary hypertension"	"Other obstetric trauma"	1	1	29	30
"K52"	"O71"	"Other and unsp noninfective gastroenteritis and colitis"	"Other obstetric trauma"	1	54	161	215
"K81"	"O71"	"Cholecystitis"	"Other obstetric trauma"	1	9	128	137
"K90"	"O71"	"Intestinal malabsorption"	"Other obstetric trauma"	1	1	76	77
"N20"	"O71"	"Calculus of kidney and ureter"	"Other obstetric trauma"	1	26	366	392
"N82"	"O71"	"Fistulae involving female genital tract"	"Other obstetric trauma"	1	2	27	29
"C34"	"O72"	"Malignant neoplasm of bronchus and lung"	"Postpartum hemorrhage"	1	1	27	28
"C79"	"O72"	"Secondary malignant neoplasm of other and unspecified sites"	"Postpartum hemorrhage"	1	0	74	74
"K45"	"O72"	"Other abdominal hernia"	"Postpartum hemorrhage"	1	189	323	512
"G98"	"O75"	"Other disorders of nervous system not elsewhere classified"	"Oth complications of labor and delivery, NEC"	1	0	37	37
"H52"	"O75"	"Disorders of refraction and accommodation"	"Oth complications of labor and delivery, NEC"	1	125	243	368
"J44"	"O75"	"Other chronic obstructive pulmonary disease"	"Oth complications of labor and delivery, NEC"	1	0	49	49
"K21"	"O75"	"Gastro-esophageal reflux disease"	"Oth complications of labor and delivery, NEC"	1	57	184	241
"K85"	"O75"	"Acute pancreatitis"	"Oth complications of labor and delivery, NEC"	1	19	113	132
"L90"	"O75"	"Atrophic disorders of skin"	"Oth complications of labor and delivery, NEC"	1	85	251	336
"M79"	"O75"	"Oth and unsp soft tissue disorders, not elsewhere classified"	"Oth complications of labor and delivery, NEC"	1	340	561	901
"N39"	"O75"	"Other disorders of urinary system"	"Oth complications of labor and delivery, NEC"	1	69	736	805
"N93"	"O75"	"Other abnormal uterine and vaginal bleeding"	"Oth complications of labor and delivery, NEC"	1	140	450	590
"A46"	"O80"	"Erysipelas"	"Encounter for full-term uncomplicated delivery"	1	0	672	672
"C85"	"O80"	"Oth and unspecified types of non-Hodgkin lymphoma"	"Encounter for full-term uncomplicated delivery"	1	1	76	77
"C92"	"O80"	"Myeloid leukemia"	"Encounter for full-term uncomplicated delivery"	1	0	58	58
"D22"	"O80"	"Melanocytic nevi"	"Encounter for full-term uncomplicated delivery"	1	0	2911	2911
"D30"	"O80"	"Benign neoplasm of urinary organs"	"Encounter for full-term uncomplicated delivery"	1	0	57	57
"D51"	"O80"	"Vitamin B12 deficiency anemia"	"Encounter for full-term uncomplicated delivery"	1	19	271	290
"D84"	"O80"	"Other immunodeficiencies"	"Encounter for full-term uncomplicated delivery"	1	0	76	76
"E53"	"O80"	"Deficiency of other B group vitamins"	"Encounter for full-term uncomplicated delivery"	1	0	71	71
"E65"	"O80"	"Localized adiposity"	"Encounter for full-term uncomplicated delivery"	1	0	1562	1562
"E80"	"O80"	"Disorders of porphyrin and bilirubin metabolism"	"Encounter for full-term uncomplicated delivery"	1	19	130	149
"E86"	"O80"	"Volume depletion"	"Encounter for full-term uncomplicated delivery"	1	51	725	776
"F34"	"O80"	"Persistent mood [affective] disorders"	"Encounter for full-term uncomplicated delivery"	1	0	115	115
"G64"	"O80"	"Other disorders of peripheral nervous system"	"Encounter for full-term uncomplicated delivery"	1	0	66	66
"G71"	"O80"	"Primary disorders of muscles"	"Encounter for full-term uncomplicated delivery"	1	0	49	49
"H36"	"O80"	"Retinal disorders in diseases classified elsewhere"	"Encounter for full-term uncomplicated delivery"	1	0	263	263
"I63"	"O80"	"Cerebral infarction"	"Encounter for full-term uncomplicated delivery"	1	0	355	355
"I70"	"O80"	"Atherosclerosis"	"Encounter for full-term uncomplicated delivery"	1	0	150	150
"I71"	"O80"	"Aortic aneurysm and dissection"	"Encounter for full-term uncomplicated delivery"	1	0	54	54
"J01"	"O80"	"Acute sinusitis"	"Encounter for full-term uncomplicated delivery"	1	0	1887	1887
"J09"	"O80"	"Influenza due to certain identified influenza viruses"	"Encounter for full-term uncomplicated delivery"	1	0	117	117
"J10"	"O80"	"Influenza due to other identified influenza virus"	"Encounter for full-term uncomplicated delivery"	1	0	141	141
"J31"	"O80"	"Chronic rhinitis, nasopharyngitis and pharyngitis"	"Encounter for full-term uncomplicated delivery"	1	49	328	377
"K05"	"O80"	"Gingivitis and periodontal diseases"	"Encounter for full-term uncomplicated delivery"	1	0	328	328
"K08"	"O80"	"Other disorders of teeth and supporting structures"	"Encounter for full-term uncomplicated delivery"	1	63	433	496
"K22"	"O80"	"Other diseases of esophagus"	"Encounter for full-term uncomplicated delivery"	1	1	328	329
"K37"	"O80"	"Unspecified appendicitis"	"Encounter for full-term uncomplicated delivery"	1	52	301	353
"K57"	"O80"	"Diverticular disease of intestine"	"Encounter for full-term uncomplicated delivery"	1	0	296	296
"K59"	"O80"	"Other functional intestinal disorders"	"Encounter for full-term uncomplicated delivery"	1	0	4358	4358
"K70"	"O80"	"Alcoholic liver disease"	"Encounter for full-term uncomplicated delivery"	1	0	42	42
"K76"	"O80"	"Other diseases of liver"	"Encounter for full-term uncomplicated delivery"	1	0	517	517
"K90"	"O80"	"Intestinal malabsorption"	"Encounter for full-term uncomplicated delivery"	1	5	435	440
"M12"	"O80"	"Other and unspecified arthropathy"	"Encounter for full-term uncomplicated delivery"	1	32	110	142
"M48"	"O80"	"Other spondylopathies"	"Encounter for full-term uncomplicated delivery"	1	0	294	294
"M50"	"O80"	"Cervical disc disorders"	"Encounter for full-term uncomplicated delivery"	1	0	1155	1155
"M60"	"O80"	"Myositis"	"Encounter for full-term uncomplicated delivery"	1	1	112	113
"M71"	"O80"	"Other bursopathies"	"Encounter for full-term uncomplicated delivery"	1	20	475	495
"N04"	"O80"	"Nephrotic syndrome"	"Encounter for full-term uncomplicated delivery"	1	8	58	66
"N39"	"O80"	"Other disorders of urinary system"	"Encounter for full-term uncomplicated delivery"	1	0	5649	5649
"N61"	"O80"	"Inflammatory disorders of breast"	"Encounter for full-term uncomplicated delivery"	1	0	1473	1473
"O61"	"O80"	"Failed induction of labor"	"Encounter for full-term uncomplicated delivery"	1	151	315	466
"C49"	"O82"	"Malignant neoplasm of other connective and soft tissue"	"Encounter for cesarean delivery without indication"	1	5	44	49
"D17"	"O82"	"Benign lipomatous neoplasm"	"Encounter for cesarean delivery without indication"	1	32	776	808
"D63"	"O82"	"Anemia in chronic diseases classified elsewhere"	"Encounter for cesarean delivery without indication"	1	0	30	30
"E83"	"O82"	"Disorders of mineral metabolism"	"Encounter for cesarean delivery without indication"	1	0	76	76
"F33"	"O82"	"Major depressive disorder, recurrent"	"Encounter for cesarean delivery without indication"	1	203	516	719
"G47"	"O82"	"Sleep disorders"	"Encounter for cesarean delivery without indication"	1	0	467	467
"H43"	"O82"	"Disorders of vitreous body"	"Encounter for cesarean delivery without indication"	1	0	116	116
"H47"	"O82"	"Other disorders of optic [2nd] nerve and visual pathways"	"Encounter for cesarean delivery without indication"	1	24	81	105
"I21"	"O82"	"Acute myocardial infarction"	"Encounter for cesarean delivery without indication"	1	0	129	129
"I27"	"O82"	"Other pulmonary heart diseases"	"Encounter for cesarean delivery without indication"	1	1	29	30
"I48"	"O82"	"Atrial fibrillation and flutter"	"Encounter for cesarean delivery without indication"	1	0	204	204
"I80"	"O82"	"Phlebitis and thrombophlebitis"	"Encounter for cesarean delivery without indication"	1	190	644	834
"J03"	"O82"	"Acute tonsillitis"	"Encounter for cesarean delivery without indication"	1	958	1358	2316
"J15"	"O82"	"Bacterial pneumonia, not elsewhere classified"	"Encounter for cesarean delivery without indication"	1	29	568	597
"K25"	"O82"	"Gastric ulcer"	"Encounter for cesarean delivery without indication"	1	28	210	238
"K28"	"O82"	"Gastrojejunal ulcer"	"Encounter for cesarean delivery without indication"	1	0	33	33
"K56"	"O82"	"Paralytic ileus and intestinal obstruction without hernia"	"Encounter for cesarean delivery without indication"	1	312	579	891
"M05"	"O82"	"Rheumatoid arthritis with rheumatoid factor"	"Encounter for cesarean delivery without indication"	1	11	242	253
"M20"	"O82"	"Acquired deformities of fingers and toes"	"Encounter for cesarean delivery without indication"	1	207	686	893
"M46"	"O82"	"Other inflammatory spondylopathies"	"Encounter for cesarean delivery without indication"	1	21	251	272
"M85"	"O82"	"Other disorders of bone density and structure"	"Encounter for cesarean delivery without indication"	1	0	253	253
"N12"	"O82"	"Tubulo-interstitial nephritis, not spcf as acute or chronic"	"Encounter for cesarean delivery without indication"	1	65	169	234
"N20"	"O82"	"Calculus of kidney and ureter"	"Encounter for cesarean delivery without indication"	1	300	957	1257
"Q65"	"O82"	"Congenital deformities of hip"	"Encounter for cesarean delivery without indication"	1	65	171	236
"M75"	"O86"	"Shoulder lesions"	"Other puerperal infections"	1	0	184	184
"J18"	"O87"	"Pneumonia, unspecified organism"	"Venous complications and hemorrhoids in the puerperium"	1	21	81	102
"M75"	"O87"	"Shoulder lesions"	"Venous complications and hemorrhoids in the puerperium"	1	0	54	54
"O91"	"O87"	"Infect of breast assoc w pregnancy, the puerp and lactation"	"Venous complications and hemorrhoids in the puerperium"	1	60	145	205
"G96"	"O90"	"Other disorders of central nervous system"	"Complications of the puerperium, not elsewhere classified"	1	12	60	72
"M50"	"O90"	"Cervical disc disorders"	"Complications of the puerperium, not elsewhere classified"	1	0	108	108
"E11"	"O91"	"Type 2 diabetes mellitus"	"Infect of breast assoc w pregnancy, the puerp and lactation"	1	3	40	43
"A41"	"O99"	"Other sepsis"	"Oth maternal diseases classd elsw but compl preg/chldbrth"	1	143	540	683
"D05"	"O99"	"Carcinoma in situ of breast"	"Oth maternal diseases classd elsw but compl preg/chldbrth"	1	0	63	63
"D47"	"O99"	"Oth neoplm of uncrt behav of lymphoid, hematpoetc & rel tiss"	"Oth maternal diseases classd elsw but compl preg/chldbrth"	1	3	39	42
"H01"	"O99"	"Other inflammation of eyelid"	"Oth maternal diseases classd elsw but compl preg/chldbrth"	1	25	107	132
"J32"	"O99"	"Chronic sinusitis"	"Oth maternal diseases classd elsw but compl preg/chldbrth"	1	236	441	677
"K45"	"O99"	"Other abdominal hernia"	"Oth maternal diseases classd elsw but compl preg/chldbrth"	1	38	472	510
"K86"	"O99"	"Other diseases of pancreas"	"Oth maternal diseases classd elsw but compl preg/chldbrth"	1	29	84	113
"M15"	"O99"	"Polyosteoarthritis"	"Oth maternal diseases classd elsw but compl preg/chldbrth"	1	0	42	42
"M16"	"O99"	"Osteoarthritis of hip"	"Oth maternal diseases classd elsw but compl preg/chldbrth"	1	27	303	330
"M19"	"O99"	"Other and unspecified osteoarthritis"	"Oth maternal diseases classd elsw but compl preg/chldbrth"	1	2	660	662
"M51"	"O99"	"Thoracic, thoracolum, and lumbosacral intvrt disc disorders"	"Oth maternal diseases classd elsw but compl preg/chldbrth"	1	765	2522	3287
"M53"	"O99"	"Other and unspecified dorsopathies, not elsewhere classified"	"Oth maternal diseases classd elsw but compl preg/chldbrth"	1	534	866	1400
"N39"	"O99"	"Other disorders of urinary system"	"Oth maternal diseases classd elsw but compl preg/chldbrth"	1	768	2764	3532
"N99"	"O99"	"Intraop and postproc comp and disorders of GU sys, NEC"	"Oth maternal diseases classd elsw but compl preg/chldbrth"	1	169	343	512
"H55"	"Q03"	"Nystagmus and other irregular eye movements"	"Congenital hydrocephalus"	1	2	37	39
"N20"	"Q05"	"Calculus of kidney and ureter"	"Spina bifida"	1	0	33	33
"M23"	"Q10"	"Internal derangement of knee"	"Congenital malform of eyelid, lacrimal apparatus and orbit"	1	1	46	47
"D24"	"Q17"	"Benign neoplasm of breast"	"Other congenital malformations of ear"	1	0	54	54
"D64"	"Q17"	"Other anemias"	"Other congenital malformations of ear"	1	0	29	29
"K60"	"Q17"	"Fissure and fistula of anal and rectal regions"	"Other congenital malformations of ear"	1	3	37	40
"N70"	"Q17"	"Salpingitis and oophoritis"	"Other congenital malformations of ear"	1	0	25	25
"N87"	"Q17"	"Dysplasia of cervix uteri"	"Other congenital malformations of ear"	1	0	66	66
"O70"	"Q17"	"Perineal laceration during delivery"	"Other congenital malformations of ear"	1	0	296	296
"C09"	"Q18"	"Malignant neoplasm of tonsil"	"Other congenital malformations of face and neck"	1	19	102	121
"C77"	"Q18"	"Secondary and unspecified malignant neoplasm of lymph nodes"	"Other congenital malformations of face and neck"	1	41	237	278
"D63"	"Q18"	"Anemia in chronic diseases classified elsewhere"	"Other congenital malformations of face and neck"	1	4	33	37
"M48"	"Q18"	"Other spondylopathies"	"Other congenital malformations of face and neck"	1	2	46	48
"M79"	"Q18"	"Oth and unsp soft tissue disorders, not elsewhere classified"	"Other congenital malformations of face and neck"	1	128	226	354
"I47"	"Q20"	"Paroxysmal tachycardia"	"Congenital malformations of cardiac chambers and connections"	1	11	76	87
"J03"	"Q20"	"Acute tonsillitis"	"Congenital malformations of cardiac chambers and connections"	1	14	103	117
"E64"	"Q21"	"Sequelae of malnutrition and other nutritional deficiencies"	"Congenital malformations of cardiac septa"	1	14	123	137
"E66"	"Q21"	"Overweight and obesity"	"Congenital malformations of cardiac septa"	1	35	223	258
"G81"	"Q21"	"Hemiplegia and hemiparesis"	"Congenital malformations of cardiac septa"	1	13	58	71
"J91"	"Q21"	"Pleural effusion in conditions classified elsewhere"	"Congenital malformations of cardiac septa"	1	3	32	35
"M13"	"Q21"	"Other arthritis"	"Congenital malformations of cardiac septa"	1	3	60	63
"M41"	"Q21"	"Scoliosis"	"Congenital malformations of cardiac septa"	1	0	116	116
"N30"	"Q21"	"Cystitis"	"Congenital malformations of cardiac septa"	1	75	322	397
"H52"	"Q24"	"Disorders of refraction and accommodation"	"Other congenital malformations of heart"	1	28	133	161
"F79"	"Q25"	"Unspecified intellectual disabilities"	"Congenital malformations of great arteries"	1	15	77	92
"G80"	"Q25"	"Cerebral palsy"	"Congenital malformations of great arteries"	1	33	253	286
"J03"	"Q25"	"Acute tonsillitis"	"Congenital malformations of great arteries"	1	58	362	420
"J14"	"Q25"	"Pneumonia due to Hemophilus influenzae"	"Congenital malformations of great arteries"	1	24	76	100
"J30"	"Q25"	"Vasomotor and allergic rhinitis"	"Congenital malformations of great arteries"	1	6	51	57
"J44"	"Q28"	"Other chronic obstructive pulmonary disease"	"Other congenital malformations of circulatory system"	1	22	71	93
"H90"	"Q31"	"Conductive and sensorineural hearing loss"	"Congenital malformations of larynx"	1	1	27	28
"J18"	"Q31"	"Pneumonia, unspecified organism"	"Congenital malformations of larynx"	1	76	197	273
"J45"	"Q31"	"Asthma"	"Congenital malformations of larynx"	1	80	197	277
"H72"	"Q35"	"Perforation of tympanic membrane"	"Cleft palate"	1	1	57	58
"B34"	"Q37"	"Viral infection of unspecified site"	"Cleft palate with cleft lip"	1	44	141	185
"H65"	"Q39"	"Nonsuppurative otitis media"	"Congenital malformations of esophagus"	1	9	73	82
"K59"	"Q39"	"Other functional intestinal disorders"	"Congenital malformations of esophagus"	1	19	73	92
"K59"	"Q41"	"Other functional intestinal disorders"	"Congenital absence, atresia and stenosis of small intestine"	1	3	74	77
"B34"	"Q43"	"Viral infection of unspecified site"	"Other congenital malformations of intestine"	1	70	161	231
"O72"	"Q43"	"Postpartum hemorrhage"	"Other congenital malformations of intestine"	1	0	26	26
"O26"	"Q51"	"Maternal care for oth conditions predom related to pregnancy"	"Congenital malformations of uterus and cervix"	1	83	172	255
"O72"	"Q51"	"Postpartum hemorrhage"	"Congenital malformations of uterus and cervix"	1	217	578	795
"O82"	"Q52"	"Encounter for cesarean delivery without indication"	"Other congenital malformations of female genitalia"	1	4	89	93
"D16"	"Q53"	"Benign neoplasm of bone and articular cartilage"	"Undescended and ectopic testicle"	1	0	29	29
"D69"	"Q53"	"Purpura and other hemorrhagic conditions"	"Undescended and ectopic testicle"	1	23	78	101
"G43"	"Q53"	"Migraine"	"Undescended and ectopic testicle"	1	0	84	84
"G51"	"Q53"	"Facial nerve disorders"	"Undescended and ectopic testicle"	1	1	30	31
"H91"	"Q53"	"Other and unspecified hearing loss"	"Undescended and ectopic testicle"	1	44	198	242
"I49"	"Q53"	"Other cardiac arrhythmias"	"Undescended and ectopic testicle"	1	0	25	25
"J30"	"Q53"	"Vasomotor and allergic rhinitis"	"Undescended and ectopic testicle"	1	13	247	260
"L05"	"Q53"	"Pilonidal cyst and sinus"	"Undescended and ectopic testicle"	1	0	38	38
"M08"	"Q53"	"Juvenile arthritis"	"Undescended and ectopic testicle"	1	4	35	39
"M25"	"Q53"	"Other joint disorder, not elsewhere classified"	"Undescended and ectopic testicle"	1	2	118	120
"M67"	"Q53"	"Other disorders of synovium and tendon"	"Undescended and ectopic testicle"	1	0	152	152
"M92"	"Q53"	"Other juvenile osteochondrosis"	"Undescended and ectopic testicle"	1	0	40	40
"D64"	"Q54"	"Other anemias"	"Hypospadias"	1	0	64	64
"H50"	"Q54"	"Other strabismus"	"Hypospadias"	1	19	70	89
"I47"	"Q54"	"Paroxysmal tachycardia"	"Hypospadias"	1	10	52	62
"M24"	"Q54"	"Other specific joint derangements"	"Hypospadias"	1	10	50	60
"J06"	"Q61"	"Acute upper resp infections of multiple and unsp sites"	"Cystic kidney disease"	1	37	103	140
"L82"	"Q61"	"Seborrheic keratosis"	"Cystic kidney disease"	1	4	45	49
"N47"	"Q62"	"Disorders of prepuce"	"Congen defects of renal pelvis and congen malform of ureter"	1	43	128	171
"F43"	"Q64"	"Reaction to severe stress, and adjustment disorders"	"Other congenital malformations of urinary system"	1	1	25	26
"G47"	"Q65"	"Sleep disorders"	"Congenital deformities of hip"	1	22	105	127
"I10"	"Q65"	"Essential (primary) hypertension"	"Congenital deformities of hip"	1	85	177	262
"J44"	"Q65"	"Other chronic obstructive pulmonary disease"	"Congenital deformities of hip"	1	36	105	141
"K64"	"Q65"	"Hemorrhoids and perianal venous thrombosis"	"Congenital deformities of hip"	1	11	67	78
"N39"	"Q65"	"Other disorders of urinary system"	"Congenital deformities of hip"	1	125	224	349
"C34"	"Q66"	"Malignant neoplasm of bronchus and lung"	"Congenital deformities of feet"	1	0	43	43
"F41"	"Q66"	"Other anxiety disorders"	"Congenital deformities of feet"	1	1	52	53
"K62"	"Q66"	"Other diseases of anus and rectum"	"Congenital deformities of feet"	1	58	150	208
"K80"	"Q66"	"Cholelithiasis"	"Congenital deformities of feet"	1	60	132	192
"L89"	"Q66"	"Pressure ulcer"	"Congenital deformities of feet"	1	3	59	62
"L97"	"Q66"	"Non-pressure chronic ulcer of lower limb, NEC"	"Congenital deformities of feet"	1	14	70	84
"O34"	"Q66"	"Maternal care for abnormality of pelvic organs"	"Congenital deformities of feet"	1	6	43	49
"O99"	"Q66"	"Oth maternal diseases classd elsw but compl preg/chldbrth"	"Congenital deformities of feet"	1	23	233	256
"O70"	"Q72"	"Perineal laceration during delivery"	"Reduction defects of lower limb"	1	0	77	77
"J30"	"Q74"	"Vasomotor and allergic rhinitis"	"Other congenital malformations of limb(s)"	1	3	37	40
"K00"	"Q74"	"Disorders of tooth development and eruption"	"Other congenital malformations of limb(s)"	1	12	60	72
"I10"	"Q78"	"Essential (primary) hypertension"	"Other osteochondrodysplasias"	1	19	155	174
"A04"	"Q79"	"Other bacterial intestinal infections"	"Congenital malformations of musculoskeletal system, NEC"	1	1	24	25
"K56"	"Q79"	"Paralytic ileus and intestinal obstruction without hernia"	"Congenital malformations of musculoskeletal system, NEC"	1	19	74	93
"A49"	"Q82"	"Bacterial infection of unspecified site"	"Other congenital malformations of skin"	1	24	93	117
"C34"	"Q82"	"Malignant neoplasm of bronchus and lung"	"Other congenital malformations of skin"	1	2	47	49
"M54"	"Q82"	"Dorsalgia"	"Other congenital malformations of skin"	1	167	304	471
"M81"	"Q82"	"Osteoporosis without current pathological fracture"	"Other congenital malformations of skin"	1	42	162	204
"F79"	"Q85"	"Unspecified intellectual disabilities"	"Phakomatoses, not elsewhere classified"	1	5	42	47
"G47"	"Q85"	"Sleep disorders"	"Phakomatoses, not elsewhere classified"	1	9	54	63
"G96"	"Q85"	"Other disorders of central nervous system"	"Phakomatoses, not elsewhere classified"	1	6	49	55
"J15"	"Q85"	"Bacterial pneumonia, not elsewhere classified"	"Phakomatoses, not elsewhere classified"	1	24	74	98
"O72"	"Q85"	"Postpartum hemorrhage"	"Phakomatoses, not elsewhere classified"	1	5	42	47
"H27"	"Q87"	"Other disorders of lens"	"Oth congenital malform syndromes affecting multiple systems"	1	22	69	91
"H54"	"Q90"	"Blindness and low vision"	"Down syndrome"	1	5	38	43
"H55"	"Q90"	"Nystagmus and other irregular eye movements"	"Down syndrome"	1	10	63	73
"H66"	"Q90"	"Suppurative and unspecified otitis media"	"Down syndrome"	1	30	134	164
"I46"	"Q90"	"Cardiac arrest"	"Down syndrome"	1	1	28	29
"J35"	"Q90"	"Chronic diseases of tonsils and adenoids"	"Down syndrome"	1	31	343	374
"K59"	"Q90"	"Other functional intestinal disorders"	"Down syndrome"	1	35	169	204
"O72"	"Q96"	"Postpartum hemorrhage"	"Turner's syndrome"	1	1	42	43
"A41"	"C44"	"Other sepsis"	"Other and unspecified malignant neoplasm of skin"	1	955	2795	3750
"K29"	"M62"	"Gastritis and duodenitis"	"Other disorders of muscle"	1	2464	3711	6175
"K59"	"C56"	"Other functional intestinal disorders"	"Malignant neoplasm of ovary"	1	515	1675	2190
"C44"	"K20"	"Other and unspecified malignant neoplasm of skin"	"Esophagitis"	1	152	319	471
"I47"	"M23"	"Paroxysmal tachycardia"	"Internal derangement of knee"	1	1008	1298	2306
"L98"	"O24"	"Oth disorders of skin, subcu, not elsewhere classified"	"Diabetes in pregnancy, childbirth, and the puerperium"	1	12	62	74
"M13"	"O02"	"Other arthritis"	"Other abnormal products of conception"	1	28	189	217
"O90"	"O13"	"Complications of the puerperium, not elsewhere classified"	"Gestational hypertension without significant proteinuria"	1	278	814	1092
"C77"	"J36"	"Secondary and unspecified malignant neoplasm of lymph nodes"	"Peritonsillar abscess"	1	0	50	50
"L08"	"M22"	"Other local infections of skin and subcutaneous tissue"	"Disorder of patella"	1	93	490	583
"G56"	"K35"	"Mononeuropathies of upper limb"	"Acute appendicitis"	1	304	1050	1354
"N18"	"K21"	"Chronic kidney disease (CKD)"	"Gastro-esophageal reflux disease"	1	298	1747	2045
"L63"	"O80"	"Alopecia areata"	"Encounter for full-term uncomplicated delivery"	1	29	102	131
"E27"	"H25"	"Other disorders of adrenal gland"	"Age-related cataract"	1	306	460	766
"M75"	"A09"	"Shoulder lesions"	"Infectious gastroenteritis and colitis, unspecified"	1	1024	1675	2699
"C79"	"L71"	"Secondary malignant neoplasm of other and unspecified sites"	"Rosacea"	1	2	45	47
"D72"	"M51"	"Other disorders of white blood cells"	"Thoracic, thoracolum, and lumbosacral intvrt disc disorders"	1	52	156	208
"H53"	"L02"	"Visual disturbances"	"Cutaneous abscess, furuncle and carbuncle"	1	200	458	658
"O13"	"L05"	"Gestational hypertension without significant proteinuria"	"Pilonidal cyst and sinus"	1	5	52	57
"O10"	"A63"	"Pre-existing hypertension compl preg/chldbrth"	"Oth predominantly sexually transmitted diseases, NEC"	1	0	60	60
"O61"	"O26"	"Failed induction of labor"	"Maternal care for oth conditions predom related to pregnancy"	1	345	589	934
"G23"	"C50"	"Other degenerative diseases of basal ganglia"	"Malignant neoplasm of breast"	1	1	25	26
"N18"	"L50"	"Chronic kidney disease (CKD)"	"Urticaria"	1	63	291	354
"F03"	"D30"	"Unspecified dementia"	"Benign neoplasm of urinary organs"	1	0	586	586
"I70"	"M75"	"Atherosclerosis"	"Shoulder lesions"	1	1000	1407	2407
"H02"	"N60"	"Other disorders of eyelid"	"Benign mammary dysplasia"	1	70	415	485
"C55"	"C53"	"Malignant neoplasm of uterus, part unspecified"	"Malignant neoplasm of cervix uteri"	1	105	313	418
"J44"	"D24"	"Other chronic obstructive pulmonary disease"	"Benign neoplasm of breast"	1	69	890	959
"F43"	"N87"	"Reaction to severe stress, and adjustment disorders"	"Dysplasia of cervix uteri"	1	92	328	420
"J81"	"M48"	"Pulmonary edema"	"Other spondylopathies"	1	94	531	625
"O36"	"H66"	"Maternal care for other fetal problems"	"Suppurative and unspecified otitis media"	1	29	118	147
"C79"	"N60"	"Secondary malignant neoplasm of other and unspecified sites"	"Benign mammary dysplasia"	1	0	270	270
"C77"	"K29"	"Secondary and unspecified malignant neoplasm of lymph nodes"	"Gastritis and duodenitis"	1	126	636	762
"H40"	"O04"	"Glaucoma"	"Complications following (induced) termination of pregnancy"	1	0	79	79
"G62"	"J34"	"Other and unspecified polyneuropathies"	"Other and unspecified disorders of nose and nasal sinuses"	1	18	238	256
"D12"	"O36"	"Benign neoplasm of colon, rectum, anus and anal canal"	"Maternal care for other fetal problems"	1	0	132	132
"F02"	"K59"	"Dementia in other diseases classified elsewhere"	"Other functional intestinal disorders"	1	203	356	559
"I11"	"O80"	"Hypertensive heart disease"	"Encounter for full-term uncomplicated delivery"	1	0	25	25
"E41"	"K22"	"Nutritional marasmus"	"Other diseases of esophagus"	1	73	180	253
"N13"	"H83"	"Obstructive and reflux uropathy"	"Other diseases of inner ear"	1	8	408	416
"L02"	"O02"	"Cutaneous abscess, furuncle and carbuncle"	"Other abnormal products of conception"	1	328	514	842
"C24"	"K40"	"Malignant neoplasm of other and unsp parts of biliary tract"	"Inguinal hernia"	1	6	102	108
"C13"	"I20"	"Malignant neoplasm of hypopharynx"	"Angina pectoris"	1	6	97	103
"E13"	"H81"	"Other specified diabetes mellitus"	"Disorders of vestibular function"	1	24	82	106
"I48"	"Q78"	"Atrial fibrillation and flutter"	"Other osteochondrodysplasias"	1	4	59	63
"I35"	"N35"	"Nonrheumatic aortic valve disorders"	"Urethral stricture"	1	78	228	306
"D47"	"I83"	"Oth neoplm of uncrt behav of lymphoid, hematpoetc & rel tiss"	"Varicose veins of lower extremities"	1	30	305	335
"D22"	"E11"	"Melanocytic nevi"	"Type 2 diabetes mellitus"	1	206	342	548
"D10"	"K35"	"Benign neoplasm of mouth and pharynx"	"Acute appendicitis"	1	38	112	150
"C41"	"I10"	"Malignant neoplasm of bone/artic cartl of and unsp sites"	"Essential (primary) hypertension"	1	106	205	311
"A46"	"B27"	"Erysipelas"	"Infectious mononucleosis"	1	2	67	69
"C78"	"E55"	"Secondary malignant neoplasm of resp and digestive organs"	"Vitamin D deficiency"	1	72	195	267
"F32"	"C50"	"Depressive episode"	"Malignant neoplasm of breast"	1	436	1445	1881
"G23"	"I83"	"Other degenerative diseases of basal ganglia"	"Varicose veins of lower extremities"	1	0	33	33
"F02"	"I10"	"Dementia in other diseases classified elsewhere"	"Essential (primary) hypertension"	1	264	875	1139
"A41"	"Q65"	"Other sepsis"	"Congenital deformities of hip"	1	26	81	107
"G62"	"H10"	"Other and unspecified polyneuropathies"	"Conjunctivitis"	1	35	346	381
"C78"	"O32"	"Secondary malignant neoplasm of resp and digestive organs"	"Maternal care for malpresentation of fetus"	1	0	29	29
"K04"	"O36"	"Diseases of pulp and periapical tissues"	"Maternal care for other fetal problems"	1	34	95	129
"C53"	"O02"	"Malignant neoplasm of cervix uteri"	"Other abnormal products of conception"	1	7	98	105
"E10"	"O03"	"Type 1 diabetes mellitus"	"Spontaneous abortion"	1	82	191	273
"E87"	"H80"	"Other disorders of fluid, electrolyte and acid-base balance"	"Otosclerosis"	1	0	194	194
"O80"	"O47"	"Encounter for full-term uncomplicated delivery"	"False labor"	1	16437	18222	34659
"A49"	"L03"	"Bacterial infection of unspecified site"	"Cellulitis and acute lymphangitis"	1	567	1041	1608
"K60"	"O30"	"Fissure and fistula of anal and rectal regions"	"Multiple gestation"	1	32	108	140
"O98"	"O20"	"Matern infec/parastc dis classd elsw but compl preg/chldbrth"	"Hemorrhage in early pregnancy"	1	85	433	518
"I50"	"J30"	"Heart failure"	"Vasomotor and allergic rhinitis"	1	35	267	302
"F41"	"C45"	"Other anxiety disorders"	"Mesothelioma"	1	26	176	202
"E03"	"B27"	"Other hypothyroidism"	"Infectious mononucleosis"	1	0	55	55
"C64"	"N92"	"Malignant neoplasm of kidney, except renal pelvis"	"Excessive, frequent and irregular menstruation"	1	0	127	127
"M65"	"O71"	"Synovitis and tenosynovitis"	"Other obstetric trauma"	1	169	493	662
"K21"	"J36"	"Gastro-esophageal reflux disease"	"Peritonsillar abscess"	1	47	200	247
"N75"	"O64"	"Diseases of Bartholin's gland"	"Obstructed labor due to malposition and malpresent of fetus"	1	40	139	179
"J95"	"M19"	"Intraop and postproc comp and disorders of resp sys, NEC"	"Other and unspecified osteoarthritis"	1	27	112	139
"I21"	"C50"	"Acute myocardial infarction"	"Malignant neoplasm of breast"	1	612	1143	1755
"J20"	"G35"	"Acute bronchitis"	"Multiple sclerosis"	1	24	106	130
"E86"	"M10"	"Volume depletion"	"Gout"	1	1594	3083	4677
"K05"	"C83"	"Gingivitis and periodontal diseases"	"Non-follicular lymphoma"	1	180	329	509
"D68"	"K05"	"Other coagulation defects"	"Gingivitis and periodontal diseases"	1	89	176	265
"C34"	"M60"	"Malignant neoplasm of bronchus and lung"	"Myositis"	1	3	63	66
"E27"	"E78"	"Other disorders of adrenal gland"	"Disorders of lipoprotein metabolism and other lipidemias"	1	198	453	651
"M54"	"A63"	"Dorsalgia"	"Oth predominantly sexually transmitted diseases, NEC"	1	566	1134	1700
"K63"	"H52"	"Other diseases of intestine"	"Disorders of refraction and accommodation"	1	30	105	135
"A40"	"I12"	"Streptococcal sepsis"	"Hypertensive chronic kidney disease"	1	15	59	74
"I50"	"N71"	"Heart failure"	"Inflammatory disease of uterus, except cervix"	1	42	121	163
"I35"	"H91"	"Nonrheumatic aortic valve disorders"	"Other and unspecified hearing loss"	1	0	8646	8646
"B37"	"M72"	"Candidiasis"	"Fibroblastic disorders"	1	55	257	312
"E23"	"O20"	"Hypofunction and other disorders of the pituitary gland"	"Hemorrhage in early pregnancy"	1	0	67	67
"O35"	"K35"	"Maternal care for known or suspected fetal abnlt and damage"	"Acute appendicitis"	1	7	138	145
"K59"	"N46"	"Other functional intestinal disorders"	"Male infertility"	1	118	292	410
"K90"	"O68"	"Intestinal malabsorption"	"Labor and delivery comp by abnlt of fetal acid-base balance"	1	30	169	199
"A26"	"N20"	"Erysipeloid"	"Calculus of kidney and ureter"	1	1	32	33
"N30"	"O65"	"Cystitis"	"Obstructed labor due to maternal pelvic abnormality"	1	72	566	638
"H36"	"O46"	"Retinal disorders in diseases classified elsewhere"	"Antepartum hemorrhage, not elsewhere classified"	1	1	24	25
"A41"	"M31"	"Other sepsis"	"Other necrotizing vasculopathies"	1	330	1229	1559
"L97"	"N60"	"Non-pressure chronic ulcer of lower limb, NEC"	"Benign mammary dysplasia"	1	0	79	79
"I27"	"H33"	"Other pulmonary heart diseases"	"Retinal detachments and breaks"	1	17	67	84
"M47"	"O08"	"Spondylosis"	"Complications following ectopic and molar pregnancy"	1	0	105	105
"G47"	"J84"	"Sleep disorders"	"Other interstitial pulmonary diseases"	1	210	358	568
"Q21"	"G45"	"Congenital malformations of cardiac septa"	"Transient cerebral ischemic attacks and related syndromes"	1	174	353	527
"D50"	"O13"	"Iron deficiency anemia"	"Gestational hypertension without significant proteinuria"	1	0	86	86
"K59"	"G71"	"Other functional intestinal disorders"	"Primary disorders of muscles"	1	58	164	222
"O71"	"O02"	"Other obstetric trauma"	"Other abnormal products of conception"	1	2036	2654	4690
"A49"	"D86"	"Bacterial infection of unspecified site"	"Sarcoidosis"	1	50	126	176
"C15"	"J34"	"Malignant neoplasm of esophagus"	"Other and unspecified disorders of nose and nasal sinuses"	1	0	33	33
"M70"	"O65"	"Soft tissue disorders related to use, overuse and pressure"	"Obstructed labor due to maternal pelvic abnormality"	1	0	126	126
"N20"	"A63"	"Calculus of kidney and ureter"	"Oth predominantly sexually transmitted diseases, NEC"	1	105	308	413
"O28"	"O03"	"Abnormal findings on antenatal screening of mother"	"Spontaneous abortion"	1	446	1236	1682
"E78"	"M17"	"Disorders of lipoprotein metabolism and other lipidemias"	"Osteoarthritis of knee"	1	4450	8163	12613
"N39"	"K61"	"Other disorders of urinary system"	"Abscess of anal and rectal regions"	1	191	598	789
"C34"	"D22"	"Malignant neoplasm of bronchus and lung"	"Melanocytic nevi"	1	33	121	154
"D09"	"M48"	"Carcinoma in situ of other and unspecified sites"	"Other spondylopathies"	1	41	153	194
"M65"	"M22"	"Synovitis and tenosynovitis"	"Disorder of patella"	1	2341	3378	5719
"K44"	"O63"	"Diaphragmatic hernia"	"Long labor"	1	16	100	116
"N39"	"O47"	"Other disorders of urinary system"	"False labor"	1	114	861	975
"C79"	"E10"	"Secondary malignant neoplasm of other and unspecified sites"	"Type 1 diabetes mellitus"	1	444	970	1414
"A49"	"Q87"	"Bacterial infection of unspecified site"	"Oth congenital malform syndromes affecting multiple systems"	1	8	54	62
"N99"	"O02"	"Intraop and postproc comp and disorders of GU sys, NEC"	"Other abnormal products of conception"	1	69	175	244
"N30"	"Q76"	"Cystitis"	"Congenital malformations of spine and bony thorax"	1	18	87	105
"N17"	"M16"	"Acute kidney failure"	"Osteoarthritis of hip"	1	0	1390	1390
"B34"	"H83"	"Viral infection of unspecified site"	"Other diseases of inner ear"	1	32	114	146
"I38"	"H83"	"Endocarditis, valve unspecified"	"Other diseases of inner ear"	1	0	42	42
"N95"	"N60"	"Menopausal and other perimenopausal disorders"	"Benign mammary dysplasia"	1	72	674	746
"M43"	"N92"	"Other deforming dorsopathies"	"Excessive, frequent and irregular menstruation"	1	129	611	740
"N40"	"I20"	"Benign prostatic hyperplasia"	"Angina pectoris"	1	4756	6171	10927
"J84"	"H90"	"Other interstitial pulmonary diseases"	"Conductive and sensorineural hearing loss"	1	81	287	368
"D12"	"H20"	"Benign neoplasm of colon, rectum, anus and anal canal"	"Iridocyclitis"	1	56	285	341
"I35"	"I80"	"Nonrheumatic aortic valve disorders"	"Phlebitis and thrombophlebitis"	1	428	1441	1869
"M22"	"Q21"	"Disorder of patella"	"Congenital malformations of cardiac septa"	1	7	43	50
"E86"	"F13"	"Volume depletion"	"Sedative, hypnotic, or anxiolytic related disorders"	1	207	331	538
"M80"	"H11"	"Osteoporosis with current pathological fracture"	"Other disorders of conjunctiva"	1	30	189	219
"K92"	"K85"	"Other diseases of digestive system"	"Acute pancreatitis"	1	791	1099	1890
"K25"	"O71"	"Gastric ulcer"	"Other obstetric trauma"	1	2	55	57
"A09"	"J42"	"Infectious gastroenteritis and colitis, unspecified"	"Unspecified chronic bronchitis"	1	639	974	1613
"K92"	"G43"	"Other diseases of digestive system"	"Migraine"	1	178	325	503
"H90"	"Q75"	"Conductive and sensorineural hearing loss"	"Other congenital malformations of skull and face bones"	1	23	83	106
"O42"	"N10"	"Premature rupture of membranes"	"Acute pyelonephritis"	1	145	282	427
"O98"	"O03"	"Matern infec/parastc dis classd elsw but compl preg/chldbrth"	"Spontaneous abortion"	1	77	291	368
"G97"	"O71"	"Intraop and postproc comp and disorders of nervous sys, NEC"	"Other obstetric trauma"	1	3	46	49
"K83"	"O99"	"Other diseases of biliary tract"	"Oth maternal diseases classd elsw but compl preg/chldbrth"	1	80	239	319
"I27"	"N87"	"Other pulmonary heart diseases"	"Dysplasia of cervix uteri"	1	2	29	31
"L97"	"L60"	"Non-pressure chronic ulcer of lower limb, NEC"	"Nail disorders"	1	121	248	369
"H27"	"Q12"	"Other disorders of lens"	"Congenital lens malformations"	1	139	247	386
"K65"	"I20"	"Peritonitis"	"Angina pectoris"	1	330	1103	1433
"E41"	"K83"	"Nutritional marasmus"	"Other diseases of biliary tract"	1	38	101	139
"J90"	"K43"	"Pleural effusion, not elsewhere classified"	"Ventral hernia"	1	87	270	357
"J18"	"O91"	"Pneumonia, unspecified organism"	"Infect of breast assoc w pregnancy, the puerp and lactation"	1	80	181	261
"I48"	"N80"	"Atrial fibrillation and flutter"	"Endometriosis"	1	3	173	176
"K60"	"O12"	"Fissure and fistula of anal and rectal regions"	"Gestational edema and proteinuria without hypertension"	1	4	40	44
"J91"	"A46"	"Pleural effusion in conditions classified elsewhere"	"Erysipelas"	1	142	257	399
"C71"	"H83"	"Malignant neoplasm of brain"	"Other diseases of inner ear"	1	0	146	146
"C16"	"M72"	"Malignant neoplasm of stomach"	"Fibroblastic disorders"	1	3	156	159
"E87"	"N40"	"Other disorders of fluid, electrolyte and acid-base balance"	"Benign prostatic hyperplasia"	1	0	3481	3481
"I95"	"I49"	"Hypotension"	"Other cardiac arrhythmias"	1	690	1264	1954
"J15"	"I12"	"Bacterial pneumonia, not elsewhere classified"	"Hypertensive chronic kidney disease"	1	117	390	507
"K76"	"L40"	"Other diseases of liver"	"Psoriasis"	1	138	303	441
"E83"	"M18"	"Disorders of mineral metabolism"	"Osteoarthritis of first carpometacarpal joint"	1	18	75	93
"I25"	"O36"	"Chronic ischemic heart disease"	"Maternal care for other fetal problems"	1	0	62	62
"K22"	"C50"	"Other diseases of esophagus"	"Malignant neoplasm of breast"	1	136	374	510
"I72"	"N03"	"Other aneurysm"	"Chronic nephritic syndrome"	1	3	44	47
"J96"	"H26"	"Respiratory failure, not elsewhere classified"	"Other cataract"	1	0	3820	3820
"M75"	"A56"	"Shoulder lesions"	"Other sexually transmitted chlamydial diseases"	1	20	85	105
"H36"	"I20"	"Retinal disorders in diseases classified elsewhere"	"Angina pectoris"	1	1074	2102	3176
"O91"	"G40"	"Infect of breast assoc w pregnancy, the puerp and lactation"	"Epilepsy and recurrent seizures"	1	10	64	74
"I61"	"C18"	"Nontraumatic intracerebral hemorrhage"	"Malignant neoplasm of colon"	1	161	288	449
"C34"	"L40"	"Malignant neoplasm of bronchus and lung"	"Psoriasis"	1	13	366	379
"K57"	"D30"	"Diverticular disease of intestine"	"Benign neoplasm of urinary organs"	1	388	839	1227
"K29"	"O32"	"Gastritis and duodenitis"	"Maternal care for malpresentation of fetus"	1	78	158	236
"J15"	"M43"	"Bacterial pneumonia, not elsewhere classified"	"Other deforming dorsopathies"	1	67	635	702
"J81"	"H80"	"Pulmonary edema"	"Otosclerosis"	1	0	71	71
"N12"	"N92"	"Tubulo-interstitial nephritis, not spcf as acute or chronic"	"Excessive, frequent and irregular menstruation"	1	61	239	300
"M48"	"N46"	"Other spondylopathies"	"Male infertility"	1	9	96	105
"A41"	"C82"	"Other sepsis"	"Follicular lymphoma"	1	136	636	772
"O72"	"K04"	"Postpartum hemorrhage"	"Diseases of pulp and periapical tissues"	1	85	275	360
"A41"	"A88"	"Other sepsis"	"Oth viral infections of central nervous system, NEC"	1	0	88	88
"J01"	"Q53"	"Acute sinusitis"	"Undescended and ectopic testicle"	1	0	39	39
"F84"	"J03"	"Pervasive developmental disorders"	"Acute tonsillitis"	1	34	132	166
"M13"	"M23"	"Other arthritis"	"Internal derangement of knee"	1	1177	2139	3316
"H54"	"H35"	"Blindness and low vision"	"Other retinal disorders"	1	601	1515	2116
"L30"	"Q17"	"Other and unspecified dermatitis"	"Other congenital malformations of ear"	1	0	39	39
"L02"	"O82"	"Cutaneous abscess, furuncle and carbuncle"	"Encounter for cesarean delivery without indication"	1	679	1012	1691
"M70"	"K29"	"Soft tissue disorders related to use, overuse and pressure"	"Gastritis and duodenitis"	1	699	916	1615
"K37"	"J36"	"Unspecified appendicitis"	"Peritonsillar abscess"	1	1	24	25
"G98"	"H72"	"Other disorders of nervous system not elsewhere classified"	"Perforation of tympanic membrane"	1	3	47	50
"I44"	"H33"	"Atrioventricular and left bundle-branch block"	"Retinal detachments and breaks"	1	50	264	314
"E70"	"E11"	"Disorders of aromatic amino-acid metabolism"	"Type 2 diabetes mellitus"	1	74	257	331
"F41"	"N20"	"Other anxiety disorders"	"Calculus of kidney and ureter"	1	132	571	703
"L97"	"J44"	"Non-pressure chronic ulcer of lower limb, NEC"	"Other chronic obstructive pulmonary disease"	1	1402	2655	4057
"K56"	"J38"	"Paralytic ileus and intestinal obstruction without hernia"	"Diseases of vocal cords and larynx, not elsewhere classified"	1	96	205	301
"I63"	"M72"	"Cerebral infarction"	"Fibroblastic disorders"	1	241	1168	1409
"K42"	"J36"	"Umbilical hernia"	"Peritonsillar abscess"	1	12	95	107
"C78"	"N30"	"Secondary malignant neoplasm of resp and digestive organs"	"Cystitis"	1	1721	3222	4943
"C77"	"M07"	"Secondary and unspecified malignant neoplasm of lymph nodes"	"Enteropathic arthropathies"	1	8	61	69
"K64"	"I60"	"Hemorrhoids and perianal venous thrombosis"	"Nontraumatic subarachnoid hemorrhage"	1	0	79	79
"N17"	"N95"	"Acute kidney failure"	"Menopausal and other perimenopausal disorders"	1	15	310	325
"K86"	"K35"	"Other diseases of pancreas"	"Acute appendicitis"	1	64	139	203
"G56"	"O36"	"Mononeuropathies of upper limb"	"Maternal care for other fetal problems"	1	215	880	1095
"C43"	"M22"	"Malignant melanoma of skin"	"Disorder of patella"	1	0	110	110
"D63"	"N97"	"Anemia in chronic diseases classified elsewhere"	"Female infertility"	1	0	42	42
"J95"	"D17"	"Intraop and postproc comp and disorders of resp sys, NEC"	"Benign lipomatous neoplasm"	1	1	54	55
"I26"	"M75"	"Pulmonary embolism"	"Shoulder lesions"	1	381	1243	1624
"J96"	"Q90"	"Respiratory failure, not elsewhere classified"	"Down syndrome"	1	32	192	224
"I13"	"I20"	"Hypertensive heart and chronic kidney disease"	"Angina pectoris"	1	118	394	512
"L30"	"M17"	"Other and unspecified dermatitis"	"Osteoarthritis of knee"	1	575	981	1556
"E86"	"N83"	"Volume depletion"	"Noninflammatory disord of ovary, fallop and broad ligament"	1	202	914	1116
"J85"	"E10"	"Abscess of lung and mediastinum"	"Type 1 diabetes mellitus"	1	67	152	219
"J44"	"L05"	"Other chronic obstructive pulmonary disease"	"Pilonidal cyst and sinus"	1	31	212	243
"I36"	"I25"	"Nonrheumatic tricuspid valve disorders"	"Chronic ischemic heart disease"	1	308	461	769
"F41"	"J43"	"Other anxiety disorders"	"Emphysema"	1	113	280	393
"D09"	"A46"	"Carcinoma in situ of other and unspecified sites"	"Erysipelas"	1	35	94	129
"C50"	"O28"	"Malignant neoplasm of breast"	"Abnormal findings on antenatal screening of mother"	1	0	44	44
"O23"	"J35"	"Infections of genitourinary tract in pregnancy"	"Chronic diseases of tonsils and adenoids"	1	3	661	664
"K59"	"H18"	"Other functional intestinal disorders"	"Other disorders of cornea"	1	281	530	811
"L98"	"C62"	"Oth disorders of skin, subcu, not elsewhere classified"	"Malignant neoplasm of testis"	1	1	27	28
"C77"	"K80"	"Secondary and unspecified malignant neoplasm of lymph nodes"	"Cholelithiasis"	1	104	788	892
"N63"	"L68"	"Unspecified lump in breast"	"Hypertrichosis"	1	26	143	169
"N46"	"N47"	"Male infertility"	"Disorders of prepuce"	1	17	386	403
"K59"	"L71"	"Other functional intestinal disorders"	"Rosacea"	1	111	204	315
"K80"	"N71"	"Cholelithiasis"	"Inflammatory disease of uterus, except cervix"	1	167	549	716
"C44"	"N35"	"Other and unspecified malignant neoplasm of skin"	"Urethral stricture"	1	66	163	229
"I99"	"D25"	"Other and unspecified disorders of circulatory system"	"Leiomyoma of uterus"	1	11	57	68
"H90"	"O80"	"Conductive and sensorineural hearing loss"	"Encounter for full-term uncomplicated delivery"	1	170	1150	1320
"E23"	"F10"	"Hypofunction and other disorders of the pituitary gland"	"Alcohol related disorders"	1	45	163	208
"C22"	"N95"	"Malignant neoplasm of liver and intrahepatic bile ducts"	"Menopausal and other perimenopausal disorders"	1	0	73	73
"J15"	"E88"	"Bacterial pneumonia, not elsewhere classified"	"Other and unspecified metabolic disorders"	1	82	241	323
"J69"	"M62"	"Pneumonitis due to solids and liquids"	"Other disorders of muscle"	1	0	292	292
"J96"	"I24"	"Respiratory failure, not elsewhere classified"	"Other acute ischemic heart diseases"	1	342	706	1048
"K92"	"L23"	"Other diseases of digestive system"	"Allergic contact dermatitis"	1	20	111	131
"C34"	"K43"	"Malignant neoplasm of bronchus and lung"	"Ventral hernia"	1	57	898	955
"I74"	"H25"	"Arterial embolism and thrombosis"	"Age-related cataract"	1	673	1114	1787
"G47"	"I63"	"Sleep disorders"	"Cerebral infarction"	1	916	1595	2511
"M85"	"O68"	"Other disorders of bone density and structure"	"Labor and delivery comp by abnlt of fetal acid-base balance"	1	0	188	188
"O08"	"O70"	"Complications following ectopic and molar pregnancy"	"Perineal laceration during delivery"	1	1975	2666	4641
"I21"	"Q18"	"Acute myocardial infarction"	"Other congenital malformations of face and neck"	1	18	79	97
"G90"	"I10"	"Disorders of autonomic nervous system"	"Essential (primary) hypertension"	1	685	967	1652
"Q61"	"E66"	"Cystic kidney disease"	"Overweight and obesity"	1	178	340	518
"I89"	"E05"	"Oth noninfective disorders of lymphatic vessels and nodes"	"Thyrotoxicosis [hyperthyroidism]"	1	41	109	150
"O91"	"H65"	"Infect of breast assoc w pregnancy, the puerp and lactation"	"Nonsuppurative otitis media"	1	0	29	29
"M85"	"C53"	"Other disorders of bone density and structure"	"Malignant neoplasm of cervix uteri"	1	0	66	66
"I50"	"H94"	"Heart failure"	"Other disorders of ear in diseases classified elsewhere"	1	25	242	267
"B96"	"M20"	"Oth bacterial agents as the cause of diseases classd elswhr"	"Acquired deformities of fingers and toes"	1	3	71	74
"B27"	"Q53"	"Infectious mononucleosis"	"Undescended and ectopic testicle"	1	4	75	79
"M85"	"M72"	"Other disorders of bone density and structure"	"Fibroblastic disorders"	1	160	539	699
"G45"	"O03"	"Transient cerebral ischemic attacks and related syndromes"	"Spontaneous abortion"	1	0	146	146
"F48"	"O04"	"Other nonpsychotic mental disorders"	"Complications following (induced) termination of pregnancy"	1	16	62	78
"I46"	"H81"	"Cardiac arrest"	"Disorders of vestibular function"	1	0	450	450
"D10"	"M51"	"Benign neoplasm of mouth and pharynx"	"Thoracic, thoracolum, and lumbosacral intvrt disc disorders"	1	137	362	499
"N45"	"H65"	"Orchitis and epididymitis"	"Nonsuppurative otitis media"	1	3	132	135
"A41"	"M21"	"Other sepsis"	"Other acquired deformities of limbs"	1	123	681	804
"N87"	"O71"	"Dysplasia of cervix uteri"	"Other obstetric trauma"	1	303	750	1053
"O23"	"H50"	"Infections of genitourinary tract in pregnancy"	"Other strabismus"	1	12	85	97
"H54"	"H25"	"Blindness and low vision"	"Age-related cataract"	1	1031	2246	3277
"G56"	"O99"	"Mononeuropathies of upper limb"	"Oth maternal diseases classd elsw but compl preg/chldbrth"	1	1775	3060	4835
"I69"	"N99"	"Sequelae of cerebrovascular disease"	"Intraop and postproc comp and disorders of GU sys, NEC"	1	205	439	644
"E68"	"N80"	"Sequelae of hyperalimentation"	"Endometriosis"	1	22	85	107
"O70"	"O02"	"Perineal laceration during delivery"	"Other abnormal products of conception"	1	0	27914	27914
"K31"	"M17"	"Other diseases of stomach and duodenum"	"Osteoarthritis of knee"	1	103	398	501
"N95"	"O62"	"Menopausal and other perimenopausal disorders"	"Abnormalities of forces of labor"	1	0	92	92
"E66"	"M92"	"Overweight and obesity"	"Other juvenile osteochondrosis"	1	22	159	181
"K57"	"N03"	"Diverticular disease of intestine"	"Chronic nephritic syndrome"	1	36	140	176
"N31"	"F10"	"Neuromuscular dysfunction of bladder, NEC"	"Alcohol related disorders"	1	165	386	551
"I50"	"N47"	"Heart failure"	"Disorders of prepuce"	1	509	897	1406
"K72"	"M71"	"Hepatic failure, not elsewhere classified"	"Other bursopathies"	1	1	54	55
"M81"	"J20"	"Osteoporosis without current pathological fracture"	"Acute bronchitis"	1	383	1227	1610
"I44"	"O03"	"Atrioventricular and left bundle-branch block"	"Spontaneous abortion"	1	0	35	35
"E89"	"J45"	"Postproc endocrine and metabolic comp and disorders, NEC"	"Asthma"	1	99	260	359
"F43"	"O03"	"Reaction to severe stress, and adjustment disorders"	"Spontaneous abortion"	1	7	569	576
"E83"	"H02"	"Disorders of mineral metabolism"	"Other disorders of eyelid"	1	61	217	278
"B37"	"I25"	"Candidiasis"	"Chronic ischemic heart disease"	1	850	1880	2730
"M23"	"Q66"	"Internal derangement of knee"	"Congenital deformities of feet"	1	158	476	634
"K21"	"F10"	"Gastro-esophageal reflux disease"	"Alcohol related disorders"	1	1697	3129	4826
"O70"	"J05"	"Perineal laceration during delivery"	"Acute obstructive laryngitis [croup] and epiglottitis"	1	0	50	50
"C78"	"L50"	"Secondary malignant neoplasm of resp and digestive organs"	"Urticaria"	1	15	219	234
"O80"	"Q74"	"Encounter for full-term uncomplicated delivery"	"Other congenital malformations of limb(s)"	1	15	95	110
"D59"	"I20"	"Acquired hemolytic anemia"	"Angina pectoris"	1	62	235	297
"D13"	"C50"	"Benign neoplasm of and ill-defined parts of digestive system"	"Malignant neoplasm of breast"	1	65	140	205
"J69"	"H83"	"Pneumonitis due to solids and liquids"	"Other diseases of inner ear"	1	0	87	87
"I63"	"E10"	"Cerebral infarction"	"Type 1 diabetes mellitus"	1	3334	3888	7222
"K63"	"N62"	"Other diseases of intestine"	"Hypertrophy of breast"	1	28	117	145
"D14"	"D24"	"Benign neoplasm of middle ear and respiratory system"	"Benign neoplasm of breast"	1	13	88	101
"J15"	"M35"	"Bacterial pneumonia, not elsewhere classified"	"Other systemic involvement of connective tissue"	1	432	1821	2253
"N87"	"O80"	"Dysplasia of cervix uteri"	"Encounter for full-term uncomplicated delivery"	1	0	9851	9851
"J90"	"N45"	"Pleural effusion, not elsewhere classified"	"Orchitis and epididymitis"	1	30	149	179
"I44"	"E04"	"Atrioventricular and left bundle-branch block"	"Other nontoxic goiter"	1	76	247	323
"D68"	"I70"	"Other coagulation defects"	"Atherosclerosis"	1	265	516	781
"G56"	"O42"	"Mononeuropathies of upper limb"	"Premature rupture of membranes"	1	177	886	1063
"K59"	"N13"	"Other functional intestinal disorders"	"Obstructive and reflux uropathy"	1	1798	2413	4211
"A49"	"O70"	"Bacterial infection of unspecified site"	"Perineal laceration during delivery"	1	146	508	654
"M10"	"H91"	"Gout"	"Other and unspecified hearing loss"	1	764	2484	3248
"K81"	"O62"	"Cholecystitis"	"Abnormalities of forces of labor"	1	0	588	588
"I35"	"K40"	"Nonrheumatic aortic valve disorders"	"Inguinal hernia"	1	0	3549	3549
"M80"	"N94"	"Osteoporosis with current pathological fracture"	"Pain and oth cond assoc w fem gntl org and menstrual cycle"	1	0	106	106
"D33"	"K35"	"Benign neoplasm of brain and oth prt central nervous system"	"Acute appendicitis"	1	18	63	81
"K64"	"E05"	"Hemorrhoids and perianal venous thrombosis"	"Thyrotoxicosis [hyperthyroidism]"	1	14	460	474
"J69"	"K29"	"Pneumonitis due to solids and liquids"	"Gastritis and duodenitis"	1	74	681	755
"I73"	"G45"	"Other peripheral vascular diseases"	"Transient cerebral ischemic attacks and related syndromes"	1	990	1892	2882
"O41"	"O03"	"Other disorders of amniotic fluid and membranes"	"Spontaneous abortion"	1	578	1076	1654
"O85"	"N97"	"Puerperal sepsis"	"Female infertility"	1	169	921	1090
"F03"	"N60"	"Unspecified dementia"	"Benign mammary dysplasia"	1	0	135	135
"D12"	"N47"	"Benign neoplasm of colon, rectum, anus and anal canal"	"Disorders of prepuce"	1	251	552	803
"M25"	"O62"	"Other joint disorder, not elsewhere classified"	"Abnormalities of forces of labor"	1	0	2058	2058
"K56"	"H93"	"Paralytic ileus and intestinal obstruction without hernia"	"Other disorders of ear, not elsewhere classified"	1	120	665	785
"N83"	"O71"	"Noninflammatory disord of ovary, fallop and broad ligament"	"Other obstetric trauma"	1	196	694	890
"F41"	"Q17"	"Other anxiety disorders"	"Other congenital malformations of ear"	1	0	50	50
"J10"	"K40"	"Influenza due to other identified influenza virus"	"Inguinal hernia"	1	0	127	127
"F41"	"H20"	"Other anxiety disorders"	"Iridocyclitis"	1	17	70	87
"M46"	"H91"	"Other inflammatory spondylopathies"	"Other and unspecified hearing loss"	1	137	288	425
"C67"	"G35"	"Malignant neoplasm of bladder"	"Multiple sclerosis"	1	1	30	31
"M16"	"O21"	"Osteoarthritis of hip"	"Excessive vomiting in pregnancy"	1	2	36	38
"M25"	"O23"	"Other joint disorder, not elsewhere classified"	"Infections of genitourinary tract in pregnancy"	1	113	351	464
"M70"	"O30"	"Soft tissue disorders related to use, overuse and pressure"	"Multiple gestation"	1	16	86	102
"A49"	"D46"	"Bacterial infection of unspecified site"	"Myelodysplastic syndromes"	1	196	389	585
"L89"	"M77"	"Pressure ulcer"	"Other enthesopathies"	1	6	131	137
"I34"	"D23"	"Nonrheumatic mitral valve disorders"	"Other benign neoplasms of skin"	1	77	188	265
"I24"	"N40"	"Other acute ischemic heart diseases"	"Benign prostatic hyperplasia"	1	219	405	624
"C14"	"K40"	"Malig neoplasm of sites in the lip, oral cavity and pharynx"	"Inguinal hernia"	1	0	38	38
"J15"	"N21"	"Bacterial pneumonia, not elsewhere classified"	"Calculus of lower urinary tract"	1	95	417	512
"A41"	"I83"	"Other sepsis"	"Varicose veins of lower extremities"	1	0	3464	3464
"C16"	"M19"	"Malignant neoplasm of stomach"	"Other and unspecified osteoarthritis"	1	51	233	284
"H52"	"Q90"	"Disorders of refraction and accommodation"	"Down syndrome"	1	83	531	614
"I51"	"H83"	"Complications and ill-defined descriptions of heart disease"	"Other diseases of inner ear"	1	0	188	188
"K83"	"J44"	"Other diseases of biliary tract"	"Other chronic obstructive pulmonary disease"	1	708	994	1702
"E13"	"I80"	"Other specified diabetes mellitus"	"Phlebitis and thrombophlebitis"	1	71	185	256
"K44"	"K40"	"Diaphragmatic hernia"	"Inguinal hernia"	1	1227	1782	3009
"I70"	"H66"	"Atherosclerosis"	"Suppurative and unspecified otitis media"	1	58	266	324
"I42"	"E04"	"Cardiomyopathy"	"Other nontoxic goiter"	1	67	177	244
"E78"	"L05"	"Disorders of lipoprotein metabolism and other lipidemias"	"Pilonidal cyst and sinus"	1	29	421	450
"L98"	"E11"	"Oth disorders of skin, subcu, not elsewhere classified"	"Type 2 diabetes mellitus"	1	1081	3023	4104
"K05"	"M79"	"Gingivitis and periodontal diseases"	"Oth and unsp soft tissue disorders, not elsewhere classified"	1	472	701	1173
"N12"	"G45"	"Tubulo-interstitial nephritis, not spcf as acute or chronic"	"Transient cerebral ischemic attacks and related syndromes"	1	50	121	171
"G98"	"M47"	"Other disorders of nervous system not elsewhere classified"	"Spondylosis"	1	162	282	444
"M07"	"O80"	"Enteropathic arthropathies"	"Encounter for full-term uncomplicated delivery"	1	0	566	566
"L98"	"I73"	"Oth disorders of skin, subcu, not elsewhere classified"	"Other peripheral vascular diseases"	1	688	1105	1793
"L59"	"N63"	"Oth disorders of skin, subcu related to radiation"	"Unspecified lump in breast"	1	4	73	77
"K42"	"M54"	"Umbilical hernia"	"Dorsalgia"	1	742	1477	2219
"M17"	"N95"	"Osteoarthritis of knee"	"Menopausal and other perimenopausal disorders"	1	1409	1731	3140
"E03"	"N20"	"Other hypothyroidism"	"Calculus of kidney and ureter"	1	292	639	931
"D63"	"M81"	"Anemia in chronic diseases classified elsewhere"	"Osteoporosis without current pathological fracture"	1	530	891	1421
"O91"	"M22"	"Infect of breast assoc w pregnancy, the puerp and lactation"	"Disorder of patella"	1	0	164	164
"G40"	"J05"	"Epilepsy and recurrent seizures"	"Acute obstructive laryngitis [croup] and epiglottitis"	1	138	362	500
"I69"	"I10"	"Sequelae of cerebrovascular disease"	"Essential (primary) hypertension"	1	0	70017	70017
"D09"	"H25"	"Carcinoma in situ of other and unspecified sites"	"Age-related cataract"	1	207	649	856
"H90"	"B34"	"Conductive and sensorineural hearing loss"	"Viral infection of unspecified site"	1	235	541	776
"K80"	"O44"	"Cholelithiasis"	"Placenta previa"	1	50	169	219
"K43"	"L03"	"Ventral hernia"	"Cellulitis and acute lymphangitis"	1	105	269	374
"I80"	"J33"	"Phlebitis and thrombophlebitis"	"Nasal polyp"	1	64	136	200
"D64"	"J05"	"Other anemias"	"Acute obstructive laryngitis [croup] and epiglottitis"	1	21	70	91
"O82"	"J35"	"Encounter for cesarean delivery without indication"	"Chronic diseases of tonsils and adenoids"	1	0	2191	2191
"K57"	"E66"	"Diverticular disease of intestine"	"Overweight and obesity"	1	2794	4118	6912
"L08"	"K50"	"Other local infections of skin and subcutaneous tissue"	"Crohn's disease [regional enteritis]"	1	77	199	276
"M81"	"O63"	"Osteoporosis without current pathological fracture"	"Long labor"	1	0	29	29
"M67"	"N62"	"Other disorders of synovium and tendon"	"Hypertrophy of breast"	1	254	395	649
"J90"	"D11"	"Pleural effusion, not elsewhere classified"	"Benign neoplasm of major salivary glands"	1	12	72	84
"K43"	"K65"	"Ventral hernia"	"Peritonitis"	1	669	1406	2075
"M10"	"L02"	"Gout"	"Cutaneous abscess, furuncle and carbuncle"	1	600	799	1399
"F71"	"H65"	"Moderate intellectual disabilities"	"Nonsuppurative otitis media"	1	3	128	131
"O46"	"O04"	"Antepartum hemorrhage, not elsewhere classified"	"Complications following (induced) termination of pregnancy"	1	680	1260	1940
"D63"	"C45"	"Anemia in chronic diseases classified elsewhere"	"Mesothelioma"	1	50	318	368
"O61"	"F10"	"Failed induction of labor"	"Alcohol related disorders"	1	0	39	39
"M71"	"D25"	"Other bursopathies"	"Leiomyoma of uterus"	1	51	217	268
"M05"	"H80"	"Rheumatoid arthritis with rheumatoid factor"	"Otosclerosis"	1	15	66	81
"K55"	"N92"	"Vascular disorders of intestine"	"Excessive, frequent and irregular menstruation"	1	0	87	87
"C92"	"O62"	"Myeloid leukemia"	"Abnormalities of forces of labor"	1	0	34	34
"J15"	"B90"	"Bacterial pneumonia, not elsewhere classified"	"Sequelae of tuberculosis"	1	40	135	175
"N39"	"H43"	"Other disorders of urinary system"	"Disorders of vitreous body"	1	431	1152	1583
"G47"	"E78"	"Sleep disorders"	"Disorders of lipoprotein metabolism and other lipidemias"	1	2592	4797	7389
"L98"	"K80"	"Oth disorders of skin, subcu, not elsewhere classified"	"Cholelithiasis"	1	333	772	1105
"D62"	"O68"	"Acute posthemorrhagic anemia"	"Labor and delivery comp by abnlt of fetal acid-base balance"	1	42	226	268
"N48"	"N40"	"Other disorders of penis"	"Benign prostatic hyperplasia"	1	899	1206	2105
"B96"	"I49"	"Oth bacterial agents as the cause of diseases classd elswhr"	"Other cardiac arrhythmias"	1	34	122	156
"F17"	"A69"	"Nicotine dependence"	"Other spirochetal infections"	1	6	48	54
"G44"	"A63"	"Other headache syndromes"	"Oth predominantly sexually transmitted diseases, NEC"	1	65	258	323
"D47"	"O04"	"Oth neoplm of uncrt behav of lymphoid, hematpoetc & rel tiss"	"Complications following (induced) termination of pregnancy"	1	0	33	33
"I51"	"I63"	"Complications and ill-defined descriptions of heart disease"	"Cerebral infarction"	1	649	1004	1653
"F32"	"J34"	"Depressive episode"	"Other and unspecified disorders of nose and nasal sinuses"	1	122	313	435
"N31"	"N70"	"Neuromuscular dysfunction of bladder, NEC"	"Salpingitis and oophoritis"	1	2	51	53
"K58"	"F10"	"Irritable bowel syndrome"	"Alcohol related disorders"	1	498	758	1256
"I63"	"H18"	"Cerebral infarction"	"Other disorders of cornea"	1	207	407	614
"I46"	"I34"	"Cardiac arrest"	"Nonrheumatic mitral valve disorders"	1	194	820	1014
"C04"	"F10"	"Malignant neoplasm of floor of mouth"	"Alcohol related disorders"	1	37	260	297
"K20"	"O62"	"Esophagitis"	"Abnormalities of forces of labor"	1	12	201	213
"G91"	"K57"	"Hydrocephalus"	"Diverticular disease of intestine"	1	90	188	278
"I31"	"N95"	"Other diseases of pericardium"	"Menopausal and other perimenopausal disorders"	1	10	53	63
"I80"	"O71"	"Phlebitis and thrombophlebitis"	"Other obstetric trauma"	1	23	197	220
"I72"	"G56"	"Other aneurysm"	"Mononeuropathies of upper limb"	1	48	152	200
"D12"	"M40"	"Benign neoplasm of colon, rectum, anus and anal canal"	"Kyphosis and lordosis"	1	11	49	60
"I46"	"G43"	"Cardiac arrest"	"Migraine"	1	0	118	118
"F05"	"K59"	"Delirium due to known physiological condition"	"Other functional intestinal disorders"	1	2362	2732	5094
"E87"	"M02"	"Other disorders of fluid, electrolyte and acid-base balance"	"Postinfective and reactive arthropathies"	1	29	262	291
"M80"	"J44"	"Osteoporosis with current pathological fracture"	"Other chronic obstructive pulmonary disease"	1	3629	6819	10448
"H54"	"K80"	"Blindness and low vision"	"Cholelithiasis"	1	358	569	927
"K90"	"M51"	"Intestinal malabsorption"	"Thoracic, thoracolum, and lumbosacral intvrt disc disorders"	1	87	209	296
"K30"	"N80"	"Functional dyspepsia"	"Endometriosis"	1	209	338	547
"O72"	"K52"	"Postpartum hemorrhage"	"Other and unsp noninfective gastroenteritis and colitis"	1	356	1203	1559
"O20"	"J35"	"Hemorrhage in early pregnancy"	"Chronic diseases of tonsils and adenoids"	1	169	1357	1526
"M20"	"H65"	"Acquired deformities of fingers and toes"	"Nonsuppurative otitis media"	1	43	282	325
"M17"	"O46"	"Osteoarthritis of knee"	"Antepartum hemorrhage, not elsewhere classified"	1	0	63	63
"I69"	"I20"	"Sequelae of cerebrovascular disease"	"Angina pectoris"	1	0	12866	12866
"N39"	"I73"	"Other disorders of urinary system"	"Other peripheral vascular diseases"	1	1611	3122	4733
"A46"	"N83"	"Erysipelas"	"Noninflammatory disord of ovary, fallop and broad ligament"	1	116	338	454
"K51"	"Q53"	"Ulcerative colitis"	"Undescended and ectopic testicle"	1	0	40	40
"I35"	"I15"	"Nonrheumatic aortic valve disorders"	"Secondary hypertension"	1	422	658	1080
"E83"	"N30"	"Disorders of mineral metabolism"	"Cystitis"	1	1122	1520	2642
"O60"	"N98"	"Preterm labor"	"Complications associated with artificial fertilization"	1	19	88	107
"N19"	"M24"	"Unspecified kidney failure"	"Other specific joint derangements"	1	26	94	120
"E86"	"K50"	"Volume depletion"	"Crohn's disease [regional enteritis]"	1	246	1027	1273
"E66"	"L50"	"Overweight and obesity"	"Urticaria"	1	572	1075	1647
"B96"	"M19"	"Oth bacterial agents as the cause of diseases classd elswhr"	"Other and unspecified osteoarthritis"	1	36	133	169
"H53"	"D35"	"Visual disturbances"	"Benign neoplasm of other and unspecified endocrine glands"	1	429	904	1333
"Q51"	"O03"	"Congenital malformations of uterus and cervix"	"Spontaneous abortion"	1	174	388	562
"I63"	"H44"	"Cerebral infarction"	"Disorders of globe"	1	68	209	277
"I26"	"K41"	"Pulmonary embolism"	"Femoral hernia"	1	16	71	87
"B36"	"O80"	"Other superficial mycoses"	"Encounter for full-term uncomplicated delivery"	1	46	183	229
"K92"	"H40"	"Other diseases of digestive system"	"Glaucoma"	1	227	930	1157
"K00"	"J35"	"Disorders of tooth development and eruption"	"Chronic diseases of tonsils and adenoids"	1	53	503	556
"M99"	"M79"	"Biomechanical lesions, not elsewhere classified"	"Oth and unsp soft tissue disorders, not elsewhere classified"	1	913	1385	2298
"I69"	"O20"	"Sequelae of cerebrovascular disease"	"Hemorrhage in early pregnancy"	1	0	71	71
"C34"	"M47"	"Malignant neoplasm of bronchus and lung"	"Spondylosis"	1	0	1507	1507
"N39"	"N45"	"Other disorders of urinary system"	"Orchitis and epididymitis"	1	730	990	1720
"K92"	"D24"	"Other diseases of digestive system"	"Benign neoplasm of breast"	1	30	257	287
"H46"	"O68"	"Optic neuritis"	"Labor and delivery comp by abnlt of fetal acid-base balance"	1	20	83	103
"O23"	"H10"	"Infections of genitourinary tract in pregnancy"	"Conjunctivitis"	1	132	238	370
"K60"	"L02"	"Fissure and fistula of anal and rectal regions"	"Cutaneous abscess, furuncle and carbuncle"	1	807	1222	2029
"J44"	"M72"	"Other chronic obstructive pulmonary disease"	"Fibroblastic disorders"	1	520	1853	2373
"M02"	"O65"	"Postinfective and reactive arthropathies"	"Obstructed labor due to maternal pelvic abnormality"	1	5	73	78
"K22"	"M75"	"Other diseases of esophagus"	"Shoulder lesions"	1	494	847	1341
"M86"	"M62"	"Osteomyelitis"	"Other disorders of muscle"	1	70	219	289
"C78"	"F13"	"Secondary malignant neoplasm of resp and digestive organs"	"Sedative, hypnotic, or anxiolytic related disorders"	1	5	35	40
"N17"	"G62"	"Acute kidney failure"	"Other and unspecified polyneuropathies"	1	322	522	844
"I63"	"N50"	"Cerebral infarction"	"Other and unspecified disorders of male genital organs"	1	130	262	392
"J22"	"I69"	"Unspecified acute lower respiratory infection"	"Sequelae of cerebrovascular disease"	1	562	1033	1595
"C78"	"J03"	"Secondary malignant neoplasm of resp and digestive organs"	"Acute tonsillitis"	1	4	108	112
"N30"	"J00"	"Cystitis"	"Acute nasopharyngitis [common cold]"	1	200	1036	1236
"K59"	"H60"	"Other functional intestinal disorders"	"Otitis externa"	1	304	589	893
"M95"	"Q65"	"Oth acquired deformities of ms sys and connective tissue"	"Congenital deformities of hip"	1	227	348	575
"D83"	"J45"	"Common variable immunodeficiency"	"Asthma"	1	62	224	286
"N17"	"O68"	"Acute kidney failure"	"Labor and delivery comp by abnlt of fetal acid-base balance"	1	2	51	53
"J03"	"Q62"	"Acute tonsillitis"	"Congen defects of renal pelvis and congen malform of ureter"	1	77	262	339
"D63"	"N85"	"Anemia in chronic diseases classified elsewhere"	"Other noninflammatory disorders of uterus, except cervix"	1	1	28	29
"E86"	"H28"	"Volume depletion"	"Cataract in diseases classified elsewhere"	1	7	143	150
"C94"	"K40"	"Other leukemias of specified cell type"	"Inguinal hernia"	1	0	39	39
"H66"	"J21"	"Suppurative and unspecified otitis media"	"Acute bronchiolitis"	1	612	858	1470
"L30"	"O68"	"Other and unspecified dermatitis"	"Labor and delivery comp by abnlt of fetal acid-base balance"	1	125	466	591
"M43"	"O03"	"Other deforming dorsopathies"	"Spontaneous abortion"	1	8	143	151
"H53"	"E04"	"Visual disturbances"	"Other nontoxic goiter"	1	143	313	456
"J18"	"I45"	"Pneumonia, unspecified organism"	"Other conduction disorders"	1	1477	2052	3529
"M81"	"L60"	"Osteoporosis without current pathological fracture"	"Nail disorders"	1	103	227	330
"E16"	"E10"	"Other disorders of pancreatic internal secretion"	"Type 1 diabetes mellitus"	1	0	14233	14233
"A40"	"H83"	"Streptococcal sepsis"	"Other diseases of inner ear"	1	1	107	108
"N39"	"D30"	"Other disorders of urinary system"	"Benign neoplasm of urinary organs"	1	426	2042	2468
"D63"	"C41"	"Anemia in chronic diseases classified elsewhere"	"Malignant neoplasm of bone/artic cartl of and unsp sites"	1	64	172	236
"J15"	"D13"	"Bacterial pneumonia, not elsewhere classified"	"Benign neoplasm of and ill-defined parts of digestive system"	1	110	310	420
"F13"	"N92"	"Sedative, hypnotic, or anxiolytic related disorders"	"Excessive, frequent and irregular menstruation"	1	32	100	132
"M85"	"J42"	"Other disorders of bone density and structure"	"Unspecified chronic bronchitis"	1	63	486	549
"C24"	"H91"	"Malignant neoplasm of other and unsp parts of biliary tract"	"Other and unspecified hearing loss"	1	16	375	391
"K26"	"O62"	"Duodenal ulcer"	"Abnormalities of forces of labor"	1	27	137	164
"E73"	"A09"	"Lactose intolerance"	"Infectious gastroenteritis and colitis, unspecified"	1	141	427	568
"J69"	"K35"	"Pneumonitis due to solids and liquids"	"Acute appendicitis"	1	33	133	166
"E66"	"D24"	"Overweight and obesity"	"Benign neoplasm of breast"	1	338	1169	1507
"K04"	"J34"	"Diseases of pulp and periapical tissues"	"Other and unspecified disorders of nose and nasal sinuses"	1	125	232	357
"K55"	"J42"	"Vascular disorders of intestine"	"Unspecified chronic bronchitis"	1	69	284	353
"A40"	"M75"	"Streptococcal sepsis"	"Shoulder lesions"	1	78	179	257
"G47"	"K26"	"Sleep disorders"	"Duodenal ulcer"	1	57	583	640
"G45"	"O65"	"Transient cerebral ischemic attacks and related syndromes"	"Obstructed labor due to maternal pelvic abnormality"	1	0	38	38
"K62"	"I12"	"Other diseases of anus and rectum"	"Hypertensive chronic kidney disease"	1	111	203	314
"E87"	"O71"	"Other disorders of fluid, electrolyte and acid-base balance"	"Other obstetric trauma"	1	0	40	40
"J09"	"O99"	"Influenza due to certain identified influenza viruses"	"Oth maternal diseases classd elsw but compl preg/chldbrth"	1	22	119	141
"N61"	"N80"	"Inflammatory disorders of breast"	"Endometriosis"	1	21	75	96
"I73"	"H91"	"Other peripheral vascular diseases"	"Other and unspecified hearing loss"	1	1306	3924	5230
"D23"	"M22"	"Other benign neoplasms of skin"	"Disorder of patella"	1	97	374	471
"G47"	"B18"	"Sleep disorders"	"Chronic viral hepatitis"	1	19	164	183
"O24"	"A63"	"Diabetes in pregnancy, childbirth, and the puerperium"	"Oth predominantly sexually transmitted diseases, NEC"	1	10	345	355
"I20"	"G35"	"Angina pectoris"	"Multiple sclerosis"	1	99	213	312
"O03"	"A63"	"Spontaneous abortion"	"Oth predominantly sexually transmitted diseases, NEC"	1	261	805	1066
"M23"	"O14"	"Internal derangement of knee"	"Pre-eclampsia"	1	221	386	607
"D09"	"M20"	"Carcinoma in situ of other and unspecified sites"	"Acquired deformities of fingers and toes"	1	0	68	68
"E03"	"J38"	"Other hypothyroidism"	"Diseases of vocal cords and larynx, not elsewhere classified"	1	133	526	659
"D12"	"O24"	"Benign neoplasm of colon, rectum, anus and anal canal"	"Diabetes in pregnancy, childbirth, and the puerperium"	1	0	52	52
"D50"	"N76"	"Iron deficiency anemia"	"Other inflammation of vagina and vulva"	1	46	174	220
"E21"	"M20"	"Hyperparathyroidism and other disorders of parathyroid gland"	"Acquired deformities of fingers and toes"	1	37	216	253
"K59"	"M24"	"Other functional intestinal disorders"	"Other specific joint derangements"	1	341	851	1192
"N30"	"B27"	"Cystitis"	"Infectious mononucleosis"	1	150	358	508
"K44"	"O34"	"Diaphragmatic hernia"	"Maternal care for abnormality of pelvic organs"	1	45	115	160
"C20"	"M43"	"Malignant neoplasm of rectum"	"Other deforming dorsopathies"	1	26	81	107
"I62"	"I10"	"Other and unspecified nontraumatic intracranial hemorrhage"	"Essential (primary) hypertension"	1	559	872	1431
"I46"	"N21"	"Cardiac arrest"	"Calculus of lower urinary tract"	1	4	119	123
"G47"	"H35"	"Sleep disorders"	"Other retinal disorders"	1	534	1076	1610
"J94"	"K58"	"Other pleural conditions"	"Irritable bowel syndrome"	1	5	66	71
"G47"	"G70"	"Sleep disorders"	"Myasthenia gravis and other myoneural disorders"	1	25	77	102
"M54"	"N97"	"Dorsalgia"	"Female infertility"	1	813	1938	2751
"K20"	"D25"	"Esophagitis"	"Leiomyoma of uterus"	1	75	171	246
"A04"	"C92"	"Other bacterial intestinal infections"	"Myeloid leukemia"	1	82	218	300
"M17"	"Q78"	"Osteoarthritis of knee"	"Other osteochondrodysplasias"	1	37	122	159
"O99"	"H72"	"Oth maternal diseases classd elsw but compl preg/chldbrth"	"Perforation of tympanic membrane"	1	45	296	341
"K45"	"J35"	"Other abdominal hernia"	"Chronic diseases of tonsils and adenoids"	1	4	109	113
"M13"	"O14"	"Other arthritis"	"Pre-eclampsia"	1	14	78	92
"M13"	"I83"	"Other arthritis"	"Varicose veins of lower extremities"	1	288	641	929
"C79"	"O62"	"Secondary malignant neoplasm of other and unspecified sites"	"Abnormalities of forces of labor"	1	0	88	88
"E11"	"H83"	"Type 2 diabetes mellitus"	"Other diseases of inner ear"	1	497	2445	2942
"L97"	"N99"	"Non-pressure chronic ulcer of lower limb, NEC"	"Intraop and postproc comp and disorders of GU sys, NEC"	1	30	126	156
"F31"	"M65"	"Bipolar disorder"	"Synovitis and tenosynovitis"	1	21	84	105
"D23"	"O42"	"Other benign neoplasms of skin"	"Premature rupture of membranes"	1	113	273	386
"B37"	"E04"	"Candidiasis"	"Other nontoxic goiter"	1	119	249	368
"H36"	"K58"	"Retinal disorders in diseases classified elsewhere"	"Irritable bowel syndrome"	1	80	185	265
"J06"	"G40"	"Acute upper resp infections of multiple and unsp sites"	"Epilepsy and recurrent seizures"	1	245	651	896
"H25"	"N94"	"Age-related cataract"	"Pain and oth cond assoc w fem gntl org and menstrual cycle"	1	3	545	548
"C01"	"I10"	"Malignant neoplasm of base of tongue"	"Essential (primary) hypertension"	1	41	125	166
"C90"	"M72"	"Multiple myeloma and malignant plasma cell neoplasms"	"Fibroblastic disorders"	1	2	89	91
"J96"	"G35"	"Respiratory failure, not elsewhere classified"	"Multiple sclerosis"	1	0	302	302
"K72"	"H40"	"Hepatic failure, not elsewhere classified"	"Glaucoma"	1	8	60	68
"N15"	"E11"	"Other renal tubulo-interstitial diseases"	"Type 2 diabetes mellitus"	1	183	329	512
"J15"	"H34"	"Bacterial pneumonia, not elsewhere classified"	"Retinal vascular occlusions"	1	138	650	788
"K56"	"A09"	"Paralytic ileus and intestinal obstruction without hernia"	"Infectious gastroenteritis and colitis, unspecified"	1	1628	1954	3582
"J43"	"O70"	"Emphysema"	"Perineal laceration during delivery"	1	0	35	35
"N19"	"L02"	"Unspecified kidney failure"	"Cutaneous abscess, furuncle and carbuncle"	1	356	760	1116
"H80"	"O02"	"Otosclerosis"	"Other abnormal products of conception"	1	19	84	103
"C88"	"F10"	"Malig immunoproliferative dis and certain oth B-cell lymph"	"Alcohol related disorders"	1	14	60	74
"K91"	"O80"	"Intraop and postproc comp and disorders of dgstv sys, NEC"	"Encounter for full-term uncomplicated delivery"	1	0	212	212
"M80"	"I49"	"Osteoporosis with current pathological fracture"	"Other cardiac arrhythmias"	1	461	1076	1537
"H25"	"N80"	"Age-related cataract"	"Endometriosis"	1	0	175	175
"J18"	"N92"	"Pneumonia, unspecified organism"	"Excessive, frequent and irregular menstruation"	1	0	3396	3396
"K83"	"C54"	"Other diseases of biliary tract"	"Malignant neoplasm of corpus uteri"	1	8	54	62
"I10"	"Q18"	"Essential (primary) hypertension"	"Other congenital malformations of face and neck"	1	80	335	415
"J91"	"C67"	"Pleural effusion in conditions classified elsewhere"	"Malignant neoplasm of bladder"	1	29	89	118
"N92"	"O44"	"Excessive, frequent and irregular menstruation"	"Placenta previa"	1	12	337	349
"M75"	"E28"	"Shoulder lesions"	"Ovarian dysfunction"	1	92	291	383
"G63"	"M16"	"Polyneuropathy in diseases classified elsewhere"	"Osteoarthritis of hip"	1	62	142	204
"K59"	"N50"	"Other functional intestinal disorders"	"Other and unspecified disorders of male genital organs"	1	394	638	1032
"O72"	"F60"	"Postpartum hemorrhage"	"Specific personality disorders"	1	246	465	711
"M72"	"N46"	"Fibroblastic disorders"	"Male infertility"	1	40	105	145
"A41"	"C25"	"Other sepsis"	"Malignant neoplasm of pancreas"	1	706	1069	1775
"I48"	"D21"	"Atrial fibrillation and flutter"	"Other benign neoplasms of connective and other soft tissue"	1	159	349	508
"K81"	"K21"	"Cholecystitis"	"Gastro-esophageal reflux disease"	1	402	779	1181
"I69"	"O64"	"Sequelae of cerebrovascular disease"	"Obstructed labor due to malposition and malpresent of fetus"	1	0	25	25
"C22"	"I71"	"Malignant neoplasm of liver and intrahepatic bile ducts"	"Aortic aneurysm and dissection"	1	30	130	160
"J15"	"F31"	"Bacterial pneumonia, not elsewhere classified"	"Bipolar disorder"	1	226	459	685
"O36"	"L68"	"Maternal care for other fetal problems"	"Hypertrichosis"	1	84	205	289
"E22"	"J03"	"Hyperfunction of pituitary gland"	"Acute tonsillitis"	1	53	133	186
"M81"	"H43"	"Osteoporosis without current pathological fracture"	"Disorders of vitreous body"	1	377	877	1254
"I99"	"O62"	"Other and unspecified disorders of circulatory system"	"Abnormalities of forces of labor"	1	4	56	60
"D43"	"I83"	"Neoplasm of uncertain behavior of brain and cnsl"	"Varicose veins of lower extremities"	1	18	121	139
"J44"	"M43"	"Other chronic obstructive pulmonary disease"	"Other deforming dorsopathies"	1	393	982	1375
"C77"	"N45"	"Secondary and unspecified malignant neoplasm of lymph nodes"	"Orchitis and epididymitis"	1	22	132	154
"G30"	"G50"	"Alzheimer's disease"	"Disorders of trigeminal nerve"	1	0	57	57
"E89"	"E01"	"Postproc endocrine and metabolic comp and disorders, NEC"	"Iodine-deficiency related thyroid disorders and allied cond"	1	0	93	93
"E03"	"N80"	"Other hypothyroidism"	"Endometriosis"	1	121	422	543
"J18"	"N48"	"Pneumonia, unspecified organism"	"Other disorders of penis"	1	495	1135	1630
"K65"	"K51"	"Peritonitis"	"Ulcerative colitis"	1	121	436	557
"J96"	"D11"	"Respiratory failure, not elsewhere classified"	"Benign neoplasm of major salivary glands"	1	26	338	364
"K08"	"M54"	"Other disorders of teeth and supporting structures"	"Dorsalgia"	1	533	808	1341
"M72"	"N87"	"Fibroblastic disorders"	"Dysplasia of cervix uteri"	1	2	176	178
"M77"	"O04"	"Other enthesopathies"	"Complications following (induced) termination of pregnancy"	1	0	1239	1239
"N20"	"N94"	"Calculus of kidney and ureter"	"Pain and oth cond assoc w fem gntl org and menstrual cycle"	1	236	379	615
"J15"	"K35"	"Bacterial pneumonia, not elsewhere classified"	"Acute appendicitis"	1	189	1077	1266
"N18"	"D17"	"Chronic kidney disease (CKD)"	"Benign lipomatous neoplasm"	1	37	519	556
"M75"	"H52"	"Shoulder lesions"	"Disorders of refraction and accommodation"	1	853	1286	2139
"I46"	"D05"	"Cardiac arrest"	"Carcinoma in situ of breast"	1	0	26	26
"N18"	"H35"	"Chronic kidney disease (CKD)"	"Other retinal disorders"	1	0	4222	4222
"J15"	"H80"	"Bacterial pneumonia, not elsewhere classified"	"Otosclerosis"	1	0	257	257
"N28"	"M50"	"Oth disorders of kidney and ureter, not elsewhere classified"	"Cervical disc disorders"	1	23	121	144
"B37"	"M23"	"Candidiasis"	"Internal derangement of knee"	1	175	503	678
"G96"	"N30"	"Other disorders of central nervous system"	"Cystitis"	1	1523	2047	3570
"M75"	"Q18"	"Shoulder lesions"	"Other congenital malformations of face and neck"	1	58	204	262
"C79"	"K09"	"Secondary malignant neoplasm of other and unspecified sites"	"Cysts of oral region, not elsewhere classified"	1	1	61	62
"F05"	"E66"	"Delirium due to known physiological condition"	"Overweight and obesity"	1	69	841	910
"O82"	"G40"	"Encounter for cesarean delivery without indication"	"Epilepsy and recurrent seizures"	1	228	717	945
"K65"	"O36"	"Peritonitis"	"Maternal care for other fetal problems"	1	20	74	94
"I73"	"I65"	"Other peripheral vascular diseases"	"Occls and stenosis of precerb art, not rslt in cereb infrc"	1	461	805	1266
"Q99"	"O02"	"Other chromosome abnormalities, not elsewhere classified"	"Other abnormal products of conception"	1	19	68	87
"O48"	"Q17"	"Late pregnancy"	"Other congenital malformations of ear"	1	0	40	40
"K65"	"K80"	"Peritonitis"	"Cholelithiasis"	1	1169	2892	4061
"K22"	"H83"	"Other diseases of esophagus"	"Other diseases of inner ear"	1	55	462	517
"I49"	"O48"	"Other cardiac arrhythmias"	"Late pregnancy"	1	0	120	120
"I73"	"J35"	"Other peripheral vascular diseases"	"Chronic diseases of tonsils and adenoids"	1	11	148	159
"A46"	"O66"	"Erysipelas"	"Other obstructed labor"	1	0	29	29
"E65"	"F10"	"Localized adiposity"	"Alcohol related disorders"	1	90	173	263
"C34"	"L72"	"Malignant neoplasm of bronchus and lung"	"Follicular cysts of skin and subcutaneous tissue"	1	1	238	239
"O13"	"O03"	"Gestational hypertension without significant proteinuria"	"Spontaneous abortion"	1	507	1208	1715
"B95"	"M23"	"Strep as the cause of diseases classified elsewhere"	"Internal derangement of knee"	1	17	182	199
"C24"	"M48"	"Malignant neoplasm of other and unsp parts of biliary tract"	"Other spondylopathies"	1	7	104	111
"C78"	"L97"	"Secondary malignant neoplasm of resp and digestive organs"	"Non-pressure chronic ulcer of lower limb, NEC"	1	77	322	399
"M77"	"O21"	"Other enthesopathies"	"Excessive vomiting in pregnancy"	1	20	134	154
"C13"	"K44"	"Malignant neoplasm of hypopharynx"	"Diaphragmatic hernia"	1	2	38	40
"K00"	"K40"	"Disorders of tooth development and eruption"	"Inguinal hernia"	1	8	138	146
"I20"	"O63"	"Angina pectoris"	"Long labor"	1	0	37	37
"L08"	"O47"	"Other local infections of skin and subcutaneous tissue"	"False labor"	1	79	206	285
"B37"	"D30"	"Candidiasis"	"Benign neoplasm of urinary organs"	1	41	205	246
"H92"	"H71"	"Otalgia and effusion of ear"	"Cholesteatoma of middle ear"	1	14	77	91
"J94"	"N81"	"Other pleural conditions"	"Female genital prolapse"	1	4	122	126
"E05"	"O65"	"Thyrotoxicosis [hyperthyroidism]"	"Obstructed labor due to maternal pelvic abnormality"	1	0	345	345
"K83"	"N40"	"Other diseases of biliary tract"	"Benign prostatic hyperplasia"	1	124	589	713
"M16"	"N61"	"Osteoarthritis of hip"	"Inflammatory disorders of breast"	1	59	129	188
"B95"	"K35"	"Strep as the cause of diseases classified elsewhere"	"Acute appendicitis"	1	6	78	84
"J95"	"I10"	"Intraop and postproc comp and disorders of resp sys, NEC"	"Essential (primary) hypertension"	1	458	1266	1724
"I71"	"J32"	"Aortic aneurysm and dissection"	"Chronic sinusitis"	1	6	104	110
"I61"	"K51"	"Nontraumatic intracerebral hemorrhage"	"Ulcerative colitis"	1	47	148	195
"E86"	"H83"	"Volume depletion"	"Other diseases of inner ear"	1	0	1349	1349
"O71"	"N70"	"Other obstetric trauma"	"Salpingitis and oophoritis"	1	210	327	537
"C78"	"C61"	"Secondary malignant neoplasm of resp and digestive organs"	"Malignant neoplasm of prostate"	1	493	1914	2407
"I89"	"C56"	"Oth noninfective disorders of lymphatic vessels and nodes"	"Malignant neoplasm of ovary"	1	43	167	210
"J15"	"N13"	"Bacterial pneumonia, not elsewhere classified"	"Obstructive and reflux uropathy"	1	623	1093	1716
"N18"	"C50"	"Chronic kidney disease (CKD)"	"Malignant neoplasm of breast"	1	84	778	862
"G31"	"M23"	"Oth degenerative diseases of nervous system, NEC"	"Internal derangement of knee"	1	0	161	161
"N19"	"M32"	"Unspecified kidney failure"	"Systemic lupus erythematosus (SLE)"	1	35	101	136
"M76"	"K29"	"Enthesopathies, lower limb, excluding foot"	"Gastritis and duodenitis"	1	354	512	866
"J15"	"N88"	"Bacterial pneumonia, not elsewhere classified"	"Other noninflammatory disorders of cervix uteri"	1	0	28	28
"I21"	"L23"	"Acute myocardial infarction"	"Allergic contact dermatitis"	1	75	197	272
"K43"	"M51"	"Ventral hernia"	"Thoracic, thoracolum, and lumbosacral intvrt disc disorders"	1	504	1091	1595
"N31"	"H46"	"Neuromuscular dysfunction of bladder, NEC"	"Optic neuritis"	1	15	86	101
"C34"	"I44"	"Malignant neoplasm of bronchus and lung"	"Atrioventricular and left bundle-branch block"	1	227	535	762
"E13"	"G40"	"Other specified diabetes mellitus"	"Epilepsy and recurrent seizures"	1	75	163	238
"L88"	"H91"	"Pyoderma gangrenosum"	"Other and unspecified hearing loss"	1	14	74	88
"G57"	"A63"	"Mononeuropathies of lower limb"	"Oth predominantly sexually transmitted diseases, NEC"	1	14	62	76
"L89"	"J30"	"Pressure ulcer"	"Vasomotor and allergic rhinitis"	1	0	34	34
"C18"	"E06"	"Malignant neoplasm of colon"	"Thyroiditis"	1	9	46	55
"I80"	"O04"	"Phlebitis and thrombophlebitis"	"Complications following (induced) termination of pregnancy"	1	23	890	913
"C34"	"H91"	"Malignant neoplasm of bronchus and lung"	"Other and unspecified hearing loss"	1	0	6202	6202
"D17"	"H83"	"Benign lipomatous neoplasm"	"Other diseases of inner ear"	1	210	338	548
"O72"	"M08"	"Postpartum hemorrhage"	"Juvenile arthritis"	1	0	49	49
"D71"	"C49"	"Functional disorders of polymorphonuclear neutrophils"	"Malignant neoplasm of other connective and soft tissue"	1	8	47	55
"F03"	"H83"	"Unspecified dementia"	"Other diseases of inner ear"	1	0	784	784
"K62"	"G82"	"Other diseases of anus and rectum"	"Paraplegia (paraparesis) and quadriplegia (quadriparesis)"	1	124	222	346
"J06"	"M75"	"Acute upper resp infections of multiple and unsp sites"	"Shoulder lesions"	1	147	598	745
"E87"	"O75"	"Other disorders of fluid, electrolyte and acid-base balance"	"Oth complications of labor and delivery, NEC"	1	0	47	47
"J95"	"C73"	"Intraop and postproc comp and disorders of resp sys, NEC"	"Malignant neoplasm of thyroid gland"	1	12	67	79
"N18"	"D41"	"Chronic kidney disease (CKD)"	"Neoplasm of uncertain behavior of urinary organs"	1	75	167	242
"J44"	"D25"	"Other chronic obstructive pulmonary disease"	"Leiomyoma of uterus"	1	44	1061	1105
"F41"	"M79"	"Other anxiety disorders"	"Oth and unsp soft tissue disorders, not elsewhere classified"	1	718	1924	2642
"C83"	"N40"	"Non-follicular lymphoma"	"Benign prostatic hyperplasia"	1	81	394	475
"I71"	"A69"	"Aortic aneurysm and dissection"	"Other spirochetal infections"	1	1	41	42
"J35"	"J05"	"Chronic diseases of tonsils and adenoids"	"Acute obstructive laryngitis [croup] and epiglottitis"	1	664	2142	2806
"G30"	"I70"	"Alzheimer's disease"	"Atherosclerosis"	1	48	364	412
"M70"	"O02"	"Soft tissue disorders related to use, overuse and pressure"	"Other abnormal products of conception"	1	60	292	352
"K86"	"M16"	"Other diseases of pancreas"	"Osteoarthritis of hip"	1	171	313	484
"C44"	"O72"	"Other and unspecified malignant neoplasm of skin"	"Postpartum hemorrhage"	1	38	176	214
"M79"	"Q78"	"Oth and unsp soft tissue disorders, not elsewhere classified"	"Other osteochondrodysplasias"	1	87	202	289
"O30"	"O04"	"Multiple gestation"	"Complications following (induced) termination of pregnancy"	1	502	913	1415
"M65"	"N87"	"Synovitis and tenosynovitis"	"Dysplasia of cervix uteri"	1	288	597	885
"C18"	"J11"	"Malignant neoplasm of colon"	"Influenza due to unidentified influenza virus"	1	23	84	107
"N17"	"K51"	"Acute kidney failure"	"Ulcerative colitis"	1	64	330	394
"O70"	"N98"	"Perineal laceration during delivery"	"Complications associated with artificial fertilization"	1	309	996	1305
"D50"	"K20"	"Iron deficiency anemia"	"Esophagitis"	1	630	916	1546
"O72"	"H71"	"Postpartum hemorrhage"	"Cholesteatoma of middle ear"	1	3	149	152
"A08"	"Q21"	"Viral and other specified intestinal infections"	"Congenital malformations of cardiac septa"	1	150	412	562
"C79"	"H20"	"Secondary malignant neoplasm of other and unspecified sites"	"Iridocyclitis"	1	7	98	105
"H26"	"O48"	"Other cataract"	"Late pregnancy"	1	0	25	25
"F33"	"G43"	"Major depressive disorder, recurrent"	"Migraine"	1	262	591	853
"J96"	"O68"	"Respiratory failure, not elsewhere classified"	"Labor and delivery comp by abnlt of fetal acid-base balance"	1	3	220	223
"D04"	"I25"	"Carcinoma in situ of skin"	"Chronic ischemic heart disease"	1	74	221	295
"C61"	"M50"	"Malignant neoplasm of prostate"	"Cervical disc disorders"	1	21	443	464
"H91"	"J03"	"Other and unspecified hearing loss"	"Acute tonsillitis"	1	282	483	765
"J18"	"D37"	"Pneumonia, unspecified organism"	"Neoplasm of uncrt behavior of oral cavity and dgstv organs"	1	290	584	874
"O72"	"G40"	"Postpartum hemorrhage"	"Epilepsy and recurrent seizures"	1	0	1076	1076
"B25"	"K51"	"Cytomegaloviral disease"	"Ulcerative colitis"	1	23	82	105
"N39"	"M25"	"Other disorders of urinary system"	"Other joint disorder, not elsewhere classified"	1	1228	1791	3019
"F32"	"C61"	"Depressive episode"	"Malignant neoplasm of prostate"	1	376	913	1289
"D21"	"M54"	"Other benign neoplasms of connective and other soft tissue"	"Dorsalgia"	1	235	430	665
"C92"	"K57"	"Myeloid leukemia"	"Diverticular disease of intestine"	1	54	238	292
"J20"	"I20"	"Acute bronchitis"	"Angina pectoris"	1	1208	1685	2893
"J90"	"J30"	"Pleural effusion, not elsewhere classified"	"Vasomotor and allergic rhinitis"	1	1	48	49
"G31"	"M75"	"Oth degenerative diseases of nervous system, NEC"	"Shoulder lesions"	1	16	215	231
"J15"	"O21"	"Bacterial pneumonia, not elsewhere classified"	"Excessive vomiting in pregnancy"	1	14	93	107
"J22"	"N81"	"Unspecified acute lower respiratory infection"	"Female genital prolapse"	1	3	255	258
"N64"	"D48"	"Other disorders of breast"	"Neoplasm of uncertain behavior of other and unsp sites"	1	14	140	154
"M67"	"O62"	"Other disorders of synovium and tendon"	"Abnormalities of forces of labor"	1	594	2052	2646
"K74"	"F11"	"Fibrosis and cirrhosis of liver"	"Opioid related disorders"	1	26	162	188
"H57"	"O20"	"Other disorders of eye and adnexa"	"Hemorrhage in early pregnancy"	1	0	243	243
"K63"	"O03"	"Other diseases of intestine"	"Spontaneous abortion"	1	0	55	55
"I89"	"J35"	"Oth noninfective disorders of lymphatic vessels and nodes"	"Chronic diseases of tonsils and adenoids"	1	0	91	91
"N19"	"H25"	"Unspecified kidney failure"	"Age-related cataract"	1	0	5538	5538
"M89"	"Q66"	"Other disorders of bone"	"Congenital deformities of feet"	1	58	135	193
"L90"	"K50"	"Atrophic disorders of skin"	"Crohn's disease [regional enteritis]"	1	59	240	299
"K56"	"Q54"	"Paralytic ileus and intestinal obstruction without hernia"	"Hypospadias"	1	5	40	45
"J13"	"G40"	"Pneumonia due to Streptococcus pneumoniae"	"Epilepsy and recurrent seizures"	1	149	289	438
"I67"	"M72"	"Other cerebrovascular diseases"	"Fibroblastic disorders"	1	34	125	159
"N95"	"N80"	"Menopausal and other perimenopausal disorders"	"Endometriosis"	1	117	240	357
"J40"	"O68"	"Bronchitis, not specified as acute or chronic"	"Labor and delivery comp by abnlt of fetal acid-base balance"	1	9	58	67
"D63"	"H83"	"Anemia in chronic diseases classified elsewhere"	"Other diseases of inner ear"	1	0	500	500
"D32"	"M16"	"Benign neoplasm of meninges"	"Osteoarthritis of hip"	1	77	181	258
"A49"	"B34"	"Bacterial infection of unspecified site"	"Viral infection of unspecified site"	1	574	939	1513
"K59"	"O02"	"Other functional intestinal disorders"	"Other abnormal products of conception"	1	275	1030	1305
"N95"	"G56"	"Menopausal and other perimenopausal disorders"	"Mononeuropathies of upper limb"	1	737	982	1719
"I50"	"H36"	"Heart failure"	"Retinal disorders in diseases classified elsewhere"	1	1363	2254	3617
"K44"	"O65"	"Diaphragmatic hernia"	"Obstructed labor due to maternal pelvic abnormality"	1	0	117	117
"N93"	"O64"	"Other abnormal uterine and vaginal bleeding"	"Obstructed labor due to malposition and malpresent of fetus"	1	66	428	494
"J15"	"G31"	"Bacterial pneumonia, not elsewhere classified"	"Oth degenerative diseases of nervous system, NEC"	1	362	564	926
"I95"	"M22"	"Hypotension"	"Disorder of patella"	1	0	96	96
"N39"	"G82"	"Other disorders of urinary system"	"Paraplegia (paraparesis) and quadriplegia (quadriparesis)"	1	591	1038	1629
"N13"	"I47"	"Obstructive and reflux uropathy"	"Paroxysmal tachycardia"	1	205	395	600
"D64"	"D27"	"Other anemias"	"Benign neoplasm of ovary"	1	141	706	847
"K76"	"N94"	"Other diseases of liver"	"Pain and oth cond assoc w fem gntl org and menstrual cycle"	1	12	178	190
"N28"	"M20"	"Oth disorders of kidney and ureter, not elsewhere classified"	"Acquired deformities of fingers and toes"	1	35	165	200
"K22"	"N95"	"Other diseases of esophagus"	"Menopausal and other perimenopausal disorders"	1	107	243	350
"G56"	"O80"	"Mononeuropathies of upper limb"	"Encounter for full-term uncomplicated delivery"	1	0	5228	5228
"H52"	"N92"	"Disorders of refraction and accommodation"	"Excessive, frequent and irregular menstruation"	1	535	949	1484
"G96"	"L03"	"Other disorders of central nervous system"	"Cellulitis and acute lymphangitis"	1	0	236	236
"K64"	"J18"	"Hemorrhoids and perianal venous thrombosis"	"Pneumonia, unspecified organism"	1	359	1691	2050
"I33"	"G45"	"Acute and subacute endocarditis"	"Transient cerebral ischemic attacks and related syndromes"	1	93	192	285
"I46"	"O70"	"Cardiac arrest"	"Perineal laceration during delivery"	1	0	39	39
"K59"	"K20"	"Other functional intestinal disorders"	"Esophagitis"	1	1024	2118	3142
"K90"	"O04"	"Intestinal malabsorption"	"Complications following (induced) termination of pregnancy"	1	6	206	212
"K57"	"H36"	"Diverticular disease of intestine"	"Retinal disorders in diseases classified elsewhere"	1	263	396	659
"G57"	"O42"	"Mononeuropathies of lower limb"	"Premature rupture of membranes"	1	17	75	92
"K22"	"G56"	"Other diseases of esophagus"	"Mononeuropathies of upper limb"	1	248	582	830
"J22"	"O62"	"Unspecified acute lower respiratory infection"	"Abnormalities of forces of labor"	1	0	94	94
"N28"	"M24"	"Oth disorders of kidney and ureter, not elsewhere classified"	"Other specific joint derangements"	1	8	51	59
"M79"	"J05"	"Oth and unsp soft tissue disorders, not elsewhere classified"	"Acute obstructive laryngitis [croup] and epiglottitis"	1	0	1094	1094
"E41"	"G56"	"Nutritional marasmus"	"Mononeuropathies of upper limb"	1	0	63	63
"C77"	"M50"	"Secondary and unspecified malignant neoplasm of lymph nodes"	"Cervical disc disorders"	1	12	236	248
"D23"	"D25"	"Other benign neoplasms of skin"	"Leiomyoma of uterus"	1	262	497	759
"K90"	"K30"	"Intestinal malabsorption"	"Functional dyspepsia"	1	178	487	665
"M43"	"O48"	"Other deforming dorsopathies"	"Late pregnancy"	1	3	66	69
"A49"	"M02"	"Bacterial infection of unspecified site"	"Postinfective and reactive arthropathies"	1	174	304	478
"D09"	"H93"	"Carcinoma in situ of other and unspecified sites"	"Other disorders of ear, not elsewhere classified"	1	0	149	149
"M13"	"K35"	"Other arthritis"	"Acute appendicitis"	1	103	325	428
"L72"	"J45"	"Follicular cysts of skin and subcutaneous tissue"	"Asthma"	1	138	278	416
"D14"	"O99"	"Benign neoplasm of middle ear and respiratory system"	"Oth maternal diseases classd elsw but compl preg/chldbrth"	1	42	104	146
"G25"	"O68"	"Other extrapyramidal and movement disorders"	"Labor and delivery comp by abnlt of fetal acid-base balance"	1	2	37	39
"O35"	"J30"	"Maternal care for known or suspected fetal abnlt and damage"	"Vasomotor and allergic rhinitis"	1	5	67	72
"D12"	"H80"	"Benign neoplasm of colon, rectum, anus and anal canal"	"Otosclerosis"	1	0	315	315
"E16"	"H93"	"Other disorders of pancreatic internal secretion"	"Other disorders of ear, not elsewhere classified"	1	71	293	364
"A49"	"N95"	"Bacterial infection of unspecified site"	"Menopausal and other perimenopausal disorders"	1	53	591	644
"I35"	"N95"	"Nonrheumatic aortic valve disorders"	"Menopausal and other perimenopausal disorders"	1	89	826	915
"D33"	"N92"	"Benign neoplasm of brain and oth prt central nervous system"	"Excessive, frequent and irregular menstruation"	1	44	154	198
"J95"	"G56"	"Intraop and postproc comp and disorders of resp sys, NEC"	"Mononeuropathies of upper limb"	1	6	133	139
"C78"	"C60"	"Secondary malignant neoplasm of resp and digestive organs"	"Malignant neoplasm of penis"	1	17	65	82
"C43"	"O47"	"Malignant melanoma of skin"	"False labor"	1	9	79	88
"E83"	"J45"	"Disorders of mineral metabolism"	"Asthma"	1	50	489	539
"M85"	"K40"	"Other disorders of bone density and structure"	"Inguinal hernia"	1	97	1037	1134
"I69"	"D32"	"Sequelae of cerebrovascular disease"	"Benign neoplasm of meninges"	1	280	443	723
"O20"	"B27"	"Hemorrhage in early pregnancy"	"Infectious mononucleosis"	1	0	141	141
"C43"	"M51"	"Malignant melanoma of skin"	"Thoracic, thoracolum, and lumbosacral intvrt disc disorders"	1	204	526	730
"K52"	"I50"	"Other and unsp noninfective gastroenteritis and colitis"	"Heart failure"	1	2501	3115	5616
"B59"	"K80"	"Pneumocystosis"	"Cholelithiasis"	1	0	29	29
"F41"	"K58"	"Other anxiety disorders"	"Irritable bowel syndrome"	1	222	576	798
"L90"	"C50"	"Atrophic disorders of skin"	"Malignant neoplasm of breast"	1	0	2797	2797
"C22"	"G40"	"Malignant neoplasm of liver and intrahepatic bile ducts"	"Epilepsy and recurrent seizures"	1	11	118	129
"D13"	"E11"	"Benign neoplasm of and ill-defined parts of digestive system"	"Type 2 diabetes mellitus"	1	343	647	990
"N18"	"C19"	"Chronic kidney disease (CKD)"	"Malignant neoplasm of rectosigmoid junction"	1	0	28	28
"M65"	"O82"	"Synovitis and tenosynovitis"	"Encounter for cesarean delivery without indication"	1	657	1130	1787
"K92"	"O04"	"Other diseases of digestive system"	"Complications following (induced) termination of pregnancy"	1	59	502	561
"G47"	"N47"	"Sleep disorders"	"Disorders of prepuce"	1	215	604	819
"M51"	"L91"	"Thoracic, thoracolum, and lumbosacral intvrt disc disorders"	"Hypertrophic disorders of skin"	1	33	102	135
"H43"	"N62"	"Disorders of vitreous body"	"Hypertrophy of breast"	1	52	128	180
"K25"	"M16"	"Gastric ulcer"	"Osteoarthritis of hip"	1	1310	2106	3416
"L08"	"O04"	"Other local infections of skin and subcutaneous tissue"	"Complications following (induced) termination of pregnancy"	1	74	1151	1225
"B99"	"I70"	"Other and unspecified infectious diseases"	"Atherosclerosis"	1	62	140	202
"J22"	"E16"	"Unspecified acute lower respiratory infection"	"Other disorders of pancreatic internal secretion"	1	85	170	255
"I25"	"H93"	"Chronic ischemic heart disease"	"Other disorders of ear, not elsewhere classified"	1	1621	3357	4978
"D63"	"M85"	"Anemia in chronic diseases classified elsewhere"	"Other disorders of bone density and structure"	1	110	214	324
"L05"	"B27"	"Pilonidal cyst and sinus"	"Infectious mononucleosis"	1	31	110	141
"N20"	"O02"	"Calculus of kidney and ureter"	"Other abnormal products of conception"	1	161	551	712
"M51"	"M22"	"Thoracic, thoracolum, and lumbosacral intvrt disc disorders"	"Disorder of patella"	1	0	1919	1919
"I48"	"O26"	"Atrial fibrillation and flutter"	"Maternal care for oth conditions predom related to pregnancy"	1	1	120	121
"N61"	"O48"	"Inflammatory disorders of breast"	"Late pregnancy"	1	4	179	183
"E87"	"M95"	"Other disorders of fluid, electrolyte and acid-base balance"	"Oth acquired deformities of ms sys and connective tissue"	1	11	97	108
"H35"	"C50"	"Other retinal disorders"	"Malignant neoplasm of breast"	1	623	1625	2248
"K59"	"H35"	"Other functional intestinal disorders"	"Other retinal disorders"	1	2146	5076	7222
"M06"	"N97"	"Other rheumatoid arthritis"	"Female infertility"	1	41	133	174
"K27"	"M54"	"Peptic ulcer, site unspecified"	"Dorsalgia"	1	578	822	1400
"J18"	"L03"	"Pneumonia, unspecified organism"	"Cellulitis and acute lymphangitis"	1	831	2764	3595
"D84"	"J06"	"Other immunodeficiencies"	"Acute upper resp infections of multiple and unsp sites"	1	105	231	336
"J94"	"M16"	"Other pleural conditions"	"Osteoarthritis of hip"	1	39	285	324
"E13"	"M50"	"Other specified diabetes mellitus"	"Cervical disc disorders"	1	12	51	63
"M77"	"J03"	"Other enthesopathies"	"Acute tonsillitis"	1	186	338	524
"I10"	"O12"	"Essential (primary) hypertension"	"Gestational edema and proteinuria without hypertension"	1	23	311	334
"M19"	"O47"	"Other and unspecified osteoarthritis"	"False labor"	1	0	134	134
"M10"	"C50"	"Gout"	"Malignant neoplasm of breast"	1	121	256	377
"M18"	"E04"	"Osteoarthritis of first carpometacarpal joint"	"Other nontoxic goiter"	1	88	274	362
"J69"	"M70"	"Pneumonitis due to solids and liquids"	"Soft tissue disorders related to use, overuse and pressure"	1	0	134	134
"I10"	"Q62"	"Essential (primary) hypertension"	"Congen defects of renal pelvis and congen malform of ureter"	1	39	108	147
"D09"	"A09"	"Carcinoma in situ of other and unspecified sites"	"Infectious gastroenteritis and colitis, unspecified"	1	18	76	94
"H57"	"N94"	"Other disorders of eye and adnexa"	"Pain and oth cond assoc w fem gntl org and menstrual cycle"	1	30	138	168
"J12"	"Q25"	"Viral pneumonia, not elsewhere classified"	"Congenital malformations of great arteries"	1	177	418	595
"I61"	"J34"	"Nontraumatic intracerebral hemorrhage"	"Other and unspecified disorders of nose and nasal sinuses"	1	9	106	115
"J44"	"M94"	"Other chronic obstructive pulmonary disease"	"Other disorders of cartilage"	1	24	82	106
"M13"	"N97"	"Other arthritis"	"Female infertility"	1	49	184	233
"D35"	"M20"	"Benign neoplasm of other and unspecified endocrine glands"	"Acquired deformities of fingers and toes"	1	31	119	150
"K25"	"O32"	"Gastric ulcer"	"Maternal care for malpresentation of fetus"	1	5	44	49
"Q55"	"Q53"	"Other congenital malformations of male genital organs"	"Undescended and ectopic testicle"	1	538	1016	1554
"I63"	"K70"	"Cerebral infarction"	"Alcoholic liver disease"	1	350	604	954
"B37"	"J34"	"Candidiasis"	"Other and unspecified disorders of nose and nasal sinuses"	1	46	135	181
"D46"	"I69"	"Myelodysplastic syndromes"	"Sequelae of cerebrovascular disease"	1	106	200	306
"O90"	"O26"	"Complications of the puerperium, not elsewhere classified"	"Maternal care for oth conditions predom related to pregnancy"	1	1054	2831	3885
"I51"	"M24"	"Complications and ill-defined descriptions of heart disease"	"Other specific joint derangements"	1	16	71	87
"E34"	"O62"	"Other endocrine disorders"	"Abnormalities of forces of labor"	1	41	133	174
"E16"	"K85"	"Other disorders of pancreatic internal secretion"	"Acute pancreatitis"	1	33	463	496
"D64"	"N75"	"Other anemias"	"Diseases of Bartholin's gland"	1	15	95	110
"D75"	"M75"	"Other and unsp diseases of blood and blood-forming organs"	"Shoulder lesions"	1	101	199	300
"D12"	"O02"	"Benign neoplasm of colon, rectum, anus and anal canal"	"Other abnormal products of conception"	1	0	168	168
"G02"	"O80"	"Meningitis in oth infec/parastc diseases classd elswhr"	"Encounter for full-term uncomplicated delivery"	1	4	43	47
"E86"	"M65"	"Volume depletion"	"Synovitis and tenosynovitis"	1	0	1516	1516
"J44"	"L40"	"Other chronic obstructive pulmonary disease"	"Psoriasis"	1	537	946	1483
"M47"	"L05"	"Spondylosis"	"Pilonidal cyst and sinus"	1	7	159	166
"M13"	"K50"	"Other arthritis"	"Crohn's disease [regional enteritis]"	1	79	244	323
"I83"	"J36"	"Varicose veins of lower extremities"	"Peritonsillar abscess"	1	49	195	244
"O85"	"O20"	"Puerperal sepsis"	"Hemorrhage in early pregnancy"	1	329	1037	1366
"C34"	"M95"	"Malignant neoplasm of bronchus and lung"	"Oth acquired deformities of ms sys and connective tissue"	1	0	72	72
"J93"	"L02"	"Pneumothorax and air leak"	"Cutaneous abscess, furuncle and carbuncle"	1	149	295	444
"D21"	"O80"	"Other benign neoplasms of connective and other soft tissue"	"Encounter for full-term uncomplicated delivery"	1	0	529	529
"M54"	"D27"	"Dorsalgia"	"Benign neoplasm of ovary"	1	797	1297	2094
"E11"	"M89"	"Type 2 diabetes mellitus"	"Other disorders of bone"	1	233	463	696
"K72"	"D23"	"Hepatic failure, not elsewhere classified"	"Other benign neoplasms of skin"	1	13	80	93
"A04"	"J36"	"Other bacterial intestinal infections"	"Peritonsillar abscess"	1	5	44	49
"K64"	"K91"	"Hemorrhoids and perianal venous thrombosis"	"Intraop and postproc comp and disorders of dgstv sys, NEC"	1	24	78	102
"K59"	"I44"	"Other functional intestinal disorders"	"Atrioventricular and left bundle-branch block"	1	1094	1479	2573
"O24"	"F10"	"Diabetes in pregnancy, childbirth, and the puerperium"	"Alcohol related disorders"	1	0	227	227
"L50"	"Q53"	"Urticaria"	"Undescended and ectopic testicle"	1	42	110	152
"N46"	"M79"	"Male infertility"	"Oth and unsp soft tissue disorders, not elsewhere classified"	1	418	640	1058
"C77"	"N76"	"Secondary and unspecified malignant neoplasm of lymph nodes"	"Other inflammation of vagina and vulva"	1	10	84	94
"K59"	"Q54"	"Other functional intestinal disorders"	"Hypospadias"	1	25	284	309
"C02"	"K13"	"Malignant neoplasm of other and unspecified parts of tongue"	"Other diseases of lip and oral mucosa"	1	60	139	199
"J96"	"M24"	"Respiratory failure, not elsewhere classified"	"Other specific joint derangements"	1	73	391	464
"I63"	"D21"	"Cerebral infarction"	"Other benign neoplasms of connective and other soft tissue"	1	58	169	227
"N95"	"N92"	"Menopausal and other perimenopausal disorders"	"Excessive, frequent and irregular menstruation"	1	0	8909	8909
"K27"	"H10"	"Peptic ulcer, site unspecified"	"Conjunctivitis"	1	47	133	180
"I70"	"O36"	"Atherosclerosis"	"Maternal care for other fetal problems"	1	0	35	35
"C93"	"D64"	"Monocytic leukemia"	"Other anemias"	1	81	221	302
"A04"	"G51"	"Other bacterial intestinal infections"	"Facial nerve disorders"	1	16	67	83
"N25"	"E10"	"Disorders resulting from impaired renal tubular function"	"Type 1 diabetes mellitus"	1	36	215	251
"G57"	"J34"	"Mononeuropathies of lower limb"	"Other and unspecified disorders of nose and nasal sinuses"	1	56	147	203
"I25"	"K60"	"Chronic ischemic heart disease"	"Fissure and fistula of anal and rectal regions"	1	510	717	1227
"N18"	"I83"	"Chronic kidney disease (CKD)"	"Varicose veins of lower extremities"	1	208	1690	1898
"I72"	"H83"	"Other aneurysm"	"Other diseases of inner ear"	1	7	166	173
"K59"	"M16"	"Other functional intestinal disorders"	"Osteoarthritis of hip"	1	0	7255	7255
"L57"	"M75"	"Skin changes due to chronic expsr to nonionizing radiation"	"Shoulder lesions"	1	229	754	983
"B96"	"G82"	"Oth bacterial agents as the cause of diseases classd elswhr"	"Paraplegia (paraparesis) and quadriplegia (quadriparesis)"	1	20	83	103
"E87"	"N84"	"Other disorders of fluid, electrolyte and acid-base balance"	"Polyp of female genital tract"	1	21	506	527
"G95"	"K61"	"Other and unspecified diseases of spinal cord"	"Abscess of anal and rectal regions"	1	7	56	63
"E87"	"L90"	"Other disorders of fluid, electrolyte and acid-base balance"	"Atrophic disorders of skin"	1	97	304	401
"A49"	"C49"	"Bacterial infection of unspecified site"	"Malignant neoplasm of other connective and soft tissue"	1	67	200	267
"I69"	"M71"	"Sequelae of cerebrovascular disease"	"Other bursopathies"	1	78	441	519
"F60"	"K29"	"Specific personality disorders"	"Gastritis and duodenitis"	1	103	218	321
"D63"	"H35"	"Anemia in chronic diseases classified elsewhere"	"Other retinal disorders"	1	235	1258	1493
"J96"	"M13"	"Respiratory failure, not elsewhere classified"	"Other arthritis"	1	244	879	1123
"E11"	"O70"	"Type 2 diabetes mellitus"	"Perineal laceration during delivery"	1	0	553	553
"M70"	"O68"	"Soft tissue disorders related to use, overuse and pressure"	"Labor and delivery comp by abnlt of fetal acid-base balance"	1	126	428	554
"O82"	"Q66"	"Encounter for cesarean delivery without indication"	"Congenital deformities of feet"	1	43	115	158
"L90"	"J45"	"Atrophic disorders of skin"	"Asthma"	1	318	890	1208
"C34"	"G46"	"Malignant neoplasm of bronchus and lung"	"Vascular syndromes of brain in cerebrovascular diseases"	1	7	69	76
"L89"	"G44"	"Pressure ulcer"	"Other headache syndromes"	1	8	73	81
"C91"	"M17"	"Lymphoid leukemia"	"Osteoarthritis of knee"	1	94	348	442
"I08"	"K01"	"Multiple valve diseases"	"Embedded and impacted teeth"	1	8	45	53
"C78"	"D39"	"Secondary malignant neoplasm of resp and digestive organs"	"Neoplasm of uncertain behavior of female genital organs"	1	66	221	287
"G98"	"N20"	"Other disorders of nervous system not elsewhere classified"	"Calculus of kidney and ureter"	1	30	197	227
"H91"	"O32"	"Other and unspecified hearing loss"	"Maternal care for malpresentation of fetus"	1	11	121	132
"A41"	"E15"	"Other sepsis"	"Nondiabetic hypoglycemic coma"	1	99	274	373
"J84"	"O80"	"Other interstitial pulmonary diseases"	"Encounter for full-term uncomplicated delivery"	1	0	87	87
"E83"	"C45"	"Disorders of mineral metabolism"	"Mesothelioma"	1	11	57	68
"J22"	"N84"	"Unspecified acute lower respiratory infection"	"Polyp of female genital tract"	1	15	63	78
"C49"	"M54"	"Malignant neoplasm of other connective and soft tissue"	"Dorsalgia"	1	75	186	261
"C43"	"O03"	"Malignant melanoma of skin"	"Spontaneous abortion"	1	0	159	159
"C79"	"M10"	"Secondary malignant neoplasm of other and unspecified sites"	"Gout"	1	62	402	464
"I73"	"M45"	"Other peripheral vascular diseases"	"Ankylosing spondylitis"	1	12	52	64
"B95"	"M51"	"Strep as the cause of diseases classified elsewhere"	"Thoracic, thoracolum, and lumbosacral intvrt disc disorders"	1	20	115	135
"D22"	"K35"	"Melanocytic nevi"	"Acute appendicitis"	1	50	405	455
"F32"	"D16"	"Depressive episode"	"Benign neoplasm of bone and articular cartilage"	1	19	87	106
"I50"	"Q18"	"Heart failure"	"Other congenital malformations of face and neck"	1	11	101	112
"I72"	"K40"	"Other aneurysm"	"Inguinal hernia"	1	69	429	498
"O72"	"N90"	"Postpartum hemorrhage"	"Other noninflammatory disorders of vulva and perineum"	1	304	622	926
"C78"	"M21"	"Secondary malignant neoplasm of resp and digestive organs"	"Other acquired deformities of limbs"	1	4	322	326
"J44"	"O80"	"Other chronic obstructive pulmonary disease"	"Encounter for full-term uncomplicated delivery"	1	0	369	369
"D84"	"J20"	"Other immunodeficiencies"	"Acute bronchitis"	1	81	327	408
"F33"	"K29"	"Major depressive disorder, recurrent"	"Gastritis and duodenitis"	1	519	1673	2192
"G31"	"M17"	"Oth degenerative diseases of nervous system, NEC"	"Osteoarthritis of knee"	1	19	417	436
"D05"	"O82"	"Carcinoma in situ of breast"	"Encounter for cesarean delivery without indication"	1	0	50	50
"E64"	"C25"	"Sequelae of malnutrition and other nutritional deficiencies"	"Malignant neoplasm of pancreas"	1	103	335	438
"N20"	"N46"	"Calculus of kidney and ureter"	"Male infertility"	1	174	291	465
"N39"	"J37"	"Other disorders of urinary system"	"Chronic laryngitis and laryngotracheitis"	1	30	301	331
"E64"	"Q25"	"Sequelae of malnutrition and other nutritional deficiencies"	"Congenital malformations of great arteries"	1	12	65	77
"K74"	"E05"	"Fibrosis and cirrhosis of liver"	"Thyrotoxicosis [hyperthyroidism]"	1	44	112	156
"A46"	"G45"	"Erysipelas"	"Transient cerebral ischemic attacks and related syndromes"	1	691	1328	2019
"D63"	"H02"	"Anemia in chronic diseases classified elsewhere"	"Other disorders of eyelid"	1	68	318	386
"M25"	"N62"	"Other joint disorder, not elsewhere classified"	"Hypertrophy of breast"	1	178	457	635
"M50"	"O24"	"Cervical disc disorders"	"Diabetes in pregnancy, childbirth, and the puerperium"	1	0	100	100
"C71"	"C44"	"Malignant neoplasm of brain"	"Other and unspecified malignant neoplasm of skin"	1	55	163	218
"I83"	"O03"	"Varicose veins of lower extremities"	"Spontaneous abortion"	1	0	1589	1589
"M48"	"O02"	"Other spondylopathies"	"Other abnormal products of conception"	1	0	86	86
"J15"	"O99"	"Bacterial pneumonia, not elsewhere classified"	"Oth maternal diseases classd elsw but compl preg/chldbrth"	1	191	734	925
"C79"	"H93"	"Secondary malignant neoplasm of other and unspecified sites"	"Other disorders of ear, not elsewhere classified"	1	0	801	801
"H50"	"Q90"	"Other strabismus"	"Down syndrome"	1	63	222	285
"N80"	"N92"	"Endometriosis"	"Excessive, frequent and irregular menstruation"	1	3657	4740	8397
"G96"	"O65"	"Other disorders of central nervous system"	"Obstructed labor due to maternal pelvic abnormality"	1	0	47	47
"C78"	"J84"	"Secondary malignant neoplasm of resp and digestive organs"	"Other interstitial pulmonary diseases"	1	226	386	612
"K57"	"F10"	"Diverticular disease of intestine"	"Alcohol related disorders"	1	913	2344	3257
"C73"	"O48"	"Malignant neoplasm of thyroid gland"	"Late pregnancy"	1	0	34	34
"E64"	"E11"	"Sequelae of malnutrition and other nutritional deficiencies"	"Type 2 diabetes mellitus"	1	276	1067	1343
"Q66"	"J05"	"Congenital deformities of feet"	"Acute obstructive laryngitis [croup] and epiglottitis"	1	135	295	430
"O34"	"G40"	"Maternal care for abnormality of pelvic organs"	"Epilepsy and recurrent seizures"	1	21	203	224
"K57"	"O62"	"Diverticular disease of intestine"	"Abnormalities of forces of labor"	1	0	174	174
"K85"	"H65"	"Acute pancreatitis"	"Nonsuppurative otitis media"	1	18	103	121
"D64"	"N61"	"Other anemias"	"Inflammatory disorders of breast"	1	41	181	222
"E66"	"G40"	"Overweight and obesity"	"Epilepsy and recurrent seizures"	1	708	1586	2294
"C67"	"M62"	"Malignant neoplasm of bladder"	"Other disorders of muscle"	1	60	252	312
"M48"	"K43"	"Other spondylopathies"	"Ventral hernia"	1	406	626	1032
"K30"	"N92"	"Functional dyspepsia"	"Excessive, frequent and irregular menstruation"	1	1252	2462	3714
"J90"	"M20"	"Pleural effusion, not elsewhere classified"	"Acquired deformities of fingers and toes"	1	13	276	289
"I20"	"L23"	"Angina pectoris"	"Allergic contact dermatitis"	1	157	302	459
"F41"	"C38"	"Other anxiety disorders"	"Malignant neoplasm of heart, mediastinum and pleura"	1	21	68	89
"J15"	"D75"	"Bacterial pneumonia, not elsewhere classified"	"Other and unsp diseases of blood and blood-forming organs"	1	172	367	539
"O70"	"J45"	"Perineal laceration during delivery"	"Asthma"	1	1920	3397	5317
"E23"	"O03"	"Hypofunction and other disorders of the pituitary gland"	"Spontaneous abortion"	1	1	58	59
"C80"	"M51"	"Malignant neoplasm without specification of site"	"Thoracic, thoracolum, and lumbosacral intvrt disc disorders"	1	4	296	300
"C90"	"D27"	"Multiple myeloma and malignant plasma cell neoplasms"	"Benign neoplasm of ovary"	1	2	28	30
"I48"	"K50"	"Atrial fibrillation and flutter"	"Crohn's disease [regional enteritis]"	1	300	452	752
"I63"	"M65"	"Cerebral infarction"	"Synovitis and tenosynovitis"	1	226	1455	1681
"E11"	"N88"	"Type 2 diabetes mellitus"	"Other noninflammatory disorders of cervix uteri"	1	16	78	94
"E23"	"O04"	"Hypofunction and other disorders of the pituitary gland"	"Complications following (induced) termination of pregnancy"	1	0	92	92
"I95"	"I42"	"Hypotension"	"Cardiomyopathy"	1	317	646	963
"F32"	"K00"	"Depressive episode"	"Disorders of tooth development and eruption"	1	2	38	40
"N18"	"M79"	"Chronic kidney disease (CKD)"	"Oth and unsp soft tissue disorders, not elsewhere classified"	1	685	2543	3228
"J18"	"D28"	"Pneumonia, unspecified organism"	"Benign neoplasm of other and unsp female genital organs"	1	18	199	217
"F01"	"M72"	"Vascular dementia"	"Fibroblastic disorders"	1	0	116	116
"H35"	"K11"	"Other retinal disorders"	"Diseases of salivary glands"	1	122	216	338
"N10"	"K40"	"Acute pyelonephritis"	"Inguinal hernia"	1	184	602	786
"J96"	"M30"	"Respiratory failure, not elsewhere classified"	"Polyarteritis nodosa and related conditions"	1	38	103	141
"K92"	"N60"	"Other diseases of digestive system"	"Benign mammary dysplasia"	1	31	232	263
"K20"	"O68"	"Esophagitis"	"Labor and delivery comp by abnlt of fetal acid-base balance"	1	29	96	125
"N83"	"M08"	"Noninflammatory disord of ovary, fallop and broad ligament"	"Juvenile arthritis"	1	0	40	40
"O90"	"O24"	"Complications of the puerperium, not elsewhere classified"	"Diabetes in pregnancy, childbirth, and the puerperium"	1	361	1062	1423
"K83"	"O02"	"Other diseases of biliary tract"	"Other abnormal products of conception"	1	2	90	92
"I69"	"H93"	"Sequelae of cerebrovascular disease"	"Other disorders of ear, not elsewhere classified"	1	0	2530	2530
"E55"	"O24"	"Vitamin D deficiency"	"Diabetes in pregnancy, childbirth, and the puerperium"	1	105	250	355
"O63"	"O02"	"Long labor"	"Other abnormal products of conception"	1	1646	2124	3770
"I65"	"M77"	"Occls and stenosis of precerb art, not rslt in cereb infrc"	"Other enthesopathies"	1	26	79	105
"E78"	"O68"	"Disorders of lipoprotein metabolism and other lipidemias"	"Labor and delivery comp by abnlt of fetal acid-base balance"	1	0	291	291
"H26"	"O04"	"Other cataract"	"Complications following (induced) termination of pregnancy"	1	0	146	146
"G30"	"C85"	"Alzheimer's disease"	"Oth and unspecified types of non-Hodgkin lymphoma"	1	3	39	42
"H34"	"N81"	"Retinal vascular occlusions"	"Female genital prolapse"	1	69	277	346
"O48"	"L20"	"Late pregnancy"	"Atopic dermatitis"	1	44	114	158
"M10"	"N04"	"Gout"	"Nephrotic syndrome"	1	58	127	185
"J69"	"K22"	"Pneumonitis due to solids and liquids"	"Other diseases of esophagus"	1	175	418	593
"K62"	"K35"	"Other diseases of anus and rectum"	"Acute appendicitis"	1	293	1015	1308
"N13"	"N92"	"Obstructive and reflux uropathy"	"Excessive, frequent and irregular menstruation"	1	171	624	795
"C91"	"E78"	"Lymphoid leukemia"	"Disorders of lipoprotein metabolism and other lipidemias"	1	179	340	519
"A08"	"C90"	"Viral and other specified intestinal infections"	"Multiple myeloma and malignant plasma cell neoplasms"	1	24	77	101
"A46"	"Q18"	"Erysipelas"	"Other congenital malformations of face and neck"	1	8	46	54
"C92"	"F10"	"Myeloid leukemia"	"Alcohol related disorders"	1	15	77	92
"L90"	"Q43"	"Atrophic disorders of skin"	"Other congenital malformations of intestine"	1	0	34	34
"B37"	"C83"	"Candidiasis"	"Non-follicular lymphoma"	1	162	479	641
"O14"	"O30"	"Pre-eclampsia"	"Multiple gestation"	1	1396	1871	3267
"O99"	"N76"	"Oth maternal diseases classd elsw but compl preg/chldbrth"	"Other inflammation of vagina and vulva"	1	674	1024	1698
"K80"	"F10"	"Cholelithiasis"	"Alcohol related disorders"	1	1103	2305	3408
"A41"	"H00"	"Other sepsis"	"Hordeolum and chalazion"	1	18	171	189
"C77"	"K26"	"Secondary and unspecified malignant neoplasm of lymph nodes"	"Duodenal ulcer"	1	79	323	402
"I72"	"K61"	"Other aneurysm"	"Abscess of anal and rectal regions"	1	7	46	53
"K20"	"O65"	"Esophagitis"	"Obstructed labor due to maternal pelvic abnormality"	1	0	28	28
"J96"	"E84"	"Respiratory failure, not elsewhere classified"	"Cystic fibrosis"	1	0	67	67
"M70"	"O71"	"Soft tissue disorders related to use, overuse and pressure"	"Other obstetric trauma"	1	7	212	219
"M48"	"N70"	"Other spondylopathies"	"Salpingitis and oophoritis"	1	0	105	105
"O92"	"M76"	"Oth disord of brst/lactatn assoc w pregnancy and the puerp"	"Enthesopathies, lower limb, excluding foot"	1	46	133	179
"G98"	"K62"	"Other disorders of nervous system not elsewhere classified"	"Other diseases of anus and rectum"	1	80	216	296
"M16"	"N80"	"Osteoarthritis of hip"	"Endometriosis"	1	0	192	192
"E87"	"K35"	"Other disorders of fluid, electrolyte and acid-base balance"	"Acute appendicitis"	1	123	731	854
"N61"	"J35"	"Inflammatory disorders of breast"	"Chronic diseases of tonsils and adenoids"	1	3	132	135
"I33"	"N40"	"Acute and subacute endocarditis"	"Benign prostatic hyperplasia"	1	106	377	483
"H33"	"O32"	"Retinal detachments and breaks"	"Maternal care for malpresentation of fetus"	1	0	28	28
"J96"	"H34"	"Respiratory failure, not elsewhere classified"	"Retinal vascular occlusions"	1	95	665	760
"I48"	"K04"	"Atrial fibrillation and flutter"	"Diseases of pulp and periapical tissues"	1	1043	1454	2497
"A09"	"C91"	"Infectious gastroenteritis and colitis, unspecified"	"Lymphoid leukemia"	1	193	326	519
"I73"	"D25"	"Other peripheral vascular diseases"	"Leiomyoma of uterus"	1	20	340	360
"F17"	"O62"	"Nicotine dependence"	"Abnormalities of forces of labor"	1	0	1257	1257
"E65"	"O40"	"Localized adiposity"	"Polyhydramnios"	1	8	99	107
"M75"	"O41"	"Shoulder lesions"	"Other disorders of amniotic fluid and membranes"	1	0	199	199
"F05"	"M65"	"Delirium due to known physiological condition"	"Synovitis and tenosynovitis"	1	0	252	252
"I11"	"D23"	"Hypertensive heart disease"	"Other benign neoplasms of skin"	1	47	129	176
"A26"	"J44"	"Erysipeloid"	"Other chronic obstructive pulmonary disease"	1	77	243	320
"K59"	"M83"	"Other functional intestinal disorders"	"Adult osteomalacia"	1	116	215	331
"I20"	"Q17"	"Angina pectoris"	"Other congenital malformations of ear"	1	1	28	29
"M89"	"J20"	"Other disorders of bone"	"Acute bronchitis"	1	49	121	170
"C34"	"L05"	"Malignant neoplasm of bronchus and lung"	"Pilonidal cyst and sinus"	1	0	67	67
"H36"	"N80"	"Retinal disorders in diseases classified elsewhere"	"Endometriosis"	1	13	56	69
"L82"	"I20"	"Seborrheic keratosis"	"Angina pectoris"	1	74	501	575
"C78"	"M22"	"Secondary malignant neoplasm of resp and digestive organs"	"Disorder of patella"	1	0	103	103
"M85"	"C61"	"Other disorders of bone density and structure"	"Malignant neoplasm of prostate"	1	236	553	789
"L08"	"M35"	"Other local infections of skin and subcutaneous tissue"	"Other systemic involvement of connective tissue"	1	217	341	558
"B37"	"N60"	"Candidiasis"	"Benign mammary dysplasia"	1	30	106	136
"D23"	"D48"	"Other benign neoplasms of skin"	"Neoplasm of uncertain behavior of other and unsp sites"	1	121	220	341
"I27"	"O80"	"Other pulmonary heart diseases"	"Encounter for full-term uncomplicated delivery"	1	0	45	45
"I48"	"N35"	"Atrial fibrillation and flutter"	"Urethral stricture"	1	394	751	1145
"C34"	"C32"	"Malignant neoplasm of bronchus and lung"	"Malignant neoplasm of larynx"	1	109	569	678
"O72"	"O48"	"Postpartum hemorrhage"	"Late pregnancy"	1	7580	12232	19812
"G43"	"D06"	"Migraine"	"Carcinoma in situ of cervix uteri"	1	18	111	129
"G23"	"H83"	"Other degenerative diseases of basal ganglia"	"Other diseases of inner ear"	1	0	29	29
"K00"	"H50"	"Disorders of tooth development and eruption"	"Other strabismus"	1	17	135	152
"I26"	"K42"	"Pulmonary embolism"	"Umbilical hernia"	1	138	340	478
"L97"	"I70"	"Non-pressure chronic ulcer of lower limb, NEC"	"Atherosclerosis"	1	4273	7348	11621
"C34"	"N32"	"Malignant neoplasm of bronchus and lung"	"Other disorders of bladder"	1	40	211	251
"K65"	"J45"	"Peritonitis"	"Asthma"	1	199	512	711
"H34"	"M75"	"Retinal vascular occlusions"	"Shoulder lesions"	1	164	408	572
"E87"	"M51"	"Other disorders of fluid, electrolyte and acid-base balance"	"Thoracic, thoracolum, and lumbosacral intvrt disc disorders"	1	0	2563	2563
"O28"	"O02"	"Abnormal findings on antenatal screening of mother"	"Other abnormal products of conception"	1	603	1332	1935
"K62"	"N60"	"Other diseases of anus and rectum"	"Benign mammary dysplasia"	1	125	594	719
"M14"	"L03"	"Arthropathies in other diseases classified elsewhere"	"Cellulitis and acute lymphangitis"	1	37	113	150
"K02"	"K86"	"Dental caries"	"Other diseases of pancreas"	1	58	152	210
"I48"	"I80"	"Atrial fibrillation and flutter"	"Phlebitis and thrombophlebitis"	1	3234	5517	8751
"N20"	"D24"	"Calculus of kidney and ureter"	"Benign neoplasm of breast"	1	149	297	446
"A41"	"O64"	"Other sepsis"	"Obstructed labor due to malposition and malpresent of fetus"	1	0	83	83
"D12"	"D05"	"Benign neoplasm of colon, rectum, anus and anal canal"	"Carcinoma in situ of breast"	1	59	138	197
"E86"	"K61"	"Volume depletion"	"Abscess of anal and rectal regions"	1	118	744	862
"L90"	"O14"	"Atrophic disorders of skin"	"Pre-eclampsia"	1	35	185	220
"K13"	"O62"	"Other diseases of lip and oral mucosa"	"Abnormalities of forces of labor"	1	8	103	111
"K63"	"K20"	"Other diseases of intestine"	"Esophagitis"	1	138	307	445
"N19"	"I83"	"Unspecified kidney failure"	"Varicose veins of lower extremities"	1	209	839	1048
"L08"	"N43"	"Other local infections of skin and subcutaneous tissue"	"Hydrocele and spermatocele"	1	91	245	336
"I85"	"G40"	"Esophageal varices"	"Epilepsy and recurrent seizures"	1	124	233	357
"E27"	"M20"	"Other disorders of adrenal gland"	"Acquired deformities of fingers and toes"	1	19	113	132
"C79"	"L03"	"Secondary malignant neoplasm of other and unspecified sites"	"Cellulitis and acute lymphangitis"	1	3	313	316
"M85"	"G43"	"Other disorders of bone density and structure"	"Migraine"	1	27	422	449
"G95"	"L05"	"Other and unspecified diseases of spinal cord"	"Pilonidal cyst and sinus"	1	0	26	26
"J05"	"Q20"	"Acute obstructive laryngitis [croup] and epiglottitis"	"Congenital malformations of cardiac chambers and connections"	1	27	99	126
"D50"	"H35"	"Iron deficiency anemia"	"Other retinal disorders"	1	656	1761	2417
"L12"	"J45"	"Pemphigoid"	"Asthma"	1	23	84	107
"J15"	"N36"	"Bacterial pneumonia, not elsewhere classified"	"Other disorders of urethra"	1	38	113	151
"H40"	"M08"	"Glaucoma"	"Juvenile arthritis"	1	5	42	47
"K66"	"O62"	"Other disorders of peritoneum"	"Abnormalities of forces of labor"	1	38	147	185
"I49"	"N20"	"Other cardiac arrhythmias"	"Calculus of kidney and ureter"	1	306	706	1012
"E85"	"I25"	"Amyloidosis"	"Chronic ischemic heart disease"	1	46	110	156
"D64"	"H71"	"Other anemias"	"Cholesteatoma of middle ear"	1	0	137	137
"M79"	"O45"	"Oth and unsp soft tissue disorders, not elsewhere classified"	"Premature separation of placenta [abruptio placentae]"	1	13	147	160
"N62"	"D48"	"Hypertrophy of breast"	"Neoplasm of uncertain behavior of other and unsp sites"	1	43	149	192
"F41"	"N35"	"Other anxiety disorders"	"Urethral stricture"	1	8	94	102
"G25"	"I25"	"Other extrapyramidal and movement disorders"	"Chronic ischemic heart disease"	1	304	584	888
"F33"	"O02"	"Major depressive disorder, recurrent"	"Other abnormal products of conception"	1	66	492	558
"I25"	"O68"	"Chronic ischemic heart disease"	"Labor and delivery comp by abnlt of fetal acid-base balance"	1	0	72	72
"D75"	"K40"	"Other and unsp diseases of blood and blood-forming organs"	"Inguinal hernia"	1	60	206	266
"N18"	"K81"	"Chronic kidney disease (CKD)"	"Cholecystitis"	1	269	516	785
"B36"	"J44"	"Other superficial mycoses"	"Other chronic obstructive pulmonary disease"	1	107	205	312
"C18"	"J34"	"Malignant neoplasm of colon"	"Other and unspecified disorders of nose and nasal sinuses"	1	0	88	88
"I42"	"H33"	"Cardiomyopathy"	"Retinal detachments and breaks"	1	42	146	188
"E25"	"E10"	"Adrenogenital disorders"	"Type 1 diabetes mellitus"	1	125	238	363
"E87"	"N83"	"Other disorders of fluid, electrolyte and acid-base balance"	"Noninflammatory disord of ovary, fallop and broad ligament"	1	112	681	793
"I67"	"G56"	"Other cerebrovascular diseases"	"Mononeuropathies of upper limb"	1	80	275	355
"E21"	"O36"	"Hyperparathyroidism and other disorders of parathyroid gland"	"Maternal care for other fetal problems"	1	2	58	60
"L98"	"M34"	"Oth disorders of skin, subcu, not elsewhere classified"	"Systemic sclerosis [scleroderma]"	1	42	116	158
"J43"	"H71"	"Emphysema"	"Cholesteatoma of middle ear"	1	1	25	26
"D50"	"E66"	"Iron deficiency anemia"	"Overweight and obesity"	1	795	2748	3543
"J44"	"M65"	"Other chronic obstructive pulmonary disease"	"Synovitis and tenosynovitis"	1	548	2108	2656
"H25"	"D17"	"Age-related cataract"	"Benign lipomatous neoplasm"	1	563	2108	2671
"E87"	"D12"	"Other disorders of fluid, electrolyte and acid-base balance"	"Benign neoplasm of colon, rectum, anus and anal canal"	1	990	2883	3873
"C52"	"N87"	"Malignant neoplasm of vagina"	"Dysplasia of cervix uteri"	1	0	38	38
"M10"	"L05"	"Gout"	"Pilonidal cyst and sinus"	1	7	66	73
"J44"	"N31"	"Other chronic obstructive pulmonary disease"	"Neuromuscular dysfunction of bladder, NEC"	1	322	590	912
"E64"	"D27"	"Sequelae of malnutrition and other nutritional deficiencies"	"Benign neoplasm of ovary"	1	4	56	60
"G95"	"M77"	"Other and unspecified diseases of spinal cord"	"Other enthesopathies"	1	10	102	112
"L90"	"H65"	"Atrophic disorders of skin"	"Nonsuppurative otitis media"	1	0	218	218
"K80"	"O03"	"Cholelithiasis"	"Spontaneous abortion"	1	0	2856	2856
"O02"	"L20"	"Other abnormal products of conception"	"Atopic dermatitis"	1	48	217	265
"J90"	"C53"	"Pleural effusion, not elsewhere classified"	"Malignant neoplasm of cervix uteri"	1	8	73	81
"F03"	"H43"	"Unspecified dementia"	"Disorders of vitreous body"	1	0	471	471
"F05"	"K86"	"Delirium due to known physiological condition"	"Other diseases of pancreas"	1	110	205	315
"C25"	"H90"	"Malignant neoplasm of pancreas"	"Conductive and sensorineural hearing loss"	1	0	309	309
"F17"	"N46"	"Nicotine dependence"	"Male infertility"	1	47	138	185
"A04"	"M81"	"Other bacterial intestinal infections"	"Osteoporosis without current pathological fracture"	1	731	1352	2083
"L05"	"H50"	"Pilonidal cyst and sinus"	"Other strabismus"	1	12	69	81
"D84"	"J45"	"Other immunodeficiencies"	"Asthma"	1	198	547	745
"G91"	"G56"	"Hydrocephalus"	"Mononeuropathies of upper limb"	1	34	158	192
"L57"	"I20"	"Skin changes due to chronic expsr to nonionizing radiation"	"Angina pectoris"	1	79	905	984
"L97"	"H02"	"Non-pressure chronic ulcer of lower limb, NEC"	"Other disorders of eyelid"	1	138	317	455
"L89"	"F10"	"Pressure ulcer"	"Alcohol related disorders"	1	193	1551	1744
"N18"	"O64"	"Chronic kidney disease (CKD)"	"Obstructed labor due to malposition and malpresent of fetus"	1	0	31	31
"M25"	"L50"	"Other joint disorder, not elsewhere classified"	"Urticaria"	1	399	572	971
"O72"	"K13"	"Postpartum hemorrhage"	"Other diseases of lip and oral mucosa"	1	25	83	108
"M25"	"A63"	"Other joint disorder, not elsewhere classified"	"Oth predominantly sexually transmitted diseases, NEC"	1	103	328	431
"K72"	"M22"	"Hepatic failure, not elsewhere classified"	"Disorder of patella"	1	0	34	34
"E06"	"O04"	"Thyroiditis"	"Complications following (induced) termination of pregnancy"	1	0	329	329
"K59"	"K44"	"Other functional intestinal disorders"	"Diaphragmatic hernia"	1	1885	4806	6691
"D13"	"K58"	"Benign neoplasm of and ill-defined parts of digestive system"	"Irritable bowel syndrome"	1	129	234	363
"N21"	"G82"	"Calculus of lower urinary tract"	"Paraplegia (paraparesis) and quadriplegia (quadriparesis)"	1	57	186	243
"E86"	"N63"	"Volume depletion"	"Unspecified lump in breast"	1	6	915	921
"D09"	"M54"	"Carcinoma in situ of other and unspecified sites"	"Dorsalgia"	1	21	240	261
"M51"	"O35"	"Thoracic, thoracolum, and lumbosacral intvrt disc disorders"	"Maternal care for known or suspected fetal abnlt and damage"	1	23	97	120
"K11"	"M51"	"Diseases of salivary glands"	"Thoracic, thoracolum, and lumbosacral intvrt disc disorders"	1	197	357	554
"N39"	"O65"	"Other disorders of urinary system"	"Obstructed labor due to maternal pelvic abnormality"	1	0	364	364
"I50"	"B18"	"Heart failure"	"Chronic viral hepatitis"	1	81	194	275
"K80"	"N97"	"Cholelithiasis"	"Female infertility"	1	412	2268	2680
"C54"	"D26"	"Malignant neoplasm of corpus uteri"	"Other benign neoplasms of uterus"	1	11	67	78
"M75"	"L52"	"Shoulder lesions"	"Erythema nodosum"	1	15	56	71
"L40"	"O42"	"Psoriasis"	"Premature rupture of membranes"	1	47	114	161
"O86"	"O12"	"Other puerperal infections"	"Gestational edema and proteinuria without hypertension"	1	135	269	404
"E87"	"G82"	"Other disorders of fluid, electrolyte and acid-base balance"	"Paraplegia (paraparesis) and quadriplegia (quadriparesis)"	1	176	320	496
"C71"	"K42"	"Malignant neoplasm of brain"	"Umbilical hernia"	1	5	57	62
"D46"	"K40"	"Myelodysplastic syndromes"	"Inguinal hernia"	1	4	281	285
"D46"	"C50"	"Myelodysplastic syndromes"	"Malignant neoplasm of breast"	1	9	97	106
"C14"	"M16"	"Malig neoplasm of sites in the lip, oral cavity and pharynx"	"Osteoarthritis of hip"	1	3	34	37
"G12"	"M17"	"Spinal muscular atrophy and related syndromes"	"Osteoarthritis of knee"	1	14	178	192
"M99"	"M20"	"Biomechanical lesions, not elsewhere classified"	"Acquired deformities of fingers and toes"	1	95	239	334
"C20"	"H66"	"Malignant neoplasm of rectum"	"Suppurative and unspecified otitis media"	1	7	47	54
"J86"	"M54"	"Pyothorax"	"Dorsalgia"	1	164	326	490
"H02"	"H33"	"Other disorders of eyelid"	"Retinal detachments and breaks"	1	256	549	805
"I71"	"G56"	"Aortic aneurysm and dissection"	"Mononeuropathies of upper limb"	1	88	636	724
"E55"	"C50"	"Vitamin D deficiency"	"Malignant neoplasm of breast"	1	38	244	282
"O40"	"O02"	"Polyhydramnios"	"Other abnormal products of conception"	1	253	860	1113
"L57"	"M31"	"Skin changes due to chronic expsr to nonionizing radiation"	"Other necrotizing vasculopathies"	1	17	110	127
"J09"	"M06"	"Influenza due to certain identified influenza viruses"	"Other rheumatoid arthritis"	1	0	64	64
"C64"	"N60"	"Malignant neoplasm of kidney, except renal pelvis"	"Benign mammary dysplasia"	1	1	34	35
"C22"	"K35"	"Malignant neoplasm of liver and intrahepatic bile ducts"	"Acute appendicitis"	1	0	43	43
"G81"	"D33"	"Hemiplegia and hemiparesis"	"Benign neoplasm of brain and oth prt central nervous system"	1	37	107	144
"C64"	"M47"	"Malignant neoplasm of kidney, except renal pelvis"	"Spondylosis"	1	62	177	239
"I69"	"O82"	"Sequelae of cerebrovascular disease"	"Encounter for cesarean delivery without indication"	1	0	170	170
"J81"	"J42"	"Pulmonary edema"	"Unspecified chronic bronchitis"	1	551	902	1453
"I68"	"G45"	"Cerebrovascular disorders in diseases classified elsewhere"	"Transient cerebral ischemic attacks and related syndromes"	1	19	70	89
"E86"	"C90"	"Volume depletion"	"Multiple myeloma and malignant plasma cell neoplasms"	1	285	651	936
"K56"	"M70"	"Paralytic ileus and intestinal obstruction without hernia"	"Soft tissue disorders related to use, overuse and pressure"	1	191	413	604
"A54"	"M23"	"Gonococcal infection"	"Internal derangement of knee"	1	20	180	200
"L30"	"M06"	"Other and unspecified dermatitis"	"Other rheumatoid arthritis"	1	196	351	547
"A04"	"K27"	"Other bacterial intestinal infections"	"Peptic ulcer, site unspecified"	1	102	237	339
"I27"	"D30"	"Other pulmonary heart diseases"	"Benign neoplasm of urinary organs"	1	27	129	156
"J93"	"K30"	"Pneumothorax and air leak"	"Functional dyspepsia"	1	139	288	427
"N32"	"O03"	"Other disorders of bladder"	"Spontaneous abortion"	1	0	45	45
"J98"	"L02"	"Other respiratory disorders"	"Cutaneous abscess, furuncle and carbuncle"	1	202	357	559
"G96"	"I20"	"Other disorders of central nervous system"	"Angina pectoris"	1	0	1692	1692
"A09"	"F10"	"Infectious gastroenteritis and colitis, unspecified"	"Alcohol related disorders"	1	1726	2293	4019
"M25"	"K61"	"Other joint disorder, not elsewhere classified"	"Abscess of anal and rectal regions"	1	141	297	438
"I20"	"O21"	"Angina pectoris"	"Excessive vomiting in pregnancy"	1	0	37	37
"K52"	"G40"	"Other and unsp noninfective gastroenteritis and colitis"	"Epilepsy and recurrent seizures"	1	474	902	1376
"D39"	"N83"	"Neoplasm of uncertain behavior of female genital organs"	"Noninflammatory disord of ovary, fallop and broad ligament"	1	517	715	1232
"C44"	"M72"	"Other and unspecified malignant neoplasm of skin"	"Fibroblastic disorders"	1	161	712	873
"A49"	"M77"	"Bacterial infection of unspecified site"	"Other enthesopathies"	1	96	440	536
"I50"	"M16"	"Heart failure"	"Osteoarthritis of hip"	1	0	10508	10508
"H18"	"K35"	"Other disorders of cornea"	"Acute appendicitis"	1	20	130	150
"E87"	"D24"	"Other disorders of fluid, electrolyte and acid-base balance"	"Benign neoplasm of breast"	1	0	360	360
"K64"	"I73"	"Hemorrhoids and perianal venous thrombosis"	"Other peripheral vascular diseases"	1	62	592	654
"I26"	"O63"	"Pulmonary embolism"	"Long labor"	1	8	45	53
"D46"	"M16"	"Myelodysplastic syndromes"	"Osteoarthritis of hip"	1	16	279	295
"N63"	"O70"	"Unspecified lump in breast"	"Perineal laceration during delivery"	1	694	2412	3106
"C64"	"D41"	"Malignant neoplasm of kidney, except renal pelvis"	"Neoplasm of uncertain behavior of urinary organs"	1	308	587	895
"C34"	"D05"	"Malignant neoplasm of bronchus and lung"	"Carcinoma in situ of breast"	1	11	94	105
"C25"	"K62"	"Malignant neoplasm of pancreas"	"Other diseases of anus and rectum"	1	95	376	471
"G47"	"H33"	"Sleep disorders"	"Retinal detachments and breaks"	1	148	395	543
"K59"	"O63"	"Other functional intestinal disorders"	"Long labor"	1	124	362	486
"E64"	"C54"	"Sequelae of malnutrition and other nutritional deficiencies"	"Malignant neoplasm of corpus uteri"	1	2	38	40
"F41"	"M70"	"Other anxiety disorders"	"Soft tissue disorders related to use, overuse and pressure"	1	124	400	524
"N39"	"O41"	"Other disorders of urinary system"	"Other disorders of amniotic fluid and membranes"	1	12	188	200
"K52"	"O80"	"Other and unsp noninfective gastroenteritis and colitis"	"Encounter for full-term uncomplicated delivery"	1	344	1604	1948
"G91"	"N62"	"Hydrocephalus"	"Hypertrophy of breast"	1	1	28	29
"I50"	"H26"	"Heart failure"	"Other cataract"	1	2626	5696	8322
"D10"	"C09"	"Benign neoplasm of mouth and pharynx"	"Malignant neoplasm of tonsil"	1	37	107	144
"O34"	"O65"	"Maternal care for abnormality of pelvic organs"	"Obstructed labor due to maternal pelvic abnormality"	1	0	4579	4579
"J90"	"M77"	"Pleural effusion, not elsewhere classified"	"Other enthesopathies"	1	20	149	169
"M67"	"D06"	"Other disorders of synovium and tendon"	"Carcinoma in situ of cervix uteri"	1	11	133	144
"N46"	"L02"	"Male infertility"	"Cutaneous abscess, furuncle and carbuncle"	1	180	358	538
"I63"	"N80"	"Cerebral infarction"	"Endometriosis"	1	0	115	115
"M80"	"K52"	"Osteoporosis with current pathological fracture"	"Other and unsp noninfective gastroenteritis and colitis"	1	803	1074	1877
"Q99"	"H65"	"Other chromosome abnormalities, not elsewhere classified"	"Nonsuppurative otitis media"	1	64	173	237
"D17"	"J34"	"Benign lipomatous neoplasm"	"Other and unspecified disorders of nose and nasal sinuses"	1	154	390	544
"C44"	"N48"	"Other and unspecified malignant neoplasm of skin"	"Other disorders of penis"	1	86	240	326
"N19"	"M48"	"Unspecified kidney failure"	"Other spondylopathies"	1	224	760	984
"J18"	"I49"	"Pneumonia, unspecified organism"	"Other cardiac arrhythmias"	1	4598	6145	10743
"K83"	"O70"	"Other diseases of biliary tract"	"Perineal laceration during delivery"	1	22	278	300
"N17"	"C50"	"Acute kidney failure"	"Malignant neoplasm of breast"	1	24	479	503
"K05"	"K21"	"Gingivitis and periodontal diseases"	"Gastro-esophageal reflux disease"	1	255	389	644
"E78"	"O80"	"Disorders of lipoprotein metabolism and other lipidemias"	"Encounter for full-term uncomplicated delivery"	1	0	619	619
"F41"	"H83"	"Other anxiety disorders"	"Other diseases of inner ear"	1	0	219	219
"C24"	"I47"	"Malignant neoplasm of other and unsp parts of biliary tract"	"Paroxysmal tachycardia"	1	4	48	52
"M87"	"M35"	"Osteonecrosis"	"Other systemic involvement of connective tissue"	1	38	102	140
"A04"	"M75"	"Other bacterial intestinal infections"	"Shoulder lesions"	1	181	523	704
"J44"	"O26"	"Other chronic obstructive pulmonary disease"	"Maternal care for oth conditions predom related to pregnancy"	1	0	106	106
"M85"	"D59"	"Other disorders of bone density and structure"	"Acquired hemolytic anemia"	1	19	68	87
"C03"	"I20"	"Malignant neoplasm of gum"	"Angina pectoris"	1	5	40	45
"I74"	"C50"	"Arterial embolism and thrombosis"	"Malignant neoplasm of breast"	1	79	203	282
"J96"	"M20"	"Respiratory failure, not elsewhere classified"	"Acquired deformities of fingers and toes"	1	0	1068	1068
"M05"	"O80"	"Rheumatoid arthritis with rheumatoid factor"	"Encounter for full-term uncomplicated delivery"	1	0	586	586
"K58"	"L05"	"Irritable bowel syndrome"	"Pilonidal cyst and sinus"	1	70	191	261
"K61"	"H10"	"Abscess of anal and rectal regions"	"Conjunctivitis"	1	124	299	423
"M51"	"D06"	"Thoracic, thoracolum, and lumbosacral intvrt disc disorders"	"Carcinoma in situ of cervix uteri"	1	0	248	248
"M13"	"I80"	"Other arthritis"	"Phlebitis and thrombophlebitis"	1	533	769	1302
"M75"	"H00"	"Shoulder lesions"	"Hordeolum and chalazion"	1	114	356	470
"M75"	"E10"	"Shoulder lesions"	"Type 1 diabetes mellitus"	1	1106	2402	3508
"I85"	"K85"	"Esophageal varices"	"Acute pancreatitis"	1	90	236	326
"G63"	"G62"	"Polyneuropathy in diseases classified elsewhere"	"Other and unspecified polyneuropathies"	1	591	881	1472
"E87"	"M18"	"Other disorders of fluid, electrolyte and acid-base balance"	"Osteoarthritis of first carpometacarpal joint"	1	66	352	418
"C79"	"L30"	"Secondary malignant neoplasm of other and unspecified sites"	"Other and unspecified dermatitis"	1	54	231	285
"C02"	"I83"	"Malignant neoplasm of other and unspecified parts of tongue"	"Varicose veins of lower extremities"	1	1	32	33
"C01"	"I20"	"Malignant neoplasm of base of tongue"	"Angina pectoris"	1	5	40	45
"A49"	"E15"	"Bacterial infection of unspecified site"	"Nondiabetic hypoglycemic coma"	1	44	108	152
"O62"	"J36"	"Abnormalities of forces of labor"	"Peritonsillar abscess"	1	280	413	693
"H83"	"O04"	"Other diseases of inner ear"	"Complications following (induced) termination of pregnancy"	1	7	75	82
"M80"	"I77"	"Osteoporosis with current pathological fracture"	"Other disorders of arteries and arterioles"	1	32	112	144
"L30"	"N40"	"Other and unspecified dermatitis"	"Benign prostatic hyperplasia"	1	260	574	834
"K35"	"F98"	"Acute appendicitis"	"Oth behav/emotn disord w onset usly occur in chldhd and adol"	1	20	112	132
"I27"	"M32"	"Other pulmonary heart diseases"	"Systemic lupus erythematosus (SLE)"	1	7	42	49
"G47"	"O91"	"Sleep disorders"	"Infect of breast assoc w pregnancy, the puerp and lactation"	1	0	31	31
"J98"	"H80"	"Other respiratory disorders"	"Otosclerosis"	1	0	57	57
"I45"	"H10"	"Other conduction disorders"	"Conjunctivitis"	1	44	142	186
"F01"	"C43"	"Vascular dementia"	"Malignant melanoma of skin"	1	14	65	79
"C79"	"M32"	"Secondary malignant neoplasm of other and unspecified sites"	"Systemic lupus erythematosus (SLE)"	1	3	36	39
"I46"	"E64"	"Cardiac arrest"	"Sequelae of malnutrition and other nutritional deficiencies"	1	62	224	286
"A41"	"K57"	"Other sepsis"	"Diverticular disease of intestine"	1	0	7649	7649
"I49"	"O20"	"Other cardiac arrhythmias"	"Hemorrhage in early pregnancy"	1	0	330	330
"K37"	"O82"	"Unspecified appendicitis"	"Encounter for cesarean delivery without indication"	1	52	147	199
"E86"	"H44"	"Volume depletion"	"Disorders of globe"	1	41	356	397
"K58"	"N87"	"Irritable bowel syndrome"	"Dysplasia of cervix uteri"	1	280	432	712
"M19"	"G40"	"Other and unspecified osteoarthritis"	"Epilepsy and recurrent seizures"	1	334	645	979
"C73"	"N97"	"Malignant neoplasm of thyroid gland"	"Female infertility"	1	1	38	39
"H43"	"N40"	"Disorders of vitreous body"	"Benign prostatic hyperplasia"	1	378	665	1043
"G96"	"M77"	"Other disorders of central nervous system"	"Other enthesopathies"	1	37	427	464
"H57"	"M02"	"Other disorders of eye and adnexa"	"Postinfective and reactive arthropathies"	1	46	269	315
"K86"	"K58"	"Other diseases of pancreas"	"Irritable bowel syndrome"	1	178	323	501
"M85"	"H71"	"Other disorders of bone density and structure"	"Cholesteatoma of middle ear"	1	0	52	52
"D12"	"I47"	"Benign neoplasm of colon, rectum, anus and anal canal"	"Paroxysmal tachycardia"	1	570	1746	2316
"J81"	"N04"	"Pulmonary edema"	"Nephrotic syndrome"	1	31	90	121
"E86"	"J84"	"Volume depletion"	"Other interstitial pulmonary diseases"	1	575	945	1520
"G47"	"Q53"	"Sleep disorders"	"Undescended and ectopic testicle"	1	19	203	222
"F41"	"I97"	"Other anxiety disorders"	"Intraop and postproc comp and disorders of circ sys, NEC"	1	24	92	116
"K86"	"J34"	"Other diseases of pancreas"	"Other and unspecified disorders of nose and nasal sinuses"	1	26	90	116
"J30"	"J03"	"Vasomotor and allergic rhinitis"	"Acute tonsillitis"	1	388	629	1017
"M72"	"K60"	"Fibroblastic disorders"	"Fissure and fistula of anal and rectal regions"	1	127	232	359
"N99"	"O03"	"Intraop and postproc comp and disorders of GU sys, NEC"	"Spontaneous abortion"	1	39	212	251
"M25"	"D27"	"Other joint disorder, not elsewhere classified"	"Benign neoplasm of ovary"	1	157	467	624
"H35"	"E78"	"Other retinal disorders"	"Disorders of lipoprotein metabolism and other lipidemias"	1	3319	3936	7255
"F41"	"O82"	"Other anxiety disorders"	"Encounter for cesarean delivery without indication"	1	344	683	1027
"A49"	"O08"	"Bacterial infection of unspecified site"	"Complications following ectopic and molar pregnancy"	1	26	96	122
"E21"	"H93"	"Hyperparathyroidism and other disorders of parathyroid gland"	"Other disorders of ear, not elsewhere classified"	1	35	206	241
"I35"	"M23"	"Nonrheumatic aortic valve disorders"	"Internal derangement of knee"	1	0	1967	1967
"N18"	"M31"	"Chronic kidney disease (CKD)"	"Other necrotizing vasculopathies"	1	600	970	1570
"I35"	"J35"	"Nonrheumatic aortic valve disorders"	"Chronic diseases of tonsils and adenoids"	1	20	132	152
"I71"	"N43"	"Aortic aneurysm and dissection"	"Hydrocele and spermatocele"	1	49	379	428
"K35"	"J20"	"Acute appendicitis"	"Acute bronchitis"	1	8	521	529
"F01"	"J45"	"Vascular dementia"	"Asthma"	1	10	247	257
"N88"	"O70"	"Other noninflammatory disorders of cervix uteri"	"Perineal laceration during delivery"	1	50	199	249
"K71"	"J35"	"Toxic liver disease"	"Chronic diseases of tonsils and adenoids"	1	7	46	53
"J69"	"M25"	"Pneumonitis due to solids and liquids"	"Other joint disorder, not elsewhere classified"	1	13	117	130
"C67"	"J45"	"Malignant neoplasm of bladder"	"Asthma"	1	136	266	402
"C16"	"E66"	"Malignant neoplasm of stomach"	"Overweight and obesity"	1	50	348	398
"G93"	"I20"	"Other disorders of brain"	"Angina pectoris"	1	148	530	678
"J18"	"L05"	"Pneumonia, unspecified organism"	"Pilonidal cyst and sinus"	1	150	391	541
"J22"	"F32"	"Unspecified acute lower respiratory infection"	"Depressive episode"	1	351	665	1016
"F05"	"I70"	"Delirium due to known physiological condition"	"Atherosclerosis"	1	248	1269	1517
"K92"	"D23"	"Other diseases of digestive system"	"Other benign neoplasms of skin"	1	164	472	636
"N30"	"D48"	"Cystitis"	"Neoplasm of uncertain behavior of other and unsp sites"	1	103	391	494
"H34"	"I83"	"Retinal vascular occlusions"	"Varicose veins of lower extremities"	1	70	289	359
"E41"	"K52"	"Nutritional marasmus"	"Other and unsp noninfective gastroenteritis and colitis"	1	80	227	307
"I63"	"N84"	"Cerebral infarction"	"Polyp of female genital tract"	1	123	440	563
"K70"	"G43"	"Alcoholic liver disease"	"Migraine"	1	20	66	86
"J44"	"M06"	"Other chronic obstructive pulmonary disease"	"Other rheumatoid arthritis"	1	1169	1842	3011
"M62"	"N70"	"Other disorders of muscle"	"Salpingitis and oophoritis"	1	561	1349	1910
"N00"	"H83"	"Acute nephritic syndrome"	"Other diseases of inner ear"	1	5	37	42
"K92"	"D30"	"Other diseases of digestive system"	"Benign neoplasm of urinary organs"	1	129	698	827
"I21"	"M22"	"Acute myocardial infarction"	"Disorder of patella"	1	0	307	307
"F51"	"O80"	"Sleep disorders not due to a substance or known physiol cond"	"Encounter for full-term uncomplicated delivery"	1	0	64	64
"J15"	"J42"	"Bacterial pneumonia, not elsewhere classified"	"Unspecified chronic bronchitis"	1	1575	3639	5214
"O73"	"O04"	"Retained placenta and membranes, without hemorrhage"	"Complications following (induced) termination of pregnancy"	1	187	696	883
"M67"	"O02"	"Other disorders of synovium and tendon"	"Other abnormal products of conception"	1	280	603	883
"G24"	"G80"	"Dystonia"	"Cerebral palsy"	1	29	155	184
"D63"	"H44"	"Anemia in chronic diseases classified elsewhere"	"Disorders of globe"	1	8	61	69
"D63"	"C10"	"Anemia in chronic diseases classified elsewhere"	"Malignant neoplasm of oropharynx"	1	33	98	131
"G12"	"M75"	"Spinal muscular atrophy and related syndromes"	"Shoulder lesions"	1	29	140	169
"E05"	"H80"	"Thyrotoxicosis [hyperthyroidism]"	"Otosclerosis"	1	49	180	229
"K92"	"M23"	"Other diseases of digestive system"	"Internal derangement of knee"	1	409	1330	1739
"I35"	"M18"	"Nonrheumatic aortic valve disorders"	"Osteoarthritis of first carpometacarpal joint"	1	58	350	408
"M25"	"J03"	"Other joint disorder, not elsewhere classified"	"Acute tonsillitis"	1	311	658	969
"I21"	"M35"	"Acute myocardial infarction"	"Other systemic involvement of connective tissue"	1	1030	1389	2419
"E11"	"H93"	"Type 2 diabetes mellitus"	"Other disorders of ear, not elsewhere classified"	1	1073	2337	3410
"M19"	"M51"	"Other and unspecified osteoarthritis"	"Thoracic, thoracolum, and lumbosacral intvrt disc disorders"	1	1616	4491	6107
"I25"	"O04"	"Chronic ischemic heart disease"	"Complications following (induced) termination of pregnancy"	1	0	156	156
"K92"	"I10"	"Other diseases of digestive system"	"Essential (primary) hypertension"	1	0	20388	20388
"K63"	"I20"	"Other diseases of intestine"	"Angina pectoris"	1	111	1296	1407
"F72"	"G80"	"Severe intellectual disabilities"	"Cerebral palsy"	1	102	209	311
"H90"	"K40"	"Conductive and sensorineural hearing loss"	"Inguinal hernia"	1	963	1735	2698
"L40"	"O04"	"Psoriasis"	"Complications following (induced) termination of pregnancy"	1	17	434	451
"B02"	"K35"	"Zoster [herpes zoster]"	"Acute appendicitis"	1	26	110	136
"M81"	"H35"	"Osteoporosis without current pathological fracture"	"Other retinal disorders"	1	2693	4008	6701
"E64"	"N30"	"Sequelae of malnutrition and other nutritional deficiencies"	"Cystitis"	1	998	1296	2294
"G30"	"H02"	"Alzheimer's disease"	"Other disorders of eyelid"	1	13	226	239
"O87"	"O21"	"Venous complications and hemorrhoids in the puerperium"	"Excessive vomiting in pregnancy"	1	69	216	285
"H94"	"A39"	"Other disorders of ear in diseases classified elsewhere"	"Meningococcal infection"	1	9	79	88
"H43"	"K30"	"Disorders of vitreous body"	"Functional dyspepsia"	1	166	475	641
"D63"	"D48"	"Anemia in chronic diseases classified elsewhere"	"Neoplasm of uncertain behavior of other and unsp sites"	1	51	181	232
"I35"	"J32"	"Nonrheumatic aortic valve disorders"	"Chronic sinusitis"	1	31	236	267
"E41"	"D30"	"Nutritional marasmus"	"Benign neoplasm of urinary organs"	1	0	28	28
"J69"	"M19"	"Pneumonitis due to solids and liquids"	"Other and unspecified osteoarthritis"	1	31	366	397
"C50"	"O66"	"Malignant neoplasm of breast"	"Other obstructed labor"	1	0	72	72
"D69"	"I20"	"Purpura and other hemorrhagic conditions"	"Angina pectoris"	1	190	1081	1271
"M19"	"M92"	"Other and unspecified osteoarthritis"	"Other juvenile osteochondrosis"	1	56	132	188
"K74"	"H90"	"Fibrosis and cirrhosis of liver"	"Conductive and sensorineural hearing loss"	1	49	116	165
"E04"	"H80"	"Other nontoxic goiter"	"Otosclerosis"	1	34	136	170
"M19"	"M79"	"Other and unspecified osteoarthritis"	"Oth and unsp soft tissue disorders, not elsewhere classified"	1	4152	6860	11012
"B02"	"J34"	"Zoster [herpes zoster]"	"Other and unspecified disorders of nose and nasal sinuses"	1	9	58	67
"D24"	"O02"	"Benign neoplasm of breast"	"Other abnormal products of conception"	1	237	603	840
"N19"	"M71"	"Unspecified kidney failure"	"Other bursopathies"	1	25	134	159
"E21"	"N95"	"Hyperparathyroidism and other disorders of parathyroid gland"	"Menopausal and other perimenopausal disorders"	1	72	224	296
"G98"	"J18"	"Other disorders of nervous system not elsewhere classified"	"Pneumonia, unspecified organism"	1	411	671	1082
"H33"	"E10"	"Retinal detachments and breaks"	"Type 1 diabetes mellitus"	1	301	766	1067
"I35"	"N94"	"Nonrheumatic aortic valve disorders"	"Pain and oth cond assoc w fem gntl org and menstrual cycle"	1	0	140	140
"J18"	"M48"	"Pneumonia, unspecified organism"	"Other spondylopathies"	1	3136	6800	9936
"C09"	"M17"	"Malignant neoplasm of tonsil"	"Osteoarthritis of knee"	1	21	96	117
"M17"	"J38"	"Osteoarthritis of knee"	"Diseases of vocal cords and larynx, not elsewhere classified"	1	354	541	895
"I45"	"N40"	"Other conduction disorders"	"Benign prostatic hyperplasia"	1	300	687	987
"E87"	"D23"	"Other disorders of fluid, electrolyte and acid-base balance"	"Other benign neoplasms of skin"	1	82	653	735
"K86"	"J30"	"Other diseases of pancreas"	"Vasomotor and allergic rhinitis"	1	4	39	43
"N48"	"M54"	"Other disorders of penis"	"Dorsalgia"	1	513	903	1416
"I73"	"J34"	"Other peripheral vascular diseases"	"Other and unspecified disorders of nose and nasal sinuses"	1	20	267	287
"D46"	"M05"	"Myelodysplastic syndromes"	"Rheumatoid arthritis with rheumatoid factor"	1	12	90	102
"G47"	"D27"	"Sleep disorders"	"Benign neoplasm of ovary"	1	0	353	353
"L30"	"O20"	"Other and unspecified dermatitis"	"Hemorrhage in early pregnancy"	1	28	331	359
"I61"	"N87"	"Nontraumatic intracerebral hemorrhage"	"Dysplasia of cervix uteri"	1	1	58	59
"M10"	"K40"	"Gout"	"Inguinal hernia"	1	371	1173	1544
"M16"	"O64"	"Osteoarthritis of hip"	"Obstructed labor due to malposition and malpresent of fetus"	1	0	58	58
"E41"	"J45"	"Nutritional marasmus"	"Asthma"	1	0	108	108
"O20"	"M41"	"Hemorrhage in early pregnancy"	"Scoliosis"	1	18	113	131
"J17"	"M17"	"Pneumonia in diseases classified elsewhere"	"Osteoarthritis of knee"	1	13	68	81
"C64"	"M19"	"Malignant neoplasm of kidney, except renal pelvis"	"Other and unspecified osteoarthritis"	1	101	201	302
"C79"	"I73"	"Secondary malignant neoplasm of other and unspecified sites"	"Other peripheral vascular diseases"	1	72	1039	1111
"H54"	"C50"	"Blindness and low vision"	"Malignant neoplasm of breast"	1	44	187	231
"D43"	"N40"	"Neoplasm of uncertain behavior of brain and cnsl"	"Benign prostatic hyperplasia"	1	34	154	188
"O86"	"J35"	"Other puerperal infections"	"Chronic diseases of tonsils and adenoids"	1	2	240	242
"E22"	"M22"	"Hyperfunction of pituitary gland"	"Disorder of patella"	1	14	60	74
"M25"	"O82"	"Other joint disorder, not elsewhere classified"	"Encounter for cesarean delivery without indication"	1	195	1456	1651
"C18"	"H83"	"Malignant neoplasm of colon"	"Other diseases of inner ear"	1	37	762	799
"J11"	"J45"	"Influenza due to unidentified influenza virus"	"Asthma"	1	657	922	1579
"C25"	"M51"	"Malignant neoplasm of pancreas"	"Thoracic, thoracolum, and lumbosacral intvrt disc disorders"	1	0	466	466
"O08"	"O71"	"Complications following ectopic and molar pregnancy"	"Other obstetric trauma"	1	306	581	887
"C78"	"C51"	"Secondary malignant neoplasm of resp and digestive organs"	"Malignant neoplasm of vulva"	1	13	109	122
"C44"	"C53"	"Other and unspecified malignant neoplasm of skin"	"Malignant neoplasm of cervix uteri"	1	10	53	63
"M92"	"N47"	"Other juvenile osteochondrosis"	"Disorders of prepuce"	1	50	121	171
"J22"	"O82"	"Unspecified acute lower respiratory infection"	"Encounter for cesarean delivery without indication"	1	0	82	82
"C41"	"H91"	"Malignant neoplasm of bone/artic cartl of and unsp sites"	"Other and unspecified hearing loss"	1	51	129	180
"A41"	"D17"	"Other sepsis"	"Benign lipomatous neoplasm"	1	58	930	988
"O46"	"H65"	"Antepartum hemorrhage, not elsewhere classified"	"Nonsuppurative otitis media"	1	4	38	42
"M77"	"H50"	"Other enthesopathies"	"Other strabismus"	1	66	149	215
"K64"	"O70"	"Hemorrhoids and perianal venous thrombosis"	"Perineal laceration during delivery"	1	0	2170	2170
"I85"	"K61"	"Esophageal varices"	"Abscess of anal and rectal regions"	1	9	77	86
"O82"	"O47"	"Encounter for cesarean delivery without indication"	"False labor"	1	5622	8398	14020
"G47"	"J11"	"Sleep disorders"	"Influenza due to unidentified influenza virus"	1	48	215	263
"C61"	"K21"	"Malignant neoplasm of prostate"	"Gastro-esophageal reflux disease"	1	215	951	1166
"N72"	"O80"	"Inflammatory disease of cervix uteri"	"Encounter for full-term uncomplicated delivery"	1	170	463	633
"E03"	"O04"	"Other hypothyroidism"	"Complications following (induced) termination of pregnancy"	1	0	1102	1102
"G98"	"D24"	"Other disorders of nervous system not elsewhere classified"	"Benign neoplasm of breast"	1	0	93	93
"K72"	"O82"	"Hepatic failure, not elsewhere classified"	"Encounter for cesarean delivery without indication"	1	3	47	50
"I33"	"M77"	"Acute and subacute endocarditis"	"Other enthesopathies"	1	5	37	42
"J18"	"O71"	"Pneumonia, unspecified organism"	"Other obstetric trauma"	1	39	534	573
"K59"	"C20"	"Other functional intestinal disorders"	"Malignant neoplasm of rectum"	1	0	4743	4743
"J10"	"G56"	"Influenza due to other identified influenza virus"	"Mononeuropathies of upper limb"	1	4	114	118
"K92"	"O00"	"Other diseases of digestive system"	"Ectopic pregnancy"	1	17	64	81
"M18"	"N63"	"Osteoarthritis of first carpometacarpal joint"	"Unspecified lump in breast"	1	27	185	212
"B34"	"O48"	"Viral infection of unspecified site"	"Late pregnancy"	1	33	222	255
"E53"	"I10"	"Deficiency of other B group vitamins"	"Essential (primary) hypertension"	1	1044	2014	3058
"M19"	"L72"	"Other and unspecified osteoarthritis"	"Follicular cysts of skin and subcutaneous tissue"	1	122	264	386
"I52"	"I21"	"Other heart disorders in diseases classified elsewhere"	"Acute myocardial infarction"	1	15	73	88
"J90"	"E11"	"Pleural effusion, not elsewhere classified"	"Type 2 diabetes mellitus"	1	567	2345	2912
"F17"	"N47"	"Nicotine dependence"	"Disorders of prepuce"	1	99	255	354
"I31"	"E66"	"Other diseases of pericardium"	"Overweight and obesity"	1	112	213	325
"K44"	"Q17"	"Diaphragmatic hernia"	"Other congenital malformations of ear"	1	0	29	29
"N28"	"D17"	"Oth disorders of kidney and ureter, not elsewhere classified"	"Benign lipomatous neoplasm"	1	34	126	160
"O92"	"H72"	"Oth disord of brst/lactatn assoc w pregnancy and the puerp"	"Perforation of tympanic membrane"	1	1	33	34
"F01"	"H53"	"Vascular dementia"	"Visual disturbances"	1	34	208	242
"H54"	"Q21"	"Blindness and low vision"	"Congenital malformations of cardiac septa"	1	23	80	103
"O72"	"N13"	"Postpartum hemorrhage"	"Obstructive and reflux uropathy"	1	311	688	999
"E66"	"H81"	"Overweight and obesity"	"Disorders of vestibular function"	1	800	1046	1846
"I21"	"N80"	"Acute myocardial infarction"	"Endometriosis"	1	6	106	112
"M81"	"H26"	"Osteoporosis without current pathological fracture"	"Other cataract"	1	2085	3262	5347
"K92"	"M02"	"Other diseases of digestive system"	"Postinfective and reactive arthropathies"	1	61	209	270
"M24"	"M23"	"Other specific joint derangements"	"Internal derangement of knee"	1	4388	5072	9460
"J34"	"O65"	"Other and unspecified disorders of nose and nasal sinuses"	"Obstructed labor due to maternal pelvic abnormality"	1	8	113	121
"I10"	"M72"	"Essential (primary) hypertension"	"Fibroblastic disorders"	1	2306	4455	6761
"C18"	"J01"	"Malignant neoplasm of colon"	"Acute sinusitis"	1	10	49	59
"G50"	"K58"	"Disorders of trigeminal nerve"	"Irritable bowel syndrome"	1	66	201	267
"N45"	"B27"	"Orchitis and epididymitis"	"Infectious mononucleosis"	1	5	48	53
"C64"	"N63"	"Malignant neoplasm of kidney, except renal pelvis"	"Unspecified lump in breast"	1	8	51	59
"I25"	"H27"	"Chronic ischemic heart disease"	"Other disorders of lens"	1	145	561	706
"C79"	"G44"	"Secondary malignant neoplasm of other and unspecified sites"	"Other headache syndromes"	1	17	198	215
"M80"	"C67"	"Osteoporosis with current pathological fracture"	"Malignant neoplasm of bladder"	1	65	176	241
"I89"	"O71"	"Oth noninfective disorders of lymphatic vessels and nodes"	"Other obstetric trauma"	1	0	35	35
"K52"	"N40"	"Other and unsp noninfective gastroenteritis and colitis"	"Benign prostatic hyperplasia"	1	413	1517	1930
"C77"	"N75"	"Secondary and unspecified malignant neoplasm of lymph nodes"	"Diseases of Bartholin's gland"	1	1	33	34
"O63"	"B27"	"Long labor"	"Infectious mononucleosis"	1	0	38	38
"E86"	"K26"	"Volume depletion"	"Duodenal ulcer"	1	1655	4264	5919
"L71"	"O48"	"Rosacea"	"Late pregnancy"	1	0	37	37
"M31"	"F10"	"Other necrotizing vasculopathies"	"Alcohol related disorders"	1	72	151	223
"C76"	"I10"	"Malignant neoplasm of other and ill-defined sites"	"Essential (primary) hypertension"	1	312	517	829
"N73"	"O80"	"Other female pelvic inflammatory diseases"	"Encounter for full-term uncomplicated delivery"	1	339	537	876
"J96"	"J35"	"Respiratory failure, not elsewhere classified"	"Chronic diseases of tonsils and adenoids"	1	189	421	610
"E78"	"H81"	"Disorders of lipoprotein metabolism and other lipidemias"	"Disorders of vestibular function"	1	1795	2376	4171
"G96"	"O66"	"Other disorders of central nervous system"	"Other obstructed labor"	1	0	30	30
"I85"	"J34"	"Esophageal varices"	"Other and unspecified disorders of nose and nasal sinuses"	1	3	46	49
"L95"	"O80"	"Vasculitis limited to skin, not elsewhere classified"	"Encounter for full-term uncomplicated delivery"	1	9	88	97
"O72"	"M70"	"Postpartum hemorrhage"	"Soft tissue disorders related to use, overuse and pressure"	1	330	1084	1414
"J20"	"Q41"	"Acute bronchitis"	"Congenital absence, atresia and stenosis of small intestine"	1	5	58	63
"G62"	"M75"	"Other and unspecified polyneuropathies"	"Shoulder lesions"	1	615	1426	2041
"A40"	"G45"	"Streptococcal sepsis"	"Transient cerebral ischemic attacks and related syndromes"	1	63	215	278
"L08"	"H72"	"Other local infections of skin and subcutaneous tissue"	"Perforation of tympanic membrane"	1	65	148	213
"H53"	"O36"	"Visual disturbances"	"Maternal care for other fetal problems"	1	50	145	195
"B44"	"C91"	"Aspergillosis"	"Lymphoid leukemia"	1	21	130	151
"O44"	"O20"	"Placenta previa"	"Hemorrhage in early pregnancy"	1	486	1293	1779
"C34"	"K73"	"Malignant neoplasm of bronchus and lung"	"Chronic hepatitis, not elsewhere classified"	1	6	46	52
"J44"	"G40"	"Other chronic obstructive pulmonary disease"	"Epilepsy and recurrent seizures"	1	1511	2196	3707
"I63"	"K50"	"Cerebral infarction"	"Crohn's disease [regional enteritis]"	1	122	243	365
"I45"	"I10"	"Other conduction disorders"	"Essential (primary) hypertension"	1	2837	3531	6368
"F17"	"M51"	"Nicotine dependence"	"Thoracic, thoracolum, and lumbosacral intvrt disc disorders"	1	383	1910	2293
"C79"	"M24"	"Secondary malignant neoplasm of other and unspecified sites"	"Other specific joint derangements"	1	0	92	92
"I10"	"A56"	"Essential (primary) hypertension"	"Other sexually transmitted chlamydial diseases"	1	3	42	45
"C22"	"N92"	"Malignant neoplasm of liver and intrahepatic bile ducts"	"Excessive, frequent and irregular menstruation"	1	0	39	39
"O28"	"A63"	"Abnormal findings on antenatal screening of mother"	"Oth predominantly sexually transmitted diseases, NEC"	1	7	197	204
"M05"	"M25"	"Rheumatoid arthritis with rheumatoid factor"	"Other joint disorder, not elsewhere classified"	1	792	1544	2336
"K25"	"O70"	"Gastric ulcer"	"Perineal laceration during delivery"	1	32	204	236
"K22"	"M02"	"Other diseases of esophagus"	"Postinfective and reactive arthropathies"	1	24	99	123
"H33"	"N92"	"Retinal detachments and breaks"	"Excessive, frequent and irregular menstruation"	1	0	357	357
"J69"	"K80"	"Pneumonitis due to solids and liquids"	"Cholelithiasis"	1	58	452	510
"H52"	"G80"	"Disorders of refraction and accommodation"	"Cerebral palsy"	1	209	694	903
"C50"	"O92"	"Malignant neoplasm of breast"	"Oth disord of brst/lactatn assoc w pregnancy and the puerp"	1	7	65	72
"C18"	"G44"	"Malignant neoplasm of colon"	"Other headache syndromes"	1	26	91	117
"E11"	"J37"	"Type 2 diabetes mellitus"	"Chronic laryngitis and laryngotracheitis"	1	101	467	568
"C56"	"O03"	"Malignant neoplasm of ovary"	"Spontaneous abortion"	1	0	30	30
"C25"	"D37"	"Malignant neoplasm of pancreas"	"Neoplasm of uncrt behavior of oral cavity and dgstv organs"	1	127	240	367
"H11"	"O80"	"Other disorders of conjunctiva"	"Encounter for full-term uncomplicated delivery"	1	10	386	396
"I47"	"N94"	"Paroxysmal tachycardia"	"Pain and oth cond assoc w fem gntl org and menstrual cycle"	1	140	258	398
"O68"	"L70"	"Labor and delivery comp by abnlt of fetal acid-base balance"	"Acne"	1	56	136	192
"O62"	"K00"	"Abnormalities of forces of labor"	"Disorders of tooth development and eruption"	1	82	432	514
"I67"	"F10"	"Other cerebrovascular diseases"	"Alcohol related disorders"	1	184	344	528
"I73"	"O82"	"Other peripheral vascular diseases"	"Encounter for cesarean delivery without indication"	1	5	125	130
"M17"	"L04"	"Osteoarthritis of knee"	"Acute lymphadenitis"	1	34	156	190
"I95"	"I21"	"Hypotension"	"Acute myocardial infarction"	1	0	3846	3846
"D50"	"J42"	"Iron deficiency anemia"	"Unspecified chronic bronchitis"	1	430	833	1263
"M23"	"O03"	"Internal derangement of knee"	"Spontaneous abortion"	1	380	1492	1872
"M81"	"G51"	"Osteoporosis without current pathological fracture"	"Facial nerve disorders"	1	89	275	364
"I44"	"C54"	"Atrioventricular and left bundle-branch block"	"Malignant neoplasm of corpus uteri"	1	20	82	102
"J84"	"K51"	"Other interstitial pulmonary diseases"	"Ulcerative colitis"	1	32	148	180
"N18"	"O26"	"Chronic kidney disease (CKD)"	"Maternal care for oth conditions predom related to pregnancy"	1	0	63	63
"G47"	"M19"	"Sleep disorders"	"Other and unspecified osteoarthritis"	1	1025	1767	2792
"M41"	"N47"	"Scoliosis"	"Disorders of prepuce"	1	62	166	228
"I34"	"D25"	"Nonrheumatic mitral valve disorders"	"Leiomyoma of uterus"	1	7	183	190
"E87"	"N47"	"Other disorders of fluid, electrolyte and acid-base balance"	"Disorders of prepuce"	1	152	468	620
"H25"	"O70"	"Age-related cataract"	"Perineal laceration during delivery"	1	0	92	92
"F17"	"K29"	"Nicotine dependence"	"Gastritis and duodenitis"	1	1351	2361	3712
"I20"	"I83"	"Angina pectoris"	"Varicose veins of lower extremities"	1	2022	2785	4807
"O41"	"J35"	"Other disorders of amniotic fluid and membranes"	"Chronic diseases of tonsils and adenoids"	1	12	191	203
"I42"	"N43"	"Cardiomyopathy"	"Hydrocele and spermatocele"	1	49	168	217
"I73"	"C62"	"Other peripheral vascular diseases"	"Malignant neoplasm of testis"	1	0	33	33
"I82"	"M75"	"Other venous embolism and thrombosis"	"Shoulder lesions"	1	207	417	624
"I15"	"E10"	"Secondary hypertension"	"Type 1 diabetes mellitus"	1	749	1407	2156
"I10"	"L72"	"Essential (primary) hypertension"	"Follicular cysts of skin and subcutaneous tissue"	1	599	879	1478
"A46"	"E78"	"Erysipelas"	"Disorders of lipoprotein metabolism and other lipidemias"	1	2022	3015	5037
"E55"	"G43"	"Vitamin D deficiency"	"Migraine"	1	73	204	277
"J81"	"D12"	"Pulmonary edema"	"Benign neoplasm of colon, rectum, anus and anal canal"	1	135	574	709
"I78"	"K35"	"Diseases of capillaries"	"Acute appendicitis"	1	28	82	110
"E16"	"I48"	"Other disorders of pancreatic internal secretion"	"Atrial fibrillation and flutter"	1	1263	1736	2999
"C67"	"M75"	"Malignant neoplasm of bladder"	"Shoulder lesions"	1	103	332	435
"N19"	"K70"	"Unspecified kidney failure"	"Alcoholic liver disease"	1	314	562	876
"F17"	"J36"	"Nicotine dependence"	"Peritonsillar abscess"	1	5	251	256
"E03"	"M51"	"Other hypothyroidism"	"Thoracic, thoracolum, and lumbosacral intvrt disc disorders"	1	663	1820	2483
"O71"	"Q17"	"Other obstetric trauma"	"Other congenital malformations of ear"	1	0	60	60
"D21"	"N92"	"Other benign neoplasms of connective and other soft tissue"	"Excessive, frequent and irregular menstruation"	1	57	324	381
"C79"	"O70"	"Secondary malignant neoplasm of other and unspecified sites"	"Perineal laceration during delivery"	1	0	98	98
"I69"	"J05"	"Sequelae of cerebrovascular disease"	"Acute obstructive laryngitis [croup] and epiglottitis"	1	6	46	52
"K83"	"M77"	"Other diseases of biliary tract"	"Other enthesopathies"	1	45	116	161
"L57"	"I21"	"Skin changes due to chronic expsr to nonionizing radiation"	"Acute myocardial infarction"	1	126	406	532
"K86"	"N87"	"Other diseases of pancreas"	"Dysplasia of cervix uteri"	1	3	56	59
"E10"	"H66"	"Type 1 diabetes mellitus"	"Suppurative and unspecified otitis media"	1	141	297	438
"J18"	"O80"	"Pneumonia, unspecified organism"	"Encounter for full-term uncomplicated delivery"	1	0	5087	5087
"H43"	"O02"	"Disorders of vitreous body"	"Other abnormal products of conception"	1	0	83	83
"C71"	"K51"	"Malignant neoplasm of brain"	"Ulcerative colitis"	1	4	34	38
"L98"	"M20"	"Oth disorders of skin, subcu, not elsewhere classified"	"Acquired deformities of fingers and toes"	1	163	430	593
"C34"	"H74"	"Malignant neoplasm of bronchus and lung"	"Other disorders of middle ear mastoid"	1	0	50	50
"D63"	"J43"	"Anemia in chronic diseases classified elsewhere"	"Emphysema"	1	46	195	241
"N82"	"O20"	"Fistulae involving female genital tract"	"Hemorrhage in early pregnancy"	1	4	48	52
"C93"	"M51"	"Monocytic leukemia"	"Thoracic, thoracolum, and lumbosacral intvrt disc disorders"	1	0	25	25
"L90"	"E05"	"Atrophic disorders of skin"	"Thyrotoxicosis [hyperthyroidism]"	1	167	288	455
"M46"	"E11"	"Other inflammatory spondylopathies"	"Type 2 diabetes mellitus"	1	250	461	711
"C20"	"H93"	"Malignant neoplasm of rectum"	"Other disorders of ear, not elsewhere classified"	1	89	341	430
"J84"	"D25"	"Other interstitial pulmonary diseases"	"Leiomyoma of uterus"	1	7	98	105
"D35"	"O26"	"Benign neoplasm of other and unspecified endocrine glands"	"Maternal care for oth conditions predom related to pregnancy"	1	1	62	63
"B18"	"O02"	"Chronic viral hepatitis"	"Other abnormal products of conception"	1	38	151	189
"C80"	"M43"	"Malignant neoplasm without specification of site"	"Other deforming dorsopathies"	1	3	50	53
"N31"	"O26"	"Neuromuscular dysfunction of bladder, NEC"	"Maternal care for oth conditions predom related to pregnancy"	1	11	67	78
"J47"	"K35"	"Bronchiectasis"	"Acute appendicitis"	1	4	55	59
"C06"	"I80"	"Malignant neoplasm of other and unspecified parts of mouth"	"Phlebitis and thrombophlebitis"	1	18	71	89
"D05"	"N63"	"Carcinoma in situ of breast"	"Unspecified lump in breast"	1	467	1174	1641
"O73"	"O02"	"Retained placenta and membranes, without hemorrhage"	"Other abnormal products of conception"	1	429	1257	1686
"C79"	"N87"	"Secondary malignant neoplasm of other and unspecified sites"	"Dysplasia of cervix uteri"	1	0	116	116
"H57"	"J30"	"Other disorders of eye and adnexa"	"Vasomotor and allergic rhinitis"	1	59	218	277
"C20"	"M65"	"Malignant neoplasm of rectum"	"Synovitis and tenosynovitis"	1	46	217	263
"G47"	"Q87"	"Sleep disorders"	"Oth congenital malform syndromes affecting multiple systems"	1	41	143	184
"I46"	"I50"	"Cardiac arrest"	"Heart failure"	1	3538	7385	10923
"L90"	"M54"	"Atrophic disorders of skin"	"Dorsalgia"	1	816	1192	2008
"K55"	"K57"	"Vascular disorders of intestine"	"Diverticular disease of intestine"	1	779	1044	1823
"J12"	"Q39"	"Viral pneumonia, not elsewhere classified"	"Congenital malformations of esophagus"	1	12	69	81
"G96"	"N20"	"Other disorders of central nervous system"	"Calculus of kidney and ureter"	1	69	585	654
"E66"	"M62"	"Overweight and obesity"	"Other disorders of muscle"	1	2675	5991	8666
"Q61"	"N40"	"Cystic kidney disease"	"Benign prostatic hyperplasia"	1	159	371	530
"I87"	"O70"	"Other disorders of veins"	"Perineal laceration during delivery"	1	8	141	149
"L81"	"O82"	"Other disorders of pigmentation"	"Encounter for cesarean delivery without indication"	1	49	119	168
"I27"	"H25"	"Other pulmonary heart diseases"	"Age-related cataract"	1	715	1800	2515
"H91"	"N46"	"Other and unspecified hearing loss"	"Male infertility"	1	49	208	257
"N92"	"J35"	"Excessive, frequent and irregular menstruation"	"Chronic diseases of tonsils and adenoids"	1	0	1601	1601
"M62"	"B27"	"Other disorders of muscle"	"Infectious mononucleosis"	1	62	271	333
"H52"	"O02"	"Disorders of refraction and accommodation"	"Other abnormal products of conception"	1	145	438	583
"O67"	"N97"	"Labor and delivery comp by intrapartum hemorrhage, NEC"	"Female infertility"	1	70	599	669
"J15"	"G20"	"Bacterial pneumonia, not elsewhere classified"	"Parkinson's disease"	1	632	1584	2216
"E27"	"D35"	"Other disorders of adrenal gland"	"Benign neoplasm of other and unspecified endocrine glands"	1	455	676	1131
"C53"	"O03"	"Malignant neoplasm of cervix uteri"	"Spontaneous abortion"	1	0	110	110
"H53"	"L20"	"Visual disturbances"	"Atopic dermatitis"	1	20	116	136
"I15"	"O24"	"Secondary hypertension"	"Diabetes in pregnancy, childbirth, and the puerperium"	1	8	100	108
"C61"	"M71"	"Malignant neoplasm of prostate"	"Other bursopathies"	1	29	195	224
"K26"	"H80"	"Duodenal ulcer"	"Otosclerosis"	1	38	120	158
"K65"	"D30"	"Peritonitis"	"Benign neoplasm of urinary organs"	1	50	191	241
"M95"	"F10"	"Oth acquired deformities of ms sys and connective tissue"	"Alcohol related disorders"	1	236	472	708
"E89"	"O32"	"Postproc endocrine and metabolic comp and disorders, NEC"	"Maternal care for malpresentation of fetus"	1	7	70	77
"J09"	"N20"	"Influenza due to certain identified influenza viruses"	"Calculus of kidney and ureter"	1	1	92	93
"N97"	"L20"	"Female infertility"	"Atopic dermatitis"	1	22	200	222
"E66"	"H00"	"Overweight and obesity"	"Hordeolum and chalazion"	1	63	246	309
"I72"	"I20"	"Other aneurysm"	"Angina pectoris"	1	299	1552	1851
"C18"	"K35"	"Malignant neoplasm of colon"	"Acute appendicitis"	1	250	1122	1372
"I50"	"C83"	"Heart failure"	"Non-follicular lymphoma"	1	353	621	974
"K57"	"D23"	"Diverticular disease of intestine"	"Other benign neoplasms of skin"	1	358	994	1352
"D64"	"I45"	"Other anemias"	"Other conduction disorders"	1	571	1029	1600
"I89"	"K35"	"Oth noninfective disorders of lymphatic vessels and nodes"	"Acute appendicitis"	1	14	102	116
"Q23"	"M17"	"Congenital malformations of aortic and mitral valves"	"Osteoarthritis of knee"	1	5	58	63
"E23"	"O02"	"Hypofunction and other disorders of the pituitary gland"	"Other abnormal products of conception"	1	6	61	67
"G56"	"O65"	"Mononeuropathies of upper limb"	"Obstructed labor due to maternal pelvic abnormality"	1	0	459	459
"I50"	"H52"	"Heart failure"	"Disorders of refraction and accommodation"	1	183	684	867
"E68"	"J45"	"Sequelae of hyperalimentation"	"Asthma"	1	54	353	407
"J15"	"K29"	"Bacterial pneumonia, not elsewhere classified"	"Gastritis and duodenitis"	1	0	5253	5253
"I46"	"M20"	"Cardiac arrest"	"Acquired deformities of fingers and toes"	1	0	325	325
"I51"	"I83"	"Complications and ill-defined descriptions of heart disease"	"Varicose veins of lower extremities"	1	93	482	575
"E16"	"H81"	"Other disorders of pancreatic internal secretion"	"Disorders of vestibular function"	1	141	240	381
"K64"	"K59"	"Hemorrhoids and perianal venous thrombosis"	"Other functional intestinal disorders"	1	1765	2787	4552
"C90"	"M19"	"Multiple myeloma and malignant plasma cell neoplasms"	"Other and unspecified osteoarthritis"	1	53	136	189
"M54"	"H80"	"Dorsalgia"	"Otosclerosis"	1	178	524	702
"K56"	"E11"	"Paralytic ileus and intestinal obstruction without hernia"	"Type 2 diabetes mellitus"	1	1600	2727	4327
"E86"	"Q61"	"Volume depletion"	"Cystic kidney disease"	1	181	370	551
"I97"	"M16"	"Intraop and postproc comp and disorders of circ sys, NEC"	"Osteoarthritis of hip"	1	50	140	190
"G91"	"K30"	"Hydrocephalus"	"Functional dyspepsia"	1	43	125	168
"G47"	"C38"	"Sleep disorders"	"Malignant neoplasm of heart, mediastinum and pleura"	1	22	74	96
"A49"	"D11"	"Bacterial infection of unspecified site"	"Benign neoplasm of major salivary glands"	1	24	146	170
"N81"	"J36"	"Female genital prolapse"	"Peritonsillar abscess"	1	12	69	81
"M18"	"N60"	"Osteoarthritis of first carpometacarpal joint"	"Benign mammary dysplasia"	1	0	244	244
"B18"	"L08"	"Chronic viral hepatitis"	"Other local infections of skin and subcutaneous tissue"	1	189	379	568
"A46"	"O30"	"Erysipelas"	"Multiple gestation"	1	3	50	53
"M06"	"M02"	"Other rheumatoid arthritis"	"Postinfective and reactive arthropathies"	1	486	969	1455
"N28"	"D23"	"Oth disorders of kidney and ureter, not elsewhere classified"	"Other benign neoplasms of skin"	1	37	141	178
"C16"	"M16"	"Malignant neoplasm of stomach"	"Osteoarthritis of hip"	1	18	410	428
"J09"	"C92"	"Influenza due to certain identified influenza viruses"	"Myeloid leukemia"	1	11	58	69
"E11"	"M51"	"Type 2 diabetes mellitus"	"Thoracic, thoracolum, and lumbosacral intvrt disc disorders"	1	2057	4718	6775
"D64"	"O62"	"Other anemias"	"Abnormalities of forces of labor"	1	0	869	869
"F17"	"M71"	"Nicotine dependence"	"Other bursopathies"	1	41	227	268
"K66"	"D25"	"Other disorders of peritoneum"	"Leiomyoma of uterus"	1	192	356	548
"M89"	"O20"	"Other disorders of bone"	"Hemorrhage in early pregnancy"	1	11	48	59
"C13"	"M17"	"Malignant neoplasm of hypopharynx"	"Osteoarthritis of knee"	1	5	57	62
"I50"	"H65"	"Heart failure"	"Nonsuppurative otitis media"	1	123	730	853
"N30"	"L02"	"Cystitis"	"Cutaneous abscess, furuncle and carbuncle"	1	1974	3428	5402
"C22"	"D25"	"Malignant neoplasm of liver and intrahepatic bile ducts"	"Leiomyoma of uterus"	1	0	30	30
"L02"	"H10"	"Cutaneous abscess, furuncle and carbuncle"	"Conjunctivitis"	1	574	1107	1681
"F43"	"M02"	"Reaction to severe stress, and adjustment disorders"	"Postinfective and reactive arthropathies"	1	18	132	150
"J96"	"O82"	"Respiratory failure, not elsewhere classified"	"Encounter for cesarean delivery without indication"	1	24	299	323
"N12"	"M20"	"Tubulo-interstitial nephritis, not spcf as acute or chronic"	"Acquired deformities of fingers and toes"	1	30	87	117
"I70"	"Q54"	"Atherosclerosis"	"Hypospadias"	1	12	64	76
"F60"	"H10"	"Specific personality disorders"	"Conjunctivitis"	1	12	76	88
"I50"	"O24"	"Heart failure"	"Diabetes in pregnancy, childbirth, and the puerperium"	1	0	31	31
"C23"	"K80"	"Malignant neoplasm of gallbladder"	"Cholelithiasis"	1	76	448	524
"M46"	"N97"	"Other inflammatory spondylopathies"	"Female infertility"	1	12	108	120
"C61"	"H66"	"Malignant neoplasm of prostate"	"Suppurative and unspecified otitis media"	1	0	126	126
"I69"	"C43"	"Sequelae of cerebrovascular disease"	"Malignant melanoma of skin"	1	232	474	706
"F33"	"G56"	"Major depressive disorder, recurrent"	"Mononeuropathies of upper limb"	1	251	904	1155
"A63"	"H65"	"Oth predominantly sexually transmitted diseases, NEC"	"Nonsuppurative otitis media"	1	12	100	112
"H16"	"Q53"	"Keratitis"	"Undescended and ectopic testicle"	1	0	29	29
"C79"	"L98"	"Secondary malignant neoplasm of other and unspecified sites"	"Oth disorders of skin, subcu, not elsewhere classified"	1	132	250	382
"J91"	"M67"	"Pleural effusion in conditions classified elsewhere"	"Other disorders of synovium and tendon"	1	5	73	78
"C18"	"G43"	"Malignant neoplasm of colon"	"Migraine"	1	14	101	115
"A41"	"G63"	"Other sepsis"	"Polyneuropathy in diseases classified elsewhere"	1	258	485	743
"O66"	"O26"	"Other obstructed labor"	"Maternal care for oth conditions predom related to pregnancy"	1	1187	1526	2713
"I36"	"N81"	"Nonrheumatic tricuspid valve disorders"	"Female genital prolapse"	1	10	48	58
"G31"	"M19"	"Oth degenerative diseases of nervous system, NEC"	"Other and unspecified osteoarthritis"	1	72	204	276
"C79"	"L05"	"Secondary malignant neoplasm of other and unspecified sites"	"Pilonidal cyst and sinus"	1	0	48	48
"J18"	"O62"	"Pneumonia, unspecified organism"	"Abnormalities of forces of labor"	1	0	3013	3013
"I26"	"N60"	"Pulmonary embolism"	"Benign mammary dysplasia"	1	22	185	207
"K22"	"O70"	"Other diseases of esophagus"	"Perineal laceration during delivery"	1	42	160	202
"A04"	"H90"	"Other bacterial intestinal infections"	"Conductive and sensorineural hearing loss"	1	32	369	401
"M25"	"M65"	"Other joint disorder, not elsewhere classified"	"Synovitis and tenosynovitis"	1	2125	2650	4775
"I46"	"K70"	"Cardiac arrest"	"Alcoholic liver disease"	1	149	695	844
"O04"	"K00"	"Complications following (induced) termination of pregnancy"	"Disorders of tooth development and eruption"	1	146	422	568
"I73"	"O32"	"Other peripheral vascular diseases"	"Maternal care for malpresentation of fetus"	1	1	28	29
"L89"	"I70"	"Pressure ulcer"	"Atherosclerosis"	1	1343	2951	4294
"J90"	"H04"	"Pleural effusion, not elsewhere classified"	"Disorders of lacrimal system"	1	12	54	66
"M80"	"J38"	"Osteoporosis with current pathological fracture"	"Diseases of vocal cords and larynx, not elsewhere classified"	1	28	262	290
"G96"	"J44"	"Other disorders of central nervous system"	"Other chronic obstructive pulmonary disease"	1	806	1728	2534
"K13"	"M22"	"Other diseases of lip and oral mucosa"	"Disorder of patella"	1	5	54	59
"E27"	"M31"	"Other disorders of adrenal gland"	"Other necrotizing vasculopathies"	1	31	153	184
"J18"	"M43"	"Pneumonia, unspecified organism"	"Other deforming dorsopathies"	1	491	1773	2264
"K56"	"H81"	"Paralytic ileus and intestinal obstruction without hernia"	"Disorders of vestibular function"	1	206	575	781
"O21"	"B27"	"Excessive vomiting in pregnancy"	"Infectious mononucleosis"	1	0	49	49
"M23"	"Q54"	"Internal derangement of knee"	"Hypospadias"	1	49	136	185
"E55"	"N80"	"Vitamin D deficiency"	"Endometriosis"	1	6	76	82
"J98"	"J34"	"Other respiratory disorders"	"Other and unspecified disorders of nose and nasal sinuses"	1	48	125	173
"A46"	"D17"	"Erysipelas"	"Benign lipomatous neoplasm"	1	215	443	658
"K80"	"D27"	"Cholelithiasis"	"Benign neoplasm of ovary"	1	603	846	1449
"K52"	"N03"	"Other and unsp noninfective gastroenteritis and colitis"	"Chronic nephritic syndrome"	1	38	151	189
"G96"	"M75"	"Other disorders of central nervous system"	"Shoulder lesions"	1	312	1322	1634
"I38"	"M23"	"Endocarditis, valve unspecified"	"Internal derangement of knee"	1	5	73	78
"K43"	"K60"	"Ventral hernia"	"Fissure and fistula of anal and rectal regions"	1	189	350	539
"N19"	"H50"	"Unspecified kidney failure"	"Other strabismus"	1	10	74	84
"J44"	"N93"	"Other chronic obstructive pulmonary disease"	"Other abnormal uterine and vaginal bleeding"	1	72	205	277
"J94"	"N60"	"Other pleural conditions"	"Benign mammary dysplasia"	1	1	32	33
"K44"	"O03"	"Diaphragmatic hernia"	"Spontaneous abortion"	1	0	370	370
"M80"	"K57"	"Osteoporosis with current pathological fracture"	"Diverticular disease of intestine"	1	928	2388	3316
"J98"	"M20"	"Other respiratory disorders"	"Acquired deformities of fingers and toes"	1	75	200	275
"H57"	"J36"	"Other disorders of eye and adnexa"	"Peritonsillar abscess"	1	7	82	89
"O92"	"O24"	"Oth disord of brst/lactatn assoc w pregnancy and the puerp"	"Diabetes in pregnancy, childbirth, and the puerperium"	1	452	1228	1680
"K92"	"H61"	"Other diseases of digestive system"	"Other disorders of external ear"	1	83	188	271
"J96"	"I34"	"Respiratory failure, not elsewhere classified"	"Nonrheumatic mitral valve disorders"	1	660	1498	2158
"F10"	"Q66"	"Alcohol related disorders"	"Congenital deformities of feet"	1	48	170	218
"C64"	"N81"	"Malignant neoplasm of kidney, except renal pelvis"	"Female genital prolapse"	1	15	189	204
"N31"	"G37"	"Neuromuscular dysfunction of bladder, NEC"	"Other demyelinating diseases of central nervous system"	1	67	264	331
"I48"	"G35"	"Atrial fibrillation and flutter"	"Multiple sclerosis"	1	9	213	222
"G98"	"L08"	"Other disorders of nervous system not elsewhere classified"	"Other local infections of skin and subcutaneous tissue"	1	32	98	130
"E87"	"L40"	"Other disorders of fluid, electrolyte and acid-base balance"	"Psoriasis"	1	122	532	654
"J69"	"E55"	"Pneumonitis due to solids and liquids"	"Vitamin D deficiency"	1	120	288	408
"A56"	"G40"	"Other sexually transmitted chlamydial diseases"	"Epilepsy and recurrent seizures"	1	5	40	45
"A08"	"H91"	"Viral and other specified intestinal infections"	"Other and unspecified hearing loss"	1	465	1002	1467
"I95"	"M77"	"Hypotension"	"Other enthesopathies"	1	19	176	195
"M72"	"E04"	"Fibroblastic disorders"	"Other nontoxic goiter"	1	179	300	479
"M16"	"N93"	"Osteoarthritis of hip"	"Other abnormal uterine and vaginal bleeding"	1	46	118	164
"F32"	"M42"	"Depressive episode"	"Spinal osteochondrosis"	1	28	108	136
"O30"	"E28"	"Multiple gestation"	"Ovarian dysfunction"	1	304	457	761
"I46"	"D30"	"Cardiac arrest"	"Benign neoplasm of urinary organs"	1	5	386	391
"M99"	"D25"	"Biomechanical lesions, not elsewhere classified"	"Leiomyoma of uterus"	1	29	212	241
"M75"	"A63"	"Shoulder lesions"	"Oth predominantly sexually transmitted diseases, NEC"	1	161	813	974
"M48"	"I47"	"Other spondylopathies"	"Paroxysmal tachycardia"	1	466	1033	1499
"G47"	"L90"	"Sleep disorders"	"Atrophic disorders of skin"	1	121	412	533
"E68"	"G40"	"Sequelae of hyperalimentation"	"Epilepsy and recurrent seizures"	1	16	84	100
"I21"	"M76"	"Acute myocardial infarction"	"Enthesopathies, lower limb, excluding foot"	1	256	463	719
"E63"	"J44"	"Other nutritional deficiencies"	"Other chronic obstructive pulmonary disease"	1	176	319	495
"E41"	"C16"	"Nutritional marasmus"	"Malignant neoplasm of stomach"	1	24	120	144
"D46"	"M23"	"Myelodysplastic syndromes"	"Internal derangement of knee"	1	5	106	111
"L97"	"A09"	"Non-pressure chronic ulcer of lower limb, NEC"	"Infectious gastroenteritis and colitis, unspecified"	1	463	755	1218
"N63"	"D48"	"Unspecified lump in breast"	"Neoplasm of uncertain behavior of other and unsp sites"	1	98	266	364
"J18"	"E11"	"Pneumonia, unspecified organism"	"Type 2 diabetes mellitus"	1	0	38944	38944
"K82"	"M23"	"Other diseases of gallbladder"	"Internal derangement of knee"	1	18	121	139
"N17"	"O36"	"Acute kidney failure"	"Maternal care for other fetal problems"	1	2	31	33
"H91"	"Q21"	"Other and unspecified hearing loss"	"Congenital malformations of cardiac septa"	1	65	264	329
"J18"	"I99"	"Pneumonia, unspecified organism"	"Other and unspecified disorders of circulatory system"	1	838	1078	1916
"D06"	"O04"	"Carcinoma in situ of cervix uteri"	"Complications following (induced) termination of pregnancy"	1	265	632	897
"D63"	"I47"	"Anemia in chronic diseases classified elsewhere"	"Paroxysmal tachycardia"	1	107	674	781
"C88"	"D31"	"Malig immunoproliferative dis and certain oth B-cell lymph"	"Benign neoplasm of eye and adnexa"	1	3	37	40
"J34"	"K35"	"Other and unspecified disorders of nose and nasal sinuses"	"Acute appendicitis"	1	254	520	774
"M65"	"Q17"	"Synovitis and tenosynovitis"	"Other congenital malformations of ear"	1	8	131	139
"E78"	"M62"	"Disorders of lipoprotein metabolism and other lipidemias"	"Other disorders of muscle"	1	0	7176	7176
"C25"	"L98"	"Malignant neoplasm of pancreas"	"Oth disorders of skin, subcu, not elsewhere classified"	1	18	85	103
"K56"	"O70"	"Paralytic ileus and intestinal obstruction without hernia"	"Perineal laceration during delivery"	1	13	288	301
"L90"	"N97"	"Atrophic disorders of skin"	"Female infertility"	1	155	483	638
"H53"	"M20"	"Visual disturbances"	"Acquired deformities of fingers and toes"	1	169	329	498
"M13"	"K80"	"Other arthritis"	"Cholelithiasis"	1	413	701	1114
"I48"	"D27"	"Atrial fibrillation and flutter"	"Benign neoplasm of ovary"	1	152	879	1031
"L90"	"O65"	"Atrophic disorders of skin"	"Obstructed labor due to maternal pelvic abnormality"	1	0	321	321
"K76"	"O42"	"Other diseases of liver"	"Premature rupture of membranes"	1	0	87	87
"E86"	"E11"	"Volume depletion"	"Type 2 diabetes mellitus"	1	0	19448	19448
"I21"	"L03"	"Acute myocardial infarction"	"Cellulitis and acute lymphangitis"	1	286	843	1129
"C34"	"H80"	"Malignant neoplasm of bronchus and lung"	"Otosclerosis"	1	0	192	192
"I46"	"F13"	"Cardiac arrest"	"Sedative, hypnotic, or anxiolytic related disorders"	1	36	120	156
"K83"	"K44"	"Other diseases of biliary tract"	"Diaphragmatic hernia"	1	190	616	806
"H53"	"A63"	"Visual disturbances"	"Oth predominantly sexually transmitted diseases, NEC"	1	21	102	123
"C80"	"I50"	"Malignant neoplasm without specification of site"	"Heart failure"	1	175	441	616
"C45"	"G56"	"Mesothelioma"	"Mononeuropathies of upper limb"	1	0	44	44
"D80"	"H65"	"Immunodeficiency with predominantly antibody defects"	"Nonsuppurative otitis media"	1	33	99	132
"D35"	"M67"	"Benign neoplasm of other and unspecified endocrine glands"	"Other disorders of synovium and tendon"	1	30	124	154
"I46"	"N83"	"Cardiac arrest"	"Noninflammatory disord of ovary, fallop and broad ligament"	1	0	156	156
"C34"	"K27"	"Malignant neoplasm of bronchus and lung"	"Peptic ulcer, site unspecified"	1	115	346	461
"J96"	"K76"	"Respiratory failure, not elsewhere classified"	"Other diseases of liver"	1	774	1155	1929
"N18"	"H10"	"Chronic kidney disease (CKD)"	"Conjunctivitis"	1	12	502	514
"A04"	"C43"	"Other bacterial intestinal infections"	"Malignant melanoma of skin"	1	25	90	115
"K56"	"O00"	"Paralytic ileus and intestinal obstruction without hernia"	"Ectopic pregnancy"	1	2	100	102
"A40"	"F10"	"Streptococcal sepsis"	"Alcohol related disorders"	1	205	548	753
"I48"	"M62"	"Atrial fibrillation and flutter"	"Other disorders of muscle"	1	0	5543	5543
"J91"	"I48"	"Pleural effusion in conditions classified elsewhere"	"Atrial fibrillation and flutter"	1	1063	1937	3000
"M07"	"L40"	"Enteropathic arthropathies"	"Psoriasis"	1	1942	2447	4389
"G31"	"K25"	"Oth degenerative diseases of nervous system, NEC"	"Gastric ulcer"	1	121	267	388
"F11"	"F10"	"Opioid related disorders"	"Alcohol related disorders"	1	816	1199	2015
"K57"	"H11"	"Diverticular disease of intestine"	"Other disorders of conjunctiva"	1	147	325	472
"M53"	"K35"	"Other and unspecified dorsopathies, not elsewhere classified"	"Acute appendicitis"	1	97	333	430
"G47"	"J45"	"Sleep disorders"	"Asthma"	1	1020	3308	4328
"M16"	"J03"	"Osteoarthritis of hip"	"Acute tonsillitis"	1	78	185	263
"A41"	"I44"	"Other sepsis"	"Atrioventricular and left bundle-branch block"	1	1084	2280	3364
"D70"	"I83"	"Neutropenia"	"Varicose veins of lower extremities"	1	11	66	77
"C34"	"H90"	"Malignant neoplasm of bronchus and lung"	"Conductive and sensorineural hearing loss"	1	125	1248	1373
"K00"	"L20"	"Disorders of tooth development and eruption"	"Atopic dermatitis"	1	9	89	98
"G98"	"O02"	"Other disorders of nervous system not elsewhere classified"	"Other abnormal products of conception"	1	0	97	97
"L98"	"M50"	"Oth disorders of skin, subcu, not elsewhere classified"	"Cervical disc disorders"	1	98	233	331
"C25"	"I83"	"Malignant neoplasm of pancreas"	"Varicose veins of lower extremities"	1	0	375	375
"M81"	"G50"	"Osteoporosis without current pathological fracture"	"Disorders of trigeminal nerve"	1	113	334	447
"G80"	"K40"	"Cerebral palsy"	"Inguinal hernia"	1	68	181	249
"M54"	"H66"	"Dorsalgia"	"Suppurative and unspecified otitis media"	1	192	965	1157
"N30"	"K01"	"Cystitis"	"Embedded and impacted teeth"	1	143	328	471
"L97"	"H25"	"Non-pressure chronic ulcer of lower limb, NEC"	"Age-related cataract"	1	1551	4295	5846
"C78"	"C01"	"Secondary malignant neoplasm of resp and digestive organs"	"Malignant neoplasm of base of tongue"	1	28	83	111
"N15"	"H91"	"Other renal tubulo-interstitial diseases"	"Other and unspecified hearing loss"	1	67	196	263
"N93"	"D06"	"Other abnormal uterine and vaginal bleeding"	"Carcinoma in situ of cervix uteri"	1	50	246	296
"I46"	"N25"	"Cardiac arrest"	"Disorders resulting from impaired renal tubular function"	1	9	77	86
"I87"	"A46"	"Other disorders of veins"	"Erysipelas"	1	650	931	1581
"G56"	"H80"	"Mononeuropathies of upper limb"	"Otosclerosis"	1	48	230	278
"K43"	"K21"	"Ventral hernia"	"Gastro-esophageal reflux disease"	1	598	1014	1612
"I06"	"M06"	"Rheumatic aortic valve diseases"	"Other rheumatoid arthritis"	1	26	81	107
"E86"	"L72"	"Volume depletion"	"Follicular cysts of skin and subcutaneous tissue"	1	33	296	329
"J81"	"K21"	"Pulmonary edema"	"Gastro-esophageal reflux disease"	1	73	437	510
"E63"	"M51"	"Other nutritional deficiencies"	"Thoracic, thoracolum, and lumbosacral intvrt disc disorders"	1	0	64	64
"E55"	"O04"	"Vitamin D deficiency"	"Complications following (induced) termination of pregnancy"	1	0	319	319
"H40"	"H83"	"Glaucoma"	"Other diseases of inner ear"	1	131	515	646
"N93"	"O68"	"Other abnormal uterine and vaginal bleeding"	"Labor and delivery comp by abnlt of fetal acid-base balance"	1	310	1555	1865
"M85"	"G56"	"Other disorders of bone density and structure"	"Mononeuropathies of upper limb"	1	362	1814	2176
"D14"	"O20"	"Benign neoplasm of middle ear and respiratory system"	"Hemorrhage in early pregnancy"	1	0	60	60
"H26"	"F10"	"Other cataract"	"Alcohol related disorders"	1	527	1072	1599
"M80"	"M15"	"Osteoporosis with current pathological fracture"	"Polyosteoarthritis"	1	371	592	963
"J90"	"J33"	"Pleural effusion, not elsewhere classified"	"Nasal polyp"	1	11	53	64
"I25"	"H66"	"Chronic ischemic heart disease"	"Suppurative and unspecified otitis media"	1	147	727	874
"N62"	"J45"	"Hypertrophy of breast"	"Asthma"	1	406	646	1052
"K50"	"O48"	"Crohn's disease [regional enteritis]"	"Late pregnancy"	1	17	75	92
"N84"	"O28"	"Polyp of female genital tract"	"Abnormal findings on antenatal screening of mother"	1	19	81	100
"D43"	"K30"	"Neoplasm of uncertain behavior of brain and cnsl"	"Functional dyspepsia"	1	22	88	110
"N39"	"D24"	"Other disorders of urinary system"	"Benign neoplasm of breast"	1	153	1212	1365
"N19"	"D24"	"Unspecified kidney failure"	"Benign neoplasm of breast"	1	14	116	130
"K59"	"M48"	"Other functional intestinal disorders"	"Other spondylopathies"	1	2439	4422	6861
"M67"	"O68"	"Other disorders of synovium and tendon"	"Labor and delivery comp by abnlt of fetal acid-base balance"	1	658	1086	1744
"D09"	"I83"	"Carcinoma in situ of other and unspecified sites"	"Varicose veins of lower extremities"	1	0	105	105
"C80"	"I44"	"Malignant neoplasm without specification of site"	"Atrioventricular and left bundle-branch block"	1	14	73	87
"J98"	"M72"	"Other respiratory disorders"	"Fibroblastic disorders"	1	82	222	304
"J90"	"K02"	"Pleural effusion, not elsewhere classified"	"Dental caries"	1	95	236	331
"K59"	"Q37"	"Other functional intestinal disorders"	"Cleft palate with cleft lip"	1	9	88	97
"K46"	"K85"	"Unspecified abdominal hernia"	"Acute pancreatitis"	1	31	92	123
"C15"	"N30"	"Malignant neoplasm of esophagus"	"Cystitis"	1	174	286	460
"I35"	"M54"	"Nonrheumatic aortic valve disorders"	"Dorsalgia"	1	931	2966	3897
"I21"	"M71"	"Acute myocardial infarction"	"Other bursopathies"	1	183	353	536
"M85"	"N20"	"Other disorders of bone density and structure"	"Calculus of kidney and ureter"	1	100	594	694
"I61"	"D23"	"Nontraumatic intracerebral hemorrhage"	"Other benign neoplasms of skin"	1	59	235	294
"G43"	"O70"	"Migraine"	"Perineal laceration during delivery"	1	834	1856	2690
"D31"	"O04"	"Benign neoplasm of eye and adnexa"	"Complications following (induced) termination of pregnancy"	1	3	55	58
"I61"	"H36"	"Nontraumatic intracerebral hemorrhage"	"Retinal disorders in diseases classified elsewhere"	1	100	323	423
"J91"	"I10"	"Pleural effusion in conditions classified elsewhere"	"Essential (primary) hypertension"	1	647	2585	3232
"O90"	"O64"	"Complications of the puerperium, not elsewhere classified"	"Obstructed labor due to malposition and malpresent of fetus"	1	776	1752	2528
"F03"	"G40"	"Unspecified dementia"	"Epilepsy and recurrent seizures"	1	1341	2205	3546
"H16"	"H10"	"Keratitis"	"Conjunctivitis"	1	1196	1590	2786
"D63"	"C78"	"Anemia in chronic diseases classified elsewhere"	"Secondary malignant neoplasm of resp and digestive organs"	1	2526	3731	6257
"A08"	"H83"	"Viral and other specified intestinal infections"	"Other diseases of inner ear"	1	21	110	131
"G61"	"O62"	"Inflammatory polyneuropathy"	"Abnormalities of forces of labor"	1	11	53	64
"N39"	"I70"	"Other disorders of urinary system"	"Atherosclerosis"	1	2516	5257	7773
"E34"	"C34"	"Other endocrine disorders"	"Malignant neoplasm of bronchus and lung"	1	146	367	513
"O46"	"M41"	"Antepartum hemorrhage, not elsewhere classified"	"Scoliosis"	1	0	28	28
"I10"	"G99"	"Essential (primary) hypertension"	"Oth disorders of nervous system in diseases classd elswhr"	1	170	285	455
"I67"	"N95"	"Other cerebrovascular diseases"	"Menopausal and other perimenopausal disorders"	1	56	146	202
"I66"	"E66"	"Occls and stenosis of cereb art, not rslt in cerebral infrc"	"Overweight and obesity"	1	122	316	438
"O28"	"O20"	"Abnormal findings on antenatal screening of mother"	"Hemorrhage in early pregnancy"	1	515	1516	2031
"I46"	"I10"	"Cardiac arrest"	"Essential (primary) hypertension"	1	0	9880	9880
"K02"	"N04"	"Dental caries"	"Nephrotic syndrome"	1	18	64	82
"H43"	"J35"	"Disorders of vitreous body"	"Chronic diseases of tonsils and adenoids"	1	5	98	103
"E65"	"K80"	"Localized adiposity"	"Cholelithiasis"	1	379	645	1024
"C34"	"N35"	"Malignant neoplasm of bronchus and lung"	"Urethral stricture"	1	21	264	285
"E78"	"M51"	"Disorders of lipoprotein metabolism and other lipidemias"	"Thoracic, thoracolum, and lumbosacral intvrt disc disorders"	1	0	8748	8748
"M17"	"O35"	"Osteoarthritis of knee"	"Maternal care for known or suspected fetal abnlt and damage"	1	0	48	48
"D59"	"O80"	"Acquired hemolytic anemia"	"Encounter for full-term uncomplicated delivery"	1	9	69	78
"C67"	"G44"	"Malignant neoplasm of bladder"	"Other headache syndromes"	1	10	58	68
"O98"	"O04"	"Matern infec/parastc dis classd elsw but compl preg/chldbrth"	"Complications following (induced) termination of pregnancy"	1	35	280	315
"M50"	"D06"	"Cervical disc disorders"	"Carcinoma in situ of cervix uteri"	1	0	76	76
"I21"	"O47"	"Acute myocardial infarction"	"False labor"	1	0	39	39
"F41"	"M16"	"Other anxiety disorders"	"Osteoarthritis of hip"	1	140	833	973
"N81"	"O03"	"Female genital prolapse"	"Spontaneous abortion"	1	0	958	958
"C22"	"I35"	"Malignant neoplasm of liver and intrahepatic bile ducts"	"Nonrheumatic aortic valve disorders"	1	71	221	292
"E78"	"J35"	"Disorders of lipoprotein metabolism and other lipidemias"	"Chronic diseases of tonsils and adenoids"	1	5	581	586
"A49"	"G40"	"Bacterial infection of unspecified site"	"Epilepsy and recurrent seizures"	1	422	1392	1814
"C79"	"K81"	"Secondary malignant neoplasm of other and unspecified sites"	"Cholecystitis"	1	49	236	285
"O70"	"Q78"	"Perineal laceration during delivery"	"Other osteochondrodysplasias"	1	3	94	97
"F32"	"K43"	"Depressive episode"	"Ventral hernia"	1	429	637	1066
"L97"	"L50"	"Non-pressure chronic ulcer of lower limb, NEC"	"Urticaria"	1	31	143	174
"K64"	"E04"	"Hemorrhoids and perianal venous thrombosis"	"Other nontoxic goiter"	1	8	617	625
"D38"	"G56"	"Neoplm of uncrt behav of mid ear & resp and intrathorac org"	"Mononeuropathies of upper limb"	1	14	59	73
"M23"	"O62"	"Internal derangement of knee"	"Abnormalities of forces of labor"	1	1156	3279	4435
"N30"	"O04"	"Cystitis"	"Complications following (induced) termination of pregnancy"	1	0	6040	6040
"N18"	"H61"	"Chronic kidney disease (CKD)"	"Other disorders of external ear"	1	44	207	251
"F17"	"O32"	"Nicotine dependence"	"Maternal care for malpresentation of fetus"	1	46	269	315
"G12"	"M19"	"Spinal muscular atrophy and related syndromes"	"Other and unspecified osteoarthritis"	1	17	62	79
"G43"	"O36"	"Migraine"	"Maternal care for other fetal problems"	1	261	503	764
"C92"	"K29"	"Myeloid leukemia"	"Gastritis and duodenitis"	1	60	164	224
"M47"	"O23"	"Spondylosis"	"Infections of genitourinary tract in pregnancy"	1	0	87	87
"L97"	"I50"	"Non-pressure chronic ulcer of lower limb, NEC"	"Heart failure"	1	2666	4060	6726
"J69"	"J34"	"Pneumonitis due to solids and liquids"	"Other and unspecified disorders of nose and nasal sinuses"	1	0	54	54
"I71"	"C61"	"Aortic aneurysm and dissection"	"Malignant neoplasm of prostate"	1	545	817	1362
"K25"	"G35"	"Gastric ulcer"	"Multiple sclerosis"	1	33	121	154
"E86"	"N41"	"Volume depletion"	"Inflammatory diseases of prostate"	1	22	159	181
"I27"	"Q90"	"Other pulmonary heart diseases"	"Down syndrome"	1	9	49	58
"M65"	"O24"	"Synovitis and tenosynovitis"	"Diabetes in pregnancy, childbirth, and the puerperium"	1	147	298	445
"I69"	"M24"	"Sequelae of cerebrovascular disease"	"Other specific joint derangements"	1	147	338	485
"K43"	"O20"	"Ventral hernia"	"Hemorrhage in early pregnancy"	1	0	382	382
"K43"	"O80"	"Ventral hernia"	"Encounter for full-term uncomplicated delivery"	1	0	1029	1029
"N60"	"M22"	"Benign mammary dysplasia"	"Disorder of patella"	1	103	381	484
"K92"	"C54"	"Other diseases of digestive system"	"Malignant neoplasm of corpus uteri"	1	32	268	300
"C16"	"K58"	"Malignant neoplasm of stomach"	"Irritable bowel syndrome"	1	5	82	87
"K04"	"N20"	"Diseases of pulp and periapical tissues"	"Calculus of kidney and ureter"	1	137	255	392
"O46"	"O20"	"Antepartum hemorrhage, not elsewhere classified"	"Hemorrhage in early pregnancy"	1	1613	3998	5611
"I95"	"N21"	"Hypotension"	"Calculus of lower urinary tract"	1	27	90	117
"C79"	"L60"	"Secondary malignant neoplasm of other and unspecified sites"	"Nail disorders"	1	14	101	115
"A49"	"G44"	"Bacterial infection of unspecified site"	"Other headache syndromes"	1	92	321	413
"B59"	"I20"	"Pneumocystosis"	"Angina pectoris"	1	3	66	69
"C78"	"E05"	"Secondary malignant neoplasm of resp and digestive organs"	"Thyrotoxicosis [hyperthyroidism]"	1	98	1085	1183
"M80"	"M48"	"Osteoporosis with current pathological fracture"	"Other spondylopathies"	1	1819	2645	4464
"F34"	"K30"	"Persistent mood [affective] disorders"	"Functional dyspepsia"	1	91	243	334
"M46"	"M67"	"Other inflammatory spondylopathies"	"Other disorders of synovium and tendon"	1	49	185	234
"C79"	"G45"	"Secondary malignant neoplasm of other and unspecified sites"	"Transient cerebral ischemic attacks and related syndromes"	1	81	1098	1179
"I46"	"J34"	"Cardiac arrest"	"Other and unspecified disorders of nose and nasal sinuses"	1	0	139	139
"N17"	"I71"	"Acute kidney failure"	"Aortic aneurysm and dissection"	1	961	1257	2218
"C15"	"N45"	"Malignant neoplasm of esophagus"	"Orchitis and epididymitis"	1	1	48	49
"C34"	"M79"	"Malignant neoplasm of bronchus and lung"	"Oth and unsp soft tissue disorders, not elsewhere classified"	1	0	2628	2628
"I48"	"F10"	"Atrial fibrillation and flutter"	"Alcohol related disorders"	1	2986	5023	8009
"H33"	"N63"	"Retinal detachments and breaks"	"Unspecified lump in breast"	1	51	133	184
"M23"	"G80"	"Internal derangement of knee"	"Cerebral palsy"	1	15	83	98
"I38"	"M19"	"Endocarditis, valve unspecified"	"Other and unspecified osteoarthritis"	1	24	74	98
"D63"	"M50"	"Anemia in chronic diseases classified elsewhere"	"Cervical disc disorders"	1	0	166	166
"C78"	"E06"	"Secondary malignant neoplasm of resp and digestive organs"	"Thyroiditis"	1	16	62	78
"O08"	"J35"	"Complications following ectopic and molar pregnancy"	"Chronic diseases of tonsils and adenoids"	1	0	655	655
"J18"	"K11"	"Pneumonia, unspecified organism"	"Diseases of salivary glands"	1	543	895	1438
"K20"	"O80"	"Esophagitis"	"Encounter for full-term uncomplicated delivery"	1	7	405	412
"I69"	"M72"	"Sequelae of cerebrovascular disease"	"Fibroblastic disorders"	1	140	1189	1329
"A46"	"K51"	"Erysipelas"	"Ulcerative colitis"	1	129	379	508
"K92"	"H81"	"Other diseases of digestive system"	"Disorders of vestibular function"	1	309	1153	1462
"D50"	"J36"	"Iron deficiency anemia"	"Peritonsillar abscess"	1	4	77	81
"C78"	"C91"	"Secondary malignant neoplasm of resp and digestive organs"	"Lymphoid leukemia"	1	70	222	292
"J33"	"E84"	"Nasal polyp"	"Cystic fibrosis"	1	0	43	43
"H26"	"G35"	"Other cataract"	"Multiple sclerosis"	1	36	113	149
"B02"	"N92"	"Zoster [herpes zoster]"	"Excessive, frequent and irregular menstruation"	1	6	173	179
"J15"	"N04"	"Bacterial pneumonia, not elsewhere classified"	"Nephrotic syndrome"	1	76	171	247
"I44"	"N84"	"Atrioventricular and left bundle-branch block"	"Polyp of female genital tract"	1	28	101	129
"E78"	"I21"	"Disorders of lipoprotein metabolism and other lipidemias"	"Acute myocardial infarction"	1	30714	33289	64003
"D61"	"M72"	"Oth aplastic anemias and other bone marrow failure syndromes"	"Fibroblastic disorders"	1	4	38	42
"C17"	"I70"	"Malignant neoplasm of small intestine"	"Atherosclerosis"	1	16	62	78
"J90"	"K80"	"Pleural effusion, not elsewhere classified"	"Cholelithiasis"	1	196	899	1095
"A49"	"L28"	"Bacterial infection of unspecified site"	"Lichen simplex chronicus and prurigo"	1	47	114	161
"E68"	"O46"	"Sequelae of hyperalimentation"	"Antepartum hemorrhage, not elsewhere classified"	1	0	71	71
"H33"	"M23"	"Retinal detachments and breaks"	"Internal derangement of knee"	1	333	785	1118
"H91"	"N80"	"Other and unspecified hearing loss"	"Endometriosis"	1	35	218	253
"G91"	"H25"	"Hydrocephalus"	"Age-related cataract"	1	304	519	823
"I11"	"G35"	"Hypertensive heart disease"	"Multiple sclerosis"	1	0	29	29
"D64"	"M23"	"Other anemias"	"Internal derangement of knee"	1	0	2625	2625
"O32"	"O21"	"Maternal care for malpresentation of fetus"	"Excessive vomiting in pregnancy"	1	483	889	1372
"N82"	"O64"	"Fistulae involving female genital tract"	"Obstructed labor due to malposition and malpresent of fetus"	1	2	28	30
"C50"	"K80"	"Malignant neoplasm of breast"	"Cholelithiasis"	1	942	1497	2439
"O86"	"O46"	"Other puerperal infections"	"Antepartum hemorrhage, not elsewhere classified"	1	267	513	780
"F05"	"C90"	"Delirium due to known physiological condition"	"Multiple myeloma and malignant plasma cell neoplasms"	1	40	109	149
"I50"	"M75"	"Heart failure"	"Shoulder lesions"	1	1087	3509	4596
"I26"	"H02"	"Pulmonary embolism"	"Other disorders of eyelid"	1	223	484	707
"K56"	"K80"	"Paralytic ileus and intestinal obstruction without hernia"	"Cholelithiasis"	1	1262	2592	3854
"J69"	"M16"	"Pneumonitis due to solids and liquids"	"Osteoarthritis of hip"	1	0	452	452
"I42"	"K40"	"Cardiomyopathy"	"Inguinal hernia"	1	231	787	1018
"M47"	"H65"	"Spondylosis"	"Nonsuppurative otitis media"	1	75	214	289
"J96"	"N39"	"Respiratory failure, not elsewhere classified"	"Other disorders of urinary system"	1	4722	7708	12430
"J06"	"C50"	"Acute upper resp infections of multiple and unsp sites"	"Malignant neoplasm of breast"	1	31	213	244
"N25"	"N03"	"Disorders resulting from impaired renal tubular function"	"Chronic nephritic syndrome"	1	40	124	164
"F32"	"E05"	"Depressive episode"	"Thyrotoxicosis [hyperthyroidism]"	1	710	1252	1962
"I25"	"A63"	"Chronic ischemic heart disease"	"Oth predominantly sexually transmitted diseases, NEC"	1	30	213	243
"M08"	"H65"	"Juvenile arthritis"	"Nonsuppurative otitis media"	1	13	142	155
"K45"	"O71"	"Other abdominal hernia"	"Other obstetric trauma"	1	0	88	88
"O99"	"J35"	"Oth maternal diseases classd elsw but compl preg/chldbrth"	"Chronic diseases of tonsils and adenoids"	1	0	3529	3529
"I42"	"J34"	"Cardiomyopathy"	"Other and unspecified disorders of nose and nasal sinuses"	1	17	117	134
"I73"	"G44"	"Other peripheral vascular diseases"	"Other headache syndromes"	1	124	280	404
"D12"	"K21"	"Benign neoplasm of colon, rectum, anus and anal canal"	"Gastro-esophageal reflux disease"	1	1409	3419	4828
"D32"	"O82"	"Benign neoplasm of meninges"	"Encounter for cesarean delivery without indication"	1	0	47	47
"G94"	"M17"	"Other disorders of brain in diseases classified elsewhere"	"Osteoarthritis of knee"	1	6	77	83
"I95"	"K02"	"Hypotension"	"Dental caries"	1	73	174	247
"J94"	"H80"	"Other pleural conditions"	"Otosclerosis"	1	0	25	25
"F41"	"M10"	"Other anxiety disorders"	"Gout"	1	119	275	394
"H25"	"M75"	"Age-related cataract"	"Shoulder lesions"	1	0	10468	10468
"E70"	"I20"	"Disorders of aromatic amino-acid metabolism"	"Angina pectoris"	1	32	241	273
"E70"	"I70"	"Disorders of aromatic amino-acid metabolism"	"Atherosclerosis"	1	144	550	694
"G96"	"M23"	"Other disorders of central nervous system"	"Internal derangement of knee"	1	217	1363	1580
"I26"	"O46"	"Pulmonary embolism"	"Antepartum hemorrhage, not elsewhere classified"	1	0	29	29
"A46"	"M54"	"Erysipelas"	"Dorsalgia"	1	1351	3205	4556
"L72"	"N97"	"Follicular cysts of skin and subcutaneous tissue"	"Female infertility"	1	8	123	131
"A38"	"H66"	"Scarlet fever"	"Suppurative and unspecified otitis media"	1	80	195	275
"M85"	"C50"	"Other disorders of bone density and structure"	"Malignant neoplasm of breast"	1	0	4252	4252
"N18"	"D32"	"Chronic kidney disease (CKD)"	"Benign neoplasm of meninges"	1	37	102	139
"O62"	"F10"	"Abnormalities of forces of labor"	"Alcohol related disorders"	1	429	1852	2281
"E86"	"J32"	"Volume depletion"	"Chronic sinusitis"	1	47	363	410
"N46"	"A63"	"Male infertility"	"Oth predominantly sexually transmitted diseases, NEC"	1	71	330	401
"I48"	"O36"	"Atrial fibrillation and flutter"	"Maternal care for other fetal problems"	1	5	107	112
"D35"	"M51"	"Benign neoplasm of other and unspecified endocrine glands"	"Thoracic, thoracolum, and lumbosacral intvrt disc disorders"	1	85	389	474
"E11"	"O04"	"Type 2 diabetes mellitus"	"Complications following (induced) termination of pregnancy"	1	0	517	517
"I34"	"N84"	"Nonrheumatic mitral valve disorders"	"Polyp of female genital tract"	1	46	129	175
"J47"	"I73"	"Bronchiectasis"	"Other peripheral vascular diseases"	1	43	112	155
"K80"	"O48"	"Cholelithiasis"	"Late pregnancy"	1	0	1775	1775
"E86"	"M76"	"Volume depletion"	"Enthesopathies, lower limb, excluding foot"	1	45	550	595
"G91"	"K21"	"Hydrocephalus"	"Gastro-esophageal reflux disease"	1	71	153	224
"H52"	"Q03"	"Disorders of refraction and accommodation"	"Congenital hydrocephalus"	1	7	123	130
"D62"	"M22"	"Acute posthemorrhagic anemia"	"Disorder of patella"	1	0	78	78
"K35"	"G80"	"Acute appendicitis"	"Cerebral palsy"	1	14	60	74
"N39"	"E10"	"Other disorders of urinary system"	"Type 1 diabetes mellitus"	1	2515	5809	8324
"J18"	"E66"	"Pneumonia, unspecified organism"	"Overweight and obesity"	1	5528	8367	13895
"A49"	"N10"	"Bacterial infection of unspecified site"	"Acute pyelonephritis"	1	547	849	1396
"H52"	"O46"	"Disorders of refraction and accommodation"	"Antepartum hemorrhage, not elsewhere classified"	1	28	98	126
"J14"	"M65"	"Pneumonia due to Hemophilus influenzae"	"Synovitis and tenosynovitis"	1	10	49	59
"C71"	"D12"	"Malignant neoplasm of brain"	"Benign neoplasm of colon, rectum, anus and anal canal"	1	52	247	299
"E83"	"O42"	"Disorders of mineral metabolism"	"Premature rupture of membranes"	1	0	30	30
"E86"	"B18"	"Volume depletion"	"Chronic viral hepatitis"	1	119	375	494
"M99"	"O04"	"Biomechanical lesions, not elsewhere classified"	"Complications following (induced) termination of pregnancy"	1	0	251	251
"I21"	"H52"	"Acute myocardial infarction"	"Disorders of refraction and accommodation"	1	243	464	707
"G96"	"F17"	"Other disorders of central nervous system"	"Nicotine dependence"	1	496	821	1317
"M51"	"M23"	"Thoracic, thoracolum, and lumbosacral intvrt disc disorders"	"Internal derangement of knee"	1	4559	5941	10500
"I26"	"J32"	"Pulmonary embolism"	"Chronic sinusitis"	1	46	148	194
"K80"	"N62"	"Cholelithiasis"	"Hypertrophy of breast"	1	369	785	1154
"J93"	"N92"	"Pneumothorax and air leak"	"Excessive, frequent and irregular menstruation"	1	30	151	181
"D05"	"D27"	"Carcinoma in situ of breast"	"Benign neoplasm of ovary"	1	12	54	66
"A49"	"N03"	"Bacterial infection of unspecified site"	"Chronic nephritic syndrome"	1	12	221	233
"I38"	"N81"	"Endocarditis, valve unspecified"	"Female genital prolapse"	1	1	34	35
"I50"	"M89"	"Heart failure"	"Other disorders of bone"	1	218	575	793
"K21"	"Q53"	"Gastro-esophageal reflux disease"	"Undescended and ectopic testicle"	1	45	143	188
"A49"	"O71"	"Bacterial infection of unspecified site"	"Other obstetric trauma"	1	9	106	115
"M76"	"J30"	"Enthesopathies, lower limb, excluding foot"	"Vasomotor and allergic rhinitis"	1	166	416	582
"N81"	"M50"	"Female genital prolapse"	"Cervical disc disorders"	1	329	520	849
"K82"	"K44"	"Other diseases of gallbladder"	"Diaphragmatic hernia"	1	40	131	171
"O34"	"Q51"	"Maternal care for abnormality of pelvic organs"	"Congenital malformations of uterus and cervix"	1	261	525	786
"C79"	"C02"	"Secondary malignant neoplasm of other and unspecified sites"	"Malignant neoplasm of other and unspecified parts of tongue"	1	20	90	110
"F17"	"H10"	"Nicotine dependence"	"Conjunctivitis"	1	0	687	687
"Q51"	"M22"	"Congenital malformations of uterus and cervix"	"Disorder of patella"	1	2	46	48
"F41"	"C79"	"Other anxiety disorders"	"Secondary malignant neoplasm of other and unspecified sites"	1	628	2322	2950
"H65"	"Q41"	"Nonsuppurative otitis media"	"Congenital absence, atresia and stenosis of small intestine"	1	4	46	50
"A04"	"K86"	"Other bacterial intestinal infections"	"Other diseases of pancreas"	1	122	228	350
"C79"	"L73"	"Secondary malignant neoplasm of other and unspecified sites"	"Other follicular disorders"	1	6	70	76
"M65"	"D27"	"Synovitis and tenosynovitis"	"Benign neoplasm of ovary"	1	245	522	767
"J22"	"K42"	"Unspecified acute lower respiratory infection"	"Umbilical hernia"	1	13	92	105
"I26"	"J20"	"Pulmonary embolism"	"Acute bronchitis"	1	252	435	687
"I26"	"N43"	"Pulmonary embolism"	"Hydrocele and spermatocele"	1	37	220	257
"J81"	"M50"	"Pulmonary edema"	"Cervical disc disorders"	1	1	106	107
"D69"	"I80"	"Purpura and other hemorrhagic conditions"	"Phlebitis and thrombophlebitis"	1	303	574	877
"H40"	"N20"	"Glaucoma"	"Calculus of kidney and ureter"	1	182	317	499
"D63"	"D05"	"Anemia in chronic diseases classified elsewhere"	"Carcinoma in situ of breast"	1	9	46	55
"K57"	"H80"	"Diverticular disease of intestine"	"Otosclerosis"	1	0	346	346
"N39"	"O24"	"Other disorders of urinary system"	"Diabetes in pregnancy, childbirth, and the puerperium"	1	66	423	489
"G95"	"C77"	"Other and unspecified diseases of spinal cord"	"Secondary and unspecified malignant neoplasm of lymph nodes"	1	263	683	946
"J09"	"K35"	"Influenza due to certain identified influenza viruses"	"Acute appendicitis"	1	0	64	64
"D63"	"K05"	"Anemia in chronic diseases classified elsewhere"	"Gingivitis and periodontal diseases"	1	149	417	566
"K04"	"I35"	"Diseases of pulp and periapical tissues"	"Nonrheumatic aortic valve disorders"	1	1320	3263	4583
"M81"	"D05"	"Osteoporosis without current pathological fracture"	"Carcinoma in situ of breast"	1	79	247	326
"J91"	"H93"	"Pleural effusion in conditions classified elsewhere"	"Other disorders of ear, not elsewhere classified"	1	9	171	180
"F71"	"Q21"	"Moderate intellectual disabilities"	"Congenital malformations of cardiac septa"	1	1	46	47
"G95"	"K29"	"Other and unspecified diseases of spinal cord"	"Gastritis and duodenitis"	1	83	338	421
"N19"	"C20"	"Unspecified kidney failure"	"Malignant neoplasm of rectum"	1	145	475	620
"C34"	"K20"	"Malignant neoplasm of bronchus and lung"	"Esophagitis"	1	152	656	808
"G80"	"G91"	"Cerebral palsy"	"Hydrocephalus"	1	125	287	412
"A49"	"G60"	"Bacterial infection of unspecified site"	"Hereditary and idiopathic neuropathy"	1	18	73	91
"F01"	"G40"	"Vascular dementia"	"Epilepsy and recurrent seizures"	1	420	751	1171
"O34"	"N30"	"Maternal care for abnormality of pelvic organs"	"Cystitis"	1	472	918	1390
"H36"	"L03"	"Retinal disorders in diseases classified elsewhere"	"Cellulitis and acute lymphangitis"	1	208	446	654
"K60"	"L03"	"Fissure and fistula of anal and rectal regions"	"Cellulitis and acute lymphangitis"	1	114	231	345
"E03"	"D06"	"Other hypothyroidism"	"Carcinoma in situ of cervix uteri"	1	0	121	121
"E11"	"O10"	"Type 2 diabetes mellitus"	"Pre-existing hypertension compl preg/chldbrth"	1	42	107	149
"I20"	"O82"	"Angina pectoris"	"Encounter for cesarean delivery without indication"	1	0	364	364
"H36"	"L20"	"Retinal disorders in diseases classified elsewhere"	"Atopic dermatitis"	1	3	31	34
"J96"	"G45"	"Respiratory failure, not elsewhere classified"	"Transient cerebral ischemic attacks and related syndromes"	1	0	3571	3571
"K25"	"O42"	"Gastric ulcer"	"Premature rupture of membranes"	1	11	73	84
"D64"	"C62"	"Other anemias"	"Malignant neoplasm of testis"	1	7	157	164
"I26"	"J42"	"Pulmonary embolism"	"Unspecified chronic bronchitis"	1	664	893	1557
"C34"	"K51"	"Malignant neoplasm of bronchus and lung"	"Ulcerative colitis"	1	24	368	392
"E13"	"M23"	"Other specified diabetes mellitus"	"Internal derangement of knee"	1	28	198	226
"A49"	"K83"	"Bacterial infection of unspecified site"	"Other diseases of biliary tract"	1	404	624	1028
"C90"	"M54"	"Multiple myeloma and malignant plasma cell neoplasms"	"Dorsalgia"	1	432	613	1045
"M17"	"J32"	"Osteoarthritis of knee"	"Chronic sinusitis"	1	278	614	892
"C79"	"D75"	"Secondary malignant neoplasm of other and unspecified sites"	"Other and unsp diseases of blood and blood-forming organs"	1	26	119	145
"J96"	"D17"	"Respiratory failure, not elsewhere classified"	"Benign lipomatous neoplasm"	1	25	730	755
"C79"	"N20"	"Secondary malignant neoplasm of other and unspecified sites"	"Calculus of kidney and ureter"	1	12	725	737
"J18"	"D26"	"Pneumonia, unspecified organism"	"Other benign neoplasms of uterus"	1	6	65	71
"M41"	"Q87"	"Scoliosis"	"Oth congenital malform syndromes affecting multiple systems"	1	64	164	228
"I38"	"N92"	"Endocarditis, valve unspecified"	"Excessive, frequent and irregular menstruation"	1	0	29	29
"N92"	"E74"	"Excessive, frequent and irregular menstruation"	"Other disorders of carbohydrate metabolism"	1	1	25	26
"K65"	"M65"	"Peritonitis"	"Synovitis and tenosynovitis"	1	98	197	295
"I31"	"K40"	"Other diseases of pericardium"	"Inguinal hernia"	1	56	171	227
"N92"	"O66"	"Excessive, frequent and irregular menstruation"	"Other obstructed labor"	1	0	835	835
"K29"	"O03"	"Gastritis and duodenitis"	"Spontaneous abortion"	1	172	599	771
"C44"	"M65"	"Other and unspecified malignant neoplasm of skin"	"Synovitis and tenosynovitis"	1	191	831	1022
"I27"	"K40"	"Other pulmonary heart diseases"	"Inguinal hernia"	1	99	571	670
"F32"	"D17"	"Depressive episode"	"Benign lipomatous neoplasm"	1	199	364	563
"C04"	"M51"	"Malignant neoplasm of floor of mouth"	"Thoracic, thoracolum, and lumbosacral intvrt disc disorders"	1	2	35	37
"I26"	"M62"	"Pulmonary embolism"	"Other disorders of muscle"	1	389	1428	1817
"E86"	"D86"	"Volume depletion"	"Sarcoidosis"	1	78	268	346
"M21"	"Q53"	"Other acquired deformities of limbs"	"Undescended and ectopic testicle"	1	20	195	215
"L57"	"O80"	"Skin changes due to chronic expsr to nonionizing radiation"	"Encounter for full-term uncomplicated delivery"	1	0	242	242
"N18"	"J35"	"Chronic kidney disease (CKD)"	"Chronic diseases of tonsils and adenoids"	1	11	118	129
"L08"	"B34"	"Other local infections of skin and subcutaneous tissue"	"Viral infection of unspecified site"	1	659	1245	1904
"K59"	"Q25"	"Other functional intestinal disorders"	"Congenital malformations of great arteries"	1	119	588	707
"K72"	"H90"	"Hepatic failure, not elsewhere classified"	"Conductive and sensorineural hearing loss"	1	15	120	135
"I20"	"H27"	"Angina pectoris"	"Other disorders of lens"	1	182	375	557
"L97"	"K21"	"Non-pressure chronic ulcer of lower limb, NEC"	"Gastro-esophageal reflux disease"	1	151	643	794
"O32"	"N70"	"Maternal care for malpresentation of fetus"	"Salpingitis and oophoritis"	1	126	318	444
"I46"	"D23"	"Cardiac arrest"	"Other benign neoplasms of skin"	1	0	285	285
"L97"	"H50"	"Non-pressure chronic ulcer of lower limb, NEC"	"Other strabismus"	1	11	73	84
"Q66"	"J00"	"Congenital deformities of feet"	"Acute nasopharyngitis [common cold]"	1	114	312	426
"I70"	"G43"	"Atherosclerosis"	"Migraine"	1	64	256	320
"I25"	"M54"	"Chronic ischemic heart disease"	"Dorsalgia"	1	5956	7248	13204
"G56"	"J34"	"Mononeuropathies of upper limb"	"Other and unspecified disorders of nose and nasal sinuses"	1	274	758	1032
"K57"	"N63"	"Diverticular disease of intestine"	"Unspecified lump in breast"	1	56	781	837
"M72"	"A63"	"Fibroblastic disorders"	"Oth predominantly sexually transmitted diseases, NEC"	1	24	108	132
"J96"	"D48"	"Respiratory failure, not elsewhere classified"	"Neoplasm of uncertain behavior of other and unsp sites"	1	39	216	255
"B34"	"K40"	"Viral infection of unspecified site"	"Inguinal hernia"	1	792	1012	1804
"L71"	"O62"	"Rosacea"	"Abnormalities of forces of labor"	1	0	243	243
"D47"	"K40"	"Oth neoplm of uncrt behav of lymphoid, hematpoetc & rel tiss"	"Inguinal hernia"	1	32	469	501
"K25"	"O23"	"Gastric ulcer"	"Infections of genitourinary tract in pregnancy"	1	11	62	73
"E87"	"G51"	"Other disorders of fluid, electrolyte and acid-base balance"	"Facial nerve disorders"	1	64	301	365
"I69"	"H04"	"Sequelae of cerebrovascular disease"	"Disorders of lacrimal system"	1	91	228	319
"K44"	"Q53"	"Diaphragmatic hernia"	"Undescended and ectopic testicle"	1	4	49	53
"H52"	"M02"	"Disorders of refraction and accommodation"	"Postinfective and reactive arthropathies"	1	62	208	270
"O72"	"I78"	"Postpartum hemorrhage"	"Diseases of capillaries"	1	99	217	316
"M19"	"N70"	"Other and unspecified osteoarthritis"	"Salpingitis and oophoritis"	1	0	176	176
"J91"	"H35"	"Pleural effusion in conditions classified elsewhere"	"Other retinal disorders"	1	102	420	522
"C20"	"H80"	"Malignant neoplasm of rectum"	"Otosclerosis"	1	3	90	93
"I20"	"M67"	"Angina pectoris"	"Other disorders of synovium and tendon"	1	880	1209	2089
"K21"	"O34"	"Gastro-esophageal reflux disease"	"Maternal care for abnormality of pelvic organs"	1	85	231	316
"K63"	"L02"	"Other diseases of intestine"	"Cutaneous abscess, furuncle and carbuncle"	1	258	669	927
"D47"	"G62"	"Oth neoplm of uncrt behav of lymphoid, hematpoetc & rel tiss"	"Other and unspecified polyneuropathies"	1	192	414	606
"O72"	"H60"	"Postpartum hemorrhage"	"Otitis externa"	1	143	385	528
"B96"	"I20"	"Oth bacterial agents as the cause of diseases classd elswhr"	"Angina pectoris"	1	14	419	433
"C78"	"K74"	"Secondary malignant neoplasm of resp and digestive organs"	"Fibrosis and cirrhosis of liver"	1	155	291	446
"K66"	"O80"	"Other disorders of peritoneum"	"Encounter for full-term uncomplicated delivery"	1	33	195	228
"L27"	"H91"	"Dermatitis due to substances taken internally"	"Other and unspecified hearing loss"	1	143	251	394
"G57"	"K35"	"Mononeuropathies of lower limb"	"Acute appendicitis"	1	52	194	246
"O82"	"J36"	"Encounter for cesarean delivery without indication"	"Peritonsillar abscess"	1	139	306	445
"N19"	"D12"	"Unspecified kidney failure"	"Benign neoplasm of colon, rectum, anus and anal canal"	1	438	1008	1446
"D64"	"O99"	"Other anemias"	"Oth maternal diseases classd elsw but compl preg/chldbrth"	1	298	1019	1317
"C18"	"N84"	"Malignant neoplasm of colon"	"Polyp of female genital tract"	1	97	301	398
"I26"	"K60"	"Pulmonary embolism"	"Fissure and fistula of anal and rectal regions"	1	54	201	255
"A04"	"G40"	"Other bacterial intestinal infections"	"Epilepsy and recurrent seizures"	1	172	585	757
"C83"	"M79"	"Non-follicular lymphoma"	"Oth and unsp soft tissue disorders, not elsewhere classified"	1	134	321	455
"O02"	"N97"	"Other abnormal products of conception"	"Female infertility"	1	5199	5737	10936
"K14"	"F10"	"Diseases of tongue"	"Alcohol related disorders"	1	57	133	190
"C25"	"M75"	"Malignant neoplasm of pancreas"	"Shoulder lesions"	1	0	474	474
"I35"	"H35"	"Nonrheumatic aortic valve disorders"	"Other retinal disorders"	1	1336	3245	4581
"M80"	"H71"	"Osteoporosis with current pathological fracture"	"Cholesteatoma of middle ear"	1	0	39	39
"J96"	"D32"	"Respiratory failure, not elsewhere classified"	"Benign neoplasm of meninges"	1	46	287	333
"N28"	"E16"	"Oth disorders of kidney and ureter, not elsewhere classified"	"Other disorders of pancreatic internal secretion"	1	114	299	413
"N47"	"J03"	"Disorders of prepuce"	"Acute tonsillitis"	1	455	632	1087
"D17"	"H66"	"Benign lipomatous neoplasm"	"Suppurative and unspecified otitis media"	1	26	154	180
"K25"	"M20"	"Gastric ulcer"	"Acquired deformities of fingers and toes"	1	373	572	945
"K72"	"G44"	"Hepatic failure, not elsewhere classified"	"Other headache syndromes"	1	9	49	58
"A41"	"E11"	"Other sepsis"	"Type 2 diabetes mellitus"	1	0	18671	18671
"K63"	"D12"	"Other diseases of intestine"	"Benign neoplasm of colon, rectum, anus and anal canal"	1	1156	1957	3113
"N17"	"K20"	"Acute kidney failure"	"Esophagitis"	1	144	462	606
"N18"	"F10"	"Chronic kidney disease (CKD)"	"Alcohol related disorders"	1	0	2272	2272
"K51"	"B27"	"Ulcerative colitis"	"Infectious mononucleosis"	1	19	68	87
"A49"	"C61"	"Bacterial infection of unspecified site"	"Malignant neoplasm of prostate"	1	325	1254	1579
"C12"	"F10"	"Malignant neoplasm of pyriform sinus"	"Alcohol related disorders"	1	0	45	45
"K72"	"K52"	"Hepatic failure, not elsewhere classified"	"Other and unsp noninfective gastroenteritis and colitis"	1	163	303	466
"I73"	"K58"	"Other peripheral vascular diseases"	"Irritable bowel syndrome"	1	128	551	679
"G96"	"D17"	"Other disorders of central nervous system"	"Benign lipomatous neoplasm"	1	61	323	384
"M48"	"C50"	"Other spondylopathies"	"Malignant neoplasm of breast"	1	440	1085	1525
"A46"	"K60"	"Erysipelas"	"Fissure and fistula of anal and rectal regions"	1	137	348	485
"M79"	"K60"	"Oth and unsp soft tissue disorders, not elsewhere classified"	"Fissure and fistula of anal and rectal regions"	1	853	1090	1943
"H91"	"K60"	"Other and unspecified hearing loss"	"Fissure and fistula of anal and rectal regions"	1	425	751	1176
"H90"	"M65"	"Conductive and sensorineural hearing loss"	"Synovitis and tenosynovitis"	1	527	739	1266
"A46"	"D23"	"Erysipelas"	"Other benign neoplasms of skin"	1	217	468	685
"J98"	"J00"	"Other respiratory disorders"	"Acute nasopharyngitis [common cold]"	1	186	366	552
"H16"	"F10"	"Keratitis"	"Alcohol related disorders"	1	204	515	719
"N39"	"M54"	"Other disorders of urinary system"	"Dorsalgia"	1	0	15109	15109
"J15"	"G72"	"Bacterial pneumonia, not elsewhere classified"	"Other and unspecified myopathies"	1	72	147	219
"K62"	"N47"	"Other diseases of anus and rectum"	"Disorders of prepuce"	1	298	450	748
"I87"	"N20"	"Other disorders of veins"	"Calculus of kidney and ureter"	1	43	111	154
"C34"	"G56"	"Malignant neoplasm of bronchus and lung"	"Mononeuropathies of upper limb"	1	0	1421	1421
"I85"	"M17"	"Esophageal varices"	"Osteoarthritis of knee"	1	70	244	314
"H16"	"O04"	"Keratitis"	"Complications following (induced) termination of pregnancy"	1	41	459	500
"I70"	"K21"	"Atherosclerosis"	"Gastro-esophageal reflux disease"	1	933	1212	2145
"D64"	"N47"	"Other anemias"	"Disorders of prepuce"	1	326	731	1057
"C16"	"D30"	"Malignant neoplasm of stomach"	"Benign neoplasm of urinary organs"	1	16	113	129
"D65"	"E78"	"Disseminated intravascular coagulation"	"Disorders of lipoprotein metabolism and other lipidemias"	1	23	95	118
"J44"	"N21"	"Other chronic obstructive pulmonary disease"	"Calculus of lower urinary tract"	1	225	379	604
"D50"	"D64"	"Iron deficiency anemia"	"Other anemias"	1	9839	10710	20549
"A41"	"H71"	"Other sepsis"	"Cholesteatoma of middle ear"	1	0	120	120
"O72"	"I47"	"Postpartum hemorrhage"	"Paroxysmal tachycardia"	1	318	952	1270
"H57"	"N47"	"Other disorders of eye and adnexa"	"Disorders of prepuce"	1	46	181	227
"N47"	"N40"	"Disorders of prepuce"	"Benign prostatic hyperplasia"	1	1048	1565	2613
"I63"	"O90"	"Cerebral infarction"	"Complications of the puerperium, not elsewhere classified"	1	0	25	25
"C20"	"H65"	"Malignant neoplasm of rectum"	"Nonsuppurative otitis media"	1	10	67	77
"J13"	"M50"	"Pneumonia due to Streptococcus pneumoniae"	"Cervical disc disorders"	1	18	64	82
"H83"	"O80"	"Other diseases of inner ear"	"Encounter for full-term uncomplicated delivery"	1	5	134	139
"G62"	"N94"	"Other and unspecified polyneuropathies"	"Pain and oth cond assoc w fem gntl org and menstrual cycle"	1	6	124	130
"F41"	"I34"	"Other anxiety disorders"	"Nonrheumatic mitral valve disorders"	1	107	200	307
"E41"	"G45"	"Nutritional marasmus"	"Transient cerebral ischemic attacks and related syndromes"	1	0	149	149
"J16"	"G40"	"Pneumonia due to oth infectious organisms, NEC"	"Epilepsy and recurrent seizures"	1	46	132	178
"M24"	"O04"	"Other specific joint derangements"	"Complications following (induced) termination of pregnancy"	1	165	654	819
"F32"	"K44"	"Depressive episode"	"Diaphragmatic hernia"	1	729	1460	2189
"D50"	"N43"	"Iron deficiency anemia"	"Hydrocele and spermatocele"	1	22	246	268
"C79"	"K50"	"Secondary malignant neoplasm of other and unspecified sites"	"Crohn's disease [regional enteritis]"	1	15	115	130
"A09"	"I20"	"Infectious gastroenteritis and colitis, unspecified"	"Angina pectoris"	1	1702	4268	5970
"G44"	"Q21"	"Other headache syndromes"	"Congenital malformations of cardiac septa"	1	1	61	62
"O00"	"O20"	"Ectopic pregnancy"	"Hemorrhage in early pregnancy"	1	1917	2585	4502
"I26"	"J44"	"Pulmonary embolism"	"Other chronic obstructive pulmonary disease"	1	3860	4456	8316
"E64"	"I21"	"Sequelae of malnutrition and other nutritional deficiencies"	"Acute myocardial infarction"	1	173	655	828
"M20"	"M32"	"Acquired deformities of fingers and toes"	"Systemic lupus erythematosus (SLE)"	1	22	83	105
"M32"	"O80"	"Systemic lupus erythematosus (SLE)"	"Encounter for full-term uncomplicated delivery"	1	20	182	202
"D63"	"J30"	"Anemia in chronic diseases classified elsewhere"	"Vasomotor and allergic rhinitis"	1	0	53	53
"L30"	"O80"	"Other and unspecified dermatitis"	"Encounter for full-term uncomplicated delivery"	1	111	1332	1443
"I10"	"L04"	"Essential (primary) hypertension"	"Acute lymphadenitis"	1	90	382	472
"J44"	"O23"	"Other chronic obstructive pulmonary disease"	"Infections of genitourinary tract in pregnancy"	1	0	58	58
"I89"	"H81"	"Oth noninfective disorders of lymphatic vessels and nodes"	"Disorders of vestibular function"	1	33	92	125
"I50"	"N21"	"Heart failure"	"Calculus of lower urinary tract"	1	203	543	746
"G30"	"I25"	"Alzheimer's disease"	"Chronic ischemic heart disease"	1	0	1615	1615
"K45"	"N97"	"Other abdominal hernia"	"Female infertility"	1	0	91	91
"J44"	"N60"	"Other chronic obstructive pulmonary disease"	"Benign mammary dysplasia"	1	63	786	849
"L82"	"D36"	"Seborrheic keratosis"	"Benign neoplasm of other and unspecified sites"	1	9	74	83
"N10"	"Q05"	"Acute pyelonephritis"	"Spina bifida"	1	14	98	112
"L02"	"N92"	"Cutaneous abscess, furuncle and carbuncle"	"Excessive, frequent and irregular menstruation"	1	1060	1325	2385
"K66"	"J35"	"Other disorders of peritoneum"	"Chronic diseases of tonsils and adenoids"	1	9	51	60
"M54"	"H83"	"Dorsalgia"	"Other diseases of inner ear"	1	926	1500	2426
"L90"	"D25"	"Atrophic disorders of skin"	"Leiomyoma of uterus"	1	265	753	1018
"K72"	"N43"	"Hepatic failure, not elsewhere classified"	"Hydrocele and spermatocele"	1	8	61	69
"N92"	"O10"	"Excessive, frequent and irregular menstruation"	"Pre-existing hypertension compl preg/chldbrth"	1	16	347	363
"K37"	"O04"	"Unspecified appendicitis"	"Complications following (induced) termination of pregnancy"	1	32	200	232
"K64"	"L50"	"Hemorrhoids and perianal venous thrombosis"	"Urticaria"	1	11	319	330
"J84"	"K80"	"Other interstitial pulmonary diseases"	"Cholelithiasis"	1	160	485	645
"K02"	"H10"	"Dental caries"	"Conjunctivitis"	1	57	199	256
"L97"	"M23"	"Non-pressure chronic ulcer of lower limb, NEC"	"Internal derangement of knee"	1	41	578	619
"I44"	"K40"	"Atrioventricular and left bundle-branch block"	"Inguinal hernia"	1	282	1462	1744
"I26"	"M76"	"Pulmonary embolism"	"Enthesopathies, lower limb, excluding foot"	1	88	276	364
"I60"	"O48"	"Nontraumatic subarachnoid hemorrhage"	"Late pregnancy"	1	0	30	30
"I15"	"H80"	"Secondary hypertension"	"Otosclerosis"	1	0	50	50
"M75"	"L68"	"Shoulder lesions"	"Hypertrichosis"	1	33	443	476
"D68"	"N62"	"Other coagulation defects"	"Hypertrophy of breast"	1	43	138	181
"I95"	"J42"	"Hypotension"	"Unspecified chronic bronchitis"	1	210	538	748
"D61"	"E66"	"Oth aplastic anemias and other bone marrow failure syndromes"	"Overweight and obesity"	1	45	136	181
"I35"	"N80"	"Nonrheumatic aortic valve disorders"	"Endometriosis"	1	1	70	71
"J10"	"N19"	"Influenza due to other identified influenza virus"	"Unspecified kidney failure"	1	42	107	149
"L98"	"L40"	"Oth disorders of skin, subcu, not elsewhere classified"	"Psoriasis"	1	231	394	625
"J06"	"B34"	"Acute upper resp infections of multiple and unsp sites"	"Viral infection of unspecified site"	1	4626	6141	10767
"K20"	"O64"	"Esophagitis"	"Obstructed labor due to malposition and malpresent of fetus"	1	3	35	38
"I35"	"K25"	"Nonrheumatic aortic valve disorders"	"Gastric ulcer"	1	1087	1502	2589
"F60"	"M23"	"Specific personality disorders"	"Internal derangement of knee"	1	86	232	318
"E13"	"C25"	"Other specified diabetes mellitus"	"Malignant neoplasm of pancreas"	1	137	414	551
"L90"	"D18"	"Atrophic disorders of skin"	"Hemangioma and lymphangioma, any site"	1	75	156	231
"J18"	"H49"	"Pneumonia, unspecified organism"	"Paralytic strabismus"	1	265	521	786
"A46"	"G82"	"Erysipelas"	"Paraplegia (paraparesis) and quadriplegia (quadriparesis)"	1	124	289	413
"M51"	"O60"	"Thoracic, thoracolum, and lumbosacral intvrt disc disorders"	"Preterm labor"	1	0	186	186
"F02"	"H35"	"Dementia in other diseases classified elsewhere"	"Other retinal disorders"	1	23	190	213
"N61"	"O03"	"Inflammatory disorders of breast"	"Spontaneous abortion"	1	8	306	314
"Q66"	"Q21"	"Congenital deformities of feet"	"Congenital malformations of cardiac septa"	1	136	258	394
"M80"	"L40"	"Osteoporosis with current pathological fracture"	"Psoriasis"	1	71	361	432
"M86"	"H36"	"Osteomyelitis"	"Retinal disorders in diseases classified elsewhere"	1	180	292	472
"N39"	"M67"	"Other disorders of urinary system"	"Other disorders of synovium and tendon"	1	578	1444	2022
"O66"	"O03"	"Other obstructed labor"	"Spontaneous abortion"	1	678	1513	2191
"M24"	"Q53"	"Other specific joint derangements"	"Undescended and ectopic testicle"	1	5	93	98
"J98"	"Q39"	"Other respiratory disorders"	"Congenital malformations of esophagus"	1	21	70	91
"G35"	"O65"	"Multiple sclerosis"	"Obstructed labor due to maternal pelvic abnormality"	1	0	97	97
"C83"	"M47"	"Non-follicular lymphoma"	"Spondylosis"	1	45	152	197
"L98"	"D17"	"Oth disorders of skin, subcu, not elsewhere classified"	"Benign lipomatous neoplasm"	1	182	298	480
"M48"	"O24"	"Other spondylopathies"	"Diabetes in pregnancy, childbirth, and the puerperium"	1	0	38	38
"A41"	"I49"	"Other sepsis"	"Other cardiac arrhythmias"	1	1194	3055	4249
"C16"	"H35"	"Malignant neoplasm of stomach"	"Other retinal disorders"	1	79	323	402
"J13"	"H81"	"Pneumonia due to Streptococcus pneumoniae"	"Disorders of vestibular function"	1	36	104	140
"C34"	"I10"	"Malignant neoplasm of bronchus and lung"	"Essential (primary) hypertension"	1	0	13585	13585
"E87"	"O82"	"Other disorders of fluid, electrolyte and acid-base balance"	"Encounter for cesarean delivery without indication"	1	0	189	189
"D80"	"J44"	"Immunodeficiency with predominantly antibody defects"	"Other chronic obstructive pulmonary disease"	1	102	217	319
"A41"	"N90"	"Other sepsis"	"Other noninflammatory disorders of vulva and perineum"	1	32	122	154
"M81"	"C61"	"Osteoporosis without current pathological fracture"	"Malignant neoplasm of prostate"	1	374	809	1183
"H49"	"N92"	"Paralytic strabismus"	"Excessive, frequent and irregular menstruation"	1	25	98	123
"C34"	"M83"	"Malignant neoplasm of bronchus and lung"	"Adult osteomalacia"	1	2	48	50
"N45"	"J45"	"Orchitis and epididymitis"	"Asthma"	1	180	484	664
"J96"	"H94"	"Respiratory failure, not elsewhere classified"	"Other disorders of ear in diseases classified elsewhere"	1	0	60	60
"J33"	"O04"	"Nasal polyp"	"Complications following (induced) termination of pregnancy"	1	4	122	126
"F05"	"C44"	"Delirium due to known physiological condition"	"Other and unspecified malignant neoplasm of skin"	1	122	880	1002
"L98"	"H36"	"Oth disorders of skin, subcu, not elsewhere classified"	"Retinal disorders in diseases classified elsewhere"	1	327	593	920
"I81"	"M51"	"Portal vein thrombosis"	"Thoracic, thoracolum, and lumbosacral intvrt disc disorders"	1	0	49	49
"L90"	"J20"	"Atrophic disorders of skin"	"Acute bronchitis"	1	0	200	200
"F10"	"M41"	"Alcohol related disorders"	"Scoliosis"	1	178	365	543
"M46"	"M72"	"Other inflammatory spondylopathies"	"Fibroblastic disorders"	1	43	106	149
"F33"	"J36"	"Major depressive disorder, recurrent"	"Peritonsillar abscess"	1	1	95	96
"D63"	"I44"	"Anemia in chronic diseases classified elsewhere"	"Atrioventricular and left bundle-branch block"	1	172	448	620
"E86"	"E66"	"Volume depletion"	"Overweight and obesity"	1	0	5171	5171
"G47"	"M90"	"Sleep disorders"	"Osteopathies in diseases classified elsewhere"	1	19	83	102
"D46"	"I80"	"Myelodysplastic syndromes"	"Phlebitis and thrombophlebitis"	1	43	157	200
"C77"	"M13"	"Secondary and unspecified malignant neoplasm of lymph nodes"	"Other arthritis"	1	55	143	198
"G96"	"O00"	"Other disorders of central nervous system"	"Ectopic pregnancy"	1	0	54	54
"I33"	"H91"	"Acute and subacute endocarditis"	"Other and unspecified hearing loss"	1	98	421	519
"M80"	"I47"	"Osteoporosis with current pathological fracture"	"Paroxysmal tachycardia"	1	307	1187	1494
"G30"	"F03"	"Alzheimer's disease"	"Unspecified dementia"	1	2029	3499	5528
"I48"	"Q54"	"Atrial fibrillation and flutter"	"Hypospadias"	1	6	144	150
"C20"	"M17"	"Malignant neoplasm of rectum"	"Osteoarthritis of knee"	1	236	811	1047
"J84"	"C20"	"Other interstitial pulmonary diseases"	"Malignant neoplasm of rectum"	1	60	137	197
"I50"	"L02"	"Heart failure"	"Cutaneous abscess, furuncle and carbuncle"	1	1416	2692	4108
"C71"	"M71"	"Malignant neoplasm of brain"	"Other bursopathies"	1	4	35	39
"N13"	"M79"	"Obstructive and reflux uropathy"	"Oth and unsp soft tissue disorders, not elsewhere classified"	1	565	907	1472
"C49"	"J35"	"Malignant neoplasm of other connective and soft tissue"	"Chronic diseases of tonsils and adenoids"	1	1	33	34
"D50"	"K40"	"Iron deficiency anemia"	"Inguinal hernia"	1	212	1396	1608
"I63"	"L72"	"Cerebral infarction"	"Follicular cysts of skin and subcutaneous tissue"	1	79	237	316
"C34"	"L84"	"Malignant neoplasm of bronchus and lung"	"Corns and callosities"	1	0	34	34
"F51"	"K40"	"Sleep disorders not due to a substance or known physiol cond"	"Inguinal hernia"	1	14	72	86
"Q61"	"D25"	"Cystic kidney disease"	"Leiomyoma of uterus"	1	9	130	139
"N18"	"J42"	"Chronic kidney disease (CKD)"	"Unspecified chronic bronchitis"	1	403	1221	1624
"D64"	"O86"	"Other anemias"	"Other puerperal infections"	1	11	96	107
"G35"	"O63"	"Multiple sclerosis"	"Long labor"	1	5	73	78
"M17"	"D23"	"Osteoarthritis of knee"	"Other benign neoplasms of skin"	1	844	1110	1954
"C15"	"K80"	"Malignant neoplasm of esophagus"	"Cholelithiasis"	1	27	212	239
"I50"	"N99"	"Heart failure"	"Intraop and postproc comp and disorders of GU sys, NEC"	1	431	786	1217
"F41"	"M76"	"Other anxiety disorders"	"Enthesopathies, lower limb, excluding foot"	1	80	214	294
"H91"	"O34"	"Other and unspecified hearing loss"	"Maternal care for abnormality of pelvic organs"	1	30	122	152
"I48"	"D10"	"Atrial fibrillation and flutter"	"Benign neoplasm of mouth and pharynx"	1	271	428	699
"N18"	"L72"	"Chronic kidney disease (CKD)"	"Follicular cysts of skin and subcutaneous tissue"	1	31	134	165
"K05"	"M67"	"Gingivitis and periodontal diseases"	"Other disorders of synovium and tendon"	1	79	169	248
"D50"	"O71"	"Iron deficiency anemia"	"Other obstetric trauma"	1	0	150	150
"K62"	"O71"	"Other diseases of anus and rectum"	"Other obstetric trauma"	1	0	305	305
"M79"	"N44"	"Oth and unsp soft tissue disorders, not elsewhere classified"	"Noninflammatory disorders of testis"	1	91	208	299
"M67"	"O04"	"Other disorders of synovium and tendon"	"Complications following (induced) termination of pregnancy"	1	342	2114	2456
"J06"	"O48"	"Acute upper resp infections of multiple and unsp sites"	"Late pregnancy"	1	0	68	68
"E11"	"K00"	"Type 2 diabetes mellitus"	"Disorders of tooth development and eruption"	1	7	60	67
"N83"	"Q17"	"Noninflammatory disord of ovary, fallop and broad ligament"	"Other congenital malformations of ear"	1	0	79	79
"F33"	"F99"	"Major depressive disorder, recurrent"	"Mental disorder, not otherwise specified"	1	157	285	442
"G56"	"D24"	"Mononeuropathies of upper limb"	"Benign neoplasm of breast"	1	205	798	1003
"J91"	"K61"	"Pleural effusion in conditions classified elsewhere"	"Abscess of anal and rectal regions"	1	10	63	73
"K02"	"M17"	"Dental caries"	"Osteoarthritis of knee"	1	174	330	504
"A41"	"H25"	"Other sepsis"	"Age-related cataract"	1	0	18296	18296
"I69"	"G45"	"Sequelae of cerebrovascular disease"	"Transient cerebral ischemic attacks and related syndromes"	1	0	23711	23711
"E87"	"G71"	"Other disorders of fluid, electrolyte and acid-base balance"	"Primary disorders of muscles"	1	10	56	66
"K29"	"O80"	"Gastritis and duodenitis"	"Encounter for full-term uncomplicated delivery"	1	467	2166	2633
"G47"	"O90"	"Sleep disorders"	"Complications of the puerperium, not elsewhere classified"	1	12	84	96
"M05"	"N70"	"Rheumatoid arthritis with rheumatoid factor"	"Salpingitis and oophoritis"	1	0	67	67
"G91"	"M77"	"Hydrocephalus"	"Other enthesopathies"	1	9	59	68
"N93"	"H10"	"Other abnormal uterine and vaginal bleeding"	"Conjunctivitis"	1	35	183	218
"M16"	"N95"	"Osteoarthritis of hip"	"Menopausal and other perimenopausal disorders"	1	682	1211	1893
"H92"	"H65"	"Otalgia and effusion of ear"	"Nonsuppurative otitis media"	1	149	426	575
"C25"	"N84"	"Malignant neoplasm of pancreas"	"Polyp of female genital tract"	1	0	94	94
"G30"	"G56"	"Alzheimer's disease"	"Mononeuropathies of upper limb"	1	0	281	281
"O34"	"M22"	"Maternal care for abnormality of pelvic organs"	"Disorder of patella"	1	0	423	423
"C61"	"E04"	"Malignant neoplasm of prostate"	"Other nontoxic goiter"	1	99	196	295
"N13"	"N81"	"Obstructive and reflux uropathy"	"Female genital prolapse"	1	161	504	665
"I46"	"N97"	"Cardiac arrest"	"Female infertility"	1	0	30	30
"M10"	"M51"	"Gout"	"Thoracic, thoracolum, and lumbosacral intvrt disc disorders"	1	353	1197	1550
"K44"	"H27"	"Diaphragmatic hernia"	"Other disorders of lens"	1	30	85	115
"O92"	"J45"	"Oth disord of brst/lactatn assoc w pregnancy and the puerp"	"Asthma"	1	81	431	512
"M47"	"H66"	"Spondylosis"	"Suppurative and unspecified otitis media"	1	37	192	229
"D61"	"N81"	"Oth aplastic anemias and other bone marrow failure syndromes"	"Female genital prolapse"	1	5	62	67
"O28"	"L05"	"Abnormal findings on antenatal screening of mother"	"Pilonidal cyst and sinus"	1	6	48	54
"M05"	"D06"	"Rheumatoid arthritis with rheumatoid factor"	"Carcinoma in situ of cervix uteri"	1	0	31	31
"I38"	"K05"	"Endocarditis, valve unspecified"	"Gingivitis and periodontal diseases"	1	40	211	251
"E87"	"D36"	"Other disorders of fluid, electrolyte and acid-base balance"	"Benign neoplasm of other and unspecified sites"	1	3	64	67
"K21"	"D16"	"Gastro-esophageal reflux disease"	"Benign neoplasm of bone and articular cartilage"	1	77	166	243
"C32"	"F10"	"Malignant neoplasm of larynx"	"Alcohol related disorders"	1	75	435	510
"H02"	"N85"	"Other disorders of eyelid"	"Other noninflammatory disorders of uterus, except cervix"	1	15	68	83
"E78"	"D25"	"Disorders of lipoprotein metabolism and other lipidemias"	"Leiomyoma of uterus"	1	0	2088	2088
"M75"	"M62"	"Shoulder lesions"	"Other disorders of muscle"	1	3576	7457	11033
"O90"	"L05"	"Complications of the puerperium, not elsewhere classified"	"Pilonidal cyst and sinus"	1	0	79	79
"C34"	"K45"	"Malignant neoplasm of bronchus and lung"	"Other abdominal hernia"	1	15	124	139
"M48"	"H11"	"Other spondylopathies"	"Other disorders of conjunctiva"	1	103	230	333
"D35"	"O48"	"Benign neoplasm of other and unspecified endocrine glands"	"Late pregnancy"	1	0	30	30
"M19"	"K35"	"Other and unspecified osteoarthritis"	"Acute appendicitis"	1	224	939	1163
"E87"	"C09"	"Other disorders of fluid, electrolyte and acid-base balance"	"Malignant neoplasm of tonsil"	1	51	158	209
"M54"	"K01"	"Dorsalgia"	"Embedded and impacted teeth"	1	181	391	572
"M75"	"D24"	"Shoulder lesions"	"Benign neoplasm of breast"	1	305	1467	1772
"I10"	"O85"	"Essential (primary) hypertension"	"Puerperal sepsis"	1	0	68	68
"K83"	"M71"	"Other diseases of biliary tract"	"Other bursopathies"	1	17	84	101
"E03"	"K21"	"Other hypothyroidism"	"Gastro-esophageal reflux disease"	1	700	1137	1837
"O02"	"B27"	"Other abnormal products of conception"	"Infectious mononucleosis"	1	0	132	132
"J91"	"H91"	"Pleural effusion in conditions classified elsewhere"	"Other and unspecified hearing loss"	1	71	960	1031
"O82"	"A56"	"Encounter for cesarean delivery without indication"	"Other sexually transmitted chlamydial diseases"	1	16	222	238
"H02"	"O82"	"Other disorders of eyelid"	"Encounter for cesarean delivery without indication"	1	5	392	397
"F03"	"J84"	"Unspecified dementia"	"Other interstitial pulmonary diseases"	1	152	280	432
"C77"	"H83"	"Secondary and unspecified malignant neoplasm of lymph nodes"	"Other diseases of inner ear"	1	13	355	368
"L98"	"O70"	"Oth disorders of skin, subcu, not elsewhere classified"	"Perineal laceration during delivery"	1	101	445	546
"J44"	"O92"	"Other chronic obstructive pulmonary disease"	"Oth disord of brst/lactatn assoc w pregnancy and the puerp"	1	2	35	37
"F41"	"N13"	"Other anxiety disorders"	"Obstructive and reflux uropathy"	1	182	742	924
"M02"	"O20"	"Postinfective and reactive arthropathies"	"Hemorrhage in early pregnancy"	1	55	126	181
"O41"	"J36"	"Other disorders of amniotic fluid and membranes"	"Peritonsillar abscess"	1	6	41	47
"K62"	"M54"	"Other diseases of anus and rectum"	"Dorsalgia"	1	2418	4271	6689
"H25"	"D27"	"Age-related cataract"	"Benign neoplasm of ovary"	1	271	1301	1572
"C09"	"K86"	"Malignant neoplasm of tonsil"	"Other diseases of pancreas"	1	3	39	42
"E85"	"M51"	"Amyloidosis"	"Thoracic, thoracolum, and lumbosacral intvrt disc disorders"	1	4	43	47
"H54"	"K21"	"Blindness and low vision"	"Gastro-esophageal reflux disease"	1	142	304	446
"O82"	"M93"	"Encounter for cesarean delivery without indication"	"Other osteochondropathies"	1	26	110	136
"I42"	"H52"	"Cardiomyopathy"	"Disorders of refraction and accommodation"	1	53	135	188
"M46"	"H83"	"Other inflammatory spondylopathies"	"Other diseases of inner ear"	1	11	67	78
"M81"	"D37"	"Osteoporosis without current pathological fracture"	"Neoplasm of uncrt behavior of oral cavity and dgstv organs"	1	36	132	168
"C18"	"D37"	"Malignant neoplasm of colon"	"Neoplasm of uncrt behavior of oral cavity and dgstv organs"	1	650	964	1614
"G57"	"J30"	"Mononeuropathies of lower limb"	"Vasomotor and allergic rhinitis"	1	24	93	117
"L40"	"N94"	"Psoriasis"	"Pain and oth cond assoc w fem gntl org and menstrual cycle"	1	47	141	188
"A41"	"G20"	"Other sepsis"	"Parkinson's disease"	1	677	1766	2443
"K02"	"G40"	"Dental caries"	"Epilepsy and recurrent seizures"	1	382	685	1067
"J81"	"I70"	"Pulmonary edema"	"Atherosclerosis"	1	771	1807	2578
"B37"	"C82"	"Candidiasis"	"Follicular lymphoma"	1	34	132	166
"H16"	"L20"	"Keratitis"	"Atopic dermatitis"	1	26	128	154
"K70"	"O04"	"Alcoholic liver disease"	"Complications following (induced) termination of pregnancy"	1	0	60	60
"E16"	"K40"	"Other disorders of pancreatic internal secretion"	"Inguinal hernia"	1	132	346	478
"I97"	"E10"	"Intraop and postproc comp and disorders of circ sys, NEC"	"Type 1 diabetes mellitus"	1	80	197	277
"C78"	"N71"	"Secondary malignant neoplasm of resp and digestive organs"	"Inflammatory disease of uterus, except cervix"	1	7	100	107
"E87"	"E16"	"Other disorders of fluid, electrolyte and acid-base balance"	"Other disorders of pancreatic internal secretion"	1	891	1290	2181
"O72"	"Q62"	"Postpartum hemorrhage"	"Congen defects of renal pelvis and congen malform of ureter"	1	116	481	597
"L92"	"O04"	"Granulomatous disorders of skin and subcutaneous tissue"	"Complications following (induced) termination of pregnancy"	1	10	126	136
"M17"	"H66"	"Osteoarthritis of knee"	"Suppurative and unspecified otitis media"	1	70	439	509
"G95"	"D25"	"Other and unspecified diseases of spinal cord"	"Leiomyoma of uterus"	1	0	142	142
"E41"	"I20"	"Nutritional marasmus"	"Angina pectoris"	1	0	165	165
"H72"	"Q53"	"Perforation of tympanic membrane"	"Undescended and ectopic testicle"	1	2	116	118
"G12"	"K29"	"Spinal muscular atrophy and related syndromes"	"Gastritis and duodenitis"	1	17	70	87
"E41"	"N20"	"Nutritional marasmus"	"Calculus of kidney and ureter"	1	3	73	76
"M18"	"I47"	"Osteoarthritis of first carpometacarpal joint"	"Paroxysmal tachycardia"	1	85	190	275
"J90"	"N95"	"Pleural effusion, not elsewhere classified"	"Menopausal and other perimenopausal disorders"	1	16	249	265
"H25"	"O02"	"Age-related cataract"	"Other abnormal products of conception"	1	0	39	39
"J84"	"N45"	"Other interstitial pulmonary diseases"	"Orchitis and epididymitis"	1	27	96	123
"J14"	"G45"	"Pneumonia due to Hemophilus influenzae"	"Transient cerebral ischemic attacks and related syndromes"	1	36	111	147
"F60"	"O26"	"Specific personality disorders"	"Maternal care for oth conditions predom related to pregnancy"	1	47	148	195
"E21"	"D24"	"Hyperparathyroidism and other disorders of parathyroid gland"	"Benign neoplasm of breast"	1	1	136	137
"I35"	"M19"	"Nonrheumatic aortic valve disorders"	"Other and unspecified osteoarthritis"	1	674	1832	2506
"N95"	"O80"	"Menopausal and other perimenopausal disorders"	"Encounter for full-term uncomplicated delivery"	1	0	142	142
"I51"	"Q21"	"Complications and ill-defined descriptions of heart disease"	"Congenital malformations of cardiac septa"	1	146	287	433
"E61"	"O62"	"Deficiency of other nutrient elements"	"Abnormalities of forces of labor"	1	0	62	62
"I81"	"B18"	"Portal vein thrombosis"	"Chronic viral hepatitis"	1	6	39	45
"I89"	"K04"	"Oth noninfective disorders of lymphatic vessels and nodes"	"Diseases of pulp and periapical tissues"	1	58	152	210
"K64"	"F60"	"Hemorrhoids and perianal venous thrombosis"	"Specific personality disorders"	1	13	80	93
"I35"	"J36"	"Nonrheumatic aortic valve disorders"	"Peritonsillar abscess"	1	0	89	89
"G95"	"N94"	"Other and unspecified diseases of spinal cord"	"Pain and oth cond assoc w fem gntl org and menstrual cycle"	1	5	49	54
"C44"	"K44"	"Other and unspecified malignant neoplasm of skin"	"Diaphragmatic hernia"	1	303	856	1159
"D25"	"O26"	"Leiomyoma of uterus"	"Maternal care for oth conditions predom related to pregnancy"	1	0	582	582
"K05"	"H83"	"Gingivitis and periodontal diseases"	"Other diseases of inner ear"	1	53	275	328
"K52"	"N84"	"Other and unsp noninfective gastroenteritis and colitis"	"Polyp of female genital tract"	1	156	343	499
"M70"	"M20"	"Soft tissue disorders related to use, overuse and pressure"	"Acquired deformities of fingers and toes"	1	602	950	1552
"I08"	"I35"	"Multiple valve diseases"	"Nonrheumatic aortic valve disorders"	1	212	887	1099
"F41"	"C15"	"Other anxiety disorders"	"Malignant neoplasm of esophagus"	1	114	582	696
"N18"	"K40"	"Chronic kidney disease (CKD)"	"Inguinal hernia"	1	0	2414	2414
"I44"	"N81"	"Atrioventricular and left bundle-branch block"	"Female genital prolapse"	1	63	524	587
"N17"	"I42"	"Acute kidney failure"	"Cardiomyopathy"	1	378	735	1113
"J47"	"I70"	"Bronchiectasis"	"Atherosclerosis"	1	45	113	158
"N64"	"O99"	"Other disorders of breast"	"Oth maternal diseases classd elsw but compl preg/chldbrth"	1	1169	1965	3134
"E11"	"J35"	"Type 2 diabetes mellitus"	"Chronic diseases of tonsils and adenoids"	1	0	588	588
"C25"	"C54"	"Malignant neoplasm of pancreas"	"Malignant neoplasm of corpus uteri"	1	0	44	44
"E83"	"K62"	"Disorders of mineral metabolism"	"Other diseases of anus and rectum"	1	151	479	630
"H36"	"F10"	"Retinal disorders in diseases classified elsewhere"	"Alcohol related disorders"	1	194	857	1051
"I10"	"O04"	"Essential (primary) hypertension"	"Complications following (induced) termination of pregnancy"	1	0	1496	1496
"I89"	"D48"	"Oth noninfective disorders of lymphatic vessels and nodes"	"Neoplasm of uncertain behavior of other and unsp sites"	1	7	72	79
"K70"	"L40"	"Alcoholic liver disease"	"Psoriasis"	1	202	335	537
"J17"	"I10"	"Pneumonia in diseases classified elsewhere"	"Essential (primary) hypertension"	1	152	320	472
"J15"	"J36"	"Bacterial pneumonia, not elsewhere classified"	"Peritonsillar abscess"	1	8	175	183
"N18"	"C64"	"Chronic kidney disease (CKD)"	"Malignant neoplasm of kidney, except renal pelvis"	1	303	863	1166
"K56"	"H72"	"Paralytic ileus and intestinal obstruction without hernia"	"Perforation of tympanic membrane"	1	25	80	105
"H53"	"Q28"	"Visual disturbances"	"Other congenital malformations of circulatory system"	1	60	179	239
"C54"	"M20"	"Malignant neoplasm of corpus uteri"	"Acquired deformities of fingers and toes"	1	67	150	217
"C10"	"I10"	"Malignant neoplasm of oropharynx"	"Essential (primary) hypertension"	1	125	426	551
"D50"	"E10"	"Iron deficiency anemia"	"Type 1 diabetes mellitus"	1	727	1910	2637
"M81"	"D07"	"Osteoporosis without current pathological fracture"	"Carcinoma in situ of other and unspecified genital organs"	1	24	117	141
"J13"	"M20"	"Pneumonia due to Streptococcus pneumoniae"	"Acquired deformities of fingers and toes"	1	31	92	123
"O82"	"O21"	"Encounter for cesarean delivery without indication"	"Excessive vomiting in pregnancy"	1	1670	3623	5293
"K52"	"O20"	"Other and unsp noninfective gastroenteritis and colitis"	"Hemorrhage in early pregnancy"	1	136	474	610
"C78"	"H90"	"Secondary malignant neoplasm of resp and digestive organs"	"Conductive and sensorineural hearing loss"	1	25	1037	1062
"C23"	"I21"	"Malignant neoplasm of gallbladder"	"Acute myocardial infarction"	1	6	39	45
"G47"	"N87"	"Sleep disorders"	"Dysplasia of cervix uteri"	1	0	299	299
"K11"	"O20"	"Diseases of salivary glands"	"Hemorrhage in early pregnancy"	1	21	109	130
"K83"	"O42"	"Other diseases of biliary tract"	"Premature rupture of membranes"	1	8	75	83
"K42"	"N87"	"Umbilical hernia"	"Dysplasia of cervix uteri"	1	27	165	192
"M75"	"H94"	"Shoulder lesions"	"Other disorders of ear in diseases classified elsewhere"	1	18	99	117
"C50"	"H66"	"Malignant neoplasm of breast"	"Suppurative and unspecified otitis media"	1	34	120	154
"K40"	"N92"	"Inguinal hernia"	"Excessive, frequent and irregular menstruation"	1	229	469	698
"C83"	"O68"	"Non-follicular lymphoma"	"Labor and delivery comp by abnlt of fetal acid-base balance"	1	0	28	28
"N30"	"D25"	"Cystitis"	"Leiomyoma of uterus"	1	903	2291	3194
"N95"	"G35"	"Menopausal and other perimenopausal disorders"	"Multiple sclerosis"	1	14	170	184
"N98"	"O04"	"Complications associated with artificial fertilization"	"Complications following (induced) termination of pregnancy"	1	20	91	111
"L29"	"H83"	"Pruritus"	"Other diseases of inner ear"	1	5	69	74
"L50"	"O02"	"Urticaria"	"Other abnormal products of conception"	1	177	341	518
"I10"	"O42"	"Essential (primary) hypertension"	"Premature rupture of membranes"	1	0	464	464
"D64"	"O82"	"Other anemias"	"Encounter for cesarean delivery without indication"	1	25	736	761
"I73"	"J30"	"Other peripheral vascular diseases"	"Vasomotor and allergic rhinitis"	1	12	142	154
"J96"	"M05"	"Respiratory failure, not elsewhere classified"	"Rheumatoid arthritis with rheumatoid factor"	1	95	1065	1160
"M85"	"N00"	"Other disorders of bone density and structure"	"Acute nephritic syndrome"	1	9	57	66
"F03"	"M50"	"Unspecified dementia"	"Cervical disc disorders"	1	0	315	315
"L57"	"G40"	"Skin changes due to chronic expsr to nonionizing radiation"	"Epilepsy and recurrent seizures"	1	59	134	193
"I67"	"C50"	"Other cerebrovascular diseases"	"Malignant neoplasm of breast"	1	60	159	219
"K56"	"L02"	"Paralytic ileus and intestinal obstruction without hernia"	"Cutaneous abscess, furuncle and carbuncle"	1	540	865	1405
"J02"	"O62"	"Acute pharyngitis"	"Abnormalities of forces of labor"	1	183	354	537
"L97"	"K43"	"Non-pressure chronic ulcer of lower limb, NEC"	"Ventral hernia"	1	90	414	504
"I71"	"D25"	"Aortic aneurysm and dissection"	"Leiomyoma of uterus"	1	0	112	112
"N61"	"O64"	"Inflammatory disorders of breast"	"Obstructed labor due to malposition and malpresent of fetus"	1	4	147	151
"G93"	"O82"	"Other disorders of brain"	"Encounter for cesarean delivery without indication"	1	25	114	139
"J18"	"O73"	"Pneumonia, unspecified organism"	"Retained placenta and membranes, without hemorrhage"	1	38	109	147
"I46"	"Q21"	"Cardiac arrest"	"Congenital malformations of cardiac septa"	1	28	131	159
"L05"	"H72"	"Pilonidal cyst and sinus"	"Perforation of tympanic membrane"	1	14	78	92
"E55"	"O62"	"Vitamin D deficiency"	"Abnormalities of forces of labor"	1	11	637	648
"J69"	"H91"	"Pneumonitis due to solids and liquids"	"Other and unspecified hearing loss"	1	0	1000	1000
"I27"	"I47"	"Other pulmonary heart diseases"	"Paroxysmal tachycardia"	1	294	569	863
"C25"	"K26"	"Malignant neoplasm of pancreas"	"Duodenal ulcer"	1	204	495	699
"E86"	"L93"	"Volume depletion"	"Lupus erythematosus"	1	13	105	118
"J11"	"O04"	"Influenza due to unidentified influenza virus"	"Complications following (induced) termination of pregnancy"	1	161	448	609
"N31"	"O04"	"Neuromuscular dysfunction of bladder, NEC"	"Complications following (induced) termination of pregnancy"	1	5	154	159
"J96"	"N73"	"Respiratory failure, not elsewhere classified"	"Other female pelvic inflammatory diseases"	1	5	84	89
"C20"	"K35"	"Malignant neoplasm of rectum"	"Acute appendicitis"	1	29	135	164
"M19"	"M93"	"Other and unspecified osteoarthritis"	"Other osteochondropathies"	1	105	325	430
"M19"	"D06"	"Other and unspecified osteoarthritis"	"Carcinoma in situ of cervix uteri"	1	0	79	79
"I95"	"E11"	"Hypotension"	"Type 2 diabetes mellitus"	1	861	3138	3999
"M43"	"M23"	"Other deforming dorsopathies"	"Internal derangement of knee"	1	638	923	1561
"K42"	"M51"	"Umbilical hernia"	"Thoracic, thoracolum, and lumbosacral intvrt disc disorders"	1	467	1001	1468
"D63"	"C34"	"Anemia in chronic diseases classified elsewhere"	"Malignant neoplasm of bronchus and lung"	1	0	5638	5638
"I15"	"Q61"	"Secondary hypertension"	"Cystic kidney disease"	1	209	383	592
"N20"	"F10"	"Calculus of kidney and ureter"	"Alcohol related disorders"	1	444	825	1269
"B96"	"C50"	"Oth bacterial agents as the cause of diseases classd elswhr"	"Malignant neoplasm of breast"	1	11	107	118
"J91"	"C53"	"Pleural effusion in conditions classified elsewhere"	"Malignant neoplasm of cervix uteri"	1	6	44	50
"K02"	"B34"	"Dental caries"	"Viral infection of unspecified site"	1	109	430	539
"D50"	"C43"	"Iron deficiency anemia"	"Malignant melanoma of skin"	1	69	211	280
"H81"	"O68"	"Disorders of vestibular function"	"Labor and delivery comp by abnlt of fetal acid-base balance"	1	70	463	533
"K70"	"M22"	"Alcoholic liver disease"	"Disorder of patella"	1	0	73	73
"B25"	"I12"	"Cytomegaloviral disease"	"Hypertensive chronic kidney disease"	1	6	51	57
"Q61"	"K35"	"Cystic kidney disease"	"Acute appendicitis"	1	18	116	134
"J10"	"G80"	"Influenza due to other identified influenza virus"	"Cerebral palsy"	1	6	38	44
"N32"	"G56"	"Other disorders of bladder"	"Mononeuropathies of upper limb"	1	120	220	340
"J09"	"O04"	"Influenza due to certain identified influenza viruses"	"Complications following (induced) termination of pregnancy"	1	0	44	44
"I95"	"I71"	"Hypotension"	"Aortic aneurysm and dissection"	1	434	695	1129
"C61"	"M67"	"Malignant neoplasm of prostate"	"Other disorders of synovium and tendon"	1	32	322	354
"E89"	"O02"	"Postproc endocrine and metabolic comp and disorders, NEC"	"Other abnormal products of conception"	1	8	133	141
"I78"	"M32"	"Diseases of capillaries"	"Systemic lupus erythematosus (SLE)"	1	2	36	38
"I87"	"M67"	"Other disorders of veins"	"Other disorders of synovium and tendon"	1	39	101	140
"N99"	"N97"	"Intraop and postproc comp and disorders of GU sys, NEC"	"Female infertility"	1	110	391	501
"J81"	"K57"	"Pulmonary edema"	"Diverticular disease of intestine"	1	254	898	1152
"G45"	"N46"	"Transient cerebral ischemic attacks and related syndromes"	"Male infertility"	1	5	91	96
"G95"	"I49"	"Other and unspecified diseases of spinal cord"	"Other cardiac arrhythmias"	1	63	144	207
"K56"	"E84"	"Paralytic ileus and intestinal obstruction without hernia"	"Cystic fibrosis"	1	4	55	59
"I50"	"H43"	"Heart failure"	"Disorders of vitreous body"	1	578	1312	1890
"N20"	"D06"	"Calculus of kidney and ureter"	"Carcinoma in situ of cervix uteri"	1	0	74	74
"K81"	"O80"	"Cholecystitis"	"Encounter for full-term uncomplicated delivery"	1	0	1045	1045
"H49"	"O80"	"Paralytic strabismus"	"Encounter for full-term uncomplicated delivery"	1	18	145	163
"J94"	"D30"	"Other pleural conditions"	"Benign neoplasm of urinary organs"	1	22	94	116
"O73"	"O14"	"Retained placenta and membranes, without hemorrhage"	"Pre-eclampsia"	1	359	524	883
"I10"	"O62"	"Essential (primary) hypertension"	"Abnormalities of forces of labor"	1	0	1746	1746
"M19"	"K60"	"Other and unspecified osteoarthritis"	"Fissure and fistula of anal and rectal regions"	1	316	712	1028
"F03"	"M67"	"Unspecified dementia"	"Other disorders of synovium and tendon"	1	0	175	175
"K64"	"O62"	"Hemorrhoids and perianal venous thrombosis"	"Abnormalities of forces of labor"	1	0	1395	1395
"H26"	"O02"	"Other cataract"	"Other abnormal products of conception"	1	0	64	64
"J06"	"Q65"	"Acute upper resp infections of multiple and unsp sites"	"Congenital deformities of hip"	1	236	410	646
"G47"	"O65"	"Sleep disorders"	"Obstructed labor due to maternal pelvic abnormality"	1	0	49	49
"J86"	"H25"	"Pyothorax"	"Age-related cataract"	1	312	455	767
"H25"	"M50"	"Age-related cataract"	"Cervical disc disorders"	1	0	2289	2289
"E86"	"G63"	"Volume depletion"	"Polyneuropathy in diseases classified elsewhere"	1	153	369	522
"M85"	"N90"	"Other disorders of bone density and structure"	"Other noninflammatory disorders of vulva and perineum"	1	37	114	151
"I61"	"N94"	"Nontraumatic intracerebral hemorrhage"	"Pain and oth cond assoc w fem gntl org and menstrual cycle"	1	2	51	53
"K60"	"N75"	"Fissure and fistula of anal and rectal regions"	"Diseases of Bartholin's gland"	1	90	187	277
"M54"	"O01"	"Dorsalgia"	"Hydatidiform mole"	1	9	58	67
"E78"	"O70"	"Disorders of lipoprotein metabolism and other lipidemias"	"Perineal laceration during delivery"	1	0	407	407
"N39"	"G37"	"Other disorders of urinary system"	"Other demyelinating diseases of central nervous system"	1	75	268	343
"C68"	"C67"	"Malignant neoplasm of other and unspecified urinary organs"	"Malignant neoplasm of bladder"	1	71	151	222
"G30"	"M48"	"Alzheimer's disease"	"Other spondylopathies"	1	2	596	598
"F43"	"M67"	"Reaction to severe stress, and adjustment disorders"	"Other disorders of synovium and tendon"	1	233	397	630
"C16"	"N45"	"Malignant neoplasm of stomach"	"Orchitis and epididymitis"	1	12	52	64
"M87"	"H91"	"Osteonecrosis"	"Other and unspecified hearing loss"	1	95	194	289
"E86"	"N32"	"Volume depletion"	"Other disorders of bladder"	1	252	717	969
"C71"	"D27"	"Malignant neoplasm of brain"	"Benign neoplasm of ovary"	1	0	60	60
"J90"	"G35"	"Pleural effusion, not elsewhere classified"	"Multiple sclerosis"	1	0	40	40
"E83"	"I73"	"Disorders of mineral metabolism"	"Other peripheral vascular diseases"	1	134	396	530
"G98"	"D32"	"Other disorders of nervous system not elsewhere classified"	"Benign neoplasm of meninges"	1	21	71	92
"K22"	"D25"	"Other diseases of esophagus"	"Leiomyoma of uterus"	1	24	212	236
"M19"	"J34"	"Other and unspecified osteoarthritis"	"Other and unspecified disorders of nose and nasal sinuses"	1	92	818	910
"N84"	"N97"	"Polyp of female genital tract"	"Female infertility"	1	908	1946	2854
"L95"	"I80"	"Vasculitis limited to skin, not elsewhere classified"	"Phlebitis and thrombophlebitis"	1	79	168	247
"H26"	"N75"	"Other cataract"	"Diseases of Bartholin's gland"	1	0	43	43
"G47"	"O21"	"Sleep disorders"	"Excessive vomiting in pregnancy"	1	0	103	103
"M16"	"K66"	"Osteoarthritis of hip"	"Other disorders of peritoneum"	1	13	87	100
"I88"	"O80"	"Nonspecific lymphadenitis"	"Encounter for full-term uncomplicated delivery"	1	235	462	697
"J81"	"M75"	"Pulmonary edema"	"Shoulder lesions"	1	33	353	386
"H90"	"N87"	"Conductive and sensorineural hearing loss"	"Dysplasia of cervix uteri"	1	53	207	260
"C25"	"N87"	"Malignant neoplasm of pancreas"	"Dysplasia of cervix uteri"	1	0	33	33
"D64"	"D30"	"Other anemias"	"Benign neoplasm of urinary organs"	1	272	1680	1952
"I73"	"M72"	"Other peripheral vascular diseases"	"Fibroblastic disorders"	1	229	784	1013
"K56"	"D24"	"Paralytic ileus and intestinal obstruction without hernia"	"Benign neoplasm of breast"	1	33	326	359
"I10"	"K44"	"Essential (primary) hypertension"	"Diaphragmatic hernia"	1	5132	6596	11728
"A41"	"N85"	"Other sepsis"	"Other noninflammatory disorders of uterus, except cervix"	1	5	122	127
"M65"	"N92"	"Synovitis and tenosynovitis"	"Excessive, frequent and irregular menstruation"	1	869	2895	3764
"C48"	"M51"	"Malignant neoplasm of retroperitoneum and peritoneum"	"Thoracic, thoracolum, and lumbosacral intvrt disc disorders"	1	2	50	52
"N13"	"M65"	"Obstructive and reflux uropathy"	"Synovitis and tenosynovitis"	1	116	412	528
"D10"	"O03"	"Benign neoplasm of mouth and pharynx"	"Spontaneous abortion"	1	0	83	83
"D63"	"H33"	"Anemia in chronic diseases classified elsewhere"	"Retinal detachments and breaks"	1	2	211	213
"O08"	"O04"	"Complications following ectopic and molar pregnancy"	"Complications following (induced) termination of pregnancy"	1	0	17738	17738
"C79"	"H90"	"Secondary malignant neoplasm of other and unspecified sites"	"Conductive and sensorineural hearing loss"	1	55	774	829
"O48"	"F10"	"Late pregnancy"	"Alcohol related disorders"	1	96	266	362
"I71"	"D16"	"Aortic aneurysm and dissection"	"Benign neoplasm of bone and articular cartilage"	1	4	44	48
"C50"	"M23"	"Malignant neoplasm of breast"	"Internal derangement of knee"	1	815	1375	2190
"O91"	"O99"	"Infect of breast assoc w pregnancy, the puerp and lactation"	"Oth maternal diseases classd elsw but compl preg/chldbrth"	1	0	5811	5811
"M48"	"D23"	"Other spondylopathies"	"Other benign neoplasms of skin"	1	240	645	885
"I97"	"M75"	"Intraop and postproc comp and disorders of circ sys, NEC"	"Shoulder lesions"	1	59	131	190
"E16"	"J45"	"Other disorders of pancreatic internal secretion"	"Asthma"	1	255	607	862
"H33"	"K30"	"Retinal detachments and breaks"	"Functional dyspepsia"	1	171	294	465
"J81"	"I48"	"Pulmonary edema"	"Atrial fibrillation and flutter"	1	3492	4203	7695
"L40"	"O48"	"Psoriasis"	"Late pregnancy"	1	16	101	117
"I46"	"M77"	"Cardiac arrest"	"Other enthesopathies"	1	0	161	161
"E04"	"N92"	"Other nontoxic goiter"	"Excessive, frequent and irregular menstruation"	1	993	2125	3118
"N17"	"C83"	"Acute kidney failure"	"Non-follicular lymphoma"	1	107	204	311
"G40"	"K40"	"Epilepsy and recurrent seizures"	"Inguinal hernia"	1	647	1350	1997
"G57"	"O36"	"Mononeuropathies of lower limb"	"Maternal care for other fetal problems"	1	21	75	96
"K74"	"O82"	"Fibrosis and cirrhosis of liver"	"Encounter for cesarean delivery without indication"	1	0	38	38
"I67"	"N81"	"Other cerebrovascular diseases"	"Female genital prolapse"	1	79	205	284
"K56"	"H91"	"Paralytic ileus and intestinal obstruction without hernia"	"Other and unspecified hearing loss"	1	0	4697	4697
"J15"	"O62"	"Bacterial pneumonia, not elsewhere classified"	"Abnormalities of forces of labor"	1	0	769	769
"K04"	"N92"	"Diseases of pulp and periapical tissues"	"Excessive, frequent and irregular menstruation"	1	156	509	665
"N17"	"M77"	"Acute kidney failure"	"Other enthesopathies"	1	1	196	197
"J90"	"H40"	"Pleural effusion, not elsewhere classified"	"Glaucoma"	1	24	314	338
"D50"	"N61"	"Iron deficiency anemia"	"Inflammatory disorders of breast"	1	14	80	94
"K72"	"H83"	"Hepatic failure, not elsewhere classified"	"Other diseases of inner ear"	1	0	110	110
"F41"	"J32"	"Other anxiety disorders"	"Chronic sinusitis"	1	42	160	202
"J40"	"Q25"	"Bronchitis, not specified as acute or chronic"	"Congenital malformations of great arteries"	1	14	57	71
"O42"	"L20"	"Premature rupture of membranes"	"Atopic dermatitis"	1	12	208	220
"I35"	"H04"	"Nonrheumatic aortic valve disorders"	"Disorders of lacrimal system"	1	56	222	278
"I45"	"M22"	"Other conduction disorders"	"Disorder of patella"	1	19	69	88
"A04"	"A46"	"Other bacterial intestinal infections"	"Erysipelas"	1	410	939	1349
"E06"	"J35"	"Thyroiditis"	"Chronic diseases of tonsils and adenoids"	1	0	146	146
"M25"	"O20"	"Other joint disorder, not elsewhere classified"	"Hemorrhage in early pregnancy"	1	11	889	900
"N28"	"K35"	"Oth disorders of kidney and ureter, not elsewhere classified"	"Acute appendicitis"	1	45	168	213
"C34"	"C43"	"Malignant neoplasm of bronchus and lung"	"Malignant melanoma of skin"	1	222	510	732
"J86"	"K86"	"Pyothorax"	"Other diseases of pancreas"	1	51	125	176
"D61"	"M79"	"Oth aplastic anemias and other bone marrow failure syndromes"	"Oth and unsp soft tissue disorders, not elsewhere classified"	1	53	133	186
"K52"	"D24"	"Other and unsp noninfective gastroenteritis and colitis"	"Benign neoplasm of breast"	1	59	408	467
"K63"	"N97"	"Other diseases of intestine"	"Female infertility"	1	24	77	101
"N13"	"C56"	"Obstructive and reflux uropathy"	"Malignant neoplasm of ovary"	1	300	857	1157
"C16"	"E78"	"Malignant neoplasm of stomach"	"Disorders of lipoprotein metabolism and other lipidemias"	1	158	690	848
"N17"	"D64"	"Acute kidney failure"	"Other anemias"	1	2415	3184	5599
"C76"	"H91"	"Malignant neoplasm of other and ill-defined sites"	"Other and unspecified hearing loss"	1	110	415	525
"M81"	"O26"	"Osteoporosis without current pathological fracture"	"Maternal care for oth conditions predom related to pregnancy"	1	0	102	102
"M85"	"N92"	"Other disorders of bone density and structure"	"Excessive, frequent and irregular menstruation"	1	0	1333	1333
"L90"	"O62"	"Atrophic disorders of skin"	"Abnormalities of forces of labor"	1	204	1424	1628
"I48"	"L72"	"Atrial fibrillation and flutter"	"Follicular cysts of skin and subcutaneous tissue"	1	165	401	566
"N39"	"D37"	"Other disorders of urinary system"	"Neoplasm of uncrt behavior of oral cavity and dgstv organs"	1	87	217	304
"I50"	"N50"	"Heart failure"	"Other and unspecified disorders of male genital organs"	1	178	323	501
"H90"	"Q96"	"Conductive and sensorineural hearing loss"	"Turner's syndrome"	1	11	62	73
"C80"	"I25"	"Malignant neoplasm without specification of site"	"Chronic ischemic heart disease"	1	52	591	643
"E86"	"K09"	"Volume depletion"	"Cysts of oral region, not elsewhere classified"	1	18	119	137
"M18"	"O04"	"Osteoarthritis of first carpometacarpal joint"	"Complications following (induced) termination of pregnancy"	1	0	71	71
"D63"	"M25"	"Anemia in chronic diseases classified elsewhere"	"Other joint disorder, not elsewhere classified"	1	61	246	307
"C67"	"K58"	"Malignant neoplasm of bladder"	"Irritable bowel syndrome"	1	18	103	121
"C71"	"N92"	"Malignant neoplasm of brain"	"Excessive, frequent and irregular menstruation"	1	0	112	112
"J44"	"H83"	"Other chronic obstructive pulmonary disease"	"Other diseases of inner ear"	1	0	3447	3447
"M13"	"N63"	"Other arthritis"	"Unspecified lump in breast"	1	92	189	281
"N17"	"D21"	"Acute kidney failure"	"Other benign neoplasms of connective and other soft tissue"	1	11	62	73
"J06"	"J38"	"Acute upper resp infections of multiple and unsp sites"	"Diseases of vocal cords and larynx, not elsewhere classified"	1	81	175	256
"E25"	"J42"	"Adrenogenital disorders"	"Unspecified chronic bronchitis"	1	23	74	97
"E64"	"I50"	"Sequelae of malnutrition and other nutritional deficiencies"	"Heart failure"	1	586	871	1457
"I85"	"H91"	"Esophageal varices"	"Other and unspecified hearing loss"	1	124	318	442
"N31"	"G83"	"Neuromuscular dysfunction of bladder, NEC"	"Other paralytic syndromes"	1	127	247	374
"G98"	"K61"	"Other disorders of nervous system not elsewhere classified"	"Abscess of anal and rectal regions"	1	1	52	53
"C24"	"H25"	"Malignant neoplasm of other and unsp parts of biliary tract"	"Age-related cataract"	1	53	422	475
"J06"	"O26"	"Acute upper resp infections of multiple and unsp sites"	"Maternal care for oth conditions predom related to pregnancy"	1	5	243	248
"M75"	"L20"	"Shoulder lesions"	"Atopic dermatitis"	1	28	284	312
"O08"	"J45"	"Complications following ectopic and molar pregnancy"	"Asthma"	1	226	451	677
"L57"	"I70"	"Skin changes due to chronic expsr to nonionizing radiation"	"Atherosclerosis"	1	140	316	456
"C78"	"O99"	"Secondary malignant neoplasm of resp and digestive organs"	"Oth maternal diseases classd elsw but compl preg/chldbrth"	1	0	118	118
"L57"	"I25"	"Skin changes due to chronic expsr to nonionizing radiation"	"Chronic ischemic heart disease"	1	248	899	1147
"I71"	"H33"	"Aortic aneurysm and dissection"	"Retinal detachments and breaks"	1	28	287	315
"I25"	"G56"	"Chronic ischemic heart disease"	"Mononeuropathies of upper limb"	1	2133	3121	5254
"N39"	"K01"	"Other disorders of urinary system"	"Embedded and impacted teeth"	1	88	256	344
"E03"	"M77"	"Other hypothyroidism"	"Other enthesopathies"	1	231	593	824
"D59"	"M16"	"Acquired hemolytic anemia"	"Osteoarthritis of hip"	1	32	99	131
"G62"	"C50"	"Other and unspecified polyneuropathies"	"Malignant neoplasm of breast"	1	142	542	684
"J69"	"H25"	"Pneumonitis due to solids and liquids"	"Age-related cataract"	1	0	1784	1784
"N12"	"M23"	"Tubulo-interstitial nephritis, not spcf as acute or chronic"	"Internal derangement of knee"	1	86	310	396
"N92"	"O69"	"Excessive, frequent and irregular menstruation"	"Labor and delivery complicated by umbilical cord comp"	1	0	121	121
"A41"	"L08"	"Other sepsis"	"Other local infections of skin and subcutaneous tissue"	1	1029	1982	3011
"C25"	"E04"	"Malignant neoplasm of pancreas"	"Other nontoxic goiter"	1	0	204	204
"C10"	"K70"	"Malignant neoplasm of oropharynx"	"Alcoholic liver disease"	1	7	177	184
"C25"	"N81"	"Malignant neoplasm of pancreas"	"Female genital prolapse"	1	0	287	287
"N28"	"I12"	"Oth disorders of kidney and ureter, not elsewhere classified"	"Hypertensive chronic kidney disease"	1	153	323	476
"C90"	"H91"	"Multiple myeloma and malignant plasma cell neoplasms"	"Other and unspecified hearing loss"	1	101	535	636
"M21"	"D24"	"Other acquired deformities of limbs"	"Benign neoplasm of breast"	1	64	172	236
"F05"	"G95"	"Delirium due to known physiological condition"	"Other and unspecified diseases of spinal cord"	1	91	269	360
"K65"	"I12"	"Peritonitis"	"Hypertensive chronic kidney disease"	1	129	418	547
"I63"	"K40"	"Cerebral infarction"	"Inguinal hernia"	1	0	4489	4489
"H65"	"Q20"	"Nonsuppurative otitis media"	"Congenital malformations of cardiac chambers and connections"	1	53	222	275
"E78"	"A15"	"Disorders of lipoprotein metabolism and other lipidemias"	"Respiratory tuberculosis"	1	26	81	107
"I69"	"M76"	"Sequelae of cerebrovascular disease"	"Enthesopathies, lower limb, excluding foot"	1	119	430	549
"C15"	"M13"	"Malignant neoplasm of esophagus"	"Other arthritis"	1	10	61	71
"O66"	"K01"	"Other obstructed labor"	"Embedded and impacted teeth"	1	1	32	33
"E66"	"O03"	"Overweight and obesity"	"Spontaneous abortion"	1	0	9576	9576
"I27"	"M48"	"Other pulmonary heart diseases"	"Other spondylopathies"	1	141	364	505
"D45"	"M51"	"Polycythemia vera"	"Thoracic, thoracolum, and lumbosacral intvrt disc disorders"	1	27	81	108
"K83"	"J35"	"Other diseases of biliary tract"	"Chronic diseases of tonsils and adenoids"	1	1	77	78
"O72"	"Q67"	"Postpartum hemorrhage"	"Congenital ms deformities of head, face, spine and chest"	1	0	155	155
"I26"	"M23"	"Pulmonary embolism"	"Internal derangement of knee"	1	205	1312	1517
"J33"	"O80"	"Nasal polyp"	"Encounter for full-term uncomplicated delivery"	1	28	340	368
"J96"	"M33"	"Respiratory failure, not elsewhere classified"	"Dermatopolymyositis"	1	27	99	126
"K76"	"J20"	"Other diseases of liver"	"Acute bronchitis"	1	62	150	212
"N30"	"C32"	"Cystitis"	"Malignant neoplasm of larynx"	1	64	179	243
"C20"	"J37"	"Malignant neoplasm of rectum"	"Chronic laryngitis and laryngotracheitis"	1	4	43	47
"K92"	"I48"	"Other diseases of digestive system"	"Atrial fibrillation and flutter"	1	5083	8623	13706
"O02"	"A63"	"Other abnormal products of conception"	"Oth predominantly sexually transmitted diseases, NEC"	1	133	918	1051
"B37"	"K40"	"Candidiasis"	"Inguinal hernia"	1	131	771	902
"M13"	"O21"	"Other arthritis"	"Excessive vomiting in pregnancy"	1	9	44	53
"C61"	"C00"	"Malignant neoplasm of prostate"	"Malignant neoplasm of lip"	1	6	42	48
"J84"	"D24"	"Other interstitial pulmonary diseases"	"Benign neoplasm of breast"	1	0	76	76
"N19"	"N31"	"Unspecified kidney failure"	"Neuromuscular dysfunction of bladder, NEC"	1	101	298	399
"J96"	"O47"	"Respiratory failure, not elsewhere classified"	"False labor"	1	0	91	91
"G62"	"H66"	"Other and unspecified polyneuropathies"	"Suppurative and unspecified otitis media"	1	4	114	118
"N83"	"F10"	"Noninflammatory disord of ovary, fallop and broad ligament"	"Alcohol related disorders"	1	366	718	1084
"E66"	"B34"	"Overweight and obesity"	"Viral infection of unspecified site"	1	599	1110	1709
"M13"	"O36"	"Other arthritis"	"Maternal care for other fetal problems"	1	36	142	178
"M13"	"K40"	"Other arthritis"	"Inguinal hernia"	1	251	737	988
"O80"	"Q72"	"Encounter for full-term uncomplicated delivery"	"Reduction defects of lower limb"	1	18	129	147
"M16"	"C62"	"Osteoarthritis of hip"	"Malignant neoplasm of testis"	1	0	44	44
"N32"	"D30"	"Other disorders of bladder"	"Benign neoplasm of urinary organs"	1	169	359	528
"O72"	"I45"	"Postpartum hemorrhage"	"Other conduction disorders"	1	40	187	227
"I47"	"H10"	"Paroxysmal tachycardia"	"Conjunctivitis"	1	219	512	731
"J95"	"K40"	"Intraop and postproc comp and disorders of resp sys, NEC"	"Inguinal hernia"	1	10	258	268
"A46"	"K35"	"Erysipelas"	"Acute appendicitis"	1	89	550	639
"C49"	"M20"	"Malignant neoplasm of other connective and soft tissue"	"Acquired deformities of fingers and toes"	1	10	53	63
"I21"	"G35"	"Acute myocardial infarction"	"Multiple sclerosis"	1	41	207	248
"C85"	"M17"	"Oth and unspecified types of non-Hodgkin lymphoma"	"Osteoarthritis of knee"	1	126	359	485
"C80"	"H93"	"Malignant neoplasm without specification of site"	"Other disorders of ear, not elsewhere classified"	1	0	156	156
"C77"	"M75"	"Secondary and unspecified malignant neoplasm of lymph nodes"	"Shoulder lesions"	1	161	1015	1176
"M51"	"O23"	"Thoracic, thoracolum, and lumbosacral intvrt disc disorders"	"Infections of genitourinary tract in pregnancy"	1	50	581	631
"N18"	"F17"	"Chronic kidney disease (CKD)"	"Nicotine dependence"	1	375	793	1168
"A49"	"K70"	"Bacterial infection of unspecified site"	"Alcoholic liver disease"	1	371	740	1111
"M84"	"G40"	"Disorder of continuity of bone"	"Epilepsy and recurrent seizures"	1	58	170	228
"K70"	"M62"	"Alcoholic liver disease"	"Other disorders of muscle"	1	131	719	850
"C50"	"L24"	"Malignant neoplasm of breast"	"Irritant contact dermatitis"	1	6	43	49
"E21"	"H90"	"Hyperparathyroidism and other disorders of parathyroid gland"	"Conductive and sensorineural hearing loss"	1	83	246	329
"A63"	"K01"	"Oth predominantly sexually transmitted diseases, NEC"	"Embedded and impacted teeth"	1	40	111	151
"M25"	"H10"	"Other joint disorder, not elsewhere classified"	"Conjunctivitis"	1	243	887	1130
"K64"	"N20"	"Hemorrhoids and perianal venous thrombosis"	"Calculus of kidney and ureter"	1	5	903	908
"E78"	"O48"	"Disorders of lipoprotein metabolism and other lipidemias"	"Late pregnancy"	1	0	62	62
"O00"	"A63"	"Ectopic pregnancy"	"Oth predominantly sexually transmitted diseases, NEC"	1	70	205	275
"J15"	"O03"	"Bacterial pneumonia, not elsewhere classified"	"Spontaneous abortion"	1	0	316	316
"C73"	"O03"	"Malignant neoplasm of thyroid gland"	"Spontaneous abortion"	1	0	49	49
"J96"	"C16"	"Respiratory failure, not elsewhere classified"	"Malignant neoplasm of stomach"	1	225	413	638
"I49"	"M77"	"Other cardiac arrhythmias"	"Other enthesopathies"	1	248	430	678
"I11"	"M67"	"Hypertensive heart disease"	"Other disorders of synovium and tendon"	1	32	100	132
"I95"	"K25"	"Hypotension"	"Gastric ulcer"	1	436	1068	1504
"C61"	"J38"	"Malignant neoplasm of prostate"	"Diseases of vocal cords and larynx, not elsewhere classified"	1	65	145	210
"O43"	"O80"	"Placental disorders"	"Encounter for full-term uncomplicated delivery"	1	256	470	726
"H25"	"J36"	"Age-related cataract"	"Peritonsillar abscess"	1	29	252	281
"I10"	"K30"	"Essential (primary) hypertension"	"Functional dyspepsia"	1	5313	8391	13704
"K04"	"M51"	"Diseases of pulp and periapical tissues"	"Thoracic, thoracolum, and lumbosacral intvrt disc disorders"	1	290	663	953
"N45"	"H83"	"Orchitis and epididymitis"	"Other diseases of inner ear"	1	140	281	421
"N30"	"M24"	"Cystitis"	"Other specific joint derangements"	1	534	828	1362
"C61"	"G43"	"Malignant neoplasm of prostate"	"Migraine"	1	5	81	86
"N03"	"N06"	"Chronic nephritic syndrome"	"Isolated proteinuria with specified morphological lesion"	1	94	221	315
"L08"	"M06"	"Other local infections of skin and subcutaneous tissue"	"Other rheumatoid arthritis"	1	184	329	513
"M16"	"O04"	"Osteoarthritis of hip"	"Complications following (induced) termination of pregnancy"	1	0	280	280
"I63"	"N45"	"Cerebral infarction"	"Orchitis and epididymitis"	1	252	455	707
"H57"	"H20"	"Other disorders of eye and adnexa"	"Iridocyclitis"	1	324	472	796
"J69"	"K57"	"Pneumonitis due to solids and liquids"	"Diverticular disease of intestine"	1	44	572	616
"J18"	"K60"	"Pneumonia, unspecified organism"	"Fissure and fistula of anal and rectal regions"	1	566	1441	2007
"K26"	"O03"	"Duodenal ulcer"	"Spontaneous abortion"	1	24	81	105
"L97"	"O80"	"Non-pressure chronic ulcer of lower limb, NEC"	"Encounter for full-term uncomplicated delivery"	1	0	40	40
"I61"	"B18"	"Nontraumatic intracerebral hemorrhage"	"Chronic viral hepatitis"	1	27	88	115
"O43"	"O02"	"Placental disorders"	"Other abnormal products of conception"	1	73	257	330
"I80"	"O60"	"Phlebitis and thrombophlebitis"	"Preterm labor"	1	4	46	50
"I15"	"M79"	"Secondary hypertension"	"Oth and unsp soft tissue disorders, not elsewhere classified"	1	428	680	1108
"N82"	"C53"	"Fistulae involving female genital tract"	"Malignant neoplasm of cervix uteri"	1	89	431	520
"C79"	"D06"	"Secondary malignant neoplasm of other and unspecified sites"	"Carcinoma in situ of cervix uteri"	1	0	40	40
"M10"	"J33"	"Gout"	"Nasal polyp"	1	22	72	94
"I48"	"C43"	"Atrial fibrillation and flutter"	"Malignant melanoma of skin"	1	628	939	1567
"B34"	"O71"	"Viral infection of unspecified site"	"Other obstetric trauma"	1	51	209	260
"L98"	"O20"	"Oth disorders of skin, subcu, not elsewhere classified"	"Hemorrhage in early pregnancy"	1	7	202	209
"O34"	"O64"	"Maternal care for abnormality of pelvic organs"	"Obstructed labor due to malposition and malpresent of fetus"	1	0	6349	6349
"K80"	"H71"	"Cholelithiasis"	"Cholesteatoma of middle ear"	1	55	148	203
"K20"	"K40"	"Esophagitis"	"Inguinal hernia"	1	604	844	1448
"M51"	"N94"	"Thoracic, thoracolum, and lumbosacral intvrt disc disorders"	"Pain and oth cond assoc w fem gntl org and menstrual cycle"	1	471	1246	1717
"I73"	"H36"	"Other peripheral vascular diseases"	"Retinal disorders in diseases classified elsewhere"	1	478	1004	1482
"M46"	"K50"	"Other inflammatory spondylopathies"	"Crohn's disease [regional enteritis]"	1	24	185	209
"G47"	"O42"	"Sleep disorders"	"Premature rupture of membranes"	1	0	183	183
"Q61"	"J34"	"Cystic kidney disease"	"Other and unspecified disorders of nose and nasal sinuses"	1	5	73	78
"N17"	"A69"	"Acute kidney failure"	"Other spirochetal infections"	1	3	40	43
"C64"	"N40"	"Malignant neoplasm of kidney, except renal pelvis"	"Benign prostatic hyperplasia"	1	176	654	830
"F03"	"N92"	"Unspecified dementia"	"Excessive, frequent and irregular menstruation"	1	0	208	208
"H81"	"H71"	"Disorders of vestibular function"	"Cholesteatoma of middle ear"	1	97	198	295
"C16"	"K20"	"Malignant neoplasm of stomach"	"Esophagitis"	1	112	298	410
"F05"	"M51"	"Delirium due to known physiological condition"	"Thoracic, thoracolum, and lumbosacral intvrt disc disorders"	1	0	653	653
"D63"	"C17"	"Anemia in chronic diseases classified elsewhere"	"Malignant neoplasm of small intestine"	1	62	155	217
"C49"	"E66"	"Malignant neoplasm of other connective and soft tissue"	"Overweight and obesity"	1	48	167	215
"M05"	"N60"	"Rheumatoid arthritis with rheumatoid factor"	"Benign mammary dysplasia"	1	30	154	184
"D63"	"D30"	"Anemia in chronic diseases classified elsewhere"	"Benign neoplasm of urinary organs"	1	38	684	722
"K29"	"D25"	"Gastritis and duodenitis"	"Leiomyoma of uterus"	1	400	758	1158
"C54"	"M62"	"Malignant neoplasm of corpus uteri"	"Other disorders of muscle"	1	75	186	261
"G56"	"Q82"	"Mononeuropathies of upper limb"	"Other congenital malformations of skin"	1	46	130	176
"C34"	"A46"	"Malignant neoplasm of bronchus and lung"	"Erysipelas"	1	278	862	1140
"C22"	"N40"	"Malignant neoplasm of liver and intrahepatic bile ducts"	"Benign prostatic hyperplasia"	1	0	344	344
"J94"	"H35"	"Other pleural conditions"	"Other retinal disorders"	1	123	323	446
"G50"	"O62"	"Disorders of trigeminal nerve"	"Abnormalities of forces of labor"	1	0	192	192
"I50"	"M99"	"Heart failure"	"Biomechanical lesions, not elsewhere classified"	1	234	625	859
"K74"	"J38"	"Fibrosis and cirrhosis of liver"	"Diseases of vocal cords and larynx, not elsewhere classified"	1	19	68	87
"C49"	"M16"	"Malignant neoplasm of other connective and soft tissue"	"Osteoarthritis of hip"	1	43	126	169
"C78"	"M83"	"Secondary malignant neoplasm of resp and digestive organs"	"Adult osteomalacia"	1	1	42	43
"M48"	"G51"	"Other spondylopathies"	"Facial nerve disorders"	1	84	173	257
"A49"	"G35"	"Bacterial infection of unspecified site"	"Multiple sclerosis"	1	0	144	144
"C78"	"N90"	"Secondary malignant neoplasm of resp and digestive organs"	"Other noninflammatory disorders of vulva and perineum"	1	2	70	72
"C22"	"J45"	"Malignant neoplasm of liver and intrahepatic bile ducts"	"Asthma"	1	5	155	160
"G45"	"M54"	"Transient cerebral ischemic attacks and related syndromes"	"Dorsalgia"	1	1961	2701	4662
"H16"	"K35"	"Keratitis"	"Acute appendicitis"	1	61	190	251
"J96"	"N40"	"Respiratory failure, not elsewhere classified"	"Benign prostatic hyperplasia"	1	0	4535	4535
"I27"	"M05"	"Other pulmonary heart diseases"	"Rheumatoid arthritis with rheumatoid factor"	1	45	167	212
"C17"	"H91"	"Malignant neoplasm of small intestine"	"Other and unspecified hearing loss"	1	15	143	158
"D86"	"L05"	"Sarcoidosis"	"Pilonidal cyst and sinus"	1	2	48	50
"A49"	"N80"	"Bacterial infection of unspecified site"	"Endometriosis"	1	19	118	137
"F45"	"O04"	"Somatoform disorders"	"Complications following (induced) termination of pregnancy"	1	75	212	287
"K52"	"O48"	"Other and unsp noninfective gastroenteritis and colitis"	"Late pregnancy"	1	24	135	159
"I78"	"O04"	"Diseases of capillaries"	"Complications following (induced) termination of pregnancy"	1	0	256	256
"I21"	"O80"	"Acute myocardial infarction"	"Encounter for full-term uncomplicated delivery"	1	0	175	175
"L90"	"N04"	"Atrophic disorders of skin"	"Nephrotic syndrome"	1	6	42	48
"I46"	"F03"	"Cardiac arrest"	"Unspecified dementia"	1	329	796	1125
"K57"	"N70"	"Diverticular disease of intestine"	"Salpingitis and oophoritis"	1	22	458	480
"J18"	"O90"	"Pneumonia, unspecified organism"	"Complications of the puerperium, not elsewhere classified"	1	107	222	329
"C17"	"M75"	"Malignant neoplasm of small intestine"	"Shoulder lesions"	1	4	72	76
"J96"	"M18"	"Respiratory failure, not elsewhere classified"	"Osteoarthritis of first carpometacarpal joint"	1	42	391	433
"I35"	"H10"	"Nonrheumatic aortic valve disorders"	"Conjunctivitis"	1	6	523	529
"N18"	"I80"	"Chronic kidney disease (CKD)"	"Phlebitis and thrombophlebitis"	1	538	2026	2564
"O92"	"O20"	"Oth disord of brst/lactatn assoc w pregnancy and the puerp"	"Hemorrhage in early pregnancy"	1	653	2263	2916
"K92"	"H72"	"Other diseases of digestive system"	"Perforation of tympanic membrane"	1	31	125	156
"N13"	"D39"	"Obstructive and reflux uropathy"	"Neoplasm of uncertain behavior of female genital organs"	1	46	113	159
"E64"	"M76"	"Sequelae of malnutrition and other nutritional deficiencies"	"Enthesopathies, lower limb, excluding foot"	1	9	54	63
"O40"	"O21"	"Polyhydramnios"	"Excessive vomiting in pregnancy"	1	89	240	329
"J22"	"J43"	"Unspecified acute lower respiratory infection"	"Emphysema"	1	74	266	340
"D61"	"M48"	"Oth aplastic anemias and other bone marrow failure syndromes"	"Other spondylopathies"	1	28	84	112
"C44"	"K85"	"Other and unspecified malignant neoplasm of skin"	"Acute pancreatitis"	1	127	238	365
"K02"	"Q54"	"Dental caries"	"Hypospadias"	1	3	37	40
"M48"	"M32"	"Other spondylopathies"	"Systemic lupus erythematosus (SLE)"	1	20	71	91
"C85"	"H93"	"Oth and unspecified types of non-Hodgkin lymphoma"	"Other disorders of ear, not elsewhere classified"	1	53	130	183
"I35"	"N62"	"Nonrheumatic aortic valve disorders"	"Hypertrophy of breast"	1	83	290	373
"F17"	"L08"	"Nicotine dependence"	"Other local infections of skin and subcutaneous tissue"	1	478	990	1468
"K28"	"I10"	"Gastrojejunal ulcer"	"Essential (primary) hypertension"	1	461	789	1250
"O42"	"O01"	"Premature rupture of membranes"	"Hydatidiform mole"	1	42	113	155
"G82"	"G40"	"Paraplegia (paraparesis) and quadriplegia (quadriparesis)"	"Epilepsy and recurrent seizures"	1	575	788	1363
"F05"	"D17"	"Delirium due to known physiological condition"	"Benign lipomatous neoplasm"	1	0	183	183
"D65"	"M17"	"Disseminated intravascular coagulation"	"Osteoarthritis of knee"	1	12	71	83
"E86"	"D34"	"Volume depletion"	"Benign neoplasm of thyroid gland"	1	19	75	94
"D47"	"O62"	"Oth neoplm of uncrt behav of lymphoid, hematpoetc & rel tiss"	"Abnormalities of forces of labor"	1	0	31	31
"D09"	"I70"	"Carcinoma in situ of other and unspecified sites"	"Atherosclerosis"	1	27	178	205
"K92"	"G51"	"Other diseases of digestive system"	"Facial nerve disorders"	1	73	150	223
"J47"	"M22"	"Bronchiectasis"	"Disorder of patella"	1	0	44	44
"K81"	"O64"	"Cholecystitis"	"Obstructed labor due to malposition and malpresent of fetus"	1	0	100	100
"H25"	"K44"	"Age-related cataract"	"Diaphragmatic hernia"	1	2298	4137	6435
"I45"	"E11"	"Other conduction disorders"	"Type 2 diabetes mellitus"	1	858	1174	2032
"E65"	"O03"	"Localized adiposity"	"Spontaneous abortion"	1	0	386	386
"M76"	"N60"	"Enthesopathies, lower limb, excluding foot"	"Benign mammary dysplasia"	1	126	340	466
"L82"	"A63"	"Seborrheic keratosis"	"Oth predominantly sexually transmitted diseases, NEC"	1	18	100	118
"H25"	"H72"	"Age-related cataract"	"Perforation of tympanic membrane"	1	162	401	563
"C73"	"M62"	"Malignant neoplasm of thyroid gland"	"Other disorders of muscle"	1	24	82	106
"H61"	"K40"	"Other disorders of external ear"	"Inguinal hernia"	1	160	281	441
"C80"	"I42"	"Malignant neoplasm without specification of site"	"Cardiomyopathy"	1	6	58	64
"O99"	"D16"	"Oth maternal diseases classd elsw but compl preg/chldbrth"	"Benign neoplasm of bone and articular cartilage"	1	57	206	263
"C67"	"M65"	"Malignant neoplasm of bladder"	"Synovitis and tenosynovitis"	1	31	173	204
"B18"	"O68"	"Chronic viral hepatitis"	"Labor and delivery comp by abnlt of fetal acid-base balance"	1	45	144	189
"H91"	"N95"	"Other and unspecified hearing loss"	"Menopausal and other perimenopausal disorders"	1	1096	1634	2730
"E87"	"C90"	"Other disorders of fluid, electrolyte and acid-base balance"	"Multiple myeloma and malignant plasma cell neoplasms"	1	146	320	466
"M35"	"M62"	"Other systemic involvement of connective tissue"	"Other disorders of muscle"	1	1525	1873	3398
"D04"	"M06"	"Carcinoma in situ of skin"	"Other rheumatoid arthritis"	1	8	58	66
"E64"	"H02"	"Sequelae of malnutrition and other nutritional deficiencies"	"Other disorders of eyelid"	1	41	139	180
"J32"	"O23"	"Chronic sinusitis"	"Infections of genitourinary tract in pregnancy"	1	33	94	127
"M85"	"E10"	"Other disorders of bone density and structure"	"Type 1 diabetes mellitus"	1	149	737	886
"A41"	"O32"	"Other sepsis"	"Maternal care for malpresentation of fetus"	1	5	96	101
"G93"	"H83"	"Other disorders of brain"	"Other diseases of inner ear"	1	7	98	105
"K59"	"N47"	"Other functional intestinal disorders"	"Disorders of prepuce"	1	828	1182	2010
"K20"	"H66"	"Esophagitis"	"Suppurative and unspecified otitis media"	1	34	113	147
"L98"	"N92"	"Oth disorders of skin, subcu, not elsewhere classified"	"Excessive, frequent and irregular menstruation"	1	125	545	670
"M81"	"H10"	"Osteoporosis without current pathological fracture"	"Conjunctivitis"	1	72	1065	1137
"N31"	"J35"	"Neuromuscular dysfunction of bladder, NEC"	"Chronic diseases of tonsils and adenoids"	1	20	103	123
"D47"	"E78"	"Oth neoplm of uncrt behav of lymphoid, hematpoetc & rel tiss"	"Disorders of lipoprotein metabolism and other lipidemias"	1	183	816	999
"I10"	"O91"	"Essential (primary) hypertension"	"Infect of breast assoc w pregnancy, the puerp and lactation"	1	4	102	106
"M80"	"D16"	"Osteoporosis with current pathological fracture"	"Benign neoplasm of bone and articular cartilage"	1	7	53	60
"J96"	"J41"	"Respiratory failure, not elsewhere classified"	"Simple and mucopurulent chronic bronchitis"	1	530	1317	1847
"C80"	"N95"	"Malignant neoplasm without specification of site"	"Menopausal and other perimenopausal disorders"	1	1	130	131
"N95"	"D24"	"Menopausal and other perimenopausal disorders"	"Benign neoplasm of breast"	1	107	653	760
"M16"	"G44"	"Osteoarthritis of hip"	"Other headache syndromes"	1	251	394	645
"M70"	"N84"	"Soft tissue disorders related to use, overuse and pressure"	"Polyp of female genital tract"	1	195	325	520
"I67"	"N92"	"Other cerebrovascular diseases"	"Excessive, frequent and irregular menstruation"	1	16	274	290
"O21"	"H65"	"Excessive vomiting in pregnancy"	"Nonsuppurative otitis media"	1	6	54	60
"C78"	"N64"	"Secondary malignant neoplasm of resp and digestive organs"	"Other disorders of breast"	1	7	191	198
"G47"	"O60"	"Sleep disorders"	"Preterm labor"	1	0	30	30
"M75"	"F50"	"Shoulder lesions"	"Eating disorders"	1	13	58	71
"N17"	"M51"	"Acute kidney failure"	"Thoracic, thoracolum, and lumbosacral intvrt disc disorders"	1	0	810	810
"J44"	"L93"	"Other chronic obstructive pulmonary disease"	"Lupus erythematosus"	1	48	144	192
"J11"	"J20"	"Influenza due to unidentified influenza virus"	"Acute bronchitis"	1	303	573	876
"K90"	"M23"	"Intestinal malabsorption"	"Internal derangement of knee"	1	129	296	425
"G14"	"B91"	"Postpolio syndrome"	"Sequelae of poliomyelitis"	1	0	68	68
"D68"	"M17"	"Other coagulation defects"	"Osteoarthritis of knee"	1	261	550	811
"C22"	"J43"	"Malignant neoplasm of liver and intrahepatic bile ducts"	"Emphysema"	1	5	48	53
"I69"	"K57"	"Sequelae of cerebrovascular disease"	"Diverticular disease of intestine"	1	2411	3556	5967
"J44"	"M89"	"Other chronic obstructive pulmonary disease"	"Other disorders of bone"	1	294	672	966
"E85"	"M16"	"Amyloidosis"	"Osteoarthritis of hip"	1	4	63	67
"M48"	"M23"	"Other spondylopathies"	"Internal derangement of knee"	1	0	4101	4101
"O13"	"J35"	"Gestational hypertension without significant proteinuria"	"Chronic diseases of tonsils and adenoids"	1	0	251	251
"H91"	"N85"	"Other and unspecified hearing loss"	"Other noninflammatory disorders of uterus, except cervix"	1	66	194	260
"H47"	"O20"	"Other disorders of optic [2nd] nerve and visual pathways"	"Hemorrhage in early pregnancy"	1	7	45	52
"A41"	"A09"	"Other sepsis"	"Infectious gastroenteritis and colitis, unspecified"	1	3163	4451	7614
"J18"	"C62"	"Pneumonia, unspecified organism"	"Malignant neoplasm of testis"	1	46	269	315
"D64"	"K41"	"Other anemias"	"Femoral hernia"	1	79	269	348
"M76"	"Q17"	"Enthesopathies, lower limb, excluding foot"	"Other congenital malformations of ear"	1	4	98	102
"E89"	"A63"	"Postproc endocrine and metabolic comp and disorders, NEC"	"Oth predominantly sexually transmitted diseases, NEC"	1	0	53	53
"O91"	"O45"	"Infect of breast assoc w pregnancy, the puerp and lactation"	"Premature separation of placenta [abruptio placentae]"	1	63	170	233
"K04"	"J30"	"Diseases of pulp and periapical tissues"	"Vasomotor and allergic rhinitis"	1	38	135	173
"E13"	"D24"	"Other specified diabetes mellitus"	"Benign neoplasm of breast"	1	1	34	35
"D25"	"O68"	"Leiomyoma of uterus"	"Labor and delivery comp by abnlt of fetal acid-base balance"	1	0	825	825
"N28"	"K29"	"Oth disorders of kidney and ureter, not elsewhere classified"	"Gastritis and duodenitis"	1	207	670	877
"I26"	"H91"	"Pulmonary embolism"	"Other and unspecified hearing loss"	1	0	3847	3847
"C95"	"K40"	"Leukemia of unspecified cell type"	"Inguinal hernia"	1	17	100	117
"I35"	"M77"	"Nonrheumatic aortic valve disorders"	"Other enthesopathies"	1	38	471	509
"K30"	"B27"	"Functional dyspepsia"	"Infectious mononucleosis"	1	20	134	154
"M47"	"N70"	"Spondylosis"	"Salpingitis and oophoritis"	1	0	175	175
"O72"	"Q83"	"Postpartum hemorrhage"	"Congenital malformations of breast"	1	128	453	581
"N18"	"H83"	"Chronic kidney disease (CKD)"	"Other diseases of inner ear"	1	0	903	903
"J43"	"O62"	"Emphysema"	"Abnormalities of forces of labor"	1	0	34	34
"N18"	"C18"	"Chronic kidney disease (CKD)"	"Malignant neoplasm of colon"	1	421	985	1406
"C78"	"D21"	"Secondary malignant neoplasm of resp and digestive organs"	"Other benign neoplasms of connective and other soft tissue"	1	14	178	192
"J15"	"J20"	"Bacterial pneumonia, not elsewhere classified"	"Acute bronchitis"	1	1352	3063	4415
"C34"	"G35"	"Malignant neoplasm of bronchus and lung"	"Multiple sclerosis"	1	2	124	126
"I89"	"C02"	"Oth noninfective disorders of lymphatic vessels and nodes"	"Malignant neoplasm of other and unspecified parts of tongue"	1	22	89	111
"J06"	"I63"	"Acute upper resp infections of multiple and unsp sites"	"Cerebral infarction"	1	121	277	398
"D63"	"C91"	"Anemia in chronic diseases classified elsewhere"	"Lymphoid leukemia"	1	167	542	709
"I70"	"M50"	"Atherosclerosis"	"Cervical disc disorders"	1	186	670	856
"K57"	"M35"	"Diverticular disease of intestine"	"Other systemic involvement of connective tissue"	1	976	1438	2414
"I72"	"O70"	"Other aneurysm"	"Perineal laceration during delivery"	1	4	34	38
"F03"	"J43"	"Unspecified dementia"	"Emphysema"	1	118	392	510
"J69"	"M75"	"Pneumonitis due to solids and liquids"	"Shoulder lesions"	1	0	252	252
"M48"	"I25"	"Other spondylopathies"	"Chronic ischemic heart disease"	1	2776	3516	6292
"E78"	"K29"	"Disorders of lipoprotein metabolism and other lipidemias"	"Gastritis and duodenitis"	1	3209	4298	7507
"M10"	"J32"	"Gout"	"Chronic sinusitis"	1	36	111	147
"I50"	"M72"	"Heart failure"	"Fibroblastic disorders"	1	249	1638	1887
"J22"	"M05"	"Unspecified acute lower respiratory infection"	"Rheumatoid arthritis with rheumatoid factor"	1	19	171	190
"C83"	"F10"	"Non-follicular lymphoma"	"Alcohol related disorders"	1	32	154	186
"O32"	"Q17"	"Maternal care for malpresentation of fetus"	"Other congenital malformations of ear"	1	0	44	44
"D47"	"I49"	"Oth neoplm of uncrt behav of lymphoid, hematpoetc & rel tiss"	"Other cardiac arrhythmias"	1	84	222	306
"D64"	"O02"	"Other anemias"	"Other abnormal products of conception"	1	11	388	399
"J01"	"M22"	"Acute sinusitis"	"Disorder of patella"	1	20	231	251
"D63"	"K51"	"Anemia in chronic diseases classified elsewhere"	"Ulcerative colitis"	1	44	261	305
"K25"	"D06"	"Gastric ulcer"	"Carcinoma in situ of cervix uteri"	1	0	55	55
"C77"	"H93"	"Secondary and unspecified malignant neoplasm of lymph nodes"	"Other disorders of ear, not elsewhere classified"	1	70	366	436
"K92"	"D17"	"Other diseases of digestive system"	"Benign lipomatous neoplasm"	1	145	419	564
"I69"	"M53"	"Sequelae of cerebrovascular disease"	"Other and unspecified dorsopathies, not elsewhere classified"	1	190	422	612
"O66"	"L20"	"Other obstructed labor"	"Atopic dermatitis"	1	3	32	35
"E66"	"K01"	"Overweight and obesity"	"Embedded and impacted teeth"	1	13	378	391
"J14"	"M20"	"Pneumonia due to Hemophilus influenzae"	"Acquired deformities of fingers and toes"	1	3	47	50
"A04"	"E11"	"Other bacterial intestinal infections"	"Type 2 diabetes mellitus"	1	374	1825	2199
"N39"	"H00"	"Other disorders of urinary system"	"Hordeolum and chalazion"	1	98	241	339
"I15"	"M22"	"Secondary hypertension"	"Disorder of patella"	1	0	92	92
"I34"	"D27"	"Nonrheumatic mitral valve disorders"	"Benign neoplasm of ovary"	1	30	129	159
"C34"	"H27"	"Malignant neoplasm of bronchus and lung"	"Other disorders of lens"	1	1	187	188
"M70"	"D27"	"Soft tissue disorders related to use, overuse and pressure"	"Benign neoplasm of ovary"	1	82	293	375
"C34"	"M65"	"Malignant neoplasm of bronchus and lung"	"Synovitis and tenosynovitis"	1	0	940	940
"M54"	"Q53"	"Dorsalgia"	"Undescended and ectopic testicle"	1	0	242	242
"C78"	"L57"	"Secondary malignant neoplasm of resp and digestive organs"	"Skin changes due to chronic expsr to nonionizing radiation"	1	51	196	247
"N92"	"O03"	"Excessive, frequent and irregular menstruation"	"Spontaneous abortion"	1	0	4881	4881
"G12"	"K21"	"Spinal muscular atrophy and related syndromes"	"Gastro-esophageal reflux disease"	1	15	76	91
"C64"	"Q61"	"Malignant neoplasm of kidney, except renal pelvis"	"Cystic kidney disease"	1	80	212	292
"C79"	"H52"	"Secondary malignant neoplasm of other and unspecified sites"	"Disorders of refraction and accommodation"	1	33	182	215
"N13"	"K11"	"Obstructive and reflux uropathy"	"Diseases of salivary glands"	1	31	86	117
"N19"	"N97"	"Unspecified kidney failure"	"Female infertility"	1	4	39	43
"I87"	"J35"	"Other disorders of veins"	"Chronic diseases of tonsils and adenoids"	1	0	43	43
"H36"	"O34"	"Retinal disorders in diseases classified elsewhere"	"Maternal care for abnormality of pelvic organs"	1	17	71	88
"G40"	"F10"	"Epilepsy and recurrent seizures"	"Alcohol related disorders"	1	3762	4841	8603
"J91"	"M48"	"Pleural effusion in conditions classified elsewhere"	"Other spondylopathies"	1	68	197	265
"G20"	"N92"	"Parkinson's disease"	"Excessive, frequent and irregular menstruation"	1	0	97	97
"F33"	"G50"	"Major depressive disorder, recurrent"	"Disorders of trigeminal nerve"	1	30	99	129
"K05"	"M23"	"Gingivitis and periodontal diseases"	"Internal derangement of knee"	1	174	498	672
"B44"	"N40"	"Aspergillosis"	"Benign prostatic hyperplasia"	1	2	41	43
"N03"	"O80"	"Chronic nephritic syndrome"	"Encounter for full-term uncomplicated delivery"	1	28	82	110
"F43"	"M22"	"Reaction to severe stress, and adjustment disorders"	"Disorder of patella"	1	55	412	467
"K20"	"O48"	"Esophagitis"	"Late pregnancy"	1	2	41	43
"C61"	"I70"	"Malignant neoplasm of prostate"	"Atherosclerosis"	1	497	921	1418
"J69"	"G56"	"Pneumonitis due to solids and liquids"	"Mononeuropathies of upper limb"	1	1	260	261
"J10"	"H36"	"Influenza due to other identified influenza virus"	"Retinal disorders in diseases classified elsewhere"	1	2	48	50
"K63"	"N47"	"Other diseases of intestine"	"Disorders of prepuce"	1	38	109	147
"A49"	"D45"	"Bacterial infection of unspecified site"	"Polycythemia vera"	1	9	79	88
"G20"	"M65"	"Parkinson's disease"	"Synovitis and tenosynovitis"	1	5	155	160
"F41"	"M71"	"Other anxiety disorders"	"Other bursopathies"	1	16	134	150
"N18"	"E03"	"Chronic kidney disease (CKD)"	"Other hypothyroidism"	1	1085	1599	2684
"G47"	"M35"	"Sleep disorders"	"Other systemic involvement of connective tissue"	1	236	614	850
"F43"	"O14"	"Reaction to severe stress, and adjustment disorders"	"Pre-eclampsia"	1	16	206	222
"M81"	"H93"	"Osteoporosis without current pathological fracture"	"Other disorders of ear, not elsewhere classified"	1	0	2298	2298
"O32"	"H65"	"Maternal care for malpresentation of fetus"	"Nonsuppurative otitis media"	1	10	68	78
"K08"	"F10"	"Other disorders of teeth and supporting structures"	"Alcohol related disorders"	1	252	885	1137
"L97"	"K86"	"Non-pressure chronic ulcer of lower limb, NEC"	"Other diseases of pancreas"	1	45	208	253
"I46"	"G51"	"Cardiac arrest"	"Facial nerve disorders"	1	0	115	115
"D63"	"K60"	"Anemia in chronic diseases classified elsewhere"	"Fissure and fistula of anal and rectal regions"	1	33	181	214
"O66"	"M22"	"Other obstructed labor"	"Disorder of patella"	1	23	196	219
"A49"	"K57"	"Bacterial infection of unspecified site"	"Diverticular disease of intestine"	1	671	2236	2907
"C25"	"L90"	"Malignant neoplasm of pancreas"	"Atrophic disorders of skin"	1	3	46	49
"E55"	"O26"	"Vitamin D deficiency"	"Maternal care for oth conditions predom related to pregnancy"	1	63	397	460
"G63"	"D25"	"Polyneuropathy in diseases classified elsewhere"	"Leiomyoma of uterus"	1	3	35	38
"J09"	"J44"	"Influenza due to certain identified influenza viruses"	"Other chronic obstructive pulmonary disease"	1	173	562	735
"M53"	"D24"	"Other and unspecified dorsopathies, not elsewhere classified"	"Benign neoplasm of breast"	1	74	194	268
"E86"	"M16"	"Volume depletion"	"Osteoarthritis of hip"	1	0	7088	7088
"J90"	"I35"	"Pleural effusion, not elsewhere classified"	"Nonrheumatic aortic valve disorders"	1	912	1934	2846
"C79"	"E78"	"Secondary malignant neoplasm of other and unspecified sites"	"Disorders of lipoprotein metabolism and other lipidemias"	1	0	2560	2560
"O36"	"L05"	"Maternal care for other fetal problems"	"Pilonidal cyst and sinus"	1	17	205	222
"M80"	"H66"	"Osteoporosis with current pathological fracture"	"Suppurative and unspecified otitis media"	1	0	135	135
"E87"	"M70"	"Other disorders of fluid, electrolyte and acid-base balance"	"Soft tissue disorders related to use, overuse and pressure"	1	153	1069	1222
"A41"	"C43"	"Other sepsis"	"Malignant melanoma of skin"	1	166	673	839
"E87"	"M22"	"Other disorders of fluid, electrolyte and acid-base balance"	"Disorder of patella"	1	0	166	166
"E87"	"H52"	"Other disorders of fluid, electrolyte and acid-base balance"	"Disorders of refraction and accommodation"	1	92	413	505
"M16"	"H72"	"Osteoarthritis of hip"	"Perforation of tympanic membrane"	1	63	147	210
"C64"	"D30"	"Malignant neoplasm of kidney, except renal pelvis"	"Benign neoplasm of urinary organs"	1	267	410	677
"I80"	"H91"	"Phlebitis and thrombophlebitis"	"Other and unspecified hearing loss"	1	1937	3836	5773
"K02"	"N92"	"Dental caries"	"Excessive, frequent and irregular menstruation"	1	150	268	418
"C16"	"M24"	"Malignant neoplasm of stomach"	"Other specific joint derangements"	1	1	27	28
"I27"	"I48"	"Other pulmonary heart diseases"	"Atrial fibrillation and flutter"	1	2008	3350	5358
"C78"	"O26"	"Secondary malignant neoplasm of resp and digestive organs"	"Maternal care for oth conditions predom related to pregnancy"	1	0	26	26
"D17"	"Q17"	"Benign lipomatous neoplasm"	"Other congenital malformations of ear"	1	4	48	52
"C78"	"K11"	"Secondary malignant neoplasm of resp and digestive organs"	"Diseases of salivary glands"	1	9	157	166
"J15"	"O13"	"Bacterial pneumonia, not elsewhere classified"	"Gestational hypertension without significant proteinuria"	1	9	68	77
"I69"	"F48"	"Sequelae of cerebrovascular disease"	"Other nonpsychotic mental disorders"	1	44	145	189
"C64"	"H10"	"Malignant neoplasm of kidney, except renal pelvis"	"Conjunctivitis"	1	1	85	86
"E04"	"O13"	"Other nontoxic goiter"	"Gestational hypertension without significant proteinuria"	1	17	143	160
"L89"	"I10"	"Pressure ulcer"	"Essential (primary) hypertension"	1	0	6258	6258
"D62"	"I25"	"Acute posthemorrhagic anemia"	"Chronic ischemic heart disease"	1	1420	3100	4520
"C78"	"K90"	"Secondary malignant neoplasm of resp and digestive organs"	"Intestinal malabsorption"	1	40	107	147
"I63"	"L03"	"Cerebral infarction"	"Cellulitis and acute lymphangitis"	1	105	762	867
"D25"	"O60"	"Leiomyoma of uterus"	"Preterm labor"	1	0	72	72
"J96"	"D75"	"Respiratory failure, not elsewhere classified"	"Other and unsp diseases of blood and blood-forming organs"	1	303	574	877
"N13"	"C67"	"Obstructive and reflux uropathy"	"Malignant neoplasm of bladder"	1	1449	2534	3983
"D63"	"J41"	"Anemia in chronic diseases classified elsewhere"	"Simple and mucopurulent chronic bronchitis"	1	20	103	123
"B37"	"G45"	"Candidiasis"	"Transient cerebral ischemic attacks and related syndromes"	1	200	633	833
"M19"	"D28"	"Other and unspecified osteoarthritis"	"Benign neoplasm of other and unsp female genital organs"	1	3	104	107
"F60"	"O00"	"Specific personality disorders"	"Ectopic pregnancy"	1	10	57	67
"N19"	"M62"	"Unspecified kidney failure"	"Other disorders of muscle"	1	74	813	887
"J96"	"N87"	"Respiratory failure, not elsewhere classified"	"Dysplasia of cervix uteri"	1	0	222	222
"G95"	"K62"	"Other and unspecified diseases of spinal cord"	"Other diseases of anus and rectum"	1	152	295	447
"I46"	"K11"	"Cardiac arrest"	"Diseases of salivary glands"	1	2	96	98
"K05"	"J45"	"Gingivitis and periodontal diseases"	"Asthma"	1	193	460	653
"K62"	"H72"	"Other diseases of anus and rectum"	"Perforation of tympanic membrane"	1	64	153	217
"J69"	"N81"	"Pneumonitis due to solids and liquids"	"Female genital prolapse"	1	0	130	130
"C18"	"M19"	"Malignant neoplasm of colon"	"Other and unspecified osteoarthritis"	1	672	889	1561
"F06"	"M65"	"Other mental disorders due to known physiological condition"	"Synovitis and tenosynovitis"	1	2	116	118
"E34"	"N47"	"Other endocrine disorders"	"Disorders of prepuce"	1	53	154	207
"A41"	"M93"	"Other sepsis"	"Other osteochondropathies"	1	0	62	62
"D63"	"C43"	"Anemia in chronic diseases classified elsewhere"	"Malignant melanoma of skin"	1	42	390	432
"K59"	"I73"	"Other functional intestinal disorders"	"Other peripheral vascular diseases"	1	1599	3151	4750
"G35"	"N97"	"Multiple sclerosis"	"Female infertility"	1	44	166	210
"L30"	"O03"	"Other and unspecified dermatitis"	"Spontaneous abortion"	1	16	264	280
"K86"	"M23"	"Other diseases of pancreas"	"Internal derangement of knee"	1	108	363	471
"D46"	"C85"	"Myelodysplastic syndromes"	"Oth and unspecified types of non-Hodgkin lymphoma"	1	26	92	118
"I31"	"K08"	"Other diseases of pericardium"	"Other disorders of teeth and supporting structures"	1	36	116	152
"I10"	"M76"	"Essential (primary) hypertension"	"Enthesopathies, lower limb, excluding foot"	1	1412	2144	3556
"O70"	"M92"	"Perineal laceration during delivery"	"Other juvenile osteochondrosis"	1	0	112	112
"M50"	"O46"	"Cervical disc disorders"	"Antepartum hemorrhage, not elsewhere classified"	1	0	77	77
"I46"	"M76"	"Cardiac arrest"	"Enthesopathies, lower limb, excluding foot"	1	0	115	115
"G21"	"G20"	"Secondary parkinsonism"	"Parkinson's disease"	1	695	1324	2019
"J96"	"E78"	"Respiratory failure, not elsewhere classified"	"Disorders of lipoprotein metabolism and other lipidemias"	1	0	10810	10810
"H35"	"M05"	"Other retinal disorders"	"Rheumatoid arthritis with rheumatoid factor"	1	307	653	960
"N18"	"M16"	"Chronic kidney disease (CKD)"	"Osteoarthritis of hip"	1	0	3011	3011
"C18"	"F10"	"Malignant neoplasm of colon"	"Alcohol related disorders"	1	409	864	1273
"J90"	"H80"	"Pleural effusion, not elsewhere classified"	"Otosclerosis"	1	0	62	62
"D25"	"O80"	"Leiomyoma of uterus"	"Encounter for full-term uncomplicated delivery"	1	0	1808	1808
"I89"	"N94"	"Oth noninfective disorders of lymphatic vessels and nodes"	"Pain and oth cond assoc w fem gntl org and menstrual cycle"	1	14	77	91
"K08"	"M65"	"Other disorders of teeth and supporting structures"	"Synovitis and tenosynovitis"	1	125	248	373
"K74"	"I25"	"Fibrosis and cirrhosis of liver"	"Chronic ischemic heart disease"	1	364	621	985
"I26"	"N92"	"Pulmonary embolism"	"Excessive, frequent and irregular menstruation"	1	114	516	630
"O73"	"O47"	"Retained placenta and membranes, without hemorrhage"	"False labor"	1	373	853	1226
"D47"	"D12"	"Oth neoplm of uncrt behav of lymphoid, hematpoetc & rel tiss"	"Benign neoplasm of colon, rectum, anus and anal canal"	1	176	436	612
"L89"	"M81"	"Pressure ulcer"	"Osteoporosis without current pathological fracture"	1	555	1503	2058
"M50"	"D27"	"Cervical disc disorders"	"Benign neoplasm of ovary"	1	119	283	402
"O65"	"A63"	"Obstructed labor due to maternal pelvic abnormality"	"Oth predominantly sexually transmitted diseases, NEC"	1	137	284	421
"C45"	"M79"	"Mesothelioma"	"Oth and unsp soft tissue disorders, not elsewhere classified"	1	7	59	66
"D43"	"M16"	"Neoplasm of uncertain behavior of brain and cnsl"	"Osteoarthritis of hip"	1	31	150	181
"C71"	"I70"	"Malignant neoplasm of brain"	"Atherosclerosis"	1	32	217	249
"K04"	"I34"	"Diseases of pulp and periapical tissues"	"Nonrheumatic mitral valve disorders"	1	525	744	1269
"O92"	"A09"	"Oth disord of brst/lactatn assoc w pregnancy and the puerp"	"Infectious gastroenteritis and colitis, unspecified"	1	69	272	341
"K72"	"K29"	"Hepatic failure, not elsewhere classified"	"Gastritis and duodenitis"	1	277	1263	1540
"I26"	"D27"	"Pulmonary embolism"	"Benign neoplasm of ovary"	1	59	256	315
"H02"	"E11"	"Other disorders of eyelid"	"Type 2 diabetes mellitus"	1	1099	1591	2690
"O36"	"O02"	"Maternal care for other fetal problems"	"Other abnormal products of conception"	1	2654	5423	8077
"A40"	"D17"	"Streptococcal sepsis"	"Benign lipomatous neoplasm"	1	9	50	59
"K08"	"O20"	"Other disorders of teeth and supporting structures"	"Hemorrhage in early pregnancy"	1	36	125	161
"H35"	"L20"	"Other retinal disorders"	"Atopic dermatitis"	1	19	74	93
"M81"	"O36"	"Osteoporosis without current pathological fracture"	"Maternal care for other fetal problems"	1	0	92	92
"D70"	"O80"	"Neutropenia"	"Encounter for full-term uncomplicated delivery"	1	0	49	49
"M85"	"F10"	"Other disorders of bone density and structure"	"Alcohol related disorders"	1	126	866	992
"A46"	"N40"	"Erysipelas"	"Benign prostatic hyperplasia"	1	657	1779	2436
"O82"	"O24"	"Encounter for cesarean delivery without indication"	"Diabetes in pregnancy, childbirth, and the puerperium"	1	3748	6616	10364
"D83"	"J20"	"Common variable immunodeficiency"	"Acute bronchitis"	1	22	138	160
"M17"	"O64"	"Osteoarthritis of knee"	"Obstructed labor due to malposition and malpresent of fetus"	1	0	116	116
"I80"	"O47"	"Phlebitis and thrombophlebitis"	"False labor"	1	59	270	329
"G30"	"K56"	"Alzheimer's disease"	"Paralytic ileus and intestinal obstruction without hernia"	1	93	191	284
"N90"	"O62"	"Other noninflammatory disorders of vulva and perineum"	"Abnormalities of forces of labor"	1	214	1011	1225
"J06"	"Q21"	"Acute upper resp infections of multiple and unsp sites"	"Congenital malformations of cardiac septa"	1	242	767	1009
"F33"	"C61"	"Major depressive disorder, recurrent"	"Malignant neoplasm of prostate"	1	121	276	397
"J84"	"F10"	"Other interstitial pulmonary diseases"	"Alcohol related disorders"	1	112	421	533
"E87"	"Q18"	"Other disorders of fluid, electrolyte and acid-base balance"	"Other congenital malformations of face and neck"	1	0	66	66
"C56"	"K80"	"Malignant neoplasm of ovary"	"Cholelithiasis"	1	165	286	451
"I86"	"O04"	"Varicose veins of other sites"	"Complications following (induced) termination of pregnancy"	1	0	47	47
"N30"	"J35"	"Cystitis"	"Chronic diseases of tonsils and adenoids"	1	462	1965	2427
"E64"	"H90"	"Sequelae of malnutrition and other nutritional deficiencies"	"Conductive and sensorineural hearing loss"	1	39	193	232
"K29"	"O14"	"Gastritis and duodenitis"	"Pre-eclampsia"	1	71	147	218
"M67"	"O71"	"Other disorders of synovium and tendon"	"Other obstetric trauma"	1	158	512	670
"D63"	"C44"	"Anemia in chronic diseases classified elsewhere"	"Other and unspecified malignant neoplasm of skin"	1	191	683	874
"C71"	"C18"	"Malignant neoplasm of brain"	"Malignant neoplasm of colon"	1	59	182	241
"C38"	"H91"	"Malignant neoplasm of heart, mediastinum and pleura"	"Other and unspecified hearing loss"	1	29	137	166
"O99"	"L04"	"Oth maternal diseases classd elsw but compl preg/chldbrth"	"Acute lymphadenitis"	1	49	159	208
"L59"	"C06"	"Oth disorders of skin, subcu related to radiation"	"Malignant neoplasm of other and unspecified parts of mouth"	1	4	43	47
"I46"	"J01"	"Cardiac arrest"	"Acute sinusitis"	1	0	62	62
"B37"	"N43"	"Candidiasis"	"Hydrocele and spermatocele"	1	34	101	135
"B02"	"F10"	"Zoster [herpes zoster]"	"Alcohol related disorders"	1	73	245	318
"O87"	"M22"	"Venous complications and hemorrhoids in the puerperium"	"Disorder of patella"	1	3	65	68
"A41"	"K29"	"Other sepsis"	"Gastritis and duodenitis"	1	0	6297	6297
"A41"	"G45"	"Other sepsis"	"Transient cerebral ischemic attacks and related syndromes"	1	0	4991	4991
"I72"	"M51"	"Other aneurysm"	"Thoracic, thoracolum, and lumbosacral intvrt disc disorders"	1	49	304	353
"K44"	"F10"	"Diaphragmatic hernia"	"Alcohol related disorders"	1	1153	2080	3233
"M24"	"Q17"	"Other specific joint derangements"	"Other congenital malformations of ear"	1	13	79	92
"E87"	"M25"	"Other disorders of fluid, electrolyte and acid-base balance"	"Other joint disorder, not elsewhere classified"	1	267	926	1193
"D04"	"M23"	"Carcinoma in situ of skin"	"Internal derangement of knee"	1	10	79	89
"C44"	"M67"	"Other and unspecified malignant neoplasm of skin"	"Other disorders of synovium and tendon"	1	126	480	606
"O04"	"O69"	"Complications following (induced) termination of pregnancy"	"Labor and delivery complicated by umbilical cord comp"	1	116	210	326
"I31"	"K35"	"Other diseases of pericardium"	"Acute appendicitis"	1	2	58	60
"A49"	"N00"	"Bacterial infection of unspecified site"	"Acute nephritic syndrome"	1	50	150	200
"I46"	"I95"	"Cardiac arrest"	"Hypotension"	1	426	659	1085
"C13"	"M10"	"Malignant neoplasm of hypopharynx"	"Gout"	1	2	33	35
"K75"	"M23"	"Other inflammatory liver diseases"	"Internal derangement of knee"	1	31	121	152
"K57"	"N46"	"Diverticular disease of intestine"	"Male infertility"	1	0	152	152
"K70"	"K58"	"Alcoholic liver disease"	"Irritable bowel syndrome"	1	102	233	335
"I46"	"A69"	"Cardiac arrest"	"Other spirochetal infections"	1	0	30	30
"K86"	"F10"	"Other diseases of pancreas"	"Alcohol related disorders"	1	1633	2900	4533
"D17"	"J35"	"Benign lipomatous neoplasm"	"Chronic diseases of tonsils and adenoids"	1	48	459	507
"G62"	"N87"	"Other and unspecified polyneuropathies"	"Dysplasia of cervix uteri"	1	0	84	84
"N18"	"I86"	"Chronic kidney disease (CKD)"	"Varicose veins of other sites"	1	15	62	77
"K55"	"C54"	"Vascular disorders of intestine"	"Malignant neoplasm of corpus uteri"	1	3	40	43
"K59"	"G61"	"Other functional intestinal disorders"	"Inflammatory polyneuropathy"	1	69	193	262
"E04"	"O02"	"Other nontoxic goiter"	"Other abnormal products of conception"	1	54	770	824
"M81"	"J05"	"Osteoporosis without current pathological fracture"	"Acute obstructive laryngitis [croup] and epiglottitis"	1	0	42	42
"H95"	"H71"	"Intraop and postproc comp and disorders of ear/mastd, NEC"	"Cholesteatoma of middle ear"	1	2	261	263
"A41"	"H72"	"Other sepsis"	"Perforation of tympanic membrane"	1	31	211	242
"F32"	"M47"	"Depressive episode"	"Spondylosis"	1	784	1401	2185
"O90"	"O70"	"Complications of the puerperium, not elsewhere classified"	"Perineal laceration during delivery"	1	0	15163	15163
"M25"	"O04"	"Other joint disorder, not elsewhere classified"	"Complications following (induced) termination of pregnancy"	1	0	1750	1750
"I51"	"M32"	"Complications and ill-defined descriptions of heart disease"	"Systemic lupus erythematosus (SLE)"	1	5	39	44
"I46"	"I42"	"Cardiac arrest"	"Cardiomyopathy"	1	637	964	1601
"F03"	"K91"	"Unspecified dementia"	"Intraop and postproc comp and disorders of dgstv sys, NEC"	1	40	135	175
"G47"	"D13"	"Sleep disorders"	"Benign neoplasm of and ill-defined parts of digestive system"	1	102	189	291
"N39"	"I45"	"Other disorders of urinary system"	"Other conduction disorders"	1	547	971	1518
"E86"	"O82"	"Volume depletion"	"Encounter for cesarean delivery without indication"	1	94	307	401
"O86"	"O14"	"Other puerperal infections"	"Pre-eclampsia"	1	638	1089	1727
"N13"	"O03"	"Obstructive and reflux uropathy"	"Spontaneous abortion"	1	45	274	319
"M16"	"D17"	"Osteoarthritis of hip"	"Benign lipomatous neoplasm"	1	484	975	1459
"F32"	"M16"	"Depressive episode"	"Osteoarthritis of hip"	1	696	2211	2907
"N63"	"N97"	"Unspecified lump in breast"	"Female infertility"	1	165	742	907
"H36"	"M42"	"Retinal disorders in diseases classified elsewhere"	"Spinal osteochondrosis"	1	0	35	35
"B01"	"B34"	"Varicella [chickenpox]"	"Viral infection of unspecified site"	1	509	747	1256
"N19"	"I35"	"Unspecified kidney failure"	"Nonrheumatic aortic valve disorders"	1	1170	1473	2643
"C56"	"N84"	"Malignant neoplasm of ovary"	"Polyp of female genital tract"	1	30	251	281
"C25"	"I15"	"Malignant neoplasm of pancreas"	"Secondary hypertension"	1	27	100	127
"K55"	"I34"	"Vascular disorders of intestine"	"Nonrheumatic mitral valve disorders"	1	77	164	241
"D24"	"D48"	"Benign neoplasm of breast"	"Neoplasm of uncertain behavior of other and unsp sites"	1	420	1045	1465
"G91"	"K80"	"Hydrocephalus"	"Cholelithiasis"	1	81	162	243
"N18"	"I26"	"Chronic kidney disease (CKD)"	"Pulmonary embolism"	1	826	1191	2017
"I49"	"H65"	"Other cardiac arrhythmias"	"Nonsuppurative otitis media"	1	38	240	278
"J96"	"H25"	"Respiratory failure, not elsewhere classified"	"Age-related cataract"	1	0	16962	16962
"J95"	"E78"	"Intraop and postproc comp and disorders of resp sys, NEC"	"Disorders of lipoprotein metabolism and other lipidemias"	1	147	460	607
"K62"	"J20"	"Other diseases of anus and rectum"	"Acute bronchitis"	1	319	767	1086
"B96"	"M35"	"Oth bacterial agents as the cause of diseases classd elswhr"	"Other systemic involvement of connective tissue"	1	24	120	144
"I27"	"D17"	"Other pulmonary heart diseases"	"Benign lipomatous neoplasm"	1	27	122	149
"M81"	"F45"	"Osteoporosis without current pathological fracture"	"Somatoform disorders"	1	52	165	217
"A49"	"D47"	"Bacterial infection of unspecified site"	"Oth neoplm of uncrt behav of lymphoid, hematpoetc & rel tiss"	1	196	321	517
"J70"	"C81"	"Respiratory conditions due to other external agents"	"Hodgkin lymphoma"	1	9	63	72
"I45"	"M17"	"Other conduction disorders"	"Osteoarthritis of knee"	1	278	678	956
"F05"	"K61"	"Delirium due to known physiological condition"	"Abscess of anal and rectal regions"	1	0	125	125
"H25"	"K58"	"Age-related cataract"	"Irritable bowel syndrome"	1	596	2307	2903
"C34"	"I86"	"Malignant neoplasm of bronchus and lung"	"Varicose veins of other sites"	1	6	44	50
"J05"	"Q21"	"Acute obstructive laryngitis [croup] and epiglottitis"	"Congenital malformations of cardiac septa"	1	211	622	833
"I73"	"N80"	"Other peripheral vascular diseases"	"Endometriosis"	1	3	78	81
"B02"	"H83"	"Zoster [herpes zoster]"	"Other diseases of inner ear"	1	21	130	151
"K45"	"O02"	"Other abdominal hernia"	"Other abnormal products of conception"	1	0	115	115
"E86"	"H33"	"Volume depletion"	"Retinal detachments and breaks"	1	0	829	829
"J18"	"K35"	"Pneumonia, unspecified organism"	"Acute appendicitis"	1	1358	2648	4006
"M31"	"D17"	"Other necrotizing vasculopathies"	"Benign lipomatous neoplasm"	1	37	98	135
"F40"	"O70"	"Phobic anxiety disorders"	"Perineal laceration during delivery"	1	166	303	469
"I48"	"L02"	"Atrial fibrillation and flutter"	"Cutaneous abscess, furuncle and carbuncle"	1	1640	2570	4210
"E89"	"C83"	"Postproc endocrine and metabolic comp and disorders, NEC"	"Non-follicular lymphoma"	1	23	75	98
"N03"	"N04"	"Chronic nephritic syndrome"	"Nephrotic syndrome"	1	315	717	1032
"D50"	"E65"	"Iron deficiency anemia"	"Localized adiposity"	1	64	411	475
"N99"	"O62"	"Intraop and postproc comp and disorders of GU sys, NEC"	"Abnormalities of forces of labor"	1	94	1016	1110
"I21"	"K58"	"Acute myocardial infarction"	"Irritable bowel syndrome"	1	400	784	1184
"K42"	"M23"	"Umbilical hernia"	"Internal derangement of knee"	1	673	1415	2088
"H54"	"M23"	"Blindness and low vision"	"Internal derangement of knee"	1	65	289	354
"E16"	"H80"	"Other disorders of pancreatic internal secretion"	"Otosclerosis"	1	1	48	49
"G94"	"N92"	"Other disorders of brain in diseases classified elsewhere"	"Excessive, frequent and irregular menstruation"	1	3	41	44
"G12"	"I20"	"Spinal muscular atrophy and related syndromes"	"Angina pectoris"	1	15	187	202
"E86"	"J44"	"Volume depletion"	"Other chronic obstructive pulmonary disease"	1	0	21913	21913
"N63"	"N87"	"Unspecified lump in breast"	"Dysplasia of cervix uteri"	1	136	494	630
"K55"	"N60"	"Vascular disorders of intestine"	"Benign mammary dysplasia"	1	0	37	37
"C91"	"M23"	"Lymphoid leukemia"	"Internal derangement of knee"	1	42	196	238
"N19"	"J38"	"Unspecified kidney failure"	"Diseases of vocal cords and larynx, not elsewhere classified"	1	43	113	156
"K80"	"O80"	"Cholelithiasis"	"Encounter for full-term uncomplicated delivery"	1	0	15251	15251
"I35"	"E66"	"Nonrheumatic aortic valve disorders"	"Overweight and obesity"	1	1061	2346	3407
"F05"	"M76"	"Delirium due to known physiological condition"	"Enthesopathies, lower limb, excluding foot"	1	0	68	68
"F43"	"M62"	"Reaction to severe stress, and adjustment disorders"	"Other disorders of muscle"	1	467	1175	1642
"K27"	"M16"	"Peptic ulcer, site unspecified"	"Osteoarthritis of hip"	1	230	518	748
"G47"	"C49"	"Sleep disorders"	"Malignant neoplasm of other connective and soft tissue"	1	76	273	349
"C49"	"K80"	"Malignant neoplasm of other connective and soft tissue"	"Cholelithiasis"	1	29	98	127
"C78"	"I47"	"Secondary malignant neoplasm of resp and digestive organs"	"Paroxysmal tachycardia"	1	121	1073	1194
"I71"	"M18"	"Aortic aneurysm and dissection"	"Osteoarthritis of first carpometacarpal joint"	1	27	122	149
"C18"	"M35"	"Malignant neoplasm of colon"	"Other systemic involvement of connective tissue"	1	223	461	684
"N18"	"K50"	"Chronic kidney disease (CKD)"	"Crohn's disease [regional enteritis]"	1	34	367	401
"M23"	"H50"	"Internal derangement of knee"	"Other strabismus"	1	242	479	721
"D64"	"N45"	"Other anemias"	"Orchitis and epididymitis"	1	216	753	969
"K46"	"C20"	"Unspecified abdominal hernia"	"Malignant neoplasm of rectum"	1	24	168	192
"I25"	"O62"	"Chronic ischemic heart disease"	"Abnormalities of forces of labor"	1	0	103	103
"J47"	"H33"	"Bronchiectasis"	"Retinal detachments and breaks"	1	13	56	69
"H91"	"A88"	"Other and unspecified hearing loss"	"Oth viral infections of central nervous system, NEC"	1	99	253	352
"C16"	"I63"	"Malignant neoplasm of stomach"	"Cerebral infarction"	1	129	328	457
"E11"	"K43"	"Type 2 diabetes mellitus"	"Ventral hernia"	1	1305	1613	2918
"J44"	"K51"	"Other chronic obstructive pulmonary disease"	"Ulcerative colitis"	1	538	927	1465
"H40"	"I83"	"Glaucoma"	"Varicose veins of lower extremities"	1	319	582	901
"E66"	"A69"	"Overweight and obesity"	"Other spirochetal infections"	1	50	165	215
"M48"	"J33"	"Other spondylopathies"	"Nasal polyp"	1	41	140	181
"I49"	"D24"	"Other cardiac arrhythmias"	"Benign neoplasm of breast"	1	30	378	408
"I26"	"O42"	"Pulmonary embolism"	"Premature rupture of membranes"	1	12	96	108
"G55"	"O70"	"Nerve root and plexus compressions in diseases classd elswhr"	"Perineal laceration during delivery"	1	1	47	48
"F41"	"I60"	"Other anxiety disorders"	"Nontraumatic subarachnoid hemorrhage"	1	47	129	176
"J15"	"N40"	"Bacterial pneumonia, not elsewhere classified"	"Benign prostatic hyperplasia"	1	0	5700	5700
"D63"	"H25"	"Anemia in chronic diseases classified elsewhere"	"Age-related cataract"	1	0	4259	4259
"D32"	"N60"	"Benign neoplasm of meninges"	"Benign mammary dysplasia"	1	0	68	68
"K62"	"H91"	"Other diseases of anus and rectum"	"Other and unspecified hearing loss"	1	2596	5469	8065
"M00"	"K40"	"Pyogenic arthritis"	"Inguinal hernia"	1	89	229	318
"C82"	"M17"	"Follicular lymphoma"	"Osteoarthritis of knee"	1	51	152	203
"M67"	"O32"	"Other disorders of synovium and tendon"	"Maternal care for malpresentation of fetus"	1	153	303	456
"D69"	"E78"	"Purpura and other hemorrhagic conditions"	"Disorders of lipoprotein metabolism and other lipidemias"	1	414	915	1329
"C66"	"I10"	"Malignant neoplasm of ureter"	"Essential (primary) hypertension"	1	72	151	223
"C15"	"J45"	"Malignant neoplasm of esophagus"	"Asthma"	1	34	178	212
"E86"	"Q42"	"Volume depletion"	"Congenital absence, atresia and stenosis of large intestine"	1	8	68	76
"A41"	"H53"	"Other sepsis"	"Visual disturbances"	1	286	1034	1320
"H25"	"K11"	"Age-related cataract"	"Diseases of salivary glands"	1	365	569	934
"C90"	"M16"	"Multiple myeloma and malignant plasma cell neoplasms"	"Osteoarthritis of hip"	1	50	305	355
"O08"	"G40"	"Complications following ectopic and molar pregnancy"	"Epilepsy and recurrent seizures"	1	28	152	180
"I67"	"O70"	"Other cerebrovascular diseases"	"Perineal laceration during delivery"	1	0	105	105
"C71"	"M22"	"Malignant neoplasm of brain"	"Disorder of patella"	1	0	29	29
"F03"	"M65"	"Unspecified dementia"	"Synovitis and tenosynovitis"	1	0	444	444
"F41"	"C32"	"Other anxiety disorders"	"Malignant neoplasm of larynx"	1	22	148	170
"F41"	"M22"	"Other anxiety disorders"	"Disorder of patella"	1	4	346	350
"J38"	"H83"	"Diseases of vocal cords and larynx, not elsewhere classified"	"Other diseases of inner ear"	1	76	204	280
"D84"	"N92"	"Other immunodeficiencies"	"Excessive, frequent and irregular menstruation"	1	0	84	84
"O04"	"O80"	"Complications following (induced) termination of pregnancy"	"Encounter for full-term uncomplicated delivery"	1	22654	26638	49292
"C61"	"M10"	"Malignant neoplasm of prostate"	"Gout"	1	336	484	820
"K29"	"K35"	"Gastritis and duodenitis"	"Acute appendicitis"	1	651	1022	1673
"A46"	"G43"	"Erysipelas"	"Migraine"	1	76	273	349
"E83"	"M50"	"Disorders of mineral metabolism"	"Cervical disc disorders"	1	6	146	152
"D63"	"K21"	"Anemia in chronic diseases classified elsewhere"	"Gastro-esophageal reflux disease"	1	97	726	823
"I95"	"N84"	"Hypotension"	"Polyp of female genital tract"	1	42	136	178
"K74"	"M79"	"Fibrosis and cirrhosis of liver"	"Oth and unsp soft tissue disorders, not elsewhere classified"	1	166	464	630
"C18"	"K05"	"Malignant neoplasm of colon"	"Gingivitis and periodontal diseases"	1	83	197	280
"E03"	"O23"	"Other hypothyroidism"	"Infections of genitourinary tract in pregnancy"	1	163	389	552
"F10"	"J30"	"Alcohol related disorders"	"Vasomotor and allergic rhinitis"	1	274	414	688
"M10"	"M02"	"Gout"	"Postinfective and reactive arthropathies"	1	436	615	1051
"C95"	"E78"	"Leukemia of unspecified cell type"	"Disorders of lipoprotein metabolism and other lipidemias"	1	36	100	136
"C93"	"M75"	"Monocytic leukemia"	"Shoulder lesions"	1	1	38	39
"K62"	"O47"	"Other diseases of anus and rectum"	"False labor"	1	57	336	393
"K72"	"I73"	"Hepatic failure, not elsewhere classified"	"Other peripheral vascular diseases"	1	68	179	247
"K42"	"O80"	"Umbilical hernia"	"Encounter for full-term uncomplicated delivery"	1	0	2384	2384
"G98"	"O80"	"Other disorders of nervous system not elsewhere classified"	"Encounter for full-term uncomplicated delivery"	1	0	360	360
"J69"	"M23"	"Pneumonitis due to solids and liquids"	"Internal derangement of knee"	1	0	192	192
"H25"	"N99"	"Age-related cataract"	"Intraop and postproc comp and disorders of GU sys, NEC"	1	549	918	1467
"M45"	"O80"	"Ankylosing spondylitis"	"Encounter for full-term uncomplicated delivery"	1	0	289	289
"A18"	"I88"	"Tuberculosis of other organs"	"Nonspecific lymphadenitis"	1	66	142	208
"F43"	"I83"	"Reaction to severe stress, and adjustment disorders"	"Varicose veins of lower extremities"	1	132	456	588
"I35"	"K50"	"Nonrheumatic aortic valve disorders"	"Crohn's disease [regional enteritis]"	1	64	141	205
"G97"	"O04"	"Intraop and postproc comp and disorders of nervous sys, NEC"	"Complications following (induced) termination of pregnancy"	1	1	144	145
"O14"	"O20"	"Pre-eclampsia"	"Hemorrhage in early pregnancy"	1	1321	2813	4134
"K92"	"G57"	"Other diseases of digestive system"	"Mononeuropathies of lower limb"	1	69	167	236
"K92"	"L04"	"Other diseases of digestive system"	"Acute lymphadenitis"	1	13	78	91
"C06"	"K80"	"Malignant neoplasm of other and unspecified parts of mouth"	"Cholelithiasis"	1	24	74	98
"I49"	"N40"	"Other cardiac arrhythmias"	"Benign prostatic hyperplasia"	1	984	2192	3176
"C78"	"D47"	"Secondary malignant neoplasm of resp and digestive organs"	"Oth neoplm of uncrt behav of lymphoid, hematpoetc & rel tiss"	1	56	185	241
"A49"	"E11"	"Bacterial infection of unspecified site"	"Type 2 diabetes mellitus"	1	0	6122	6122
"E87"	"H50"	"Other disorders of fluid, electrolyte and acid-base balance"	"Other strabismus"	1	41	271	312
"K44"	"O66"	"Diaphragmatic hernia"	"Other obstructed labor"	1	6	72	78
"E87"	"N95"	"Other disorders of fluid, electrolyte and acid-base balance"	"Menopausal and other perimenopausal disorders"	1	115	1107	1222
"L90"	"K65"	"Atrophic disorders of skin"	"Peritonitis"	1	83	242	325
"F43"	"M54"	"Reaction to severe stress, and adjustment disorders"	"Dorsalgia"	1	1071	2000	3071
"G44"	"N20"	"Other headache syndromes"	"Calculus of kidney and ureter"	1	343	534	877
"G45"	"H10"	"Transient cerebral ischemic attacks and related syndromes"	"Conjunctivitis"	1	167	665	832
"C54"	"N92"	"Malignant neoplasm of corpus uteri"	"Excessive, frequent and irregular menstruation"	1	0	1761	1761
"K59"	"I80"	"Other functional intestinal disorders"	"Phlebitis and thrombophlebitis"	1	1737	3797	5534
"O24"	"K01"	"Diabetes in pregnancy, childbirth, and the puerperium"	"Embedded and impacted teeth"	1	0	42	42
"N18"	"E10"	"Chronic kidney disease (CKD)"	"Type 1 diabetes mellitus"	1	0	7128	7128
"D64"	"N60"	"Other anemias"	"Benign mammary dysplasia"	1	23	490	513
"H26"	"N87"	"Other cataract"	"Dysplasia of cervix uteri"	1	1	182	183
"C50"	"D28"	"Malignant neoplasm of breast"	"Benign neoplasm of other and unsp female genital organs"	1	20	92	112
"K56"	"M76"	"Paralytic ileus and intestinal obstruction without hernia"	"Enthesopathies, lower limb, excluding foot"	1	67	214	281
"F41"	"E83"	"Other anxiety disorders"	"Disorders of mineral metabolism"	1	187	371	558
"K74"	"H91"	"Fibrosis and cirrhosis of liver"	"Other and unspecified hearing loss"	1	205	488	693
"M16"	"H94"	"Osteoarthritis of hip"	"Other disorders of ear in diseases classified elsewhere"	1	25	112	137
"J15"	"H26"	"Bacterial pneumonia, not elsewhere classified"	"Other cataract"	1	0	4224	4224
"F17"	"F11"	"Nicotine dependence"	"Opioid related disorders"	1	123	328	451
"J96"	"C06"	"Respiratory failure, not elsewhere classified"	"Malignant neoplasm of other and unspecified parts of mouth"	1	122	330	452
"C20"	"M22"	"Malignant neoplasm of rectum"	"Disorder of patella"	1	0	38	38
"I10"	"Q83"	"Essential (primary) hypertension"	"Congenital malformations of breast"	1	15	74	89
"J96"	"O26"	"Respiratory failure, not elsewhere classified"	"Maternal care for oth conditions predom related to pregnancy"	1	0	137	137
"O40"	"F10"	"Polyhydramnios"	"Alcohol related disorders"	1	0	77	77
"D10"	"O62"	"Benign neoplasm of mouth and pharynx"	"Abnormalities of forces of labor"	1	4	216	220
"K43"	"O14"	"Ventral hernia"	"Pre-eclampsia"	1	0	178	178
"L89"	"M41"	"Pressure ulcer"	"Scoliosis"	1	42	139	181
"K21"	"O20"	"Gastro-esophageal reflux disease"	"Hemorrhage in early pregnancy"	1	20	670	690
"E16"	"F10"	"Other disorders of pancreatic internal secretion"	"Alcohol related disorders"	1	787	1467	2254
"K72"	"N87"	"Hepatic failure, not elsewhere classified"	"Dysplasia of cervix uteri"	1	0	31	31
"D05"	"D48"	"Carcinoma in situ of breast"	"Neoplasm of uncertain behavior of other and unsp sites"	1	23	123	146
"C83"	"H25"	"Non-follicular lymphoma"	"Age-related cataract"	1	460	737	1197
"J06"	"N81"	"Acute upper resp infections of multiple and unsp sites"	"Female genital prolapse"	1	17	173	190
"K83"	"M23"	"Other diseases of biliary tract"	"Internal derangement of knee"	1	91	453	544
"K63"	"M77"	"Other diseases of intestine"	"Other enthesopathies"	1	35	183	218
"E05"	"O36"	"Thyrotoxicosis [hyperthyroidism]"	"Maternal care for other fetal problems"	1	311	516	827
"F02"	"I21"	"Dementia in other diseases classified elsewhere"	"Acute myocardial infarction"	1	65	150	215
"J18"	"M33"	"Pneumonia, unspecified organism"	"Dermatopolymyositis"	1	81	185	266
"E86"	"A15"	"Volume depletion"	"Respiratory tuberculosis"	1	35	227	262
"E16"	"M50"	"Other disorders of pancreatic internal secretion"	"Cervical disc disorders"	1	51	122	173
"O72"	"M24"	"Postpartum hemorrhage"	"Other specific joint derangements"	1	125	1173	1298
"G30"	"F79"	"Alzheimer's disease"	"Unspecified intellectual disabilities"	1	0	26	26
"C18"	"L40"	"Malignant neoplasm of colon"	"Psoriasis"	1	54	185	239
"N93"	"O48"	"Other abnormal uterine and vaginal bleeding"	"Late pregnancy"	1	18	528	546
"J03"	"L20"	"Acute tonsillitis"	"Atopic dermatitis"	1	381	627	1008
"O86"	"O99"	"Other puerperal infections"	"Oth maternal diseases classd elsw but compl preg/chldbrth"	1	3687	4185	7872
"G43"	"N97"	"Migraine"	"Female infertility"	1	241	611	852
"C49"	"N60"	"Malignant neoplasm of other connective and soft tissue"	"Benign mammary dysplasia"	1	1	29	30
"O91"	"O72"	"Infect of breast assoc w pregnancy, the puerp and lactation"	"Postpartum hemorrhage"	1	0	10304	10304
"A46"	"K80"	"Erysipelas"	"Cholelithiasis"	1	688	1666	2354
"K05"	"J34"	"Gingivitis and periodontal diseases"	"Other and unspecified disorders of nose and nasal sinuses"	1	58	157	215
"G91"	"O62"	"Hydrocephalus"	"Abnormalities of forces of labor"	1	0	48	48
"N39"	"M23"	"Other disorders of urinary system"	"Internal derangement of knee"	1	1512	4279	5791
"O34"	"O63"	"Maternal care for abnormality of pelvic organs"	"Long labor"	1	803	1810	2613
"M72"	"M23"	"Fibroblastic disorders"	"Internal derangement of knee"	1	1086	1998	3084
"I73"	"N97"	"Other peripheral vascular diseases"	"Female infertility"	1	7	82	89
"E68"	"O35"	"Sequelae of hyperalimentation"	"Maternal care for known or suspected fetal abnlt and damage"	1	5	37	42
"F05"	"H25"	"Delirium due to known physiological condition"	"Age-related cataract"	1	0	4620	4620
"H26"	"M22"	"Other cataract"	"Disorder of patella"	1	6	201	207
"I63"	"H52"	"Cerebral infarction"	"Disorders of refraction and accommodation"	1	253	460	713
"F45"	"G40"	"Somatoform disorders"	"Epilepsy and recurrent seizures"	1	134	257	391
"N05"	"N04"	"Unspecified nephritic syndrome"	"Nephrotic syndrome"	1	204	394	598
"O36"	"O00"	"Maternal care for other fetal problems"	"Ectopic pregnancy"	1	438	1020	1458
"F41"	"H25"	"Other anxiety disorders"	"Age-related cataract"	1	741	2228	2969
"M53"	"I83"	"Other and unspecified dorsopathies, not elsewhere classified"	"Varicose veins of lower extremities"	1	306	566	872
"I73"	"O26"	"Other peripheral vascular diseases"	"Maternal care for oth conditions predom related to pregnancy"	1	0	72	72
"M53"	"H80"	"Other and unspecified dorsopathies, not elsewhere classified"	"Otosclerosis"	1	10	48	58
"I33"	"I10"	"Acute and subacute endocarditis"	"Essential (primary) hypertension"	1	695	1521	2216
"M70"	"L03"	"Soft tissue disorders related to use, overuse and pressure"	"Cellulitis and acute lymphangitis"	1	426	801	1227
"J44"	"K40"	"Other chronic obstructive pulmonary disease"	"Inguinal hernia"	1	0	8573	8573
"A04"	"A09"	"Other bacterial intestinal infections"	"Infectious gastroenteritis and colitis, unspecified"	1	2456	3384	5840
"N19"	"O03"	"Unspecified kidney failure"	"Spontaneous abortion"	1	0	34	34
"D68"	"N92"	"Other coagulation defects"	"Excessive, frequent and irregular menstruation"	1	423	605	1028
"D50"	"H81"	"Iron deficiency anemia"	"Disorders of vestibular function"	1	231	727	958
"M67"	"F98"	"Other disorders of synovium and tendon"	"Oth behav/emotn disord w onset usly occur in chldhd and adol"	1	1	73	74
"K45"	"O75"	"Other abdominal hernia"	"Oth complications of labor and delivery, NEC"	1	0	64	64
"J81"	"D17"	"Pulmonary edema"	"Benign lipomatous neoplasm"	1	7	100	107
"C61"	"K30"	"Malignant neoplasm of prostate"	"Functional dyspepsia"	1	125	810	935
"N19"	"I48"	"Unspecified kidney failure"	"Atrial fibrillation and flutter"	1	3355	5180	8535
"I10"	"N75"	"Essential (primary) hypertension"	"Diseases of Bartholin's gland"	1	98	451	549
"M80"	"H80"	"Osteoporosis with current pathological fracture"	"Otosclerosis"	1	0	181	181
"N87"	"J35"	"Dysplasia of cervix uteri"	"Chronic diseases of tonsils and adenoids"	1	0	838	838
"J15"	"H81"	"Bacterial pneumonia, not elsewhere classified"	"Disorders of vestibular function"	1	0	1919	1919
"M67"	"O20"	"Other disorders of synovium and tendon"	"Hemorrhage in early pregnancy"	1	187	787	974
"H26"	"K13"	"Other cataract"	"Other diseases of lip and oral mucosa"	1	76	163	239
"C83"	"I20"	"Non-follicular lymphoma"	"Angina pectoris"	1	77	556	633
"D59"	"H91"	"Acquired hemolytic anemia"	"Other and unspecified hearing loss"	1	59	160	219
"G43"	"J36"	"Migraine"	"Peritonsillar abscess"	1	50	126	176
"Q23"	"M65"	"Congenital malformations of aortic and mitral valves"	"Synovitis and tenosynovitis"	1	7	40	47
"I47"	"M51"	"Paroxysmal tachycardia"	"Thoracic, thoracolum, and lumbosacral intvrt disc disorders"	1	904	1317	2221
"K31"	"N40"	"Other diseases of stomach and duodenum"	"Benign prostatic hyperplasia"	1	111	300	411
"A41"	"H33"	"Other sepsis"	"Retinal detachments and breaks"	1	31	750	781
"M65"	"O68"	"Synovitis and tenosynovitis"	"Labor and delivery comp by abnlt of fetal acid-base balance"	1	680	1000	1680
"M25"	"M22"	"Other joint disorder, not elsewhere classified"	"Disorder of patella"	1	646	1982	2628
"I63"	"O42"	"Cerebral infarction"	"Premature rupture of membranes"	1	0	58	58
"K35"	"J45"	"Acute appendicitis"	"Asthma"	1	1322	1812	3134
"J96"	"D13"	"Respiratory failure, not elsewhere classified"	"Benign neoplasm of and ill-defined parts of digestive system"	1	107	359	466
"M85"	"N03"	"Other disorders of bone density and structure"	"Chronic nephritic syndrome"	1	1	90	91
"N30"	"M23"	"Cystitis"	"Internal derangement of knee"	1	2192	4681	6873
"J91"	"K43"	"Pleural effusion in conditions classified elsewhere"	"Ventral hernia"	1	50	139	189
"K05"	"N20"	"Gingivitis and periodontal diseases"	"Calculus of kidney and ureter"	1	98	227	325
"F03"	"I26"	"Unspecified dementia"	"Pulmonary embolism"	1	580	806	1386
"J84"	"H91"	"Other interstitial pulmonary diseases"	"Other and unspecified hearing loss"	1	304	1290	1594
"H01"	"K40"	"Other inflammation of eyelid"	"Inguinal hernia"	1	42	200	242
"J15"	"I20"	"Bacterial pneumonia, not elsewhere classified"	"Angina pectoris"	1	0	9330	9330
"E55"	"M62"	"Vitamin D deficiency"	"Other disorders of muscle"	1	101	910	1011
"A41"	"C13"	"Other sepsis"	"Malignant neoplasm of hypopharynx"	1	54	129	183
"K72"	"I21"	"Hepatic failure, not elsewhere classified"	"Acute myocardial infarction"	1	121	333	454
"D62"	"K35"	"Acute posthemorrhagic anemia"	"Acute appendicitis"	1	35	198	233
"G96"	"D12"	"Other disorders of central nervous system"	"Benign neoplasm of colon, rectum, anus and anal canal"	1	527	712	1239
"E78"	"K35"	"Disorders of lipoprotein metabolism and other lipidemias"	"Acute appendicitis"	1	521	1549	2070
"D63"	"K43"	"Anemia in chronic diseases classified elsewhere"	"Ventral hernia"	1	104	430	534
"C34"	"Q40"	"Malignant neoplasm of bronchus and lung"	"Other congenital malformations of upper alimentary tract"	1	13	71	84
"G96"	"K86"	"Other disorders of central nervous system"	"Other diseases of pancreas"	1	37	185	222
"O99"	"Q52"	"Oth maternal diseases classd elsw but compl preg/chldbrth"	"Other congenital malformations of female genitalia"	1	1	87	88
"I69"	"H00"	"Sequelae of cerebrovascular disease"	"Hordeolum and chalazion"	1	17	139	156
"C64"	"K40"	"Malignant neoplasm of kidney, except renal pelvis"	"Inguinal hernia"	1	65	512	577
"I67"	"O03"	"Other cerebrovascular diseases"	"Spontaneous abortion"	1	0	40	40
"L57"	"I12"	"Skin changes due to chronic expsr to nonionizing radiation"	"Hypertensive chronic kidney disease"	1	0	67	67
"I61"	"K76"	"Nontraumatic intracerebral hemorrhage"	"Other diseases of liver"	1	113	205	318
"C18"	"C54"	"Malignant neoplasm of colon"	"Malignant neoplasm of corpus uteri"	1	86	196	282
"E73"	"J45"	"Lactose intolerance"	"Asthma"	1	163	381	544
"G21"	"H93"	"Secondary parkinsonism"	"Other disorders of ear, not elsewhere classified"	1	5	64	69
"D64"	"N48"	"Other anemias"	"Other disorders of penis"	1	63	450	513
"G20"	"J37"	"Parkinson's disease"	"Chronic laryngitis and laryngotracheitis"	1	2	28	30
"I73"	"H02"	"Other peripheral vascular diseases"	"Other disorders of eyelid"	1	495	712	1207
"G30"	"I48"	"Alzheimer's disease"	"Atrial fibrillation and flutter"	1	464	2124	2588
"F33"	"O63"	"Major depressive disorder, recurrent"	"Long labor"	1	35	121	156
"J96"	"K44"	"Respiratory failure, not elsewhere classified"	"Diaphragmatic hernia"	1	0	2438	2438
"F33"	"M17"	"Major depressive disorder, recurrent"	"Osteoarthritis of knee"	1	328	1660	1988
"F03"	"G55"	"Unspecified dementia"	"Nerve root and plexus compressions in diseases classd elswhr"	1	0	43	43
"F33"	"J35"	"Major depressive disorder, recurrent"	"Chronic diseases of tonsils and adenoids"	1	0	318	318
"F32"	"K29"	"Depressive episode"	"Gastritis and duodenitis"	1	1618	2598	4216
"E27"	"O02"	"Other disorders of adrenal gland"	"Other abnormal products of conception"	1	0	35	35
"K59"	"J33"	"Other functional intestinal disorders"	"Nasal polyp"	1	97	339	436
"I70"	"J30"	"Atherosclerosis"	"Vasomotor and allergic rhinitis"	1	24	105	129
"G47"	"L08"	"Sleep disorders"	"Other local infections of skin and subcutaneous tissue"	1	291	737	1028
"L29"	"O80"	"Pruritus"	"Encounter for full-term uncomplicated delivery"	1	7	409	416
"N12"	"K80"	"Tubulo-interstitial nephritis, not spcf as acute or chronic"	"Cholelithiasis"	1	132	319	451
"C18"	"M07"	"Malignant neoplasm of colon"	"Enteropathic arthropathies"	1	19	72	91
"L82"	"N92"	"Seborrheic keratosis"	"Excessive, frequent and irregular menstruation"	1	6	298	304
"H16"	"H83"	"Keratitis"	"Other diseases of inner ear"	1	44	108	152
"O14"	"L05"	"Pre-eclampsia"	"Pilonidal cyst and sinus"	1	16	119	135
"J15"	"M20"	"Bacterial pneumonia, not elsewhere classified"	"Acquired deformities of fingers and toes"	1	59	1243	1302
"I50"	"K80"	"Heart failure"	"Cholelithiasis"	1	2657	5231	7888
"H43"	"M50"	"Disorders of vitreous body"	"Cervical disc disorders"	1	48	276	324
"N60"	"O14"	"Benign mammary dysplasia"	"Pre-eclampsia"	1	16	192	208
"G93"	"K35"	"Other disorders of brain"	"Acute appendicitis"	1	38	102	140
"A04"	"N03"	"Other bacterial intestinal infections"	"Chronic nephritic syndrome"	1	10	98	108
"D62"	"O70"	"Acute posthemorrhagic anemia"	"Perineal laceration during delivery"	1	83	330	413
"D62"	"N03"	"Acute posthemorrhagic anemia"	"Chronic nephritic syndrome"	1	17	64	81
"J80"	"I73"	"Acute respiratory distress syndrome"	"Other peripheral vascular diseases"	1	5	67	72
"L97"	"K81"	"Non-pressure chronic ulcer of lower limb, NEC"	"Cholecystitis"	1	87	173	260
"G45"	"N40"	"Transient cerebral ischemic attacks and related syndromes"	"Benign prostatic hyperplasia"	1	1840	2654	4494
"O73"	"J35"	"Retained placenta and membranes, without hemorrhage"	"Chronic diseases of tonsils and adenoids"	1	0	158	158
"E66"	"K30"	"Overweight and obesity"	"Functional dyspepsia"	1	2144	3329	5473
"J15"	"K20"	"Bacterial pneumonia, not elsewhere classified"	"Esophagitis"	1	374	1553	1927
"O80"	"N70"	"Encounter for full-term uncomplicated delivery"	"Salpingitis and oophoritis"	1	1983	2456	4439
"L28"	"N97"	"Lichen simplex chronicus and prurigo"	"Female infertility"	1	4	38	42
"L97"	"N95"	"Non-pressure chronic ulcer of lower limb, NEC"	"Menopausal and other perimenopausal disorders"	1	69	262	331
"D34"	"O80"	"Benign neoplasm of thyroid gland"	"Encounter for full-term uncomplicated delivery"	1	0	335	335
"N39"	"N92"	"Other disorders of urinary system"	"Excessive, frequent and irregular menstruation"	1	0	6746	6746
"C22"	"M70"	"Malignant neoplasm of liver and intrahepatic bile ducts"	"Soft tissue disorders related to use, overuse and pressure"	1	0	82	82
"E89"	"D25"	"Postproc endocrine and metabolic comp and disorders, NEC"	"Leiomyoma of uterus"	1	19	176	195
"I80"	"N80"	"Phlebitis and thrombophlebitis"	"Endometriosis"	1	73	187	260
"F17"	"G45"	"Nicotine dependence"	"Transient cerebral ischemic attacks and related syndromes"	1	382	743	1125
"L57"	"N81"	"Skin changes due to chronic expsr to nonionizing radiation"	"Female genital prolapse"	1	55	307	362
"I35"	"N48"	"Nonrheumatic aortic valve disorders"	"Other disorders of penis"	1	58	329	387
"C79"	"D30"	"Secondary malignant neoplasm of other and unspecified sites"	"Benign neoplasm of urinary organs"	1	49	1004	1053
"I33"	"E10"	"Acute and subacute endocarditis"	"Type 1 diabetes mellitus"	1	134	369	503
"D83"	"O80"	"Common variable immunodeficiency"	"Encounter for full-term uncomplicated delivery"	1	0	30	30
"H35"	"O63"	"Other retinal disorders"	"Long labor"	1	2	42	44
"E11"	"K44"	"Type 2 diabetes mellitus"	"Diaphragmatic hernia"	1	1655	2250	3905
"I10"	"Q17"	"Essential (primary) hypertension"	"Other congenital malformations of ear"	1	0	84	84
"L60"	"Q17"	"Nail disorders"	"Other congenital malformations of ear"	1	7	60	67
"B44"	"I10"	"Aspergillosis"	"Essential (primary) hypertension"	1	60	203	263
"I70"	"D27"	"Atherosclerosis"	"Benign neoplasm of ovary"	1	109	259	368
"J90"	"M72"	"Pleural effusion, not elsewhere classified"	"Fibroblastic disorders"	1	20	329	349
"I46"	"J32"	"Cardiac arrest"	"Chronic sinusitis"	1	2	98	100
"C56"	"G56"	"Malignant neoplasm of ovary"	"Mononeuropathies of upper limb"	1	63	159	222
"M07"	"M25"	"Enteropathic arthropathies"	"Other joint disorder, not elsewhere classified"	1	654	971	1625
"E64"	"M71"	"Sequelae of malnutrition and other nutritional deficiencies"	"Other bursopathies"	1	4	51	55
"I48"	"M51"	"Atrial fibrillation and flutter"	"Thoracic, thoracolum, and lumbosacral intvrt disc disorders"	1	0	6833	6833
"H26"	"O23"	"Other cataract"	"Infections of genitourinary tract in pregnancy"	1	1	32	33
"K91"	"H90"	"Intraop and postproc comp and disorders of dgstv sys, NEC"	"Conductive and sensorineural hearing loss"	1	53	121	174
"D32"	"O99"	"Benign neoplasm of meninges"	"Oth maternal diseases classd elsw but compl preg/chldbrth"	1	0	67	67
"M80"	"C54"	"Osteoporosis with current pathological fracture"	"Malignant neoplasm of corpus uteri"	1	5	171	176
"K63"	"G43"	"Other diseases of intestine"	"Migraine"	1	31	138	169
"L08"	"M79"	"Other local infections of skin and subcutaneous tissue"	"Oth and unsp soft tissue disorders, not elsewhere classified"	1	1977	2527	4504
"C95"	"I20"	"Leukemia of unspecified cell type"	"Angina pectoris"	1	20	161	181
"B18"	"J34"	"Chronic viral hepatitis"	"Other and unspecified disorders of nose and nasal sinuses"	1	43	113	156
"E50"	"E10"	"Vitamin A deficiency"	"Type 1 diabetes mellitus"	1	110	213	323
"G96"	"M65"	"Other disorders of central nervous system"	"Synovitis and tenosynovitis"	1	29	651	680
"I95"	"G56"	"Hypotension"	"Mononeuropathies of upper limb"	1	76	698	774
"F05"	"J33"	"Delirium due to known physiological condition"	"Nasal polyp"	1	0	28	28
"C25"	"H80"	"Malignant neoplasm of pancreas"	"Otosclerosis"	1	0	47	47
"K04"	"D24"	"Diseases of pulp and periapical tissues"	"Benign neoplasm of breast"	1	53	139	192
"H50"	"H83"	"Other strabismus"	"Other diseases of inner ear"	1	43	112	155
"G96"	"A88"	"Other disorders of central nervous system"	"Oth viral infections of central nervous system, NEC"	1	6	60	66
"L08"	"J05"	"Other local infections of skin and subcutaneous tissue"	"Acute obstructive laryngitis [croup] and epiglottitis"	1	0	387	387
"C78"	"N99"	"Secondary malignant neoplasm of resp and digestive organs"	"Intraop and postproc comp and disorders of GU sys, NEC"	1	57	325	382
"K56"	"M23"	"Paralytic ileus and intestinal obstruction without hernia"	"Internal derangement of knee"	1	245	1010	1255
"K92"	"I15"	"Other diseases of digestive system"	"Secondary hypertension"	1	352	533	885
"O62"	"J35"	"Abnormalities of forces of labor"	"Chronic diseases of tonsils and adenoids"	1	0	3442	3442
"O60"	"O30"	"Preterm labor"	"Multiple gestation"	1	534	1377	1911
"I50"	"K20"	"Heart failure"	"Esophagitis"	1	985	1771	2756
"D62"	"I48"	"Acute posthemorrhagic anemia"	"Atrial fibrillation and flutter"	1	1899	3314	5213
"E06"	"F10"	"Thyroiditis"	"Alcohol related disorders"	1	17	108	125
"F10"	"J35"	"Alcohol related disorders"	"Chronic diseases of tonsils and adenoids"	1	299	1326	1625
"H57"	"Q17"	"Other disorders of eye and adnexa"	"Other congenital malformations of ear"	1	0	67	67
"E41"	"I70"	"Nutritional marasmus"	"Atherosclerosis"	1	36	235	271
"K31"	"N92"	"Other diseases of stomach and duodenum"	"Excessive, frequent and irregular menstruation"	1	0	163	163
"G96"	"N87"	"Other disorders of central nervous system"	"Dysplasia of cervix uteri"	1	2	178	180
"E11"	"N97"	"Type 2 diabetes mellitus"	"Female infertility"	1	0	572	572
"A49"	"D68"	"Bacterial infection of unspecified site"	"Other coagulation defects"	1	196	326	522
"E87"	"A46"	"Other disorders of fluid, electrolyte and acid-base balance"	"Erysipelas"	1	1836	2755	4591
"I99"	"H93"	"Other and unspecified disorders of circulatory system"	"Other disorders of ear, not elsewhere classified"	1	54	174	228
"I46"	"Q22"	"Cardiac arrest"	"Congenital malformations of pulmonary and tricuspid valves"	1	3	31	34
"J35"	"A09"	"Chronic diseases of tonsils and adenoids"	"Infectious gastroenteritis and colitis, unspecified"	1	1927	3143	5070
"A09"	"Q41"	"Infectious gastroenteritis and colitis, unspecified"	"Congenital absence, atresia and stenosis of small intestine"	1	12	71	83
"K59"	"G62"	"Other functional intestinal disorders"	"Other and unspecified polyneuropathies"	1	1206	1681	2887
"D64"	"O41"	"Other anemias"	"Other disorders of amniotic fluid and membranes"	1	6	76	82
"I48"	"O63"	"Atrial fibrillation and flutter"	"Long labor"	1	0	44	44
"N17"	"E03"	"Acute kidney failure"	"Other hypothyroidism"	1	394	698	1092
"A41"	"J92"	"Other sepsis"	"Pleural plaque"	1	36	253	289
"K83"	"D12"	"Other diseases of biliary tract"	"Benign neoplasm of colon, rectum, anus and anal canal"	1	325	548	873
"F41"	"H93"	"Other anxiety disorders"	"Other disorders of ear, not elsewhere classified"	1	62	514	576
"G90"	"Q90"	"Disorders of autonomic nervous system"	"Down syndrome"	1	5	49	54
"K56"	"H20"	"Paralytic ileus and intestinal obstruction without hernia"	"Iridocyclitis"	1	36	114	150
"D25"	"O32"	"Leiomyoma of uterus"	"Maternal care for malpresentation of fetus"	1	0	379	379
"I63"	"D23"	"Cerebral infarction"	"Other benign neoplasms of skin"	1	267	731	998
"G50"	"O82"	"Disorders of trigeminal nerve"	"Encounter for cesarean delivery without indication"	1	2	139	141
"F06"	"K40"	"Other mental disorders due to known physiological condition"	"Inguinal hernia"	1	16	317	333
"A54"	"O68"	"Gonococcal infection"	"Labor and delivery comp by abnlt of fetal acid-base balance"	1	13	65	78
"M24"	"M22"	"Other specific joint derangements"	"Disorder of patella"	1	790	1343	2133
"I27"	"G43"	"Other pulmonary heart diseases"	"Migraine"	1	12	56	68
"I26"	"I25"	"Pulmonary embolism"	"Chronic ischemic heart disease"	1	2570	3702	6272
"E78"	"N60"	"Disorders of lipoprotein metabolism and other lipidemias"	"Benign mammary dysplasia"	1	35	1010	1045
"I73"	"M35"	"Other peripheral vascular diseases"	"Other systemic involvement of connective tissue"	1	610	882	1492
"D38"	"N40"	"Neoplm of uncrt behav of mid ear & resp and intrathorac org"	"Benign prostatic hyperplasia"	1	53	173	226
"M85"	"E88"	"Other disorders of bone density and structure"	"Other and unspecified metabolic disorders"	1	37	143	180
"C79"	"K25"	"Secondary malignant neoplasm of other and unspecified sites"	"Gastric ulcer"	1	274	966	1240
"N17"	"I21"	"Acute kidney failure"	"Acute myocardial infarction"	1	1592	3219	4811
"C77"	"K20"	"Secondary and unspecified malignant neoplasm of lymph nodes"	"Esophagitis"	1	57	225	282
"J96"	"J38"	"Respiratory failure, not elsewhere classified"	"Diseases of vocal cords and larynx, not elsewhere classified"	1	499	1237	1736
"E86"	"K60"	"Volume depletion"	"Fissure and fistula of anal and rectal regions"	1	155	687	842
"K43"	"O99"	"Ventral hernia"	"Oth maternal diseases classd elsw but compl preg/chldbrth"	1	60	983	1043
"D12"	"M06"	"Benign neoplasm of colon, rectum, anus and anal canal"	"Other rheumatoid arthritis"	1	324	722	1046
"G20"	"H90"	"Parkinson's disease"	"Conductive and sensorineural hearing loss"	1	65	382	447
"I47"	"J34"	"Paroxysmal tachycardia"	"Other and unspecified disorders of nose and nasal sinuses"	1	150	256	406
"N92"	"O65"	"Excessive, frequent and irregular menstruation"	"Obstructed labor due to maternal pelvic abnormality"	1	0	1174	1174
"G93"	"M20"	"Other disorders of brain"	"Acquired deformities of fingers and toes"	1	39	105	144
"I61"	"N48"	"Nontraumatic intracerebral hemorrhage"	"Other disorders of penis"	1	23	107	130
"F43"	"K35"	"Reaction to severe stress, and adjustment disorders"	"Acute appendicitis"	1	134	525	659
"I50"	"H83"	"Heart failure"	"Other diseases of inner ear"	1	0	3512	3512
"I50"	"G56"	"Heart failure"	"Mononeuropathies of upper limb"	1	0	4047	4047
"F41"	"M24"	"Other anxiety disorders"	"Other specific joint derangements"	1	49	184	233
"A49"	"O99"	"Bacterial infection of unspecified site"	"Oth maternal diseases classd elsw but compl preg/chldbrth"	1	197	466	663
"C17"	"M16"	"Malignant neoplasm of small intestine"	"Osteoarthritis of hip"	1	5	77	82
"I83"	"O80"	"Varicose veins of lower extremities"	"Encounter for full-term uncomplicated delivery"	1	0	8754	8754
"M81"	"N92"	"Osteoporosis without current pathological fracture"	"Excessive, frequent and irregular menstruation"	1	0	1458	1458
"G31"	"C44"	"Oth degenerative diseases of nervous system, NEC"	"Other and unspecified malignant neoplasm of skin"	1	62	150	212
"L82"	"K50"	"Seborrheic keratosis"	"Crohn's disease [regional enteritis]"	1	2	41	43
"M18"	"N95"	"Osteoarthritis of first carpometacarpal joint"	"Menopausal and other perimenopausal disorders"	1	164	325	489
"E87"	"M81"	"Other disorders of fluid, electrolyte and acid-base balance"	"Osteoporosis without current pathological fracture"	1	3894	4472	8366
"I82"	"H25"	"Other venous embolism and thrombosis"	"Age-related cataract"	1	530	934	1464
"H83"	"C62"	"Other diseases of inner ear"	"Malignant neoplasm of testis"	1	25	110	135
"L98"	"N31"	"Oth disorders of skin, subcu, not elsewhere classified"	"Neuromuscular dysfunction of bladder, NEC"	1	83	197	280
"B37"	"O65"	"Candidiasis"	"Obstructed labor due to maternal pelvic abnormality"	1	14	69	83
"I67"	"D24"	"Other cerebrovascular diseases"	"Benign neoplasm of breast"	1	4	69	73
"E29"	"N62"	"Testicular dysfunction"	"Hypertrophy of breast"	1	151	408	559
"I65"	"N92"	"Occls and stenosis of precerb art, not rslt in cereb infrc"	"Excessive, frequent and irregular menstruation"	1	8	122	130
"I48"	"M53"	"Atrial fibrillation and flutter"	"Other and unspecified dorsopathies, not elsewhere classified"	1	346	739	1085
"H52"	"G00"	"Disorders of refraction and accommodation"	"Bacterial meningitis, not elsewhere classified"	1	21	94	115
"I83"	"O23"	"Varicose veins of lower extremities"	"Infections of genitourinary tract in pregnancy"	1	45	588	633
"J12"	"Q90"	"Viral pneumonia, not elsewhere classified"	"Down syndrome"	1	31	154	185
"H35"	"D30"	"Other retinal disorders"	"Benign neoplasm of urinary organs"	1	281	640	921
"K92"	"M43"	"Other diseases of digestive system"	"Other deforming dorsopathies"	1	111	348	459
"C18"	"H43"	"Malignant neoplasm of colon"	"Disorders of vitreous body"	1	109	299	408
"C77"	"E05"	"Secondary and unspecified malignant neoplasm of lymph nodes"	"Thyrotoxicosis [hyperthyroidism]"	1	92	396	488
"F32"	"L03"	"Depressive episode"	"Cellulitis and acute lymphangitis"	1	131	476	607
"M17"	"M71"	"Osteoarthritis of knee"	"Other bursopathies"	1	2582	3007	5589
"J96"	"C53"	"Respiratory failure, not elsewhere classified"	"Malignant neoplasm of cervix uteri"	1	6	203	209
"N30"	"K40"	"Cystitis"	"Inguinal hernia"	1	0	7276	7276
"F33"	"K85"	"Major depressive disorder, recurrent"	"Acute pancreatitis"	1	220	355	575
"I95"	"O62"	"Hypotension"	"Abnormalities of forces of labor"	1	35	157	192
"D68"	"N20"	"Other coagulation defects"	"Calculus of kidney and ureter"	1	95	214	309
"A41"	"I48"	"Other sepsis"	"Atrial fibrillation and flutter"	1	0	27428	27428
"A49"	"M54"	"Bacterial infection of unspecified site"	"Dorsalgia"	1	0	4331	4331
"K25"	"N63"	"Gastric ulcer"	"Unspecified lump in breast"	1	150	291	441
"E87"	"N41"	"Other disorders of fluid, electrolyte and acid-base balance"	"Inflammatory diseases of prostate"	1	20	81	101
"G93"	"I48"	"Other disorders of brain"	"Atrial fibrillation and flutter"	1	449	641	1090
"I61"	"M72"	"Nontraumatic intracerebral hemorrhage"	"Fibroblastic disorders"	1	29	300	329
"F41"	"N70"	"Other anxiety disorders"	"Salpingitis and oophoritis"	1	0	166	166
"I69"	"F99"	"Sequelae of cerebrovascular disease"	"Mental disorder, not otherwise specified"	1	68	165	233
"N39"	"I42"	"Other disorders of urinary system"	"Cardiomyopathy"	1	659	1016	1675
"K90"	"K35"	"Intestinal malabsorption"	"Acute appendicitis"	1	34	188	222
"J42"	"M62"	"Unspecified chronic bronchitis"	"Other disorders of muscle"	1	741	1080	1821
"D43"	"K44"	"Neoplasm of uncertain behavior of brain and cnsl"	"Diaphragmatic hernia"	1	14	59	73
"F41"	"H72"	"Other anxiety disorders"	"Perforation of tympanic membrane"	1	2	94	96
"E78"	"H40"	"Disorders of lipoprotein metabolism and other lipidemias"	"Glaucoma"	1	1054	1365	2419
"M77"	"O99"	"Other enthesopathies"	"Oth maternal diseases classd elsw but compl preg/chldbrth"	1	339	863	1202
"J22"	"J41"	"Unspecified acute lower respiratory infection"	"Simple and mucopurulent chronic bronchitis"	1	4	136	140
"I42"	"N63"	"Cardiomyopathy"	"Unspecified lump in breast"	1	19	88	107
"M81"	"M33"	"Osteoporosis without current pathological fracture"	"Dermatopolymyositis"	1	63	149	212
"I70"	"N95"	"Atherosclerosis"	"Menopausal and other perimenopausal disorders"	1	422	607	1029
"C15"	"M72"	"Malignant neoplasm of esophagus"	"Fibroblastic disorders"	1	0	158	158
"M10"	"O62"	"Gout"	"Abnormalities of forces of labor"	1	1	49	50
"K29"	"I20"	"Gastritis and duodenitis"	"Angina pectoris"	1	5068	7661	12729
"E66"	"H52"	"Overweight and obesity"	"Disorders of refraction and accommodation"	1	809	1033	1842
"Q61"	"D24"	"Cystic kidney disease"	"Benign neoplasm of breast"	1	7	45	52
"C34"	"H26"	"Malignant neoplasm of bronchus and lung"	"Other cataract"	1	311	1869	2180
"K62"	"N87"	"Other diseases of anus and rectum"	"Dysplasia of cervix uteri"	1	61	471	532
"O82"	"N96"	"Encounter for cesarean delivery without indication"	"Recurrent pregnancy loss"	1	514	956	1470
"J96"	"L97"	"Respiratory failure, not elsewhere classified"	"Non-pressure chronic ulcer of lower limb, NEC"	1	967	1782	2749
"C18"	"D27"	"Malignant neoplasm of colon"	"Benign neoplasm of ovary"	1	115	296	411
"C93"	"M17"	"Monocytic leukemia"	"Osteoarthritis of knee"	1	0	44	44
"H20"	"O04"	"Iridocyclitis"	"Complications following (induced) termination of pregnancy"	1	17	268	285
"H53"	"I83"	"Visual disturbances"	"Varicose veins of lower extremities"	1	168	548	716
"F43"	"G43"	"Reaction to severe stress, and adjustment disorders"	"Migraine"	1	380	607	987
"C78"	"D22"	"Secondary malignant neoplasm of resp and digestive organs"	"Melanocytic nevi"	1	53	217	270
"L97"	"H65"	"Non-pressure chronic ulcer of lower limb, NEC"	"Nonsuppurative otitis media"	1	11	110	121
"E34"	"D25"	"Other endocrine disorders"	"Leiomyoma of uterus"	1	9	125	134
"K63"	"N31"	"Other diseases of intestine"	"Neuromuscular dysfunction of bladder, NEC"	1	18	118	136
"G95"	"K60"	"Other and unspecified diseases of spinal cord"	"Fissure and fistula of anal and rectal regions"	1	18	70	88
"F01"	"I63"	"Vascular dementia"	"Cerebral infarction"	1	1025	2662	3687
"I20"	"J37"	"Angina pectoris"	"Chronic laryngitis and laryngotracheitis"	1	231	403	634
"F02"	"D12"	"Dementia in other diseases classified elsewhere"	"Benign neoplasm of colon, rectum, anus and anal canal"	1	12	125	137
"K59"	"I63"	"Other functional intestinal disorders"	"Cerebral infarction"	1	3635	5597	9232
"M99"	"O14"	"Biomechanical lesions, not elsewhere classified"	"Pre-eclampsia"	1	0	35	35
"D06"	"J35"	"Carcinoma in situ of cervix uteri"	"Chronic diseases of tonsils and adenoids"	1	24	84	108
"I42"	"M53"	"Cardiomyopathy"	"Other and unspecified dorsopathies, not elsewhere classified"	1	31	91	122
"E78"	"L68"	"Disorders of lipoprotein metabolism and other lipidemias"	"Hypertrichosis"	1	0	249	249
"J90"	"M54"	"Pleural effusion, not elsewhere classified"	"Dorsalgia"	1	306	1201	1507
"D50"	"Q18"	"Iron deficiency anemia"	"Other congenital malformations of face and neck"	1	3	50	53
"C15"	"E04"	"Malignant neoplasm of esophagus"	"Other nontoxic goiter"	1	17	96	113
"D17"	"O00"	"Benign lipomatous neoplasm"	"Ectopic pregnancy"	1	0	94	94
"O80"	"M08"	"Encounter for full-term uncomplicated delivery"	"Juvenile arthritis"	1	0	82	82
"O62"	"O47"	"Abnormalities of forces of labor"	"False labor"	1	8474	10335	18809
"C79"	"J30"	"Secondary malignant neoplasm of other and unspecified sites"	"Vasomotor and allergic rhinitis"	1	0	79	79
"H93"	"O34"	"Other disorders of ear, not elsewhere classified"	"Maternal care for abnormality of pelvic organs"	1	26	97	123
"E13"	"N97"	"Other specified diabetes mellitus"	"Female infertility"	1	1	29	30
"I46"	"N18"	"Cardiac arrest"	"Chronic kidney disease (CKD)"	1	810	1772	2582
"K55"	"M16"	"Vascular disorders of intestine"	"Osteoarthritis of hip"	1	28	423	451
"H90"	"D17"	"Conductive and sensorineural hearing loss"	"Benign lipomatous neoplasm"	1	276	441	717
"M16"	"O65"	"Osteoarthritis of hip"	"Obstructed labor due to maternal pelvic abnormality"	1	0	44	44
"J96"	"D45"	"Respiratory failure, not elsewhere classified"	"Polycythemia vera"	1	37	204	241
"I35"	"M95"	"Nonrheumatic aortic valve disorders"	"Oth acquired deformities of ms sys and connective tissue"	1	13	63	76
"F17"	"O64"	"Nicotine dependence"	"Obstructed labor due to malposition and malpresent of fetus"	1	0	192	192
"K30"	"O04"	"Functional dyspepsia"	"Complications following (induced) termination of pregnancy"	1	0	2197	2197
"M96"	"O62"	"Intraop and postproc comp and disorders of ms sys, NEC"	"Abnormalities of forces of labor"	1	0	48	48
"E66"	"G80"	"Overweight and obesity"	"Cerebral palsy"	1	36	130	166
"O35"	"M62"	"Maternal care for known or suspected fetal abnlt and damage"	"Other disorders of muscle"	1	84	187	271
"E11"	"O34"	"Type 2 diabetes mellitus"	"Maternal care for abnormality of pelvic organs"	1	15	229	244
"C15"	"K26"	"Malignant neoplasm of esophagus"	"Duodenal ulcer"	1	25	223	248
"L89"	"H83"	"Pressure ulcer"	"Other diseases of inner ear"	1	0	174	174
"O80"	"M92"	"Encounter for full-term uncomplicated delivery"	"Other juvenile osteochondrosis"	1	10	154	164
"E21"	"M67"	"Hyperparathyroidism and other disorders of parathyroid gland"	"Other disorders of synovium and tendon"	1	42	194	236
"J84"	"N95"	"Other interstitial pulmonary diseases"	"Menopausal and other perimenopausal disorders"	1	40	141	181
"E55"	"O02"	"Vitamin D deficiency"	"Other abnormal products of conception"	1	13	238	251
"N39"	"O03"	"Other disorders of urinary system"	"Spontaneous abortion"	1	0	1237	1237
"C50"	"O34"	"Malignant neoplasm of breast"	"Maternal care for abnormality of pelvic organs"	1	0	137	137
"I35"	"M16"	"Nonrheumatic aortic valve disorders"	"Osteoarthritis of hip"	1	0	4483	4483
"H26"	"I20"	"Other cataract"	"Angina pectoris"	1	0	6691	6691
"J96"	"C43"	"Respiratory failure, not elsewhere classified"	"Malignant melanoma of skin"	1	63	541	604
"I99"	"O80"	"Other and unspecified disorders of circulatory system"	"Encounter for full-term uncomplicated delivery"	1	3	120	123
"I48"	"K30"	"Atrial fibrillation and flutter"	"Functional dyspepsia"	1	1451	4021	5472
"F01"	"E78"	"Vascular dementia"	"Disorders of lipoprotein metabolism and other lipidemias"	1	457	1638	2095
"F05"	"E10"	"Delirium due to known physiological condition"	"Type 1 diabetes mellitus"	1	198	988	1186
"K72"	"M47"	"Hepatic failure, not elsewhere classified"	"Spondylosis"	1	19	174	193
"M70"	"Q17"	"Soft tissue disorders related to use, overuse and pressure"	"Other congenital malformations of ear"	1	1	85	86
"J45"	"Q70"	"Asthma"	"Syndactyly"	1	25	95	120
"B96"	"G35"	"Oth bacterial agents as the cause of diseases classd elswhr"	"Multiple sclerosis"	1	0	35	35
"M35"	"M02"	"Other systemic involvement of connective tissue"	"Postinfective and reactive arthropathies"	1	308	474	782
"I10"	"D17"	"Essential (primary) hypertension"	"Benign lipomatous neoplasm"	1	2209	4117	6326
"M10"	"L03"	"Gout"	"Cellulitis and acute lymphangitis"	1	303	692	995
"E88"	"I20"	"Other and unspecified metabolic disorders"	"Angina pectoris"	1	106	263	369
"M80"	"M43"	"Osteoporosis with current pathological fracture"	"Other deforming dorsopathies"	1	233	542	775
"D64"	"M31"	"Other anemias"	"Other necrotizing vasculopathies"	1	576	988	1564
"M48"	"D30"	"Other spondylopathies"	"Benign neoplasm of urinary organs"	1	211	423	634
"O21"	"M23"	"Excessive vomiting in pregnancy"	"Internal derangement of knee"	1	271	427	698
"E61"	"F10"	"Deficiency of other nutrient elements"	"Alcohol related disorders"	1	61	253	314
"A31"	"I20"	"Infection due to other mycobacteria"	"Angina pectoris"	1	11	55	66
"K62"	"J30"	"Other diseases of anus and rectum"	"Vasomotor and allergic rhinitis"	1	108	419	527
"E86"	"C77"	"Volume depletion"	"Secondary and unspecified malignant neoplasm of lymph nodes"	1	954	2096	3050
"K80"	"O24"	"Cholelithiasis"	"Diabetes in pregnancy, childbirth, and the puerperium"	1	524	931	1455
"J47"	"E10"	"Bronchiectasis"	"Type 1 diabetes mellitus"	1	31	135	166
"J86"	"N92"	"Pyothorax"	"Excessive, frequent and irregular menstruation"	1	2	66	68
"G30"	"G45"	"Alzheimer's disease"	"Transient cerebral ischemic attacks and related syndromes"	1	131	931	1062
"D12"	"H52"	"Benign neoplasm of colon, rectum, anus and anal canal"	"Disorders of refraction and accommodation"	1	172	677	849
"F79"	"H66"	"Unspecified intellectual disabilities"	"Suppurative and unspecified otitis media"	1	51	289	340
"E78"	"O03"	"Disorders of lipoprotein metabolism and other lipidemias"	"Spontaneous abortion"	1	0	226	226
"F17"	"E10"	"Nicotine dependence"	"Type 1 diabetes mellitus"	1	731	993	1724
"N84"	"N87"	"Polyp of female genital tract"	"Dysplasia of cervix uteri"	1	410	932	1342
"C34"	"J36"	"Malignant neoplasm of bronchus and lung"	"Peritonsillar abscess"	1	0	72	72
"E64"	"O82"	"Sequelae of malnutrition and other nutritional deficiencies"	"Encounter for cesarean delivery without indication"	1	0	64	64
"J95"	"K04"	"Intraop and postproc comp and disorders of resp sys, NEC"	"Diseases of pulp and periapical tissues"	1	47	247	294
"D50"	"J44"	"Iron deficiency anemia"	"Other chronic obstructive pulmonary disease"	1	2551	3895	6446
"B01"	"J00"	"Varicella [chickenpox]"	"Acute nasopharyngitis [common cold]"	1	219	499	718
"L05"	"M22"	"Pilonidal cyst and sinus"	"Disorder of patella"	1	150	329	479
"C34"	"I27"	"Malignant neoplasm of bronchus and lung"	"Other pulmonary heart diseases"	1	218	350	568
"J96"	"N90"	"Respiratory failure, not elsewhere classified"	"Other noninflammatory disorders of vulva and perineum"	1	9	122	131
"M85"	"I25"	"Other disorders of bone density and structure"	"Chronic ischemic heart disease"	1	575	1862	2437
"H57"	"N87"	"Other disorders of eye and adnexa"	"Dysplasia of cervix uteri"	1	12	156	168
"D64"	"K61"	"Other anemias"	"Abscess of anal and rectal regions"	1	142	596	738
"C25"	"D25"	"Malignant neoplasm of pancreas"	"Leiomyoma of uterus"	1	0	113	113
"K74"	"K35"	"Fibrosis and cirrhosis of liver"	"Acute appendicitis"	1	15	88	103
"M86"	"M06"	"Osteomyelitis"	"Other rheumatoid arthritis"	1	56	177	233
"J44"	"D34"	"Other chronic obstructive pulmonary disease"	"Benign neoplasm of thyroid gland"	1	31	86	117
"D50"	"M18"	"Iron deficiency anemia"	"Osteoarthritis of first carpometacarpal joint"	1	70	154	224
"K25"	"I83"	"Gastric ulcer"	"Varicose veins of lower extremities"	1	686	1156	1842
"I97"	"M54"	"Intraop and postproc comp and disorders of circ sys, NEC"	"Dorsalgia"	1	72	180	252
"F41"	"L90"	"Other anxiety disorders"	"Atrophic disorders of skin"	1	87	248	335
"L30"	"O65"	"Other and unspecified dermatitis"	"Obstructed labor due to maternal pelvic abnormality"	1	0	117	117
"N30"	"J32"	"Cystitis"	"Chronic sinusitis"	1	292	691	983
"L98"	"D30"	"Oth disorders of skin, subcu, not elsewhere classified"	"Benign neoplasm of urinary organs"	1	62	137	199
"N89"	"C53"	"Other noninflammatory disorders of vagina"	"Malignant neoplasm of cervix uteri"	1	40	124	164
"N28"	"N18"	"Oth disorders of kidney and ureter, not elsewhere classified"	"Chronic kidney disease (CKD)"	1	2177	2897	5074
"D12"	"B18"	"Benign neoplasm of colon, rectum, anus and anal canal"	"Chronic viral hepatitis"	1	40	138	178
"K76"	"O75"	"Other diseases of liver"	"Oth complications of labor and delivery, NEC"	1	5	52	57
"H60"	"Q53"	"Otitis externa"	"Undescended and ectopic testicle"	1	4	53	57
"A41"	"K50"	"Other sepsis"	"Crohn's disease [regional enteritis]"	1	190	785	975
"M80"	"A69"	"Osteoporosis with current pathological fracture"	"Other spirochetal infections"	1	0	34	34
"N39"	"L72"	"Other disorders of urinary system"	"Follicular cysts of skin and subcutaneous tissue"	1	151	377	528
"N18"	"M14"	"Chronic kidney disease (CKD)"	"Arthropathies in other diseases classified elsewhere"	1	97	181	278
"O24"	"J35"	"Diabetes in pregnancy, childbirth, and the puerperium"	"Chronic diseases of tonsils and adenoids"	1	0	408	408
"M80"	"H40"	"Osteoporosis with current pathological fracture"	"Glaucoma"	1	265	979	1244
"N39"	"H26"	"Other disorders of urinary system"	"Other cataract"	1	1803	4590	6393
"G30"	"F43"	"Alzheimer's disease"	"Reaction to severe stress, and adjustment disorders"	1	14	102	116
"I71"	"C20"	"Aortic aneurysm and dissection"	"Malignant neoplasm of rectum"	1	148	275	423
"M48"	"O48"	"Other spondylopathies"	"Late pregnancy"	1	0	40	40
"E60"	"F10"	"Dietary zinc deficiency"	"Alcohol related disorders"	1	59	183	242
"J90"	"H44"	"Pleural effusion, not elsewhere classified"	"Disorders of globe"	1	5	54	59
"M16"	"O24"	"Osteoarthritis of hip"	"Diabetes in pregnancy, childbirth, and the puerperium"	1	0	44	44
"M79"	"N43"	"Oth and unsp soft tissue disorders, not elsewhere classified"	"Hydrocele and spermatocele"	1	396	853	1249
"K83"	"D17"	"Other diseases of biliary tract"	"Benign lipomatous neoplasm"	1	39	121	160
"H71"	"J20"	"Cholesteatoma of middle ear"	"Acute bronchitis"	1	3	75	78
"I48"	"M17"	"Atrial fibrillation and flutter"	"Osteoarthritis of knee"	1	0	16149	16149
"E86"	"K83"	"Volume depletion"	"Other diseases of biliary tract"	1	752	1236	1988
"K40"	"M62"	"Inguinal hernia"	"Other disorders of muscle"	1	1110	1623	2733
"D12"	"N81"	"Benign neoplasm of colon, rectum, anus and anal canal"	"Female genital prolapse"	1	611	2090	2701
"A04"	"C81"	"Other bacterial intestinal infections"	"Hodgkin lymphoma"	1	13	65	78
"L90"	"J36"	"Atrophic disorders of skin"	"Peritonsillar abscess"	1	32	109	141
"O61"	"O21"	"Failed induction of labor"	"Excessive vomiting in pregnancy"	1	47	165	212
"K31"	"O80"	"Other diseases of stomach and duodenum"	"Encounter for full-term uncomplicated delivery"	1	0	91	91
"N19"	"D51"	"Unspecified kidney failure"	"Vitamin B12 deficiency anemia"	1	137	335	472
"G44"	"L05"	"Other headache syndromes"	"Pilonidal cyst and sinus"	1	51	124	175
"I26"	"N62"	"Pulmonary embolism"	"Hypertrophy of breast"	1	51	205	256
"I47"	"H80"	"Paroxysmal tachycardia"	"Otosclerosis"	1	43	179	222
"B34"	"Q90"	"Viral infection of unspecified site"	"Down syndrome"	1	25	264	289
"M80"	"H35"	"Osteoporosis with current pathological fracture"	"Other retinal disorders"	1	1011	2814	3825
"I70"	"O26"	"Atherosclerosis"	"Maternal care for oth conditions predom related to pregnancy"	1	0	33	33
"J15"	"J33"	"Bacterial pneumonia, not elsewhere classified"	"Nasal polyp"	1	39	239	278
"J18"	"O63"	"Pneumonia, unspecified organism"	"Long labor"	1	61	360	421
"O92"	"O23"	"Oth disord of brst/lactatn assoc w pregnancy and the puerp"	"Infections of genitourinary tract in pregnancy"	1	719	1134	1853
"K59"	"H65"	"Other functional intestinal disorders"	"Nonsuppurative otitis media"	1	654	2177	2831
"K27"	"H83"	"Peptic ulcer, site unspecified"	"Other diseases of inner ear"	1	33	157	190
"G98"	"O36"	"Other disorders of nervous system not elsewhere classified"	"Maternal care for other fetal problems"	1	0	73	73
"D63"	"O04"	"Anemia in chronic diseases classified elsewhere"	"Complications following (induced) termination of pregnancy"	1	0	33	33
"I63"	"I70"	"Cerebral infarction"	"Atherosclerosis"	1	3704	4167	7871
"E86"	"M20"	"Volume depletion"	"Acquired deformities of fingers and toes"	1	0	1729	1729
"O75"	"K35"	"Oth complications of labor and delivery, NEC"	"Acute appendicitis"	1	118	454	572
"M20"	"N97"	"Acquired deformities of fingers and toes"	"Female infertility"	1	96	404	500
"J96"	"M23"	"Respiratory failure, not elsewhere classified"	"Internal derangement of knee"	1	0	1919	1919
"G62"	"N46"	"Other and unspecified polyneuropathies"	"Male infertility"	1	2	64	66
"N30"	"J44"	"Cystitis"	"Other chronic obstructive pulmonary disease"	1	10456	13692	24148
"M13"	"J05"	"Other arthritis"	"Acute obstructive laryngitis [croup] and epiglottitis"	1	39	190	229
"C78"	"N41"	"Secondary malignant neoplasm of resp and digestive organs"	"Inflammatory diseases of prostate"	1	8	81	89
"N87"	"L05"	"Dysplasia of cervix uteri"	"Pilonidal cyst and sinus"	1	29	118	147
"H90"	"D06"	"Conductive and sensorineural hearing loss"	"Carcinoma in situ of cervix uteri"	1	2	53	55
"A41"	"C64"	"Other sepsis"	"Malignant neoplasm of kidney, except renal pelvis"	1	423	785	1208
"I48"	"L92"	"Atrial fibrillation and flutter"	"Granulomatous disorders of skin and subcutaneous tissue"	1	45	123	168
"E16"	"M51"	"Other disorders of pancreatic internal secretion"	"Thoracic, thoracolum, and lumbosacral intvrt disc disorders"	1	144	432	576
"H53"	"N70"	"Visual disturbances"	"Salpingitis and oophoritis"	1	5	87	92
"M48"	"D14"	"Other spondylopathies"	"Benign neoplasm of middle ear and respiratory system"	1	126	284	410
"G62"	"J36"	"Other and unspecified polyneuropathies"	"Peritonsillar abscess"	1	2	37	39
"M53"	"O13"	"Other and unspecified dorsopathies, not elsewhere classified"	"Gestational hypertension without significant proteinuria"	1	21	70	91
"C80"	"E10"	"Malignant neoplasm without specification of site"	"Type 1 diabetes mellitus"	1	60	239	299
"A41"	"C73"	"Other sepsis"	"Malignant neoplasm of thyroid gland"	1	24	77	101
"O72"	"L52"	"Postpartum hemorrhage"	"Erythema nodosum"	1	14	144	158
"I73"	"O71"	"Other peripheral vascular diseases"	"Other obstetric trauma"	1	10	62	72
"I50"	"N84"	"Heart failure"	"Polyp of female genital tract"	1	148	491	639
"C91"	"N43"	"Lymphoid leukemia"	"Hydrocele and spermatocele"	1	11	66	77
"F17"	"M95"	"Nicotine dependence"	"Oth acquired deformities of ms sys and connective tissue"	1	20	165	185
"I50"	"H20"	"Heart failure"	"Iridocyclitis"	1	124	452	576
"E06"	"N87"	"Thyroiditis"	"Dysplasia of cervix uteri"	1	19	136	155
"O99"	"Q67"	"Oth maternal diseases classd elsw but compl preg/chldbrth"	"Congenital ms deformities of head, face, spine and chest"	1	15	85	100
"I51"	"M67"	"Complications and ill-defined descriptions of heart disease"	"Other disorders of synovium and tendon"	1	42	165	207
"M23"	"N87"	"Internal derangement of knee"	"Dysplasia of cervix uteri"	1	673	950	1623
"K04"	"D27"	"Diseases of pulp and periapical tissues"	"Benign neoplasm of ovary"	1	44	105	149
"N08"	"M51"	"Glomerular disorders in diseases classified elsewhere"	"Thoracic, thoracolum, and lumbosacral intvrt disc disorders"	1	3	36	39
"D09"	"K35"	"Carcinoma in situ of other and unspecified sites"	"Acute appendicitis"	1	1	41	42
"E53"	"I80"	"Deficiency of other B group vitamins"	"Phlebitis and thrombophlebitis"	1	101	291	392
"Q61"	"N92"	"Cystic kidney disease"	"Excessive, frequent and irregular menstruation"	1	2	192	194
"F60"	"F10"	"Specific personality disorders"	"Alcohol related disorders"	1	344	1303	1647
"C61"	"I25"	"Malignant neoplasm of prostate"	"Chronic ischemic heart disease"	1	1599	3462	5061
"N60"	"O99"	"Benign mammary dysplasia"	"Oth maternal diseases classd elsw but compl preg/chldbrth"	1	451	861	1312
"M23"	"L03"	"Internal derangement of knee"	"Cellulitis and acute lymphangitis"	1	610	1359	1969
"C92"	"M67"	"Myeloid leukemia"	"Other disorders of synovium and tendon"	1	6	47	53
"J69"	"F23"	"Pneumonitis due to solids and liquids"	"Brief psychotic disorder"	1	9	64	73
"I69"	"E78"	"Sequelae of cerebrovascular disease"	"Disorders of lipoprotein metabolism and other lipidemias"	1	0	35581	35581
"H43"	"O04"	"Disorders of vitreous body"	"Complications following (induced) termination of pregnancy"	1	0	86	86
"D12"	"M47"	"Benign neoplasm of colon, rectum, anus and anal canal"	"Spondylosis"	1	1016	2061	3077
"M77"	"A63"	"Other enthesopathies"	"Oth predominantly sexually transmitted diseases, NEC"	1	68	300	368
"G91"	"M70"	"Hydrocephalus"	"Soft tissue disorders related to use, overuse and pressure"	1	12	85	97
"K83"	"M16"	"Other diseases of biliary tract"	"Osteoarthritis of hip"	1	112	582	694
"G97"	"O68"	"Intraop and postproc comp and disorders of nervous sys, NEC"	"Labor and delivery comp by abnlt of fetal acid-base balance"	1	25	131	156
"A46"	"N87"	"Erysipelas"	"Dysplasia of cervix uteri"	1	18	196	214
"M41"	"J20"	"Scoliosis"	"Acute bronchitis"	1	0	275	275
"E23"	"D33"	"Hypofunction and other disorders of the pituitary gland"	"Benign neoplasm of brain and oth prt central nervous system"	1	80	232	312
"O86"	"G40"	"Other puerperal infections"	"Epilepsy and recurrent seizures"	1	19	64	83
"M99"	"H80"	"Biomechanical lesions, not elsewhere classified"	"Otosclerosis"	1	5	38	43
"C22"	"H35"	"Malignant neoplasm of liver and intrahepatic bile ducts"	"Other retinal disorders"	1	19	272	291
"J18"	"M18"	"Pneumonia, unspecified organism"	"Osteoarthritis of first carpometacarpal joint"	1	427	851	1278
"H57"	"O63"	"Other disorders of eye and adnexa"	"Long labor"	1	8	80	88
"F33"	"I63"	"Major depressive disorder, recurrent"	"Cerebral infarction"	1	1358	1792	3150
"I48"	"M65"	"Atrial fibrillation and flutter"	"Synovitis and tenosynovitis"	1	0	3338	3338
"A41"	"O23"	"Other sepsis"	"Infections of genitourinary tract in pregnancy"	1	58	150	208
"C64"	"I10"	"Malignant neoplasm of kidney, except renal pelvis"	"Essential (primary) hypertension"	1	879	2078	2957
"I48"	"D36"	"Atrial fibrillation and flutter"	"Benign neoplasm of other and unspecified sites"	1	35	172	207
"D68"	"L20"	"Other coagulation defects"	"Atopic dermatitis"	1	4	58	62
"I73"	"E05"	"Other peripheral vascular diseases"	"Thyrotoxicosis [hyperthyroidism]"	1	373	620	993
"N47"	"Q21"	"Disorders of prepuce"	"Congenital malformations of cardiac septa"	1	17	182	199
"C15"	"N92"	"Malignant neoplasm of esophagus"	"Excessive, frequent and irregular menstruation"	1	0	29	29
"K52"	"C67"	"Other and unsp noninfective gastroenteritis and colitis"	"Malignant neoplasm of bladder"	1	130	295	425
"K57"	"K13"	"Diverticular disease of intestine"	"Other diseases of lip and oral mucosa"	1	108	266	374
"J95"	"C20"	"Intraop and postproc comp and disorders of resp sys, NEC"	"Malignant neoplasm of rectum"	1	66	182	248
"I80"	"D30"	"Phlebitis and thrombophlebitis"	"Benign neoplasm of urinary organs"	1	241	424	665
"D47"	"F10"	"Oth neoplm of uncrt behav of lymphoid, hematpoetc & rel tiss"	"Alcohol related disorders"	1	22	296	318
"K91"	"F10"	"Intraop and postproc comp and disorders of dgstv sys, NEC"	"Alcohol related disorders"	1	111	335	446
"I48"	"M76"	"Atrial fibrillation and flutter"	"Enthesopathies, lower limb, excluding foot"	1	276	913	1189
"C48"	"C62"	"Malignant neoplasm of retroperitoneum and peritoneum"	"Malignant neoplasm of testis"	1	29	93	122
"C44"	"M51"	"Other and unspecified malignant neoplasm of skin"	"Thoracic, thoracolum, and lumbosacral intvrt disc disorders"	1	233	1673	1906
"M25"	"K58"	"Other joint disorder, not elsewhere classified"	"Irritable bowel syndrome"	1	600	1092	1692
"M77"	"N92"	"Other enthesopathies"	"Excessive, frequent and irregular menstruation"	1	807	2165	2972
"C91"	"K80"	"Lymphoid leukemia"	"Cholelithiasis"	1	98	188	286
"G95"	"H80"	"Other and unspecified diseases of spinal cord"	"Otosclerosis"	1	0	30	30
"G96"	"I42"	"Other disorders of central nervous system"	"Cardiomyopathy"	1	91	204	295
"I10"	"G35"	"Essential (primary) hypertension"	"Multiple sclerosis"	1	195	722	917
"E11"	"D27"	"Type 2 diabetes mellitus"	"Benign neoplasm of ovary"	1	262	717	979
"F02"	"C61"	"Dementia in other diseases classified elsewhere"	"Malignant neoplasm of prostate"	1	17	95	112
"F03"	"I71"	"Unspecified dementia"	"Aortic aneurysm and dissection"	1	358	796	1154
"M75"	"G40"	"Shoulder lesions"	"Epilepsy and recurrent seizures"	1	537	1069	1606
"G20"	"J34"	"Parkinson's disease"	"Other and unspecified disorders of nose and nasal sinuses"	1	0	59	59
"J06"	"M51"	"Acute upper resp infections of multiple and unsp sites"	"Thoracic, thoracolum, and lumbosacral intvrt disc disorders"	1	56	514	570
"K59"	"M02"	"Other functional intestinal disorders"	"Postinfective and reactive arthropathies"	1	240	777	1017
"H26"	"E05"	"Other cataract"	"Thyrotoxicosis [hyperthyroidism]"	1	615	1075	1690
"E87"	"H36"	"Other disorders of fluid, electrolyte and acid-base balance"	"Retinal disorders in diseases classified elsewhere"	1	216	1306	1522
"K92"	"N48"	"Other diseases of digestive system"	"Other disorders of penis"	1	120	245	365
"M62"	"N71"	"Other disorders of muscle"	"Inflammatory disease of uterus, except cervix"	1	652	879	1531
"N30"	"J12"	"Cystitis"	"Viral pneumonia, not elsewhere classified"	1	151	320	471
"K40"	"O02"	"Inguinal hernia"	"Other abnormal products of conception"	1	63	152	215
"K74"	"J45"	"Fibrosis and cirrhosis of liver"	"Asthma"	1	96	307	403
"N84"	"O42"	"Polyp of female genital tract"	"Premature rupture of membranes"	1	32	425	457
"K08"	"O26"	"Other disorders of teeth and supporting structures"	"Maternal care for oth conditions predom related to pregnancy"	1	22	109	131
"M85"	"K51"	"Other disorders of bone density and structure"	"Ulcerative colitis"	1	43	848	891
"C16"	"D23"	"Malignant neoplasm of stomach"	"Other benign neoplasms of skin"	1	6	105	111
"E78"	"H11"	"Disorders of lipoprotein metabolism and other lipidemias"	"Other disorders of conjunctiva"	1	292	585	877
"C71"	"H40"	"Malignant neoplasm of brain"	"Glaucoma"	1	19	99	118
"M20"	"N80"	"Acquired deformities of fingers and toes"	"Endometriosis"	1	79	257	336
"J94"	"E10"	"Other pleural conditions"	"Type 1 diabetes mellitus"	1	150	383	533
"I10"	"O48"	"Essential (primary) hypertension"	"Late pregnancy"	1	0	253	253
"J84"	"G40"	"Other interstitial pulmonary diseases"	"Epilepsy and recurrent seizures"	1	74	198	272
"N94"	"O80"	"Pain and oth cond assoc w fem gntl org and menstrual cycle"	"Encounter for full-term uncomplicated delivery"	1	0	7421	7421
"C38"	"E66"	"Malignant neoplasm of heart, mediastinum and pleura"	"Overweight and obesity"	1	3	37	40
"D06"	"N87"	"Carcinoma in situ of cervix uteri"	"Dysplasia of cervix uteri"	1	1822	2399	4221
"I61"	"I25"	"Nontraumatic intracerebral hemorrhage"	"Chronic ischemic heart disease"	1	1052	2618	3670
"D84"	"M23"	"Other immunodeficiencies"	"Internal derangement of knee"	1	14	88	102
"M18"	"N80"	"Osteoarthritis of first carpometacarpal joint"	"Endometriosis"	1	0	93	93
"L90"	"O64"	"Atrophic disorders of skin"	"Obstructed labor due to malposition and malpresent of fetus"	1	47	379	426
"M05"	"N92"	"Rheumatoid arthritis with rheumatoid factor"	"Excessive, frequent and irregular menstruation"	1	56	569	625
"J90"	"O20"	"Pleural effusion, not elsewhere classified"	"Hemorrhage in early pregnancy"	1	0	25	25
"A49"	"C64"	"Bacterial infection of unspecified site"	"Malignant neoplasm of kidney, except renal pelvis"	1	131	311	442
"K46"	"O70"	"Unspecified abdominal hernia"	"Perineal laceration during delivery"	1	0	82	82
"J90"	"N99"	"Pleural effusion, not elsewhere classified"	"Intraop and postproc comp and disorders of GU sys, NEC"	1	33	94	127
"I42"	"G44"	"Cardiomyopathy"	"Other headache syndromes"	1	32	88	120
"F60"	"J45"	"Specific personality disorders"	"Asthma"	1	103	319	422
"J90"	"M85"	"Pleural effusion, not elsewhere classified"	"Other disorders of bone density and structure"	1	145	304	449
"E55"	"N40"	"Vitamin D deficiency"	"Benign prostatic hyperplasia"	1	94	636	730
"H90"	"Q89"	"Conductive and sensorineural hearing loss"	"Other congenital malformations, not elsewhere classified"	1	16	90	106
"M46"	"G56"	"Other inflammatory spondylopathies"	"Mononeuropathies of upper limb"	1	116	271	387
"K29"	"D06"	"Gastritis and duodenitis"	"Carcinoma in situ of cervix uteri"	1	15	111	126
"D63"	"C77"	"Anemia in chronic diseases classified elsewhere"	"Secondary and unspecified malignant neoplasm of lymph nodes"	1	769	1714	2483
"F01"	"N20"	"Vascular dementia"	"Calculus of kidney and ureter"	1	9	138	147
"C18"	"K42"	"Malignant neoplasm of colon"	"Umbilical hernia"	1	137	314	451
"L97"	"O04"	"Non-pressure chronic ulcer of lower limb, NEC"	"Complications following (induced) termination of pregnancy"	1	0	45	45
"F17"	"Q18"	"Nicotine dependence"	"Other congenital malformations of face and neck"	1	10	83	93
"B34"	"O65"	"Viral infection of unspecified site"	"Obstructed labor due to maternal pelvic abnormality"	1	0	180	180
"I89"	"O14"	"Oth noninfective disorders of lymphatic vessels and nodes"	"Pre-eclampsia"	1	0	29	29
"I69"	"I47"	"Sequelae of cerebrovascular disease"	"Paroxysmal tachycardia"	1	1326	2903	4229
"L97"	"M19"	"Non-pressure chronic ulcer of lower limb, NEC"	"Other and unspecified osteoarthritis"	1	326	892	1218
"J18"	"H26"	"Pneumonia, unspecified organism"	"Other cataract"	1	0	11985	11985
"I45"	"J45"	"Other conduction disorders"	"Asthma"	1	321	625	946
"I35"	"O68"	"Nonrheumatic aortic valve disorders"	"Labor and delivery comp by abnlt of fetal acid-base balance"	1	0	67	67
"I26"	"G45"	"Pulmonary embolism"	"Transient cerebral ischemic attacks and related syndromes"	1	368	1017	1385
"L29"	"O03"	"Pruritus"	"Spontaneous abortion"	1	2	87	89
"G98"	"M17"	"Other disorders of nervous system not elsewhere classified"	"Osteoarthritis of knee"	1	120	589	709
"I34"	"L02"	"Nonrheumatic mitral valve disorders"	"Cutaneous abscess, furuncle and carbuncle"	1	192	316	508
"J47"	"N95"	"Bronchiectasis"	"Menopausal and other perimenopausal disorders"	1	25	145	170
"J47"	"M19"	"Bronchiectasis"	"Other and unspecified osteoarthritis"	1	91	261	352
"L97"	"K80"	"Non-pressure chronic ulcer of lower limb, NEC"	"Cholelithiasis"	1	197	776	973
"I21"	"O62"	"Acute myocardial infarction"	"Abnormalities of forces of labor"	1	0	92	92
"C78"	"I60"	"Secondary malignant neoplasm of resp and digestive organs"	"Nontraumatic subarachnoid hemorrhage"	1	2	96	98
"A46"	"E66"	"Erysipelas"	"Overweight and obesity"	1	2325	3592	5917
"M84"	"K30"	"Disorder of continuity of bone"	"Functional dyspepsia"	1	57	137	194
"G96"	"E05"	"Other disorders of central nervous system"	"Thyrotoxicosis [hyperthyroidism]"	1	91	408	499
"K83"	"I47"	"Other diseases of biliary tract"	"Paroxysmal tachycardia"	1	99	294	393
"Q66"	"Q90"	"Congenital deformities of feet"	"Down syndrome"	1	19	107	126
"N35"	"C61"	"Urethral stricture"	"Malignant neoplasm of prostate"	1	437	862	1299
"D62"	"O62"	"Acute posthemorrhagic anemia"	"Abnormalities of forces of labor"	1	27	370	397
"A41"	"Q87"	"Other sepsis"	"Oth congenital malform syndromes affecting multiple systems"	1	24	94	118
"N30"	"H40"	"Cystitis"	"Glaucoma"	1	985	3017	4002
"A49"	"I49"	"Bacterial infection of unspecified site"	"Other cardiac arrhythmias"	1	316	1302	1618
"A49"	"O42"	"Bacterial infection of unspecified site"	"Premature rupture of membranes"	1	53	133	186
"H92"	"J00"	"Otalgia and effusion of ear"	"Acute nasopharyngitis [common cold]"	1	52	293	345
"M48"	"H71"	"Other spondylopathies"	"Cholesteatoma of middle ear"	1	10	74	84
"J15"	"D18"	"Bacterial pneumonia, not elsewhere classified"	"Hemangioma and lymphangioma, any site"	1	83	221	304
"D84"	"J15"	"Other immunodeficiencies"	"Bacterial pneumonia, not elsewhere classified"	1	110	233	343
"E13"	"I83"	"Other specified diabetes mellitus"	"Varicose veins of lower extremities"	1	42	153	195
"C90"	"G45"	"Multiple myeloma and malignant plasma cell neoplasms"	"Transient cerebral ischemic attacks and related syndromes"	1	57	153	210
"D84"	"J03"	"Other immunodeficiencies"	"Acute tonsillitis"	1	95	236	331
"C22"	"E11"	"Malignant neoplasm of liver and intrahepatic bile ducts"	"Type 2 diabetes mellitus"	1	125	1127	1252
"C16"	"L02"	"Malignant neoplasm of stomach"	"Cutaneous abscess, furuncle and carbuncle"	1	22	133	155
"C18"	"H65"	"Malignant neoplasm of colon"	"Nonsuppurative otitis media"	1	15	150	165
"C24"	"M23"	"Malignant neoplasm of other and unsp parts of biliary tract"	"Internal derangement of knee"	1	0	83	83
"I48"	"D11"	"Atrial fibrillation and flutter"	"Benign neoplasm of major salivary glands"	1	206	463	669
"M66"	"O02"	"Spontaneous rupture of synovium and tendon"	"Other abnormal products of conception"	1	0	30	30
"C78"	"M48"	"Secondary malignant neoplasm of resp and digestive organs"	"Other spondylopathies"	1	126	1187	1313
"H91"	"Q89"	"Other and unspecified hearing loss"	"Other congenital malformations, not elsewhere classified"	1	11	51	62
"J44"	"N97"	"Other chronic obstructive pulmonary disease"	"Female infertility"	1	0	158	158
"D35"	"O68"	"Benign neoplasm of other and unspecified endocrine glands"	"Labor and delivery comp by abnlt of fetal acid-base balance"	1	1	99	100
"K62"	"H33"	"Other diseases of anus and rectum"	"Retinal detachments and breaks"	1	222	346	568
"E16"	"H90"	"Other disorders of pancreatic internal secretion"	"Conductive and sensorineural hearing loss"	1	128	321	449
"I86"	"K85"	"Varicose veins of other sites"	"Acute pancreatitis"	1	15	77	92
"O47"	"E28"	"False labor"	"Ovarian dysfunction"	1	323	636	959
"I61"	"H80"	"Nontraumatic intracerebral hemorrhage"	"Otosclerosis"	1	0	106	106
"A41"	"C34"	"Other sepsis"	"Malignant neoplasm of bronchus and lung"	1	1794	3158	4952
"J13"	"I20"	"Pneumonia due to Streptococcus pneumoniae"	"Angina pectoris"	1	148	658	806
"O90"	"O99"	"Complications of the puerperium, not elsewhere classified"	"Oth maternal diseases classd elsw but compl preg/chldbrth"	1	0	12619	12619
"I46"	"G63"	"Cardiac arrest"	"Polyneuropathy in diseases classified elsewhere"	1	20	146	166
"C16"	"L03"	"Malignant neoplasm of stomach"	"Cellulitis and acute lymphangitis"	1	0	74	74
"A41"	"N83"	"Other sepsis"	"Noninflammatory disord of ovary, fallop and broad ligament"	1	188	766	954
"K74"	"K85"	"Fibrosis and cirrhosis of liver"	"Acute pancreatitis"	1	144	346	490
"L97"	"M80"	"Non-pressure chronic ulcer of lower limb, NEC"	"Osteoporosis with current pathological fracture"	1	604	889	1493
"J47"	"K51"	"Bronchiectasis"	"Ulcerative colitis"	1	0	107	107
"K92"	"H83"	"Other diseases of digestive system"	"Other diseases of inner ear"	1	0	906	906
"I63"	"K42"	"Cerebral infarction"	"Umbilical hernia"	1	219	616	835
"D23"	"J05"	"Other benign neoplasms of skin"	"Acute obstructive laryngitis [croup] and epiglottitis"	1	2	109	111
"N13"	"J37"	"Obstructive and reflux uropathy"	"Chronic laryngitis and laryngotracheitis"	1	2	46	48
"C83"	"O80"	"Non-follicular lymphoma"	"Encounter for full-term uncomplicated delivery"	1	0	48	48
"I89"	"H83"	"Oth noninfective disorders of lymphatic vessels and nodes"	"Other diseases of inner ear"	1	0	74	74
"I51"	"O48"	"Complications and ill-defined descriptions of heart disease"	"Late pregnancy"	1	3	35	38
"J96"	"I10"	"Respiratory failure, not elsewhere classified"	"Essential (primary) hypertension"	1	0	31031	31031
"L90"	"H50"	"Atrophic disorders of skin"	"Other strabismus"	1	44	141	185
"A49"	"N92"	"Bacterial infection of unspecified site"	"Excessive, frequent and irregular menstruation"	1	9	714	723
"A04"	"N60"	"Other bacterial intestinal infections"	"Benign mammary dysplasia"	1	4	108	112
"I51"	"E78"	"Complications and ill-defined descriptions of heart disease"	"Disorders of lipoprotein metabolism and other lipidemias"	1	1057	2366	3423
"J93"	"H80"	"Pneumothorax and air leak"	"Otosclerosis"	1	0	39	39
"I82"	"M50"	"Other venous embolism and thrombosis"	"Cervical disc disorders"	1	30	129	159
"K62"	"C50"	"Other diseases of anus and rectum"	"Malignant neoplasm of breast"	1	585	1159	1744
"M75"	"I47"	"Shoulder lesions"	"Paroxysmal tachycardia"	1	1038	1474	2512
"E03"	"N43"	"Other hypothyroidism"	"Hydrocele and spermatocele"	1	26	94	120
"H43"	"E66"	"Disorders of vitreous body"	"Overweight and obesity"	1	406	612	1018
"G81"	"I63"	"Hemiplegia and hemiparesis"	"Cerebral infarction"	1	636	1090	1726
"I78"	"I21"	"Diseases of capillaries"	"Acute myocardial infarction"	1	438	700	1138
"M77"	"L20"	"Other enthesopathies"	"Atopic dermatitis"	1	18	114	132
"K91"	"E78"	"Intraop and postproc comp and disorders of dgstv sys, NEC"	"Disorders of lipoprotein metabolism and other lipidemias"	1	285	470	755
"J38"	"C73"	"Diseases of vocal cords and larynx, not elsewhere classified"	"Malignant neoplasm of thyroid gland"	1	117	227	344
"O82"	"H72"	"Encounter for cesarean delivery without indication"	"Perforation of tympanic membrane"	1	60	142	202
"C76"	"M62"	"Malignant neoplasm of other and ill-defined sites"	"Other disorders of muscle"	1	27	104	131
"K21"	"A63"	"Gastro-esophageal reflux disease"	"Oth predominantly sexually transmitted diseases, NEC"	1	96	349	445
"D64"	"D11"	"Other anemias"	"Benign neoplasm of major salivary glands"	1	76	322	398
"I50"	"N83"	"Heart failure"	"Noninflammatory disord of ovary, fallop and broad ligament"	1	208	572	780
"F43"	"F10"	"Reaction to severe stress, and adjustment disorders"	"Alcohol related disorders"	1	1062	1716	2778
"C80"	"M81"	"Malignant neoplasm without specification of site"	"Osteoporosis without current pathological fracture"	1	74	339	413
"F44"	"J44"	"Dissociative and conversion disorders"	"Other chronic obstructive pulmonary disease"	1	82	171	253
"N19"	"K61"	"Unspecified kidney failure"	"Abscess of anal and rectal regions"	1	67	222	289
"M62"	"L20"	"Other disorders of muscle"	"Atopic dermatitis"	1	103	257	360
"G56"	"O68"	"Mononeuropathies of upper limb"	"Labor and delivery comp by abnlt of fetal acid-base balance"	1	0	2334	2334
"M75"	"N84"	"Shoulder lesions"	"Polyp of female genital tract"	1	883	1328	2211
"E87"	"G35"	"Other disorders of fluid, electrolyte and acid-base balance"	"Multiple sclerosis"	1	0	186	186
"I50"	"D30"	"Heart failure"	"Benign neoplasm of urinary organs"	1	531	1883	2414
"F32"	"H65"	"Depressive episode"	"Nonsuppurative otitis media"	1	43	249	292
"N39"	"N64"	"Other disorders of urinary system"	"Other disorders of breast"	1	464	732	1196
"E78"	"H83"	"Disorders of lipoprotein metabolism and other lipidemias"	"Other diseases of inner ear"	1	0	3037	3037
"M85"	"B25"	"Other disorders of bone density and structure"	"Cytomegaloviral disease"	1	19	72	91
"I69"	"K50"	"Sequelae of cerebrovascular disease"	"Crohn's disease [regional enteritis]"	1	135	273	408
"K25"	"O68"	"Gastric ulcer"	"Labor and delivery comp by abnlt of fetal acid-base balance"	1	15	168	183
"J09"	"M47"	"Influenza due to certain identified influenza viruses"	"Spondylosis"	1	1	77	78
"M19"	"O42"	"Other and unspecified osteoarthritis"	"Premature rupture of membranes"	1	0	154	154
"I46"	"J43"	"Cardiac arrest"	"Emphysema"	1	46	438	484
"C34"	"N99"	"Malignant neoplasm of bronchus and lung"	"Intraop and postproc comp and disorders of GU sys, NEC"	1	21	254	275
"N25"	"N92"	"Disorders resulting from impaired renal tubular function"	"Excessive, frequent and irregular menstruation"	1	165	279	444
"M31"	"D25"	"Other necrotizing vasculopathies"	"Leiomyoma of uterus"	1	8	114	122
"K52"	"N43"	"Other and unsp noninfective gastroenteritis and colitis"	"Hydrocele and spermatocele"	1	108	254	362
"I15"	"H93"	"Secondary hypertension"	"Other disorders of ear, not elsewhere classified"	1	73	282	355
"K76"	"O36"	"Other diseases of liver"	"Maternal care for other fetal problems"	1	16	110	126
"N36"	"C20"	"Other disorders of urethra"	"Malignant neoplasm of rectum"	1	33	108	141
"C78"	"D62"	"Secondary malignant neoplasm of resp and digestive organs"	"Acute posthemorrhagic anemia"	1	257	442	699
"C25"	"N43"	"Malignant neoplasm of pancreas"	"Hydrocele and spermatocele"	1	0	106	106
"J96"	"M47"	"Respiratory failure, not elsewhere classified"	"Spondylosis"	1	0	2315	2315
"F43"	"H10"	"Reaction to severe stress, and adjustment disorders"	"Conjunctivitis"	1	56	379	435
"I10"	"L05"	"Essential (primary) hypertension"	"Pilonidal cyst and sinus"	1	121	747	868
"O68"	"H65"	"Labor and delivery comp by abnlt of fetal acid-base balance"	"Nonsuppurative otitis media"	1	35	250	285
"M75"	"O32"	"Shoulder lesions"	"Maternal care for malpresentation of fetus"	1	0	461	461
"O75"	"O47"	"Oth complications of labor and delivery, NEC"	"False labor"	1	1432	2891	4323
"J18"	"N60"	"Pneumonia, unspecified organism"	"Benign mammary dysplasia"	1	103	1162	1265
"O60"	"O20"	"Preterm labor"	"Hemorrhage in early pregnancy"	1	694	1666	2360
"F02"	"K57"	"Dementia in other diseases classified elsewhere"	"Diverticular disease of intestine"	1	28	153	181
"M14"	"L02"	"Arthropathies in other diseases classified elsewhere"	"Cutaneous abscess, furuncle and carbuncle"	1	93	213	306
"J22"	"O26"	"Unspecified acute lower respiratory infection"	"Maternal care for oth conditions predom related to pregnancy"	1	0	38	38
"M67"	"K40"	"Other disorders of synovium and tendon"	"Inguinal hernia"	1	600	936	1536
"D12"	"O08"	"Benign neoplasm of colon, rectum, anus and anal canal"	"Complications following ectopic and molar pregnancy"	1	0	50	50
"F33"	"O30"	"Major depressive disorder, recurrent"	"Multiple gestation"	1	38	101	139
"E64"	"O26"	"Sequelae of malnutrition and other nutritional deficiencies"	"Maternal care for oth conditions predom related to pregnancy"	1	1	44	45
"C83"	"K29"	"Non-follicular lymphoma"	"Gastritis and duodenitis"	1	111	247	358
"M24"	"H10"	"Other specific joint derangements"	"Conjunctivitis"	1	191	460	651
"D64"	"I21"	"Other anemias"	"Acute myocardial infarction"	1	0	15390	15390
"I51"	"M35"	"Complications and ill-defined descriptions of heart disease"	"Other systemic involvement of connective tissue"	1	161	314	475
"E83"	"C73"	"Disorders of mineral metabolism"	"Malignant neoplasm of thyroid gland"	1	62	230	292
"E34"	"Q25"	"Other endocrine disorders"	"Congenital malformations of great arteries"	1	5	150	155
"B37"	"I21"	"Candidiasis"	"Acute myocardial infarction"	1	440	988	1428
"F03"	"I49"	"Unspecified dementia"	"Other cardiac arrhythmias"	1	444	1751	2195
"E70"	"I10"	"Disorders of aromatic amino-acid metabolism"	"Essential (primary) hypertension"	1	211	447	658
"M25"	"O08"	"Other joint disorder, not elsewhere classified"	"Complications following ectopic and molar pregnancy"	1	86	220	306
"J44"	"H33"	"Other chronic obstructive pulmonary disease"	"Retinal detachments and breaks"	1	320	808	1128
"C15"	"K40"	"Malignant neoplasm of esophagus"	"Inguinal hernia"	1	22	440	462
"K59"	"N84"	"Other functional intestinal disorders"	"Polyp of female genital tract"	1	410	1208	1618
"D35"	"O02"	"Benign neoplasm of other and unspecified endocrine glands"	"Other abnormal products of conception"	1	1	77	78
"O99"	"L68"	"Oth maternal diseases classd elsw but compl preg/chldbrth"	"Hypertrichosis"	1	242	658	900
"D63"	"M99"	"Anemia in chronic diseases classified elsewhere"	"Biomechanical lesions, not elsewhere classified"	1	9	84	93
"J15"	"L30"	"Bacterial pneumonia, not elsewhere classified"	"Other and unspecified dermatitis"	1	392	1092	1484
"C50"	"M50"	"Malignant neoplasm of breast"	"Cervical disc disorders"	1	189	504	693
"K52"	"H36"	"Other and unsp noninfective gastroenteritis and colitis"	"Retinal disorders in diseases classified elsewhere"	1	246	490	736
"J44"	"N40"	"Other chronic obstructive pulmonary disease"	"Benign prostatic hyperplasia"	1	3840	6778	10618
"F41"	"H35"	"Other anxiety disorders"	"Other retinal disorders"	1	212	748	960
"D12"	"O42"	"Benign neoplasm of colon, rectum, anus and anal canal"	"Premature rupture of membranes"	1	0	120	120
"E16"	"K57"	"Other disorders of pancreatic internal secretion"	"Diverticular disease of intestine"	1	261	443	704
"M47"	"E04"	"Spondylosis"	"Other nontoxic goiter"	1	471	731	1202
"M53"	"O04"	"Other and unspecified dorsopathies, not elsewhere classified"	"Complications following (induced) termination of pregnancy"	1	0	699	699
"K83"	"H40"	"Other diseases of biliary tract"	"Glaucoma"	1	76	175	251
"I82"	"O20"	"Other venous embolism and thrombosis"	"Hemorrhage in early pregnancy"	1	0	88	88
"H26"	"L02"	"Other cataract"	"Cutaneous abscess, furuncle and carbuncle"	1	466	776	1242
"K12"	"C81"	"Stomatitis and related lesions"	"Hodgkin lymphoma"	1	13	60	73
"M25"	"I47"	"Other joint disorder, not elsewhere classified"	"Paroxysmal tachycardia"	1	346	624	970
"M25"	"O46"	"Other joint disorder, not elsewhere classified"	"Antepartum hemorrhage, not elsewhere classified"	1	21	205	226
"J96"	"H83"	"Respiratory failure, not elsewhere classified"	"Other diseases of inner ear"	1	0	1037	1037
"K63"	"N92"	"Other diseases of intestine"	"Excessive, frequent and irregular menstruation"	1	8	374	382
"K31"	"O68"	"Other diseases of stomach and duodenum"	"Labor and delivery comp by abnlt of fetal acid-base balance"	1	2	32	34
"O99"	"H10"	"Oth maternal diseases classd elsw but compl preg/chldbrth"	"Conjunctivitis"	1	436	1173	1609
"E11"	"Q54"	"Type 2 diabetes mellitus"	"Hypospadias"	1	49	120	169
"E50"	"E78"	"Vitamin A deficiency"	"Disorders of lipoprotein metabolism and other lipidemias"	1	97	276	373
"D43"	"H25"	"Neoplasm of uncertain behavior of brain and cnsl"	"Age-related cataract"	1	175	299	474
"M14"	"O80"	"Arthropathies in other diseases classified elsewhere"	"Encounter for full-term uncomplicated delivery"	1	0	30	30
"M05"	"J34"	"Rheumatoid arthritis with rheumatoid factor"	"Other and unspecified disorders of nose and nasal sinuses"	1	32	107	139
"I50"	"M95"	"Heart failure"	"Oth acquired deformities of ms sys and connective tissue"	1	41	153	194
"D64"	"Q66"	"Other anemias"	"Congenital deformities of feet"	1	22	148	170
"C34"	"M24"	"Malignant neoplasm of bronchus and lung"	"Other specific joint derangements"	1	0	179	179
"H53"	"O99"	"Visual disturbances"	"Oth maternal diseases classd elsw but compl preg/chldbrth"	1	237	408	645
"N95"	"N63"	"Menopausal and other perimenopausal disorders"	"Unspecified lump in breast"	1	175	702	877
"H81"	"O70"	"Disorders of vestibular function"	"Perineal laceration during delivery"	1	155	726	881
"I50"	"I20"	"Heart failure"	"Angina pectoris"	1	0	47143	47143
"F03"	"M51"	"Unspecified dementia"	"Thoracic, thoracolum, and lumbosacral intvrt disc disorders"	1	0	1385	1385
"D72"	"O70"	"Other disorders of white blood cells"	"Perineal laceration during delivery"	1	6	72	78
"A41"	"F99"	"Other sepsis"	"Mental disorder, not otherwise specified"	1	56	275	331
"E66"	"M54"	"Overweight and obesity"	"Dorsalgia"	1	5683	8534	14217
"A04"	"O20"	"Other bacterial intestinal infections"	"Hemorrhage in early pregnancy"	1	33	90	123
"C56"	"M17"	"Malignant neoplasm of ovary"	"Osteoarthritis of knee"	1	154	347	501
"M81"	"M42"	"Osteoporosis without current pathological fracture"	"Spinal osteochondrosis"	1	62	196	258
"L90"	"N92"	"Atrophic disorders of skin"	"Excessive, frequent and irregular menstruation"	1	524	1472	1996
"I69"	"O32"	"Sequelae of cerebrovascular disease"	"Maternal care for malpresentation of fetus"	1	0	33	33
"M86"	"J45"	"Osteomyelitis"	"Asthma"	1	115	213	328
"M25"	"K51"	"Other joint disorder, not elsewhere classified"	"Ulcerative colitis"	1	240	778	1018
"Q74"	"Q89"	"Other congenital malformations of limb(s)"	"Other congenital malformations, not elsewhere classified"	1	68	149	217
"N18"	"J34"	"Chronic kidney disease (CKD)"	"Other and unspecified disorders of nose and nasal sinuses"	1	1	213	214
"O41"	"K35"	"Other disorders of amniotic fluid and membranes"	"Acute appendicitis"	1	47	131	178
"L30"	"O82"	"Other and unspecified dermatitis"	"Encounter for cesarean delivery without indication"	1	163	477	640
"M31"	"M51"	"Other necrotizing vasculopathies"	"Thoracic, thoracolum, and lumbosacral intvrt disc disorders"	1	213	359	572
"I48"	"D39"	"Atrial fibrillation and flutter"	"Neoplasm of uncertain behavior of female genital organs"	1	43	154	197
"I61"	"M18"	"Nontraumatic intracerebral hemorrhage"	"Osteoarthritis of first carpometacarpal joint"	1	21	91	112
"L97"	"N63"	"Non-pressure chronic ulcer of lower limb, NEC"	"Unspecified lump in breast"	1	2	161	163
"I10"	"B18"	"Essential (primary) hypertension"	"Chronic viral hepatitis"	1	304	538	842
"Q85"	"J45"	"Phakomatoses, not elsewhere classified"	"Asthma"	1	118	269	387
"D63"	"C82"	"Anemia in chronic diseases classified elsewhere"	"Follicular lymphoma"	1	60	154	214
"G63"	"E11"	"Polyneuropathy in diseases classified elsewhere"	"Type 2 diabetes mellitus"	1	322	2046	2368
"I26"	"O04"	"Pulmonary embolism"	"Complications following (induced) termination of pregnancy"	1	0	334	334
"H80"	"N97"	"Otosclerosis"	"Female infertility"	1	24	77	101
"J14"	"N92"	"Pneumonia due to Hemophilus influenzae"	"Excessive, frequent and irregular menstruation"	1	1	29	30
"C82"	"M51"	"Follicular lymphoma"	"Thoracic, thoracolum, and lumbosacral intvrt disc disorders"	1	31	123	154
"A04"	"M51"	"Other bacterial intestinal infections"	"Thoracic, thoracolum, and lumbosacral intvrt disc disorders"	1	65	680	745
"K11"	"M22"	"Diseases of salivary glands"	"Disorder of patella"	1	29	115	144
"O72"	"J45"	"Postpartum hemorrhage"	"Asthma"	1	0	5884	5884
"F03"	"C43"	"Unspecified dementia"	"Malignant melanoma of skin"	1	60	303	363
"C61"	"I20"	"Malignant neoplasm of prostate"	"Angina pectoris"	1	0	4187	4187
"D62"	"J38"	"Acute posthemorrhagic anemia"	"Diseases of vocal cords and larynx, not elsewhere classified"	1	21	85	106
"N30"	"K80"	"Cystitis"	"Cholelithiasis"	1	4376	6859	11235
"O72"	"L50"	"Postpartum hemorrhage"	"Urticaria"	1	375	1278	1653
"K92"	"C91"	"Other diseases of digestive system"	"Lymphoid leukemia"	1	98	196	294
"O91"	"O42"	"Infect of breast assoc w pregnancy, the puerp and lactation"	"Premature rupture of membranes"	1	420	1619	2039
"N90"	"O02"	"Other noninflammatory disorders of vulva and perineum"	"Other abnormal products of conception"	1	115	213	328
"N81"	"H65"	"Female genital prolapse"	"Nonsuppurative otitis media"	1	82	189	271
"E03"	"O70"	"Other hypothyroidism"	"Perineal laceration during delivery"	1	584	2340	2924
"I10"	"O66"	"Essential (primary) hypertension"	"Other obstructed labor"	1	0	174	174
"K91"	"G82"	"Intraop and postproc comp and disorders of dgstv sys, NEC"	"Paraplegia (paraparesis) and quadriplegia (quadriparesis)"	1	19	72	91
"K52"	"D14"	"Other and unsp noninfective gastroenteritis and colitis"	"Benign neoplasm of middle ear and respiratory system"	1	91	179	270
"M10"	"H36"	"Gout"	"Retinal disorders in diseases classified elsewhere"	1	207	378	585
"C50"	"N88"	"Malignant neoplasm of breast"	"Other noninflammatory disorders of cervix uteri"	1	12	69	81
"F52"	"C50"	"Sexual dysfnct not due to a substance or known physiol cond"	"Malignant neoplasm of breast"	1	22	88	110
"L98"	"O04"	"Oth disorders of skin, subcu, not elsewhere classified"	"Complications following (induced) termination of pregnancy"	1	2	415	417
"J18"	"I21"	"Pneumonia, unspecified organism"	"Acute myocardial infarction"	1	15971	20467	36438
"M16"	"M91"	"Osteoarthritis of hip"	"Juvenile osteochondrosis of hip and pelvis"	1	84	194	278
"F41"	"G45"	"Other anxiety disorders"	"Transient cerebral ischemic attacks and related syndromes"	1	275	827	1102
"M81"	"E78"	"Osteoporosis without current pathological fracture"	"Disorders of lipoprotein metabolism and other lipidemias"	1	3942	5663	9605
"C93"	"I20"	"Monocytic leukemia"	"Angina pectoris"	1	0	67	67
"K65"	"N03"	"Peritonitis"	"Chronic nephritic syndrome"	1	61	355	416
"C44"	"L20"	"Other and unspecified malignant neoplasm of skin"	"Atopic dermatitis"	1	18	89	107
"M85"	"A63"	"Other disorders of bone density and structure"	"Oth predominantly sexually transmitted diseases, NEC"	1	3	153	156
"K43"	"O42"	"Ventral hernia"	"Premature rupture of membranes"	1	0	255	255
"E86"	"K73"	"Volume depletion"	"Chronic hepatitis, not elsewhere classified"	1	65	174	239
"G54"	"M62"	"Nerve root and plexus disorders"	"Other disorders of muscle"	1	215	421	636
"K30"	"O71"	"Functional dyspepsia"	"Other obstetric trauma"	1	71	311	382
"I87"	"O03"	"Other disorders of veins"	"Spontaneous abortion"	1	0	59	59
"O99"	"Q17"	"Oth maternal diseases classd elsw but compl preg/chldbrth"	"Other congenital malformations of ear"	1	0	194	194
"M47"	"K30"	"Spondylosis"	"Functional dyspepsia"	1	854	1721	2575
"F32"	"N95"	"Depressive episode"	"Menopausal and other perimenopausal disorders"	1	384	599	983
"F06"	"K59"	"Other mental disorders due to known physiological condition"	"Other functional intestinal disorders"	1	357	514	871
"O32"	"M22"	"Maternal care for malpresentation of fetus"	"Disorder of patella"	1	41	467	508
"J84"	"M72"	"Other interstitial pulmonary diseases"	"Fibroblastic disorders"	1	22	176	198
"I73"	"D16"	"Other peripheral vascular diseases"	"Benign neoplasm of bone and articular cartilage"	1	33	90	123
"O70"	"J20"	"Perineal laceration during delivery"	"Acute bronchitis"	1	122	227	349
"D30"	"K30"	"Benign neoplasm of urinary organs"	"Functional dyspepsia"	1	180	296	476
"L08"	"G80"	"Other local infections of skin and subcutaneous tissue"	"Cerebral palsy"	1	36	132	168
"M17"	"O86"	"Osteoarthritis of knee"	"Other puerperal infections"	1	0	68	68
"C18"	"M75"	"Malignant neoplasm of colon"	"Shoulder lesions"	1	270	1111	1381
"D43"	"M72"	"Neoplasm of uncertain behavior of brain and cnsl"	"Fibroblastic disorders"	1	6	47	53
"N30"	"K61"	"Cystitis"	"Abscess of anal and rectal regions"	1	398	804	1202
"C55"	"N95"	"Malignant neoplasm of uterus, part unspecified"	"Menopausal and other perimenopausal disorders"	1	49	297	346
"M19"	"O46"	"Other and unspecified osteoarthritis"	"Antepartum hemorrhage, not elsewhere classified"	1	0	53	53
"F41"	"C16"	"Other anxiety disorders"	"Malignant neoplasm of stomach"	1	124	623	747
"K43"	"O13"	"Ventral hernia"	"Gestational hypertension without significant proteinuria"	1	0	81	81
"Q61"	"D17"	"Cystic kidney disease"	"Benign lipomatous neoplasm"	1	21	115	136
"K81"	"O34"	"Cholecystitis"	"Maternal care for abnormality of pelvic organs"	1	28	89	117
"G44"	"O66"	"Other headache syndromes"	"Other obstructed labor"	1	19	107	126
"Q61"	"N20"	"Cystic kidney disease"	"Calculus of kidney and ureter"	1	397	757	1154
"C80"	"I34"	"Malignant neoplasm without specification of site"	"Nonrheumatic mitral valve disorders"	1	9	62	71
"I50"	"N45"	"Heart failure"	"Orchitis and epididymitis"	1	470	859	1329
"C20"	"L03"	"Malignant neoplasm of rectum"	"Cellulitis and acute lymphangitis"	1	23	98	121
"I51"	"I48"	"Complications and ill-defined descriptions of heart disease"	"Atrial fibrillation and flutter"	1	1988	3454	5442
"J47"	"J33"	"Bronchiectasis"	"Nasal polyp"	1	22	90	112
"E64"	"F17"	"Sequelae of malnutrition and other nutritional deficiencies"	"Nicotine dependence"	1	175	445	620
"L30"	"I10"	"Other and unspecified dermatitis"	"Essential (primary) hypertension"	1	2225	2821	5046
"I67"	"M20"	"Other cerebrovascular diseases"	"Acquired deformities of fingers and toes"	1	59	143	202
"E27"	"K51"	"Other disorders of adrenal gland"	"Ulcerative colitis"	1	16	94	110
"I69"	"N70"	"Sequelae of cerebrovascular disease"	"Salpingitis and oophoritis"	1	0	81	81
"E78"	"K30"	"Disorders of lipoprotein metabolism and other lipidemias"	"Functional dyspepsia"	1	2354	4184	6538
"N92"	"O40"	"Excessive, frequent and irregular menstruation"	"Polyhydramnios"	1	34	364	398
"N28"	"L97"	"Oth disorders of kidney and ureter, not elsewhere classified"	"Non-pressure chronic ulcer of lower limb, NEC"	1	210	328	538
"L40"	"D27"	"Psoriasis"	"Benign neoplasm of ovary"	1	41	101	142
"E64"	"H33"	"Sequelae of malnutrition and other nutritional deficiencies"	"Retinal detachments and breaks"	1	8	65	73
"O72"	"M95"	"Postpartum hemorrhage"	"Oth acquired deformities of ms sys and connective tissue"	1	105	506	611
"B00"	"J45"	"Herpesviral [herpes simplex] infections"	"Asthma"	1	203	349	552
"K08"	"Q87"	"Other disorders of teeth and supporting structures"	"Oth congenital malform syndromes affecting multiple systems"	1	3	47	50
"K92"	"I50"	"Other diseases of digestive system"	"Heart failure"	1	5147	6407	11554
"C34"	"A09"	"Malignant neoplasm of bronchus and lung"	"Infectious gastroenteritis and colitis, unspecified"	1	371	871	1242
"E86"	"O14"	"Volume depletion"	"Pre-eclampsia"	1	13	63	76
"I69"	"H25"	"Sequelae of cerebrovascular disease"	"Age-related cataract"	1	0	20033	20033
"E86"	"K92"	"Volume depletion"	"Other diseases of digestive system"	1	4409	5047	9456
"G56"	"K61"	"Mononeuropathies of upper limb"	"Abscess of anal and rectal regions"	1	230	460	690
"J96"	"K27"	"Respiratory failure, not elsewhere classified"	"Peptic ulcer, site unspecified"	1	871	1163	2034
"H25"	"K61"	"Age-related cataract"	"Abscess of anal and rectal regions"	1	169	726	895
"O28"	"O04"	"Abnormal findings on antenatal screening of mother"	"Complications following (induced) termination of pregnancy"	1	304	877	1181
"K74"	"F19"	"Fibrosis and cirrhosis of liver"	"Other psychoactive substance related disorders"	1	17	81	98
"E64"	"C03"	"Sequelae of malnutrition and other nutritional deficiencies"	"Malignant neoplasm of gum"	1	15	77	92
"N28"	"K52"	"Oth disorders of kidney and ureter, not elsewhere classified"	"Other and unsp noninfective gastroenteritis and colitis"	1	222	375	597
"H52"	"J30"	"Disorders of refraction and accommodation"	"Vasomotor and allergic rhinitis"	1	182	332	514
"I11"	"H83"	"Hypertensive heart disease"	"Other diseases of inner ear"	1	0	311	311
"K55"	"G40"	"Vascular disorders of intestine"	"Epilepsy and recurrent seizures"	1	52	146	198
"H90"	"O26"	"Conductive and sensorineural hearing loss"	"Maternal care for oth conditions predom related to pregnancy"	1	51	166	217
"H02"	"H80"	"Other disorders of eyelid"	"Otosclerosis"	1	7	145	152
"D69"	"M65"	"Purpura and other hemorrhagic conditions"	"Synovitis and tenosynovitis"	1	89	226	315
"N17"	"K43"	"Acute kidney failure"	"Ventral hernia"	1	243	415	658
"M70"	"M22"	"Soft tissue disorders related to use, overuse and pressure"	"Disorder of patella"	1	438	1097	1535
"O00"	"B27"	"Ectopic pregnancy"	"Infectious mononucleosis"	1	0	40	40
"C64"	"L03"	"Malignant neoplasm of kidney, except renal pelvis"	"Cellulitis and acute lymphangitis"	1	2	58	60
"M80"	"D14"	"Osteoporosis with current pathological fracture"	"Benign neoplasm of middle ear and respiratory system"	1	28	213	241
"K90"	"O82"	"Intestinal malabsorption"	"Encounter for cesarean delivery without indication"	1	32	178	210
"M45"	"K35"	"Ankylosing spondylitis"	"Acute appendicitis"	1	12	60	72
"C15"	"H43"	"Malignant neoplasm of esophagus"	"Disorders of vitreous body"	1	3	61	64
"C78"	"O72"	"Secondary malignant neoplasm of resp and digestive organs"	"Postpartum hemorrhage"	1	0	100	100
"G20"	"C54"	"Parkinson's disease"	"Malignant neoplasm of corpus uteri"	1	7	42	49
"J15"	"M71"	"Bacterial pneumonia, not elsewhere classified"	"Other bursopathies"	1	27	473	500
"J18"	"G11"	"Pneumonia, unspecified organism"	"Hereditary ataxia"	1	54	170	224
"E87"	"N97"	"Other disorders of fluid, electrolyte and acid-base balance"	"Female infertility"	1	0	116	116
"O72"	"K11"	"Postpartum hemorrhage"	"Diseases of salivary glands"	1	88	314	402
"J09"	"N03"	"Influenza due to certain identified influenza viruses"	"Chronic nephritic syndrome"	1	0	25	25
"A41"	"K76"	"Other sepsis"	"Other diseases of liver"	1	1068	1497	2565
"G56"	"N92"	"Mononeuropathies of upper limb"	"Excessive, frequent and irregular menstruation"	1	0	5016	5016
"M19"	"H83"	"Other and unspecified osteoarthritis"	"Other diseases of inner ear"	1	225	924	1149
"C78"	"G63"	"Secondary malignant neoplasm of resp and digestive organs"	"Polyneuropathy in diseases classified elsewhere"	1	19	81	100
"I69"	"H91"	"Sequelae of cerebrovascular disease"	"Other and unspecified hearing loss"	1	0	14889	14889
"C15"	"N20"	"Malignant neoplasm of esophagus"	"Calculus of kidney and ureter"	1	7	105	112
"K57"	"I25"	"Diverticular disease of intestine"	"Chronic ischemic heart disease"	1	4881	7419	12300
"K30"	"J03"	"Functional dyspepsia"	"Acute tonsillitis"	1	344	510	854
"H65"	"Q90"	"Nonsuppurative otitis media"	"Down syndrome"	1	117	560	677
"C77"	"H10"	"Secondary and unspecified malignant neoplasm of lymph nodes"	"Conjunctivitis"	1	0	169	169
"J22"	"K22"	"Unspecified acute lower respiratory infection"	"Other diseases of esophagus"	1	83	198	281
"H33"	"M77"	"Retinal detachments and breaks"	"Other enthesopathies"	1	88	177	265
"J15"	"E03"	"Bacterial pneumonia, not elsewhere classified"	"Other hypothyroidism"	1	1238	2153	3391
"F32"	"Q17"	"Depressive episode"	"Other congenital malformations of ear"	1	0	42	42
"M51"	"O66"	"Thoracic, thoracolum, and lumbosacral intvrt disc disorders"	"Other obstructed labor"	1	0	286	286
"N19"	"A46"	"Unspecified kidney failure"	"Erysipelas"	1	769	1195	1964
"F03"	"I27"	"Unspecified dementia"	"Other pulmonary heart diseases"	1	167	350	517
"K76"	"K80"	"Other diseases of liver"	"Cholelithiasis"	1	1255	1740	2995
"O72"	"N91"	"Postpartum hemorrhage"	"Absent, scanty and rare menstruation"	1	146	967	1113
"C61"	"K80"	"Malignant neoplasm of prostate"	"Cholelithiasis"	1	303	1049	1352
"I69"	"M79"	"Sequelae of cerebrovascular disease"	"Oth and unsp soft tissue disorders, not elsewhere classified"	1	2178	3895	6073
"D25"	"O86"	"Leiomyoma of uterus"	"Other puerperal infections"	1	0	108	108
"J93"	"M22"	"Pneumothorax and air leak"	"Disorder of patella"	1	22	89	111
"O99"	"Q78"	"Oth maternal diseases classd elsw but compl preg/chldbrth"	"Other osteochondrodysplasias"	1	0	76	76
"N19"	"C61"	"Unspecified kidney failure"	"Malignant neoplasm of prostate"	1	526	1180	1706
"I47"	"O02"	"Paroxysmal tachycardia"	"Other abnormal products of conception"	1	93	300	393
"F33"	"C44"	"Major depressive disorder, recurrent"	"Other and unspecified malignant neoplasm of skin"	1	275	470	745
"C79"	"D21"	"Secondary malignant neoplasm of other and unspecified sites"	"Other benign neoplasms of connective and other soft tissue"	1	9	121	130
"K00"	"A09"	"Disorders of tooth development and eruption"	"Infectious gastroenteritis and colitis, unspecified"	1	10	296	306
"C78"	"K45"	"Secondary malignant neoplasm of resp and digestive organs"	"Other abdominal hernia"	1	35	150	185
"L89"	"H40"	"Pressure ulcer"	"Glaucoma"	1	22	372	394
"J96"	"N36"	"Respiratory failure, not elsewhere classified"	"Other disorders of urethra"	1	29	105	134
"M72"	"K58"	"Fibroblastic disorders"	"Irritable bowel syndrome"	1	177	318	495
"H90"	"O68"	"Conductive and sensorineural hearing loss"	"Labor and delivery comp by abnlt of fetal acid-base balance"	1	138	332	470
"M19"	"M24"	"Other and unspecified osteoarthritis"	"Other specific joint derangements"	1	1264	1923	3187
"E83"	"M51"	"Disorders of mineral metabolism"	"Thoracic, thoracolum, and lumbosacral intvrt disc disorders"	1	31	583	614
"I95"	"J38"	"Hypotension"	"Diseases of vocal cords and larynx, not elsewhere classified"	1	35	154	189
"F41"	"J44"	"Other anxiety disorders"	"Other chronic obstructive pulmonary disease"	1	1049	3125	4174
"M85"	"H83"	"Other disorders of bone density and structure"	"Other diseases of inner ear"	1	0	358	358
"N12"	"J05"	"Tubulo-interstitial nephritis, not spcf as acute or chronic"	"Acute obstructive laryngitis [croup] and epiglottitis"	1	10	54	64
"E22"	"O04"	"Hyperfunction of pituitary gland"	"Complications following (induced) termination of pregnancy"	1	25	165	190
"I80"	"O46"	"Phlebitis and thrombophlebitis"	"Antepartum hemorrhage, not elsewhere classified"	1	12	103	115
"I74"	"M65"	"Arterial embolism and thrombosis"	"Synovitis and tenosynovitis"	1	49	155	204
"C78"	"N43"	"Secondary malignant neoplasm of resp and digestive organs"	"Hydrocele and spermatocele"	1	3	432	435
"E64"	"D13"	"Sequelae of malnutrition and other nutritional deficiencies"	"Benign neoplasm of and ill-defined parts of digestive system"	1	49	136	185
"M00"	"O80"	"Pyogenic arthritis"	"Encounter for full-term uncomplicated delivery"	1	21	87	108
"I60"	"M16"	"Nontraumatic subarachnoid hemorrhage"	"Osteoarthritis of hip"	1	122	219	341
"C78"	"M18"	"Secondary malignant neoplasm of resp and digestive organs"	"Osteoarthritis of first carpometacarpal joint"	1	0	218	218
"N39"	"Q25"	"Other disorders of urinary system"	"Congenital malformations of great arteries"	1	30	112	142
"C80"	"G44"	"Malignant neoplasm without specification of site"	"Other headache syndromes"	1	1	30	31
"A49"	"G56"	"Bacterial infection of unspecified site"	"Mononeuropathies of upper limb"	1	186	1334	1520
"M19"	"M02"	"Other and unspecified osteoarthritis"	"Postinfective and reactive arthropathies"	1	193	552	745
"K29"	"H83"	"Gastritis and duodenitis"	"Other diseases of inner ear"	1	427	983	1410
"C15"	"M18"	"Malignant neoplasm of esophagus"	"Osteoarthritis of first carpometacarpal joint"	1	0	28	28
"K45"	"O82"	"Other abdominal hernia"	"Encounter for cesarean delivery without indication"	1	0	324	324
"F06"	"H33"	"Other mental disorders due to known physiological condition"	"Retinal detachments and breaks"	1	9	58	67
"I46"	"N50"	"Cardiac arrest"	"Other and unspecified disorders of male genital organs"	1	9	109	118
"D21"	"N97"	"Other benign neoplasms of connective and other soft tissue"	"Female infertility"	1	22	86	108
"J15"	"K81"	"Bacterial pneumonia, not elsewhere classified"	"Cholecystitis"	1	469	960	1429
"C10"	"E66"	"Malignant neoplasm of oropharynx"	"Overweight and obesity"	1	5	53	58
"G50"	"J34"	"Disorders of trigeminal nerve"	"Other and unspecified disorders of nose and nasal sinuses"	1	62	151	213
"K60"	"J05"	"Fissure and fistula of anal and rectal regions"	"Acute obstructive laryngitis [croup] and epiglottitis"	1	27	95	122
"H25"	"O26"	"Age-related cataract"	"Maternal care for oth conditions predom related to pregnancy"	1	0	33	33
"M79"	"O86"	"Oth and unsp soft tissue disorders, not elsewhere classified"	"Other puerperal infections"	1	124	284	408
"I61"	"M23"	"Nontraumatic intracerebral hemorrhage"	"Internal derangement of knee"	1	68	538	606
"M70"	"N63"	"Soft tissue disorders related to use, overuse and pressure"	"Unspecified lump in breast"	1	167	294	461
"K72"	"K61"	"Hepatic failure, not elsewhere classified"	"Abscess of anal and rectal regions"	1	11	129	140
"C17"	"D12"	"Malignant neoplasm of small intestine"	"Benign neoplasm of colon, rectum, anus and anal canal"	1	46	254	300
"L89"	"D24"	"Pressure ulcer"	"Benign neoplasm of breast"	1	0	62	62
"J93"	"O65"	"Pneumothorax and air leak"	"Obstructed labor due to maternal pelvic abnormality"	1	0	29	29
"F33"	"I25"	"Major depressive disorder, recurrent"	"Chronic ischemic heart disease"	1	995	2410	3405
"I63"	"I83"	"Cerebral infarction"	"Varicose veins of lower extremities"	1	0	2717	2717
"K59"	"D10"	"Other functional intestinal disorders"	"Benign neoplasm of mouth and pharynx"	1	249	527	776
"I87"	"L03"	"Other disorders of veins"	"Cellulitis and acute lymphangitis"	1	35	139	174
"I49"	"O70"	"Other cardiac arrhythmias"	"Perineal laceration during delivery"	1	70	757	827
"C20"	"G45"	"Malignant neoplasm of rectum"	"Transient cerebral ischemic attacks and related syndromes"	1	245	430	675
"M16"	"O63"	"Osteoarthritis of hip"	"Long labor"	1	0	40	40
"O34"	"K35"	"Maternal care for abnormality of pelvic organs"	"Acute appendicitis"	1	79	501	580
"E78"	"E28"	"Disorders of lipoprotein metabolism and other lipidemias"	"Ovarian dysfunction"	1	68	176	244
"B37"	"I47"	"Candidiasis"	"Paroxysmal tachycardia"	1	227	461	688
"J40"	"O62"	"Bronchitis, not specified as acute or chronic"	"Abnormalities of forces of labor"	1	8	70	78
"C18"	"J03"	"Malignant neoplasm of colon"	"Acute tonsillitis"	1	11	61	72
"F31"	"M23"	"Bipolar disorder"	"Internal derangement of knee"	1	44	156	200
"M47"	"D25"	"Spondylosis"	"Leiomyoma of uterus"	1	138	1103	1241
"J22"	"K92"	"Unspecified acute lower respiratory infection"	"Other diseases of digestive system"	1	337	488	825
"M54"	"L68"	"Dorsalgia"	"Hypertrichosis"	1	184	459	643
"M16"	"N63"	"Osteoarthritis of hip"	"Unspecified lump in breast"	1	186	654	840
"L93"	"M32"	"Lupus erythematosus"	"Systemic lupus erythematosus (SLE)"	1	319	500	819
"D35"	"J45"	"Benign neoplasm of other and unspecified endocrine glands"	"Asthma"	1	77	263	340
"K64"	"C61"	"Hemorrhoids and perianal venous thrombosis"	"Malignant neoplasm of prostate"	1	162	564	726
"K74"	"M76"	"Fibrosis and cirrhosis of liver"	"Enthesopathies, lower limb, excluding foot"	1	6	63	69
"O82"	"O12"	"Encounter for cesarean delivery without indication"	"Gestational edema and proteinuria without hypertension"	1	1339	1820	3159
"L97"	"C61"	"Non-pressure chronic ulcer of lower limb, NEC"	"Malignant neoplasm of prostate"	1	172	307	479
"D69"	"H65"	"Purpura and other hemorrhagic conditions"	"Nonsuppurative otitis media"	1	94	259	353
"E88"	"N92"	"Other and unspecified metabolic disorders"	"Excessive, frequent and irregular menstruation"	1	36	187	223
"C13"	"M16"	"Malignant neoplasm of hypopharynx"	"Osteoarthritis of hip"	1	2	51	53
"I35"	"N83"	"Nonrheumatic aortic valve disorders"	"Noninflammatory disord of ovary, fallop and broad ligament"	1	90	332	422
"F41"	"M72"	"Other anxiety disorders"	"Fibroblastic disorders"	1	37	234	271
"F98"	"J05"	"Oth behav/emotn disord w onset usly occur in chldhd and adol"	"Acute obstructive laryngitis [croup] and epiglottitis"	1	36	232	268
"M79"	"O68"	"Oth and unsp soft tissue disorders, not elsewhere classified"	"Labor and delivery comp by abnlt of fetal acid-base balance"	1	999	2169	3168
"M65"	"O02"	"Synovitis and tenosynovitis"	"Other abnormal products of conception"	1	300	573	873
"M99"	"G56"	"Biomechanical lesions, not elsewhere classified"	"Mononeuropathies of upper limb"	1	338	762	1100
"K04"	"N60"	"Diseases of pulp and periapical tissues"	"Benign mammary dysplasia"	1	39	134	173
"I26"	"L72"	"Pulmonary embolism"	"Follicular cysts of skin and subcutaneous tissue"	1	25	130	155
"M23"	"O80"	"Internal derangement of knee"	"Encounter for full-term uncomplicated delivery"	1	0	8358	8358
"J96"	"K30"	"Respiratory failure, not elsewhere classified"	"Functional dyspepsia"	1	0	2626	2626
"L08"	"G40"	"Other local infections of skin and subcutaneous tissue"	"Epilepsy and recurrent seizures"	1	342	818	1160
"I20"	"O20"	"Angina pectoris"	"Hemorrhage in early pregnancy"	1	0	226	226
"F17"	"N87"	"Nicotine dependence"	"Dysplasia of cervix uteri"	1	321	686	1007
"O98"	"N97"	"Matern infec/parastc dis classd elsw but compl preg/chldbrth"	"Female infertility"	1	44	343	387
"I80"	"K35"	"Phlebitis and thrombophlebitis"	"Acute appendicitis"	1	194	697	891
"I69"	"K40"	"Sequelae of cerebrovascular disease"	"Inguinal hernia"	1	0	4930	4930
"C25"	"N39"	"Malignant neoplasm of pancreas"	"Other disorders of urinary system"	1	229	495	724
"K70"	"J03"	"Alcoholic liver disease"	"Acute tonsillitis"	1	9	50	59
"L89"	"C50"	"Pressure ulcer"	"Malignant neoplasm of breast"	1	43	438	481
"I51"	"M20"	"Complications and ill-defined descriptions of heart disease"	"Acquired deformities of fingers and toes"	1	30	226	256
"B95"	"O62"	"Strep as the cause of diseases classified elsewhere"	"Abnormalities of forces of labor"	1	20	184	204
"I10"	"Q53"	"Essential (primary) hypertension"	"Undescended and ectopic testicle"	1	1	154	155
"G24"	"O26"	"Dystonia"	"Maternal care for oth conditions predom related to pregnancy"	1	2	36	38
"J96"	"M65"	"Respiratory failure, not elsewhere classified"	"Synovitis and tenosynovitis"	1	0	1109	1109
"G93"	"N20"	"Other disorders of brain"	"Calculus of kidney and ureter"	1	56	124	180
"D24"	"J35"	"Benign neoplasm of breast"	"Chronic diseases of tonsils and adenoids"	1	48	467	515
"I99"	"C50"	"Other and unspecified disorders of circulatory system"	"Malignant neoplasm of breast"	1	37	95	132
"D73"	"O80"	"Diseases of spleen"	"Encounter for full-term uncomplicated delivery"	1	3	37	40
"I25"	"D24"	"Chronic ischemic heart disease"	"Benign neoplasm of breast"	1	78	684	762
"C78"	"J41"	"Secondary malignant neoplasm of resp and digestive organs"	"Simple and mucopurulent chronic bronchitis"	1	24	246	270
"J81"	"I44"	"Pulmonary edema"	"Atrioventricular and left bundle-branch block"	1	406	607	1013
"N17"	"I48"	"Acute kidney failure"	"Atrial fibrillation and flutter"	1	3963	5413	9376
"A41"	"C20"	"Other sepsis"	"Malignant neoplasm of rectum"	1	509	2073	2582
"J69"	"M48"	"Pneumonitis due to solids and liquids"	"Other spondylopathies"	1	8	409	417
"C92"	"D46"	"Myeloid leukemia"	"Myelodysplastic syndromes"	1	435	950	1385
"M10"	"M79"	"Gout"	"Oth and unsp soft tissue disorders, not elsewhere classified"	1	1256	2118	3374
"H25"	"J03"	"Age-related cataract"	"Acute tonsillitis"	1	85	343	428
"J45"	"Q75"	"Asthma"	"Other congenital malformations of skull and face bones"	1	99	188	287
"M48"	"D86"	"Other spondylopathies"	"Sarcoidosis"	1	42	119	161
"C16"	"D14"	"Malignant neoplasm of stomach"	"Benign neoplasm of middle ear and respiratory system"	1	6	57	63
"F41"	"C54"	"Other anxiety disorders"	"Malignant neoplasm of corpus uteri"	1	50	276	326
"I48"	"M23"	"Atrial fibrillation and flutter"	"Internal derangement of knee"	1	0	6187	6187
"M16"	"O32"	"Osteoarthritis of hip"	"Maternal care for malpresentation of fetus"	1	0	59	59
"I51"	"M79"	"Complications and ill-defined descriptions of heart disease"	"Oth and unsp soft tissue disorders, not elsewhere classified"	1	286	799	1085
"C18"	"L23"	"Malignant neoplasm of colon"	"Allergic contact dermatitis"	1	12	79	91
"J42"	"O80"	"Unspecified chronic bronchitis"	"Encounter for full-term uncomplicated delivery"	1	5	117	122
"J09"	"D12"	"Influenza due to certain identified influenza viruses"	"Benign neoplasm of colon, rectum, anus and anal canal"	1	20	166	186
"A49"	"C25"	"Bacterial infection of unspecified site"	"Malignant neoplasm of pancreas"	1	257	490	747
"O72"	"O20"	"Postpartum hemorrhage"	"Hemorrhage in early pregnancy"	1	0	29779	29779
"C25"	"N83"	"Malignant neoplasm of pancreas"	"Noninflammatory disord of ovary, fallop and broad ligament"	1	10	100	110
"E78"	"O90"	"Disorders of lipoprotein metabolism and other lipidemias"	"Complications of the puerperium, not elsewhere classified"	1	0	63	63
"O87"	"O20"	"Venous complications and hemorrhoids in the puerperium"	"Hemorrhage in early pregnancy"	1	208	629	837
"C43"	"O36"	"Malignant melanoma of skin"	"Maternal care for other fetal problems"	1	25	114	139
"O70"	"Q22"	"Perineal laceration during delivery"	"Congenital malformations of pulmonary and tricuspid valves"	1	10	54	64
"D35"	"O99"	"Benign neoplasm of other and unspecified endocrine glands"	"Oth maternal diseases classd elsw but compl preg/chldbrth"	1	75	152	227
"F17"	"O34"	"Nicotine dependence"	"Maternal care for abnormality of pelvic organs"	1	123	235	358
"M16"	"O26"	"Osteoarthritis of hip"	"Maternal care for oth conditions predom related to pregnancy"	1	0	126	126
"I73"	"N84"	"Other peripheral vascular diseases"	"Polyp of female genital tract"	1	85	233	318
"M10"	"M70"	"Gout"	"Soft tissue disorders related to use, overuse and pressure"	1	556	1086	1642
"K43"	"C19"	"Ventral hernia"	"Malignant neoplasm of rectosigmoid junction"	1	24	126	150
"I63"	"M70"	"Cerebral infarction"	"Soft tissue disorders related to use, overuse and pressure"	1	380	1141	1521
"C34"	"M81"	"Malignant neoplasm of bronchus and lung"	"Osteoporosis without current pathological fracture"	1	943	2556	3499
"I46"	"I21"	"Cardiac arrest"	"Acute myocardial infarction"	1	5164	6335	11499
"M80"	"N99"	"Osteoporosis with current pathological fracture"	"Intraop and postproc comp and disorders of GU sys, NEC"	1	40	194	234
"L57"	"I50"	"Skin changes due to chronic expsr to nonionizing radiation"	"Heart failure"	1	369	527	896
"L89"	"M54"	"Pressure ulcer"	"Dorsalgia"	1	126	1487	1613
"I35"	"D21"	"Nonrheumatic aortic valve disorders"	"Other benign neoplasms of connective and other soft tissue"	1	27	123	150
"A49"	"D17"	"Bacterial infection of unspecified site"	"Benign lipomatous neoplasm"	1	61	480	541
"J85"	"M50"	"Abscess of lung and mediastinum"	"Cervical disc disorders"	1	2	26	28
"C41"	"C61"	"Malignant neoplasm of bone/artic cartl of and unsp sites"	"Malignant neoplasm of prostate"	1	134	234	368
"N18"	"I10"	"Chronic kidney disease (CKD)"	"Essential (primary) hypertension"	1	0	31159	31159
"F01"	"N40"	"Vascular dementia"	"Benign prostatic hyperplasia"	1	127	1079	1206
"J96"	"I21"	"Respiratory failure, not elsewhere classified"	"Acute myocardial infarction"	1	0	11263	11263
"N30"	"N20"	"Cystitis"	"Calculus of kidney and ureter"	1	4398	5352	9750
"K22"	"H71"	"Other diseases of esophagus"	"Cholesteatoma of middle ear"	1	10	47	57
"E06"	"A63"	"Thyroiditis"	"Oth predominantly sexually transmitted diseases, NEC"	1	2	67	69
"O23"	"Q66"	"Infections of genitourinary tract in pregnancy"	"Congenital deformities of feet"	1	7	41	48
"G45"	"N60"	"Transient cerebral ischemic attacks and related syndromes"	"Benign mammary dysplasia"	1	35	371	406
"D07"	"O62"	"Carcinoma in situ of other and unspecified genital organs"	"Abnormalities of forces of labor"	1	0	45	45
"J96"	"F33"	"Respiratory failure, not elsewhere classified"	"Major depressive disorder, recurrent"	1	1095	1656	2751
"K05"	"M16"	"Gingivitis and periodontal diseases"	"Osteoarthritis of hip"	1	268	443	711
"L98"	"E04"	"Oth disorders of skin, subcu, not elsewhere classified"	"Other nontoxic goiter"	1	122	252	374
"K83"	"O20"	"Other diseases of biliary tract"	"Hemorrhage in early pregnancy"	1	0	87	87
"I10"	"O64"	"Essential (primary) hypertension"	"Obstructed labor due to malposition and malpresent of fetus"	1	0	316	316
"M13"	"O68"	"Other arthritis"	"Labor and delivery comp by abnlt of fetal acid-base balance"	1	72	336	408
"A09"	"M17"	"Infectious gastroenteritis and colitis, unspecified"	"Osteoarthritis of knee"	1	1368	2159	3527
"J18"	"Q61"	"Pneumonia, unspecified organism"	"Cystic kidney disease"	1	460	642	1102
"J94"	"M23"	"Other pleural conditions"	"Internal derangement of knee"	1	23	166	189
"J81"	"E10"	"Pulmonary edema"	"Type 1 diabetes mellitus"	1	558	1335	1893
"E64"	"N31"	"Sequelae of malnutrition and other nutritional deficiencies"	"Neuromuscular dysfunction of bladder, NEC"	1	25	77	102
"G25"	"J35"	"Other extrapyramidal and movement disorders"	"Chronic diseases of tonsils and adenoids"	1	2	62	64
"J15"	"I21"	"Bacterial pneumonia, not elsewhere classified"	"Acute myocardial infarction"	1	0	10541	10541
"J47"	"I83"	"Bronchiectasis"	"Varicose veins of lower extremities"	1	15	209	224
"E66"	"I88"	"Overweight and obesity"	"Nonspecific lymphadenitis"	1	109	254	363
"K85"	"N94"	"Acute pancreatitis"	"Pain and oth cond assoc w fem gntl org and menstrual cycle"	1	30	119	149
"C25"	"D17"	"Malignant neoplasm of pancreas"	"Benign lipomatous neoplasm"	1	0	129	129
"M99"	"D24"	"Biomechanical lesions, not elsewhere classified"	"Benign neoplasm of breast"	1	16	114	130
"M65"	"O04"	"Synovitis and tenosynovitis"	"Complications following (induced) termination of pregnancy"	1	268	1885	2153
"K83"	"K25"	"Other diseases of biliary tract"	"Gastric ulcer"	1	305	636	941
"N30"	"C18"	"Cystitis"	"Malignant neoplasm of colon"	1	2014	2468	4482
"G56"	"N46"	"Mononeuropathies of upper limb"	"Male infertility"	1	159	287	446
"C79"	"A46"	"Secondary malignant neoplasm of other and unspecified sites"	"Erysipelas"	1	246	646	892
"J15"	"J43"	"Bacterial pneumonia, not elsewhere classified"	"Emphysema"	1	979	1643	2622
"M65"	"K35"	"Synovitis and tenosynovitis"	"Acute appendicitis"	1	529	1060	1589
"I67"	"M54"	"Other cerebrovascular diseases"	"Dorsalgia"	1	267	577	844
"J13"	"H91"	"Pneumonia due to Streptococcus pneumoniae"	"Other and unspecified hearing loss"	1	223	670	893
"C43"	"O04"	"Malignant melanoma of skin"	"Complications following (induced) termination of pregnancy"	1	0	335	335
"C77"	"N48"	"Secondary and unspecified malignant neoplasm of lymph nodes"	"Other disorders of penis"	1	28	122	150
"M79"	"C62"	"Oth and unsp soft tissue disorders, not elsewhere classified"	"Malignant neoplasm of testis"	1	43	120	163
"F13"	"F10"	"Sedative, hypnotic, or anxiolytic related disorders"	"Alcohol related disorders"	1	844	1323	2167
"D09"	"E78"	"Carcinoma in situ of other and unspecified sites"	"Disorders of lipoprotein metabolism and other lipidemias"	1	46	500	546
"G31"	"B18"	"Oth degenerative diseases of nervous system, NEC"	"Chronic viral hepatitis"	1	7	45	52
"O75"	"A63"	"Oth complications of labor and delivery, NEC"	"Oth predominantly sexually transmitted diseases, NEC"	1	16	564	580
"K04"	"J35"	"Diseases of pulp and periapical tissues"	"Chronic diseases of tonsils and adenoids"	1	56	279	335
"E83"	"H80"	"Disorders of mineral metabolism"	"Otosclerosis"	1	0	49	49
"D68"	"M79"	"Other coagulation defects"	"Oth and unsp soft tissue disorders, not elsewhere classified"	1	550	1001	1551
"C25"	"J32"	"Malignant neoplasm of pancreas"	"Chronic sinusitis"	1	0	39	39
"I15"	"N81"	"Secondary hypertension"	"Female genital prolapse"	1	168	384	552
"E86"	"I61"	"Volume depletion"	"Nontraumatic intracerebral hemorrhage"	1	1163	1672	2835
"I82"	"K85"	"Other venous embolism and thrombosis"	"Acute pancreatitis"	1	91	201	292
"M72"	"N20"	"Fibroblastic disorders"	"Calculus of kidney and ureter"	1	250	399	649
"N30"	"M21"	"Cystitis"	"Other acquired deformities of limbs"	1	536	1097	1633
"M51"	"O45"	"Thoracic, thoracolum, and lumbosacral intvrt disc disorders"	"Premature separation of placenta [abruptio placentae]"	1	0	92	92
"K43"	"I71"	"Ventral hernia"	"Aortic aneurysm and dissection"	1	680	1632	2312
"N19"	"H72"	"Unspecified kidney failure"	"Perforation of tympanic membrane"	1	11	63	74
"K25"	"H90"	"Gastric ulcer"	"Conductive and sensorineural hearing loss"	1	550	922	1472
"K29"	"O62"	"Gastritis and duodenitis"	"Abnormalities of forces of labor"	1	368	1145	1513
"D72"	"I83"	"Other disorders of white blood cells"	"Varicose veins of lower extremities"	1	18	98	116
"C78"	"M35"	"Secondary malignant neoplasm of resp and digestive organs"	"Other systemic involvement of connective tissue"	1	35	627	662
"D50"	"H90"	"Iron deficiency anemia"	"Conductive and sensorineural hearing loss"	1	173	795	968
"I61"	"D30"	"Nontraumatic intracerebral hemorrhage"	"Benign neoplasm of urinary organs"	1	35	208	243
"N17"	"H81"	"Acute kidney failure"	"Disorders of vestibular function"	1	21	405	426
"O99"	"E10"	"Oth maternal diseases classd elsw but compl preg/chldbrth"	"Type 1 diabetes mellitus"	1	179	530	709
"D12"	"O20"	"Benign neoplasm of colon, rectum, anus and anal canal"	"Hemorrhage in early pregnancy"	1	0	132	132
"G45"	"N84"	"Transient cerebral ischemic attacks and related syndromes"	"Polyp of female genital tract"	1	166	362	528
"C83"	"L04"	"Non-follicular lymphoma"	"Acute lymphadenitis"	1	44	170	214
"G96"	"K80"	"Other disorders of central nervous system"	"Cholelithiasis"	1	123	1116	1239
"N17"	"M54"	"Acute kidney failure"	"Dorsalgia"	1	234	1660	1894
"L40"	"N60"	"Psoriasis"	"Benign mammary dysplasia"	1	44	140	184
"F33"	"D11"	"Major depressive disorder, recurrent"	"Benign neoplasm of major salivary glands"	1	22	80	102
"C10"	"M65"	"Malignant neoplasm of oropharynx"	"Synovitis and tenosynovitis"	1	0	35	35
"O70"	"L05"	"Perineal laceration during delivery"	"Pilonidal cyst and sinus"	1	123	1022	1145
"M16"	"D48"	"Osteoarthritis of hip"	"Neoplasm of uncertain behavior of other and unsp sites"	1	37	131	168
"E89"	"E05"	"Postproc endocrine and metabolic comp and disorders, NEC"	"Thyrotoxicosis [hyperthyroidism]"	1	0	2196	2196
"N63"	"O30"	"Unspecified lump in breast"	"Multiple gestation"	1	36	249	285
"N20"	"O26"	"Calculus of kidney and ureter"	"Maternal care for oth conditions predom related to pregnancy"	1	204	708	912
"C71"	"C43"	"Malignant neoplasm of brain"	"Malignant melanoma of skin"	1	78	251	329
"C79"	"H50"	"Secondary malignant neoplasm of other and unspecified sites"	"Other strabismus"	1	28	117	145
"O22"	"O04"	"Venous complications and hemorrhoids in pregnancy"	"Complications following (induced) termination of pregnancy"	1	54	168	222
"K64"	"J03"	"Hemorrhoids and perianal venous thrombosis"	"Acute tonsillitis"	1	0	421	421
"N28"	"M19"	"Oth disorders of kidney and ureter, not elsewhere classified"	"Other and unspecified osteoarthritis"	1	184	365	549
"C24"	"G56"	"Malignant neoplasm of other and unsp parts of biliary tract"	"Mononeuropathies of upper limb"	1	0	77	77
"J03"	"J14"	"Acute tonsillitis"	"Pneumonia due to Hemophilus influenzae"	1	91	180	271
"D53"	"N81"	"Other nutritional anemias"	"Female genital prolapse"	1	2	32	34
"G95"	"K35"	"Other and unspecified diseases of spinal cord"	"Acute appendicitis"	1	2	143	145
"I63"	"M02"	"Cerebral infarction"	"Postinfective and reactive arthropathies"	1	37	284	321
"G31"	"M51"	"Oth degenerative diseases of nervous system, NEC"	"Thoracic, thoracolum, and lumbosacral intvrt disc disorders"	1	6	294	300
"M23"	"F95"	"Internal derangement of knee"	"Tic disorder"	1	25	76	101
"K57"	"N87"	"Diverticular disease of intestine"	"Dysplasia of cervix uteri"	1	0	339	339
"H65"	"Q89"	"Nonsuppurative otitis media"	"Other congenital malformations, not elsewhere classified"	1	85	303	388
"D10"	"M65"	"Benign neoplasm of mouth and pharynx"	"Synovitis and tenosynovitis"	1	106	198	304
"I89"	"M67"	"Oth noninfective disorders of lymphatic vessels and nodes"	"Other disorders of synovium and tendon"	1	43	143	186
"G12"	"K40"	"Spinal muscular atrophy and related syndromes"	"Inguinal hernia"	1	4	135	139
"J96"	"K45"	"Respiratory failure, not elsewhere classified"	"Other abdominal hernia"	1	86	257	343
"D34"	"O03"	"Benign neoplasm of thyroid gland"	"Spontaneous abortion"	1	0	59	59
"H57"	"D43"	"Other disorders of eye and adnexa"	"Neoplasm of uncertain behavior of brain and cnsl"	1	26	115	141
"E89"	"O48"	"Postproc endocrine and metabolic comp and disorders, NEC"	"Late pregnancy"	1	1	61	62
"H33"	"K35"	"Retinal detachments and breaks"	"Acute appendicitis"	1	68	156	224
"A41"	"M71"	"Other sepsis"	"Other bursopathies"	1	45	594	639
"L89"	"K26"	"Pressure ulcer"	"Duodenal ulcer"	1	207	703	910
"N18"	"O71"	"Chronic kidney disease (CKD)"	"Other obstetric trauma"	1	0	30	30
"A41"	"M07"	"Other sepsis"	"Enteropathic arthropathies"	1	50	289	339
"O92"	"O21"	"Oth disord of brst/lactatn assoc w pregnancy and the puerp"	"Excessive vomiting in pregnancy"	1	250	1068	1318
"D59"	"M51"	"Acquired hemolytic anemia"	"Thoracic, thoracolum, and lumbosacral intvrt disc disorders"	1	19	67	86
"K83"	"H26"	"Other diseases of biliary tract"	"Other cataract"	1	175	396	571
"K59"	"H66"	"Other functional intestinal disorders"	"Suppurative and unspecified otitis media"	1	921	2122	3043
"O47"	"O03"	"False labor"	"Spontaneous abortion"	1	1887	4737	6624
"B96"	"G40"	"Oth bacterial agents as the cause of diseases classd elswhr"	"Epilepsy and recurrent seizures"	1	45	167	212
"J14"	"M16"	"Pneumonia due to Hemophilus influenzae"	"Osteoarthritis of hip"	1	28	158	186
"M85"	"O42"	"Other disorders of bone density and structure"	"Premature rupture of membranes"	1	0	110	110
"I49"	"D16"	"Other cardiac arrhythmias"	"Benign neoplasm of bone and articular cartilage"	1	26	84	110
"C25"	"D14"	"Malignant neoplasm of pancreas"	"Benign neoplasm of middle ear and respiratory system"	1	0	67	67
"C79"	"C62"	"Secondary malignant neoplasm of other and unspecified sites"	"Malignant neoplasm of testis"	1	49	178	227
"M17"	"H74"	"Osteoarthritis of knee"	"Other disorders of middle ear mastoid"	1	11	87	98
"M47"	"M54"	"Spondylosis"	"Dorsalgia"	1	11624	14622	26246
"N39"	"M70"	"Other disorders of urinary system"	"Soft tissue disorders related to use, overuse and pressure"	1	901	1847	2748
"H01"	"L02"	"Other inflammation of eyelid"	"Cutaneous abscess, furuncle and carbuncle"	1	63	198	261
"J81"	"D64"	"Pulmonary edema"	"Other anemias"	1	1468	1918	3386
"N19"	"K30"	"Unspecified kidney failure"	"Functional dyspepsia"	1	213	755	968
"D72"	"H91"	"Other disorders of white blood cells"	"Other and unspecified hearing loss"	1	69	265	334
"J15"	"I50"	"Bacterial pneumonia, not elsewhere classified"	"Heart failure"	1	9730	12273	22003
"A49"	"D05"	"Bacterial infection of unspecified site"	"Carcinoma in situ of breast"	1	17	91	108
"G47"	"O46"	"Sleep disorders"	"Antepartum hemorrhage, not elsewhere classified"	1	0	55	55
"O70"	"H65"	"Perineal laceration during delivery"	"Nonsuppurative otitis media"	1	0	475	475
"C34"	"M96"	"Malignant neoplasm of bronchus and lung"	"Intraop and postproc comp and disorders of ms sys, NEC"	1	8	108	116
"C34"	"N80"	"Malignant neoplasm of bronchus and lung"	"Endometriosis"	1	0	58	58
"C16"	"G56"	"Malignant neoplasm of stomach"	"Mononeuropathies of upper limb"	1	10	234	244
"D50"	"M16"	"Iron deficiency anemia"	"Osteoarthritis of hip"	1	341	2090	2431
"K72"	"M65"	"Hepatic failure, not elsewhere classified"	"Synovitis and tenosynovitis"	1	2	114	116
"O72"	"Q87"	"Postpartum hemorrhage"	"Oth congenital malform syndromes affecting multiple systems"	1	3	69	72
"D62"	"M23"	"Acute posthemorrhagic anemia"	"Internal derangement of knee"	1	76	413	489
"C56"	"O82"	"Malignant neoplasm of ovary"	"Encounter for cesarean delivery without indication"	1	1	46	47
"G51"	"O62"	"Facial nerve disorders"	"Abnormalities of forces of labor"	1	115	441	556
"J15"	"D34"	"Bacterial pneumonia, not elsewhere classified"	"Benign neoplasm of thyroid gland"	1	20	72	92
"M16"	"N75"	"Osteoarthritis of hip"	"Diseases of Bartholin's gland"	1	10	103	113
"N18"	"D14"	"Chronic kidney disease (CKD)"	"Benign neoplasm of middle ear and respiratory system"	1	26	227	253
"D09"	"K40"	"Carcinoma in situ of other and unspecified sites"	"Inguinal hernia"	1	0	294	294
"B96"	"J45"	"Oth bacterial agents as the cause of diseases classd elswhr"	"Asthma"	1	37	321	358
"E87"	"D03"	"Other disorders of fluid, electrolyte and acid-base balance"	"Melanoma in situ"	1	33	102	135
"M17"	"K61"	"Osteoarthritis of knee"	"Abscess of anal and rectal regions"	1	212	564	776
"O40"	"N97"	"Polyhydramnios"	"Female infertility"	1	107	935	1042
"K22"	"M23"	"Other diseases of esophagus"	"Internal derangement of knee"	1	292	846	1138
"G56"	"H50"	"Mononeuropathies of upper limb"	"Other strabismus"	1	130	245	375
"J96"	"Q44"	"Respiratory failure, not elsewhere classified"	"Congenital malform of gallbladder, bile ducts and liver"	1	11	70	81
"F60"	"K35"	"Specific personality disorders"	"Acute appendicitis"	1	25	158	183
"I50"	"G54"	"Heart failure"	"Nerve root and plexus disorders"	1	100	201	301
"O99"	"J38"	"Oth maternal diseases classd elsw but compl preg/chldbrth"	"Diseases of vocal cords and larynx, not elsewhere classified"	1	111	201	312
"C18"	"M21"	"Malignant neoplasm of colon"	"Other acquired deformities of limbs"	1	53	178	231
"K56"	"H71"	"Paralytic ileus and intestinal obstruction without hernia"	"Cholesteatoma of middle ear"	1	14	59	73
"K04"	"N63"	"Diseases of pulp and periapical tissues"	"Unspecified lump in breast"	1	53	128	181
"E66"	"H93"	"Overweight and obesity"	"Other disorders of ear, not elsewhere classified"	1	765	1339	2104
"K44"	"O99"	"Diaphragmatic hernia"	"Oth maternal diseases classd elsw but compl preg/chldbrth"	1	302	511	813
"I63"	"E04"	"Cerebral infarction"	"Other nontoxic goiter"	1	330	929	1259
"F44"	"M54"	"Dissociative and conversion disorders"	"Dorsalgia"	1	142	281	423
"L97"	"G51"	"Non-pressure chronic ulcer of lower limb, NEC"	"Facial nerve disorders"	1	22	83	105
"O03"	"L20"	"Spontaneous abortion"	"Atopic dermatitis"	1	63	159	222
"G98"	"O68"	"Other disorders of nervous system not elsewhere classified"	"Labor and delivery comp by abnlt of fetal acid-base balance"	1	0	194	194
"N19"	"K21"	"Unspecified kidney failure"	"Gastro-esophageal reflux disease"	1	239	734	973
"G47"	"H25"	"Sleep disorders"	"Age-related cataract"	1	1766	2636	4402
"C61"	"H16"	"Malignant neoplasm of prostate"	"Keratitis"	1	30	102	132
"K21"	"O48"	"Gastro-esophageal reflux disease"	"Late pregnancy"	1	0	241	241
"J06"	"K56"	"Acute upper resp infections of multiple and unsp sites"	"Paralytic ileus and intestinal obstruction without hernia"	1	88	183	271
"A41"	"M35"	"Other sepsis"	"Other systemic involvement of connective tissue"	1	530	2349	2879
"J95"	"C13"	"Intraop and postproc comp and disorders of resp sys, NEC"	"Malignant neoplasm of hypopharynx"	1	46	212	258
"I69"	"I99"	"Sequelae of cerebrovascular disease"	"Other and unspecified disorders of circulatory system"	1	279	451	730
"F03"	"M66"	"Unspecified dementia"	"Spontaneous rupture of synovium and tendon"	1	2	99	101
"M75"	"L50"	"Shoulder lesions"	"Urticaria"	1	456	895	1351
"I63"	"N03"	"Cerebral infarction"	"Chronic nephritic syndrome"	1	46	113	159
"N40"	"H93"	"Benign prostatic hyperplasia"	"Other disorders of ear, not elsewhere classified"	1	1159	1696	2855
"C73"	"E04"	"Malignant neoplasm of thyroid gland"	"Other nontoxic goiter"	1	619	2618	3237
"N12"	"C67"	"Tubulo-interstitial nephritis, not spcf as acute or chronic"	"Malignant neoplasm of bladder"	1	46	114	160
"A49"	"C83"	"Bacterial infection of unspecified site"	"Non-follicular lymphoma"	1	195	624	819
"N30"	"C53"	"Cystitis"	"Malignant neoplasm of cervix uteri"	1	268	925	1193
"E87"	"N35"	"Other disorders of fluid, electrolyte and acid-base balance"	"Urethral stricture"	1	51	290	341
"N30"	"D06"	"Cystitis"	"Carcinoma in situ of cervix uteri"	1	53	234	287
"K76"	"K60"	"Other diseases of liver"	"Fissure and fistula of anal and rectal regions"	1	78	192	270
"I10"	"L68"	"Essential (primary) hypertension"	"Hypertrichosis"	1	42	584	626
"M53"	"N87"	"Other and unspecified dorsopathies, not elsewhere classified"	"Dysplasia of cervix uteri"	1	78	261	339
"J43"	"H93"	"Emphysema"	"Other disorders of ear, not elsewhere classified"	1	71	282	353
"F17"	"M93"	"Nicotine dependence"	"Other osteochondropathies"	1	0	47	47
"M19"	"N64"	"Other and unspecified osteoarthritis"	"Other disorders of breast"	1	203	408	611
"L98"	"N47"	"Oth disorders of skin, subcu, not elsewhere classified"	"Disorders of prepuce"	1	99	222	321
"E11"	"J34"	"Type 2 diabetes mellitus"	"Other and unspecified disorders of nose and nasal sinuses"	1	144	870	1014
"D13"	"O20"	"Benign neoplasm of and ill-defined parts of digestive system"	"Hemorrhage in early pregnancy"	1	0	45	45
"D50"	"N81"	"Iron deficiency anemia"	"Female genital prolapse"	1	158	941	1099
"M47"	"J36"	"Spondylosis"	"Peritonsillar abscess"	1	14	120	134
"G70"	"M17"	"Myasthenia gravis and other myoneural disorders"	"Osteoarthritis of knee"	1	27	81	108
"E64"	"N60"	"Sequelae of malnutrition and other nutritional deficiencies"	"Benign mammary dysplasia"	1	1	53	54
"E27"	"O70"	"Other disorders of adrenal gland"	"Perineal laceration during delivery"	1	0	77	77
"H33"	"H83"	"Retinal detachments and breaks"	"Other diseases of inner ear"	1	99	275	374
"I48"	"M77"	"Atrial fibrillation and flutter"	"Other enthesopathies"	1	267	1201	1468
"E63"	"K21"	"Other nutritional deficiencies"	"Gastro-esophageal reflux disease"	1	36	138	174
"D63"	"K02"	"Anemia in chronic diseases classified elsewhere"	"Dental caries"	1	118	293	411
"I61"	"K30"	"Nontraumatic intracerebral hemorrhage"	"Functional dyspepsia"	1	102	561	663
"K62"	"O00"	"Other diseases of anus and rectum"	"Ectopic pregnancy"	1	0	122	122
"A04"	"I99"	"Other bacterial intestinal infections"	"Other and unspecified disorders of circulatory system"	1	63	169	232
"A41"	"K92"	"Other sepsis"	"Other diseases of digestive system"	1	3616	4830	8446
"Q65"	"O70"	"Congenital deformities of hip"	"Perineal laceration during delivery"	1	122	237	359
"L97"	"G82"	"Non-pressure chronic ulcer of lower limb, NEC"	"Paraplegia (paraparesis) and quadriplegia (quadriparesis)"	1	52	232	284
"M54"	"E30"	"Dorsalgia"	"Disorders of puberty, not elsewhere classified"	1	1	92	93
"F17"	"D25"	"Nicotine dependence"	"Leiomyoma of uterus"	1	588	958	1546
"O48"	"K01"	"Late pregnancy"	"Embedded and impacted teeth"	1	15	59	74
"I21"	"J36"	"Acute myocardial infarction"	"Peritonsillar abscess"	1	36	164	200
"E86"	"D11"	"Volume depletion"	"Benign neoplasm of major salivary glands"	1	34	413	447
"L57"	"N18"	"Skin changes due to chronic expsr to nonionizing radiation"	"Chronic kidney disease (CKD)"	1	181	446	627
"E11"	"H71"	"Type 2 diabetes mellitus"	"Cholesteatoma of middle ear"	1	36	191	227
"D35"	"O20"	"Benign neoplasm of other and unspecified endocrine glands"	"Hemorrhage in early pregnancy"	1	0	74	74
"N30"	"M16"	"Cystitis"	"Osteoarthritis of hip"	1	0	11514	11514
"I61"	"M62"	"Nontraumatic intracerebral hemorrhage"	"Other disorders of muscle"	1	79	676	755
"E83"	"I83"	"Disorders of mineral metabolism"	"Varicose veins of lower extremities"	1	49	406	455
"I00"	"M05"	"Rheumatic fever without heart involvement"	"Rheumatoid arthritis with rheumatoid factor"	1	71	215	286
"I25"	"H94"	"Chronic ischemic heart disease"	"Other disorders of ear in diseases classified elsewhere"	1	54	230	284
"L02"	"M62"	"Cutaneous abscess, furuncle and carbuncle"	"Other disorders of muscle"	1	1256	2212	3468
"F33"	"K22"	"Major depressive disorder, recurrent"	"Other diseases of esophagus"	1	215	346	561
"E21"	"F10"	"Hyperparathyroidism and other disorders of parathyroid gland"	"Alcohol related disorders"	1	55	240	295
"N28"	"I10"	"Oth disorders of kidney and ureter, not elsewhere classified"	"Essential (primary) hypertension"	1	0	5360	5360
"I87"	"M79"	"Other disorders of veins"	"Oth and unsp soft tissue disorders, not elsewhere classified"	1	404	731	1135
"M75"	"O46"	"Shoulder lesions"	"Antepartum hemorrhage, not elsewhere classified"	1	0	278	278
"K70"	"J36"	"Alcoholic liver disease"	"Peritonsillar abscess"	1	2	26	28
"F06"	"J35"	"Other mental disorders due to known physiological condition"	"Chronic diseases of tonsils and adenoids"	1	0	43	43
"O73"	"K35"	"Retained placenta and membranes, without hemorrhage"	"Acute appendicitis"	1	26	123	149
"I61"	"K61"	"Nontraumatic intracerebral hemorrhage"	"Abscess of anal and rectal regions"	1	18	122	140
"M20"	"N87"	"Acquired deformities of fingers and toes"	"Dysplasia of cervix uteri"	1	170	460	630
"A41"	"O62"	"Other sepsis"	"Abnormalities of forces of labor"	1	0	493	493
"D63"	"N87"	"Anemia in chronic diseases classified elsewhere"	"Dysplasia of cervix uteri"	1	0	55	55
"A41"	"Q85"	"Other sepsis"	"Phakomatoses, not elsewhere classified"	1	13	70	83
"E64"	"K35"	"Sequelae of malnutrition and other nutritional deficiencies"	"Acute appendicitis"	1	7	132	139
"E86"	"C09"	"Volume depletion"	"Malignant neoplasm of tonsil"	1	95	376	471
"C43"	"N92"	"Malignant melanoma of skin"	"Excessive, frequent and irregular menstruation"	1	113	477	590
"K20"	"H83"	"Esophagitis"	"Other diseases of inner ear"	1	149	351	500
"I11"	"M65"	"Hypertensive heart disease"	"Synovitis and tenosynovitis"	1	53	248	301
"N13"	"K35"	"Obstructive and reflux uropathy"	"Acute appendicitis"	1	133	419	552
"O30"	"O02"	"Multiple gestation"	"Other abnormal products of conception"	1	771	2445	3216
"E85"	"M75"	"Amyloidosis"	"Shoulder lesions"	1	9	50	59
"M81"	"G70"	"Osteoporosis without current pathological fracture"	"Myasthenia gravis and other myoneural disorders"	1	54	160	214
"G20"	"H93"	"Parkinson's disease"	"Other disorders of ear, not elsewhere classified"	1	2	372	374
"D64"	"O03"	"Other anemias"	"Spontaneous abortion"	1	0	494	494
"N63"	"K00"	"Unspecified lump in breast"	"Disorders of tooth development and eruption"	1	4	44	48
"E86"	"H02"	"Volume depletion"	"Other disorders of eyelid"	1	403	2125	2528
"M53"	"N92"	"Other and unspecified dorsopathies, not elsewhere classified"	"Excessive, frequent and irregular menstruation"	1	444	1120	1564
"I26"	"H71"	"Pulmonary embolism"	"Cholesteatoma of middle ear"	1	0	44	44
"E83"	"M76"	"Disorders of mineral metabolism"	"Enthesopathies, lower limb, excluding foot"	1	21	105	126
"D24"	"O68"	"Benign neoplasm of breast"	"Labor and delivery comp by abnlt of fetal acid-base balance"	1	438	1015	1453
"F01"	"I21"	"Vascular dementia"	"Acute myocardial infarction"	1	196	835	1031
"H52"	"O30"	"Disorders of refraction and accommodation"	"Multiple gestation"	1	44	125	169
"M85"	"I70"	"Other disorders of bone density and structure"	"Atherosclerosis"	1	290	537	827
"M72"	"L20"	"Fibroblastic disorders"	"Atopic dermatitis"	1	17	62	79
"H44"	"J35"	"Disorders of globe"	"Chronic diseases of tonsils and adenoids"	1	0	86	86
"K65"	"H40"	"Peritonitis"	"Glaucoma"	1	48	150	198
"K64"	"N31"	"Hemorrhoids and perianal venous thrombosis"	"Neuromuscular dysfunction of bladder, NEC"	1	0	152	152
"C78"	"M66"	"Secondary malignant neoplasm of resp and digestive organs"	"Spontaneous rupture of synovium and tendon"	1	0	74	74
"D17"	"O36"	"Benign lipomatous neoplasm"	"Maternal care for other fetal problems"	1	31	279	310
"K76"	"N60"	"Other diseases of liver"	"Benign mammary dysplasia"	1	33	155	188
"I20"	"N92"	"Angina pectoris"	"Excessive, frequent and irregular menstruation"	1	0	3024	3024
"K25"	"H83"	"Gastric ulcer"	"Other diseases of inner ear"	1	226	870	1096
"J45"	"O48"	"Asthma"	"Late pregnancy"	1	235	467	702
"N31"	"O62"	"Neuromuscular dysfunction of bladder, NEC"	"Abnormalities of forces of labor"	1	8	148	156
"I25"	"M32"	"Chronic ischemic heart disease"	"Systemic lupus erythematosus (SLE)"	1	66	147	213
"I83"	"L03"	"Varicose veins of lower extremities"	"Cellulitis and acute lymphangitis"	1	341	705	1046
"J90"	"N76"	"Pleural effusion, not elsewhere classified"	"Other inflammation of vagina and vulva"	1	0	59	59
"I73"	"K42"	"Other peripheral vascular diseases"	"Umbilical hernia"	1	141	325	466
"H54"	"H36"	"Blindness and low vision"	"Retinal disorders in diseases classified elsewhere"	1	92	300	392
"M47"	"O14"	"Spondylosis"	"Pre-eclampsia"	1	0	67	67
"N83"	"O62"	"Noninflammatory disord of ovary, fallop and broad ligament"	"Abnormalities of forces of labor"	1	1020	3263	4283
"G56"	"H65"	"Mononeuropathies of upper limb"	"Nonsuppurative otitis media"	1	93	367	460
"J69"	"K42"	"Pneumonitis due to solids and liquids"	"Umbilical hernia"	1	20	111	131
"J43"	"M75"	"Emphysema"	"Shoulder lesions"	1	159	491	650
"K29"	"O26"	"Gastritis and duodenitis"	"Maternal care for oth conditions predom related to pregnancy"	1	255	468	723
"O72"	"Q74"	"Postpartum hemorrhage"	"Other congenital malformations of limb(s)"	1	0	69	69
"K43"	"N97"	"Ventral hernia"	"Female infertility"	1	0	309	309
"I48"	"M19"	"Atrial fibrillation and flutter"	"Other and unspecified osteoarthritis"	1	3100	4197	7297
"I49"	"O65"	"Other cardiac arrhythmias"	"Obstructed labor due to maternal pelvic abnormality"	1	0	82	82
"N13"	"K26"	"Obstructive and reflux uropathy"	"Duodenal ulcer"	1	256	395	651
"N10"	"G45"	"Acute pyelonephritis"	"Transient cerebral ischemic attacks and related syndromes"	1	261	421	682
"F84"	"J05"	"Pervasive developmental disorders"	"Acute obstructive laryngitis [croup] and epiglottitis"	1	0	146	146
"C53"	"O63"	"Malignant neoplasm of cervix uteri"	"Long labor"	1	1	52	53
"C45"	"C61"	"Mesothelioma"	"Malignant neoplasm of prostate"	1	16	65	81
"K57"	"N75"	"Diverticular disease of intestine"	"Diseases of Bartholin's gland"	1	0	108	108
"D12"	"D24"	"Benign neoplasm of colon, rectum, anus and anal canal"	"Benign neoplasm of breast"	1	0	771	771
"N13"	"K40"	"Obstructive and reflux uropathy"	"Inguinal hernia"	1	237	1128	1365
"F17"	"L23"	"Nicotine dependence"	"Allergic contact dermatitis"	1	86	228	314
"E86"	"G25"	"Volume depletion"	"Other extrapyramidal and movement disorders"	1	306	575	881
"C25"	"K81"	"Malignant neoplasm of pancreas"	"Cholecystitis"	1	143	251	394
"M75"	"H74"	"Shoulder lesions"	"Other disorders of middle ear mastoid"	1	2	76	78
"E87"	"H11"	"Other disorders of fluid, electrolyte and acid-base balance"	"Other disorders of conjunctiva"	1	30	315	345
"G44"	"Q53"	"Other headache syndromes"	"Undescended and ectopic testicle"	1	0	68	68
"I42"	"M67"	"Cardiomyopathy"	"Other disorders of synovium and tendon"	1	39	166	205
"C49"	"D17"	"Malignant neoplasm of other connective and soft tissue"	"Benign lipomatous neoplasm"	1	154	402	556
"J06"	"Q03"	"Acute upper resp infections of multiple and unsp sites"	"Congenital hydrocephalus"	1	11	56	67
"G30"	"C61"	"Alzheimer's disease"	"Malignant neoplasm of prostate"	1	37	292	329
"I50"	"M53"	"Heart failure"	"Other and unspecified dorsopathies, not elsewhere classified"	1	209	591	800
"N17"	"O70"	"Acute kidney failure"	"Perineal laceration during delivery"	1	2	48	50
"I13"	"K40"	"Hypertensive heart and chronic kidney disease"	"Inguinal hernia"	1	17	72	89
"I83"	"O36"	"Varicose veins of lower extremities"	"Maternal care for other fetal problems"	1	39	1150	1189
"I20"	"O92"	"Angina pectoris"	"Oth disord of brst/lactatn assoc w pregnancy and the puerp"	1	0	50	50
"N10"	"C67"	"Acute pyelonephritis"	"Malignant neoplasm of bladder"	1	181	571	752
"H91"	"M75"	"Other and unspecified hearing loss"	"Shoulder lesions"	1	3955	4782	8737
"C77"	"D17"	"Secondary and unspecified malignant neoplasm of lymph nodes"	"Benign lipomatous neoplasm"	1	54	330	384
"N17"	"I44"	"Acute kidney failure"	"Atrioventricular and left bundle-branch block"	1	510	756	1266
"N62"	"O65"	"Hypertrophy of breast"	"Obstructed labor due to maternal pelvic abnormality"	1	57	200	257
"J18"	"N49"	"Pneumonia, unspecified organism"	"Inflammatory disorders of male genital organs, NEC"	1	232	445	677
"D25"	"O30"	"Leiomyoma of uterus"	"Multiple gestation"	1	0	203	203
"I47"	"D25"	"Paroxysmal tachycardia"	"Leiomyoma of uterus"	1	222	468	690
"I67"	"M75"	"Other cerebrovascular diseases"	"Shoulder lesions"	1	166	354	520
"G47"	"D30"	"Sleep disorders"	"Benign neoplasm of urinary organs"	1	106	300	406
"F33"	"E11"	"Major depressive disorder, recurrent"	"Type 2 diabetes mellitus"	1	1167	2347	3514
"D64"	"G44"	"Other anemias"	"Other headache syndromes"	1	204	573	777
"E11"	"O80"	"Type 2 diabetes mellitus"	"Encounter for full-term uncomplicated delivery"	1	0	982	982
"G56"	"O14"	"Mononeuropathies of upper limb"	"Pre-eclampsia"	1	107	674	781
"C48"	"M75"	"Malignant neoplasm of retroperitoneum and peritoneum"	"Shoulder lesions"	1	10	49	59
"K59"	"D45"	"Other functional intestinal disorders"	"Polycythemia vera"	1	53	150	203
"M99"	"K80"	"Biomechanical lesions, not elsewhere classified"	"Cholelithiasis"	1	213	436	649
"K91"	"I83"	"Intraop and postproc comp and disorders of dgstv sys, NEC"	"Varicose veins of lower extremities"	1	76	160	236
"N39"	"C32"	"Other disorders of urinary system"	"Malignant neoplasm of larynx"	1	36	144	180
"H18"	"N92"	"Other disorders of cornea"	"Excessive, frequent and irregular menstruation"	1	19	256	275
"M16"	"K51"	"Osteoarthritis of hip"	"Ulcerative colitis"	1	295	466	761
"M85"	"O70"	"Other disorders of bone density and structure"	"Perineal laceration during delivery"	1	0	324	324
"E34"	"G91"	"Other endocrine disorders"	"Hydrocephalus"	1	13	61	74
"Q40"	"F10"	"Other congenital malformations of upper alimentary tract"	"Alcohol related disorders"	1	67	190	257
"O85"	"O13"	"Puerperal sepsis"	"Gestational hypertension without significant proteinuria"	1	100	219	319
"J15"	"K05"	"Bacterial pneumonia, not elsewhere classified"	"Gingivitis and periodontal diseases"	1	307	1221	1528
"J18"	"O75"	"Pneumonia, unspecified organism"	"Oth complications of labor and delivery, NEC"	1	142	469	611
"D16"	"H66"	"Benign neoplasm of bone and articular cartilage"	"Suppurative and unspecified otitis media"	1	7	69	76
"E85"	"I10"	"Amyloidosis"	"Essential (primary) hypertension"	1	78	232	310
"L08"	"O62"	"Other local infections of skin and subcutaneous tissue"	"Abnormalities of forces of labor"	1	242	946	1188
"N18"	"J03"	"Chronic kidney disease (CKD)"	"Acute tonsillitis"	1	66	151	217
"K92"	"E11"	"Other diseases of digestive system"	"Type 2 diabetes mellitus"	1	2652	5499	8151
"L98"	"J05"	"Oth disorders of skin, subcu, not elsewhere classified"	"Acute obstructive laryngitis [croup] and epiglottitis"	1	2	60	62
"E41"	"I48"	"Nutritional marasmus"	"Atrial fibrillation and flutter"	1	172	590	762
"C14"	"M54"	"Malig neoplasm of sites in the lip, oral cavity and pharynx"	"Dorsalgia"	1	5	47	52
"H44"	"O80"	"Disorders of globe"	"Encounter for full-term uncomplicated delivery"	1	0	515	515
"G44"	"O82"	"Other headache syndromes"	"Encounter for cesarean delivery without indication"	1	256	1077	1333
"L90"	"N47"	"Atrophic disorders of skin"	"Disorders of prepuce"	1	243	417	660
"M67"	"G80"	"Other disorders of synovium and tendon"	"Cerebral palsy"	1	135	345	480
"E23"	"M65"	"Hypofunction and other disorders of the pituitary gland"	"Synovitis and tenosynovitis"	1	33	107	140
"K60"	"O70"	"Fissure and fistula of anal and rectal regions"	"Perineal laceration during delivery"	1	525	1580	2105
"K56"	"M43"	"Paralytic ileus and intestinal obstruction without hernia"	"Other deforming dorsopathies"	1	83	252	335
"C34"	"C21"	"Malignant neoplasm of bronchus and lung"	"Malignant neoplasm of anus and anal canal"	1	6	73	79
"G96"	"L60"	"Other disorders of central nervous system"	"Nail disorders"	1	24	82	106
"J96"	"D31"	"Respiratory failure, not elsewhere classified"	"Benign neoplasm of eye and adnexa"	1	16	116	132
"I10"	"O90"	"Essential (primary) hypertension"	"Complications of the puerperium, not elsewhere classified"	1	38	249	287
"D25"	"O13"	"Leiomyoma of uterus"	"Gestational hypertension without significant proteinuria"	1	0	115	115
"M67"	"L04"	"Other disorders of synovium and tendon"	"Acute lymphadenitis"	1	28	119	147
"D17"	"O48"	"Benign lipomatous neoplasm"	"Late pregnancy"	1	0	263	263
"K63"	"H91"	"Other diseases of intestine"	"Other and unspecified hearing loss"	1	233	1137	1370
"A41"	"L95"	"Other sepsis"	"Vasculitis limited to skin, not elsewhere classified"	1	131	276	407
"I42"	"H40"	"Cardiomyopathy"	"Glaucoma"	1	79	160	239
"D07"	"N83"	"Carcinoma in situ of other and unspecified genital organs"	"Noninflammatory disord of ovary, fallop and broad ligament"	1	96	182	278
"C17"	"E66"	"Malignant neoplasm of small intestine"	"Overweight and obesity"	1	17	90	107
"J94"	"F10"	"Other pleural conditions"	"Alcohol related disorders"	1	161	426	587
"I35"	"O03"	"Nonrheumatic aortic valve disorders"	"Spontaneous abortion"	1	0	57	57
"K30"	"Q53"	"Functional dyspepsia"	"Undescended and ectopic testicle"	1	0	67	67
"E64"	"O80"	"Sequelae of malnutrition and other nutritional deficiencies"	"Encounter for full-term uncomplicated delivery"	1	0	112	112
"K55"	"N40"	"Vascular disorders of intestine"	"Benign prostatic hyperplasia"	1	69	406	475
"D68"	"I63"	"Other coagulation defects"	"Cerebral infarction"	1	740	1701	2441
"I60"	"J35"	"Nontraumatic subarachnoid hemorrhage"	"Chronic diseases of tonsils and adenoids"	1	2	42	44
"J98"	"I83"	"Other respiratory disorders"	"Varicose veins of lower extremities"	1	104	414	518
"J91"	"N94"	"Pleural effusion in conditions classified elsewhere"	"Pain and oth cond assoc w fem gntl org and menstrual cycle"	1	0	25	25
"M19"	"M20"	"Other and unspecified osteoarthritis"	"Acquired deformities of fingers and toes"	1	2637	3558	6195
"D12"	"L40"	"Benign neoplasm of colon, rectum, anus and anal canal"	"Psoriasis"	1	204	539	743
"J22"	"K58"	"Unspecified acute lower respiratory infection"	"Irritable bowel syndrome"	1	1	112	113
"N80"	"L20"	"Endometriosis"	"Atopic dermatitis"	1	15	59	74
"G43"	"O65"	"Migraine"	"Obstructed labor due to maternal pelvic abnormality"	1	0	413	413
"G62"	"J30"	"Other and unspecified polyneuropathies"	"Vasomotor and allergic rhinitis"	1	5	139	144
"I25"	"Q54"	"Chronic ischemic heart disease"	"Hypospadias"	1	46	197	243
"N30"	"J30"	"Cystitis"	"Vasomotor and allergic rhinitis"	1	285	680	965
"I67"	"M51"	"Other cerebrovascular diseases"	"Thoracic, thoracolum, and lumbosacral intvrt disc disorders"	1	110	423	533
"K42"	"M62"	"Umbilical hernia"	"Other disorders of muscle"	1	492	976	1468
"N28"	"M35"	"Oth disorders of kidney and ureter, not elsewhere classified"	"Other systemic involvement of connective tissue"	1	96	223	319
"G98"	"I48"	"Other disorders of nervous system not elsewhere classified"	"Atrial fibrillation and flutter"	1	309	486	795
"I82"	"K35"	"Other venous embolism and thrombosis"	"Acute appendicitis"	1	21	163	184
"H35"	"M31"	"Other retinal disorders"	"Other necrotizing vasculopathies"	1	468	735	1203
"D39"	"O01"	"Neoplasm of uncertain behavior of female genital organs"	"Hydatidiform mole"	1	8	51	59
"J47"	"M79"	"Bronchiectasis"	"Oth and unsp soft tissue disorders, not elsewhere classified"	1	61	365	426
"K51"	"O62"	"Ulcerative colitis"	"Abnormalities of forces of labor"	1	297	790	1087
"K83"	"J34"	"Other diseases of biliary tract"	"Other and unspecified disorders of nose and nasal sinuses"	1	11	68	79
"M17"	"O91"	"Osteoarthritis of knee"	"Infect of breast assoc w pregnancy, the puerp and lactation"	1	0	53	53
"C26"	"I20"	"Malignant neoplasm of other and ill-defined digestive organs"	"Angina pectoris"	1	0	55	55
"F41"	"I25"	"Other anxiety disorders"	"Chronic ischemic heart disease"	1	594	2141	2735
"I61"	"C44"	"Nontraumatic intracerebral hemorrhage"	"Other and unspecified malignant neoplasm of skin"	1	301	561	862
"F03"	"K57"	"Unspecified dementia"	"Diverticular disease of intestine"	1	0	3549	3549
"E11"	"N70"	"Type 2 diabetes mellitus"	"Salpingitis and oophoritis"	1	2	297	299
"N82"	"O42"	"Fistulae involving female genital tract"	"Premature rupture of membranes"	1	0	35	35
"K43"	"O75"	"Ventral hernia"	"Oth complications of labor and delivery, NEC"	1	2	184	186
"K64"	"H50"	"Hemorrhoids and perianal venous thrombosis"	"Other strabismus"	1	0	123	123
"C22"	"M20"	"Malignant neoplasm of liver and intrahepatic bile ducts"	"Acquired deformities of fingers and toes"	1	0	71	71
"C78"	"I35"	"Secondary malignant neoplasm of resp and digestive organs"	"Nonrheumatic aortic valve disorders"	1	326	1093	1419
"F43"	"G40"	"Reaction to severe stress, and adjustment disorders"	"Epilepsy and recurrent seizures"	1	316	647	963
"N18"	"M48"	"Chronic kidney disease (CKD)"	"Other spondylopathies"	1	397	1773	2170
"O72"	"B27"	"Postpartum hemorrhage"	"Infectious mononucleosis"	1	0	352	352
"E78"	"H93"	"Disorders of lipoprotein metabolism and other lipidemias"	"Other disorders of ear, not elsewhere classified"	1	1144	3090	4234
"I50"	"N60"	"Heart failure"	"Benign mammary dysplasia"	1	8	433	441
"J01"	"O65"	"Acute sinusitis"	"Obstructed labor due to maternal pelvic abnormality"	1	2	147	149
"M79"	"O66"	"Oth and unsp soft tissue disorders, not elsewhere classified"	"Other obstructed labor"	1	87	286	373
"M25"	"G56"	"Other joint disorder, not elsewhere classified"	"Mononeuropathies of upper limb"	1	1641	2406	4047
"K22"	"N70"	"Other diseases of esophagus"	"Salpingitis and oophoritis"	1	0	49	49
"K92"	"N95"	"Other diseases of digestive system"	"Menopausal and other perimenopausal disorders"	1	188	601	789
"C25"	"L97"	"Malignant neoplasm of pancreas"	"Non-pressure chronic ulcer of lower limb, NEC"	1	38	121	159
"G91"	"M51"	"Hydrocephalus"	"Thoracic, thoracolum, and lumbosacral intvrt disc disorders"	1	34	330	364
"C61"	"M77"	"Malignant neoplasm of prostate"	"Other enthesopathies"	1	17	245	262
"M22"	"H72"	"Disorder of patella"	"Perforation of tympanic membrane"	1	59	139	198
"J94"	"L02"	"Other pleural conditions"	"Cutaneous abscess, furuncle and carbuncle"	1	66	158	224
"C53"	"O70"	"Malignant neoplasm of cervix uteri"	"Perineal laceration during delivery"	1	0	336	336
"H01"	"N92"	"Other inflammation of eyelid"	"Excessive, frequent and irregular menstruation"	1	3	192	195
"D23"	"O68"	"Other benign neoplasms of skin"	"Labor and delivery comp by abnlt of fetal acid-base balance"	1	213	598	811
"I50"	"N97"	"Heart failure"	"Female infertility"	1	0	57	57
"K91"	"H80"	"Intraop and postproc comp and disorders of dgstv sys, NEC"	"Otosclerosis"	1	1	29	30
"G63"	"L02"	"Polyneuropathy in diseases classified elsewhere"	"Cutaneous abscess, furuncle and carbuncle"	1	78	219	297
"K58"	"O71"	"Irritable bowel syndrome"	"Other obstetric trauma"	1	111	214	325
"G93"	"O26"	"Other disorders of brain"	"Maternal care for oth conditions predom related to pregnancy"	1	6	76	82
"K72"	"K58"	"Hepatic failure, not elsewhere classified"	"Irritable bowel syndrome"	1	10	93	103
"N30"	"H26"	"Cystitis"	"Other cataract"	1	2408	5743	8151
"G97"	"O62"	"Intraop and postproc comp and disorders of nervous sys, NEC"	"Abnormalities of forces of labor"	1	12	239	251
"I49"	"C50"	"Other cardiac arrhythmias"	"Malignant neoplasm of breast"	1	383	684	1067
"A09"	"N40"	"Infectious gastroenteritis and colitis, unspecified"	"Benign prostatic hyperplasia"	1	669	1624	2293
"G43"	"H65"	"Migraine"	"Nonsuppurative otitis media"	1	2	416	418
"J85"	"M17"	"Abscess of lung and mediastinum"	"Osteoarthritis of knee"	1	23	99	122
"C78"	"K09"	"Secondary malignant neoplasm of resp and digestive organs"	"Cysts of oral region, not elsewhere classified"	1	0	78	78
"H57"	"M06"	"Other disorders of eye and adnexa"	"Other rheumatoid arthritis"	1	81	235	316
"K85"	"O71"	"Acute pancreatitis"	"Other obstetric trauma"	1	8	157	165
"K05"	"C50"	"Gingivitis and periodontal diseases"	"Malignant neoplasm of breast"	1	118	462	580
"I80"	"C20"	"Phlebitis and thrombophlebitis"	"Malignant neoplasm of rectum"	1	456	652	1108
"D47"	"I70"	"Oth neoplm of uncrt behav of lymphoid, hematpoetc & rel tiss"	"Atherosclerosis"	1	154	460	614
"G90"	"J35"	"Disorders of autonomic nervous system"	"Chronic diseases of tonsils and adenoids"	1	4	34	38
"J91"	"K60"	"Pleural effusion in conditions classified elsewhere"	"Fissure and fistula of anal and rectal regions"	1	11	52	63
"M85"	"M81"	"Other disorders of bone density and structure"	"Osteoporosis without current pathological fracture"	1	3896	4656	8552
"J98"	"M17"	"Other respiratory disorders"	"Osteoarthritis of knee"	1	281	667	948
"M51"	"L03"	"Thoracic, thoracolum, and lumbosacral intvrt disc disorders"	"Cellulitis and acute lymphangitis"	1	453	884	1337
"N45"	"J35"	"Orchitis and epididymitis"	"Chronic diseases of tonsils and adenoids"	1	18	288	306
"C56"	"D25"	"Malignant neoplasm of ovary"	"Leiomyoma of uterus"	1	128	653	781
"L90"	"F10"	"Atrophic disorders of skin"	"Alcohol related disorders"	1	246	559	805
"J84"	"L02"	"Other interstitial pulmonary diseases"	"Cutaneous abscess, furuncle and carbuncle"	1	59	271	330
"I48"	"K35"	"Atrial fibrillation and flutter"	"Acute appendicitis"	1	635	1477	2112
"E41"	"K80"	"Nutritional marasmus"	"Cholelithiasis"	1	11	189	200
"K25"	"N92"	"Gastric ulcer"	"Excessive, frequent and irregular menstruation"	1	156	870	1026
"O35"	"M79"	"Maternal care for known or suspected fetal abnlt and damage"	"Oth and unsp soft tissue disorders, not elsewhere classified"	1	100	186	286
"C18"	"H90"	"Malignant neoplasm of colon"	"Conductive and sensorineural hearing loss"	1	207	700	907
"L89"	"K50"	"Pressure ulcer"	"Crohn's disease [regional enteritis]"	1	18	104	122
"D63"	"D75"	"Anemia in chronic diseases classified elsewhere"	"Other and unsp diseases of blood and blood-forming organs"	1	46	129	175
"A09"	"M05"	"Infectious gastroenteritis and colitis, unspecified"	"Rheumatoid arthritis with rheumatoid factor"	1	321	535	856
"K59"	"G95"	"Other functional intestinal disorders"	"Other and unspecified diseases of spinal cord"	1	906	2002	2908
"K11"	"G80"	"Diseases of salivary glands"	"Cerebral palsy"	1	10	52	62
"C85"	"N81"	"Oth and unspecified types of non-Hodgkin lymphoma"	"Female genital prolapse"	1	36	129	165
"C18"	"E11"	"Malignant neoplasm of colon"	"Type 2 diabetes mellitus"	1	1812	2651	4463
"D63"	"N20"	"Anemia in chronic diseases classified elsewhere"	"Calculus of kidney and ureter"	1	58	509	567
"D05"	"O02"	"Carcinoma in situ of breast"	"Other abnormal products of conception"	1	0	35	35
"A04"	"D23"	"Other bacterial intestinal infections"	"Other benign neoplasms of skin"	1	43	145	188
"B34"	"O82"	"Viral infection of unspecified site"	"Encounter for cesarean delivery without indication"	1	312	749	1061
"I11"	"O82"	"Hypertensive heart disease"	"Encounter for cesarean delivery without indication"	1	0	26	26
"C92"	"I73"	"Myeloid leukemia"	"Other peripheral vascular diseases"	1	41	108	149
"I69"	"M05"	"Sequelae of cerebrovascular disease"	"Rheumatoid arthritis with rheumatoid factor"	1	274	851	1125
"F17"	"O48"	"Nicotine dependence"	"Late pregnancy"	1	0	219	219
"N92"	"O86"	"Excessive, frequent and irregular menstruation"	"Other puerperal infections"	1	17	738	755
"O66"	"A63"	"Other obstructed labor"	"Oth predominantly sexually transmitted diseases, NEC"	1	8	249	257
"D43"	"L02"	"Neoplasm of uncertain behavior of brain and cnsl"	"Cutaneous abscess, furuncle and carbuncle"	1	22	76	98
"J94"	"H83"	"Other pleural conditions"	"Other diseases of inner ear"	1	0	139	139
"C61"	"J45"	"Malignant neoplasm of prostate"	"Asthma"	1	194	726	920
"K62"	"K21"	"Other diseases of anus and rectum"	"Gastro-esophageal reflux disease"	1	1462	2271	3733
"D64"	"H52"	"Other anemias"	"Disorders of refraction and accommodation"	1	144	597	741
"N12"	"C53"	"Tubulo-interstitial nephritis, not spcf as acute or chronic"	"Malignant neoplasm of cervix uteri"	1	8	51	59
"I89"	"C04"	"Oth noninfective disorders of lymphatic vessels and nodes"	"Malignant neoplasm of floor of mouth"	1	17	77	94
"E86"	"L05"	"Volume depletion"	"Pilonidal cyst and sinus"	1	29	129	158
"H35"	"O47"	"Other retinal disorders"	"False labor"	1	5	72	77
"J69"	"M20"	"Pneumonitis due to solids and liquids"	"Acquired deformities of fingers and toes"	1	0	149	149
"J81"	"N47"	"Pulmonary edema"	"Disorders of prepuce"	1	32	131	163
"M70"	"M89"	"Soft tissue disorders related to use, overuse and pressure"	"Other disorders of bone"	1	143	295	438
"F05"	"K92"	"Delirium due to known physiological condition"	"Other diseases of digestive system"	1	556	965	1521
"A41"	"I10"	"Other sepsis"	"Essential (primary) hypertension"	1	0	36681	36681
"J44"	"M24"	"Other chronic obstructive pulmonary disease"	"Other specific joint derangements"	1	195	472	667
"C71"	"M79"	"Malignant neoplasm of brain"	"Oth and unsp soft tissue disorders, not elsewhere classified"	1	49	277	326
"E87"	"N62"	"Other disorders of fluid, electrolyte and acid-base balance"	"Hypertrophy of breast"	1	28	412	440
"M81"	"O65"	"Osteoporosis without current pathological fracture"	"Obstructed labor due to maternal pelvic abnormality"	1	0	26	26
"D09"	"M19"	"Carcinoma in situ of other and unspecified sites"	"Other and unspecified osteoarthritis"	1	27	183	210
"M25"	"L20"	"Other joint disorder, not elsewhere classified"	"Atopic dermatitis"	1	50	249	299
"K80"	"O68"	"Cholelithiasis"	"Labor and delivery comp by abnlt of fetal acid-base balance"	1	0	5447	5447
"C85"	"M62"	"Oth and unspecified types of non-Hodgkin lymphoma"	"Other disorders of muscle"	1	36	174	210
"K52"	"H26"	"Other and unsp noninfective gastroenteritis and colitis"	"Other cataract"	1	650	1104	1754
"N17"	"F32"	"Acute kidney failure"	"Depressive episode"	1	496	832	1328
"M07"	"O71"	"Enteropathic arthropathies"	"Other obstetric trauma"	1	0	86	86
"J15"	"K83"	"Bacterial pneumonia, not elsewhere classified"	"Other diseases of biliary tract"	1	384	652	1036
"I44"	"M48"	"Atrioventricular and left bundle-branch block"	"Other spondylopathies"	1	344	732	1076
"I31"	"I10"	"Other diseases of pericardium"	"Essential (primary) hypertension"	1	695	1481	2176
"M53"	"O30"	"Other and unspecified dorsopathies, not elsewhere classified"	"Multiple gestation"	1	10	117	127
"N28"	"C61"	"Oth disorders of kidney and ureter, not elsewhere classified"	"Malignant neoplasm of prostate"	1	113	250	363
"H25"	"O80"	"Age-related cataract"	"Encounter for full-term uncomplicated delivery"	1	0	137	137
"K63"	"M35"	"Other diseases of intestine"	"Other systemic involvement of connective tissue"	1	74	309	383
"M96"	"M62"	"Intraop and postproc comp and disorders of ms sys, NEC"	"Other disorders of muscle"	1	142	309	451
"I49"	"O80"	"Other cardiac arrhythmias"	"Encounter for full-term uncomplicated delivery"	1	0	1148	1148
"M62"	"O64"	"Other disorders of muscle"	"Obstructed labor due to malposition and malpresent of fetus"	1	291	639	930
"G54"	"O70"	"Nerve root and plexus disorders"	"Perineal laceration during delivery"	1	16	177	193
"B99"	"E10"	"Other and unspecified infectious diseases"	"Type 1 diabetes mellitus"	1	43	133	176
"M19"	"J03"	"Other and unspecified osteoarthritis"	"Acute tonsillitis"	1	77	346	423
"J69"	"N40"	"Pneumonitis due to solids and liquids"	"Benign prostatic hyperplasia"	1	0	697	697
"D80"	"O04"	"Immunodeficiency with predominantly antibody defects"	"Complications following (induced) termination of pregnancy"	1	0	28	28
"M51"	"L20"	"Thoracic, thoracolum, and lumbosacral intvrt disc disorders"	"Atopic dermatitis"	1	51	217	268
"H40"	"J35"	"Glaucoma"	"Chronic diseases of tonsils and adenoids"	1	16	67	83
"K76"	"O68"	"Other diseases of liver"	"Labor and delivery comp by abnlt of fetal acid-base balance"	1	1	191	192
"E21"	"O68"	"Hyperparathyroidism and other disorders of parathyroid gland"	"Labor and delivery comp by abnlt of fetal acid-base balance"	1	0	89	89
"D04"	"H91"	"Carcinoma in situ of skin"	"Other and unspecified hearing loss"	1	66	296	362
"J94"	"H33"	"Other pleural conditions"	"Retinal detachments and breaks"	1	7	51	58
"M76"	"H80"	"Enthesopathies, lower limb, excluding foot"	"Otosclerosis"	1	18	69	87
"O90"	"O72"	"Complications of the puerperium, not elsewhere classified"	"Postpartum hemorrhage"	1	7515	8284	15799
"I61"	"E11"	"Nontraumatic intracerebral hemorrhage"	"Type 2 diabetes mellitus"	1	1325	1979	3304
"A04"	"C54"	"Other bacterial intestinal infections"	"Malignant neoplasm of corpus uteri"	1	1	78	79
"K56"	"I47"	"Paralytic ileus and intestinal obstruction without hernia"	"Paroxysmal tachycardia"	1	392	912	1304
"C25"	"K80"	"Malignant neoplasm of pancreas"	"Cholelithiasis"	1	381	1610	1991
"K59"	"O48"	"Other functional intestinal disorders"	"Late pregnancy"	1	20	459	479
"I63"	"M75"	"Cerebral infarction"	"Shoulder lesions"	1	1057	2830	3887
"G96"	"M22"	"Other disorders of central nervous system"	"Disorder of patella"	1	0	244	244
"I11"	"D17"	"Hypertensive heart disease"	"Benign lipomatous neoplasm"	1	54	178	232
"C15"	"D30"	"Malignant neoplasm of esophagus"	"Benign neoplasm of urinary organs"	1	11	112	123
"D64"	"D24"	"Other anemias"	"Benign neoplasm of breast"	1	24	583	607
"J96"	"B91"	"Respiratory failure, not elsewhere classified"	"Sequelae of poliomyelitis"	1	116	251	367
"J69"	"G71"	"Pneumonitis due to solids and liquids"	"Primary disorders of muscles"	1	2	42	44
"D68"	"M65"	"Other coagulation defects"	"Synovitis and tenosynovitis"	1	122	288	410
"K04"	"N87"	"Diseases of pulp and periapical tissues"	"Dysplasia of cervix uteri"	1	31	111	142
"G98"	"O34"	"Other disorders of nervous system not elsewhere classified"	"Maternal care for abnormality of pelvic organs"	1	2	100	102
"H20"	"O20"	"Iridocyclitis"	"Hemorrhage in early pregnancy"	1	30	107	137
"I69"	"N85"	"Sequelae of cerebrovascular disease"	"Other noninflammatory disorders of uterus, except cervix"	1	22	107	129
"J44"	"H80"	"Other chronic obstructive pulmonary disease"	"Otosclerosis"	1	23	611	634
"G96"	"A69"	"Other disorders of central nervous system"	"Other spirochetal infections"	1	49	117	166
"I49"	"K80"	"Other cardiac arrhythmias"	"Cholelithiasis"	1	911	1622	2533
"K91"	"M17"	"Intraop and postproc comp and disorders of dgstv sys, NEC"	"Osteoarthritis of knee"	1	148	317	465
"I42"	"O04"	"Cardiomyopathy"	"Complications following (induced) termination of pregnancy"	1	0	67	67
"C18"	"O72"	"Malignant neoplasm of colon"	"Postpartum hemorrhage"	1	8	58	66
"J84"	"N87"	"Other interstitial pulmonary diseases"	"Dysplasia of cervix uteri"	1	1	59	60
"G56"	"K60"	"Mononeuropathies of upper limb"	"Fissure and fistula of anal and rectal regions"	1	374	567	941
"J18"	"Q51"	"Pneumonia, unspecified organism"	"Congenital malformations of uterus and cervix"	1	12	55	67
"I73"	"D14"	"Other peripheral vascular diseases"	"Benign neoplasm of middle ear and respiratory system"	1	99	259	358
"D12"	"K35"	"Benign neoplasm of colon, rectum, anus and anal canal"	"Acute appendicitis"	1	232	1587	1819
"G20"	"E78"	"Parkinson's disease"	"Disorders of lipoprotein metabolism and other lipidemias"	1	384	978	1362
"I35"	"I73"	"Nonrheumatic aortic valve disorders"	"Other peripheral vascular diseases"	1	1327	2113	3440
"K76"	"N20"	"Other diseases of liver"	"Calculus of kidney and ureter"	1	223	355	578
"I15"	"K80"	"Secondary hypertension"	"Cholelithiasis"	1	323	602	925
"J69"	"E53"	"Pneumonitis due to solids and liquids"	"Deficiency of other B group vitamins"	1	31	96	127
"M65"	"Q21"	"Synovitis and tenosynovitis"	"Congenital malformations of cardiac septa"	1	26	87	113
"K92"	"H90"	"Other diseases of digestive system"	"Conductive and sensorineural hearing loss"	1	260	1243	1503
"O26"	"M22"	"Maternal care for oth conditions predom related to pregnancy"	"Disorder of patella"	1	168	1256	1424
"E27"	"I10"	"Other disorders of adrenal gland"	"Essential (primary) hypertension"	1	514	1443	1957
"I81"	"K25"	"Portal vein thrombosis"	"Gastric ulcer"	1	46	115	161
"J15"	"H04"	"Bacterial pneumonia, not elsewhere classified"	"Disorders of lacrimal system"	1	44	285	329
"F17"	"K26"	"Nicotine dependence"	"Duodenal ulcer"	1	641	938	1579
"C78"	"J34"	"Secondary malignant neoplasm of resp and digestive organs"	"Other and unspecified disorders of nose and nasal sinuses"	1	0	175	175
"K08"	"M51"	"Other disorders of teeth and supporting structures"	"Thoracic, thoracolum, and lumbosacral intvrt disc disorders"	1	229	441	670
"O90"	"O21"	"Complications of the puerperium, not elsewhere classified"	"Excessive vomiting in pregnancy"	1	287	916	1203
"J06"	"M79"	"Acute upper resp infections of multiple and unsp sites"	"Oth and unsp soft tissue disorders, not elsewhere classified"	1	465	1187	1652
"E13"	"O62"	"Other specified diabetes mellitus"	"Abnormalities of forces of labor"	1	0	60	60
"C44"	"O80"	"Other and unspecified malignant neoplasm of skin"	"Encounter for full-term uncomplicated delivery"	1	0	307	307
"B59"	"C83"	"Pneumocystosis"	"Non-follicular lymphoma"	1	29	122	151
"N93"	"N87"	"Other abnormal uterine and vaginal bleeding"	"Dysplasia of cervix uteri"	1	749	1276	2025
"E86"	"I47"	"Volume depletion"	"Paroxysmal tachycardia"	1	0	4922	4922
"I20"	"O80"	"Angina pectoris"	"Encounter for full-term uncomplicated delivery"	1	0	678	678
"I26"	"O14"	"Pulmonary embolism"	"Pre-eclampsia"	1	22	79	101
"A41"	"N03"	"Other sepsis"	"Chronic nephritic syndrome"	1	125	552	677
"I10"	"A69"	"Essential (primary) hypertension"	"Other spirochetal infections"	1	231	506	737
"K59"	"C64"	"Other functional intestinal disorders"	"Malignant neoplasm of kidney, except renal pelvis"	1	455	1083	1538
"I82"	"C53"	"Other venous embolism and thrombosis"	"Malignant neoplasm of cervix uteri"	1	21	94	115
"C34"	"I22"	"Malignant neoplasm of bronchus and lung"	"Subsequent STEMI & NSTEMI mocard infrc"	1	0	64	64
"N39"	"C85"	"Other disorders of urinary system"	"Oth and unspecified types of non-Hodgkin lymphoma"	1	247	417	664
"O64"	"K01"	"Obstructed labor due to malposition and malpresent of fetus"	"Embedded and impacted teeth"	1	1	57	58
"K80"	"N87"	"Cholelithiasis"	"Dysplasia of cervix uteri"	1	453	952	1405
"I46"	"N13"	"Cardiac arrest"	"Obstructive and reflux uropathy"	1	68	372	440
"I15"	"O65"	"Secondary hypertension"	"Obstructed labor due to maternal pelvic abnormality"	1	0	30	30
"O28"	"J35"	"Abnormal findings on antenatal screening of mother"	"Chronic diseases of tonsils and adenoids"	1	0	227	227
"M21"	"Q05"	"Other acquired deformities of limbs"	"Spina bifida"	1	0	31	31
"L97"	"J37"	"Non-pressure chronic ulcer of lower limb, NEC"	"Chronic laryngitis and laryngotracheitis"	1	0	71	71
"E50"	"E66"	"Vitamin A deficiency"	"Overweight and obesity"	1	64	146	210
"G44"	"A87"	"Other headache syndromes"	"Viral meningitis"	1	71	151	222
"M35"	"J45"	"Other systemic involvement of connective tissue"	"Asthma"	1	882	1285	2167
"E21"	"O82"	"Hyperparathyroidism and other disorders of parathyroid gland"	"Encounter for cesarean delivery without indication"	1	0	116	116
"N16"	"E10"	"Renal tubulo-interstitial disord in diseases classd elswhr"	"Type 1 diabetes mellitus"	1	19	152	171
"M89"	"O04"	"Other disorders of bone"	"Complications following (induced) termination of pregnancy"	1	27	167	194
"O33"	"O66"	"Maternal care for disproportion"	"Other obstructed labor"	1	96	185	281
"M51"	"O73"	"Thoracic, thoracolum, and lumbosacral intvrt disc disorders"	"Retained placenta and membranes, without hemorrhage"	1	18	145	163
"C34"	"H18"	"Malignant neoplasm of bronchus and lung"	"Other disorders of cornea"	1	47	242	289
"N17"	"M70"	"Acute kidney failure"	"Soft tissue disorders related to use, overuse and pressure"	1	30	398	428
"C15"	"I49"	"Malignant neoplasm of esophagus"	"Other cardiac arrhythmias"	1	35	150	185
"E83"	"K01"	"Disorders of mineral metabolism"	"Embedded and impacted teeth"	1	19	79	98
"D50"	"D17"	"Iron deficiency anemia"	"Benign lipomatous neoplasm"	1	83	363	446
"N93"	"O72"	"Other abnormal uterine and vaginal bleeding"	"Postpartum hemorrhage"	1	2057	3112	5169
"E86"	"O62"	"Volume depletion"	"Abnormalities of forces of labor"	1	51	390	441
"G47"	"H91"	"Sleep disorders"	"Other and unspecified hearing loss"	1	1261	3091	4352
"K55"	"H90"	"Vascular disorders of intestine"	"Conductive and sensorineural hearing loss"	1	20	177	197
"J10"	"G40"	"Influenza due to other identified influenza virus"	"Epilepsy and recurrent seizures"	1	20	151	171
"F03"	"C61"	"Unspecified dementia"	"Malignant neoplasm of prostate"	1	285	984	1269
"F03"	"D14"	"Unspecified dementia"	"Benign neoplasm of middle ear and respiratory system"	1	0	159	159
"I71"	"I25"	"Aortic aneurysm and dissection"	"Chronic ischemic heart disease"	1	2530	4898	7428
"M19"	"H91"	"Other and unspecified osteoarthritis"	"Other and unspecified hearing loss"	1	2851	4419	7270
"M23"	"B01"	"Internal derangement of knee"	"Varicella [chickenpox]"	1	0	45	45
"K44"	"O80"	"Diaphragmatic hernia"	"Encounter for full-term uncomplicated delivery"	1	0	1488	1488
"N62"	"H83"	"Hypertrophy of breast"	"Other diseases of inner ear"	1	54	284	338
"K02"	"K61"	"Dental caries"	"Abscess of anal and rectal regions"	1	50	125	175
"M53"	"O65"	"Other and unspecified dorsopathies, not elsewhere classified"	"Obstructed labor due to maternal pelvic abnormality"	1	0	108	108
"A49"	"K25"	"Bacterial infection of unspecified site"	"Gastric ulcer"	1	412	1537	1949
"F84"	"Q66"	"Pervasive developmental disorders"	"Congenital deformities of feet"	1	42	104	146
"L89"	"H25"	"Pressure ulcer"	"Age-related cataract"	1	0	3483	3483
"I34"	"C50"	"Nonrheumatic mitral valve disorders"	"Malignant neoplasm of breast"	1	134	422	556
"D50"	"D24"	"Iron deficiency anemia"	"Benign neoplasm of breast"	1	42	296	338
"D63"	"J45"	"Anemia in chronic diseases classified elsewhere"	"Asthma"	1	52	669	721
"K62"	"O10"	"Other diseases of anus and rectum"	"Pre-existing hypertension compl preg/chldbrth"	1	7	43	50
"J15"	"M54"	"Bacterial pneumonia, not elsewhere classified"	"Dorsalgia"	1	0	7933	7933
"A04"	"M72"	"Other bacterial intestinal infections"	"Fibroblastic disorders"	1	19	198	217
"H43"	"O62"	"Disorders of vitreous body"	"Abnormalities of forces of labor"	1	0	91	91
"J13"	"O82"	"Pneumonia due to Streptococcus pneumoniae"	"Encounter for cesarean delivery without indication"	1	10	53	63
"I35"	"N85"	"Nonrheumatic aortic valve disorders"	"Other noninflammatory disorders of uterus, except cervix"	1	2	56	58
"N80"	"B27"	"Endometriosis"	"Infectious mononucleosis"	1	0	45	45
"I51"	"J22"	"Complications and ill-defined descriptions of heart disease"	"Unspecified acute lower respiratory infection"	1	164	280	444
"C34"	"Q28"	"Malignant neoplasm of bronchus and lung"	"Other congenital malformations of circulatory system"	1	0	35	35
"K13"	"O80"	"Other diseases of lip and oral mucosa"	"Encounter for full-term uncomplicated delivery"	1	4	189	193
"I85"	"J45"	"Esophageal varices"	"Asthma"	1	60	154	214
"L08"	"H83"	"Other local infections of skin and subcutaneous tissue"	"Other diseases of inner ear"	1	79	284	363
"G43"	"N47"	"Migraine"	"Disorders of prepuce"	1	89	242	331
"K29"	"O70"	"Gastritis and duodenitis"	"Perineal laceration during delivery"	1	520	715	1235
"J18"	"C81"	"Pneumonia, unspecified organism"	"Hodgkin lymphoma"	1	236	625	861
"K21"	"M22"	"Gastro-esophageal reflux disease"	"Disorder of patella"	1	140	981	1121
"I69"	"N45"	"Sequelae of cerebrovascular disease"	"Orchitis and epididymitis"	1	315	578	893
"M31"	"O20"	"Other necrotizing vasculopathies"	"Hemorrhage in early pregnancy"	1	0	30	30
"O70"	"D48"	"Perineal laceration during delivery"	"Neoplasm of uncertain behavior of other and unsp sites"	1	29	83	112
"J90"	"G44"	"Pleural effusion, not elsewhere classified"	"Other headache syndromes"	1	17	93	110
"I71"	"E11"	"Aortic aneurysm and dissection"	"Type 2 diabetes mellitus"	1	1224	1664	2888
"D46"	"M19"	"Myelodysplastic syndromes"	"Other and unspecified osteoarthritis"	1	37	153	190
"A49"	"L40"	"Bacterial infection of unspecified site"	"Psoriasis"	1	125	437	562
"J01"	"H66"	"Acute sinusitis"	"Suppurative and unspecified otitis media"	1	207	381	588
"D63"	"D10"	"Anemia in chronic diseases classified elsewhere"	"Benign neoplasm of mouth and pharynx"	1	26	109	135
"C78"	"J98"	"Secondary malignant neoplasm of resp and digestive organs"	"Other respiratory disorders"	1	353	742	1095
"C78"	"J33"	"Secondary malignant neoplasm of resp and digestive organs"	"Nasal polyp"	1	0	94	94
"F41"	"C77"	"Other anxiety disorders"	"Secondary and unspecified malignant neoplasm of lymph nodes"	1	273	1268	1541
"L30"	"J05"	"Other and unspecified dermatitis"	"Acute obstructive laryngitis [croup] and epiglottitis"	1	25	136	161
"I34"	"O02"	"Nonrheumatic mitral valve disorders"	"Other abnormal products of conception"	1	4	50	54
"A04"	"M77"	"Other bacterial intestinal infections"	"Other enthesopathies"	1	36	154	190
"E70"	"H36"	"Disorders of aromatic amino-acid metabolism"	"Retinal disorders in diseases classified elsewhere"	1	12	69	81
"L12"	"I10"	"Pemphigoid"	"Essential (primary) hypertension"	1	213	479	692
"B37"	"H90"	"Candidiasis"	"Conductive and sensorineural hearing loss"	1	125	376	501
"J85"	"K35"	"Abscess of lung and mediastinum"	"Acute appendicitis"	1	5	39	44
"H18"	"E66"	"Other disorders of cornea"	"Overweight and obesity"	1	183	324	507
"N76"	"Q17"	"Other inflammation of vagina and vulva"	"Other congenital malformations of ear"	1	0	39	39
"O92"	"M79"	"Oth disord of brst/lactatn assoc w pregnancy and the puerp"	"Oth and unsp soft tissue disorders, not elsewhere classified"	1	255	425	680
"M05"	"F10"	"Rheumatoid arthritis with rheumatoid factor"	"Alcohol related disorders"	1	123	217	340
"K64"	"D50"	"Hemorrhoids and perianal venous thrombosis"	"Iron deficiency anemia"	1	306	625	931
"G12"	"I10"	"Spinal muscular atrophy and related syndromes"	"Essential (primary) hypertension"	1	173	413	586
"M18"	"M77"	"Osteoarthritis of first carpometacarpal joint"	"Other enthesopathies"	1	258	514	772
"M72"	"O82"	"Fibroblastic disorders"	"Encounter for cesarean delivery without indication"	1	0	278	278
"L93"	"O03"	"Lupus erythematosus"	"Spontaneous abortion"	1	2	40	42
"G96"	"O03"	"Other disorders of central nervous system"	"Spontaneous abortion"	1	0	218	218
"C15"	"H02"	"Malignant neoplasm of esophagus"	"Other disorders of eyelid"	1	10	106	116
"L89"	"M16"	"Pressure ulcer"	"Osteoarthritis of hip"	1	0	1318	1318
"C45"	"I25"	"Mesothelioma"	"Chronic ischemic heart disease"	1	29	149	178
"K22"	"M70"	"Other diseases of esophagus"	"Soft tissue disorders related to use, overuse and pressure"	1	179	349	528
"N89"	"O04"	"Other noninflammatory disorders of vagina"	"Complications following (induced) termination of pregnancy"	1	73	309	382
"O99"	"K09"	"Oth maternal diseases classd elsw but compl preg/chldbrth"	"Cysts of oral region, not elsewhere classified"	1	5	47	52
"M50"	"J35"	"Cervical disc disorders"	"Chronic diseases of tonsils and adenoids"	1	2	392	394
"M07"	"N63"	"Enteropathic arthropathies"	"Unspecified lump in breast"	1	23	98	121
"N26"	"I10"	"Unspecified contracted kidney"	"Essential (primary) hypertension"	1	342	540	882
"K40"	"J00"	"Inguinal hernia"	"Acute nasopharyngitis [common cold]"	1	357	553	910
"F31"	"H83"	"Bipolar disorder"	"Other diseases of inner ear"	1	2	46	48
"L97"	"K42"	"Non-pressure chronic ulcer of lower limb, NEC"	"Umbilical hernia"	1	73	294	367
"L89"	"L72"	"Pressure ulcer"	"Follicular cysts of skin and subcutaneous tissue"	1	6	42	48
"J18"	"M66"	"Pneumonia, unspecified organism"	"Spontaneous rupture of synovium and tendon"	1	224	435	659
"N10"	"C53"	"Acute pyelonephritis"	"Malignant neoplasm of cervix uteri"	1	31	158	189
"H52"	"Q31"	"Disorders of refraction and accommodation"	"Congenital malformations of larynx"	1	2	50	52
"N13"	"O62"	"Obstructive and reflux uropathy"	"Abnormalities of forces of labor"	1	225	460	685
"C83"	"M16"	"Non-follicular lymphoma"	"Osteoarthritis of hip"	1	82	314	396
"E68"	"E78"	"Sequelae of hyperalimentation"	"Disorders of lipoprotein metabolism and other lipidemias"	1	142	278	420
"F17"	"M24"	"Nicotine dependence"	"Other specific joint derangements"	1	80	358	438
"M75"	"Q51"	"Shoulder lesions"	"Congenital malformations of uterus and cervix"	1	12	52	64
"N17"	"H80"	"Acute kidney failure"	"Otosclerosis"	1	0	50	50
"K72"	"H93"	"Hepatic failure, not elsewhere classified"	"Other disorders of ear, not elsewhere classified"	1	8	138	146
"N30"	"L05"	"Cystitis"	"Pilonidal cyst and sinus"	1	144	336	480
"L28"	"O80"	"Lichen simplex chronicus and prurigo"	"Encounter for full-term uncomplicated delivery"	1	0	174	174
"Q61"	"M75"	"Cystic kidney disease"	"Shoulder lesions"	1	120	366	486
"E16"	"E66"	"Other disorders of pancreatic internal secretion"	"Overweight and obesity"	1	447	1172	1619
"N39"	"K22"	"Other disorders of urinary system"	"Other diseases of esophagus"	1	800	1208	2008
"M80"	"K40"	"Osteoporosis with current pathological fracture"	"Inguinal hernia"	1	119	1387	1506
"I69"	"C50"	"Sequelae of cerebrovascular disease"	"Malignant neoplasm of breast"	1	534	1637	2171
"L30"	"N43"	"Other and unspecified dermatitis"	"Hydrocele and spermatocele"	1	48	125	173
"K21"	"O65"	"Gastro-esophageal reflux disease"	"Obstructed labor due to maternal pelvic abnormality"	1	0	165	165
"N97"	"F10"	"Female infertility"	"Alcohol related disorders"	1	78	524	602
"H54"	"F10"	"Blindness and low vision"	"Alcohol related disorders"	1	234	525	759
"I48"	"L20"	"Atrial fibrillation and flutter"	"Atopic dermatitis"	1	43	128	171
"J93"	"J35"	"Pneumothorax and air leak"	"Chronic diseases of tonsils and adenoids"	1	15	105	120
"E88"	"M51"	"Other and unspecified metabolic disorders"	"Thoracic, thoracolum, and lumbosacral intvrt disc disorders"	1	75	203	278
"N32"	"O26"	"Other disorders of bladder"	"Maternal care for oth conditions predom related to pregnancy"	1	3	45	48
"A41"	"F33"	"Other sepsis"	"Major depressive disorder, recurrent"	1	1250	1729	2979
"I47"	"H65"	"Paroxysmal tachycardia"	"Nonsuppurative otitis media"	1	77	273	350
"M79"	"O30"	"Oth and unsp soft tissue disorders, not elsewhere classified"	"Multiple gestation"	1	143	377	520
"N30"	"E11"	"Cystitis"	"Type 2 diabetes mellitus"	1	0	25811	25811
"I86"	"J35"	"Varicose veins of other sites"	"Chronic diseases of tonsils and adenoids"	1	12	94	106
"E21"	"O04"	"Hyperparathyroidism and other disorders of parathyroid gland"	"Complications following (induced) termination of pregnancy"	1	0	66	66
"I42"	"G45"	"Cardiomyopathy"	"Transient cerebral ischemic attacks and related syndromes"	1	321	557	878
"D12"	"L08"	"Benign neoplasm of colon, rectum, anus and anal canal"	"Other local infections of skin and subcutaneous tissue"	1	318	711	1029
"M47"	"L23"	"Spondylosis"	"Allergic contact dermatitis"	1	58	185	243
"J45"	"Q38"	"Asthma"	"Other congenital malformations of tongue, mouth and pharynx"	1	104	308	412
"M15"	"N63"	"Polyosteoarthritis"	"Unspecified lump in breast"	1	59	145	204
"K58"	"N92"	"Irritable bowel syndrome"	"Excessive, frequent and irregular menstruation"	1	1016	1701	2717
"G47"	"Q79"	"Sleep disorders"	"Congenital malformations of musculoskeletal system, NEC"	1	3	39	42
"D68"	"H65"	"Other coagulation defects"	"Nonsuppurative otitis media"	1	2	115	117
"M67"	"A63"	"Other disorders of synovium and tendon"	"Oth predominantly sexually transmitted diseases, NEC"	1	195	409	604
"K59"	"K02"	"Other functional intestinal disorders"	"Dental caries"	1	564	1059	1623
"H47"	"K35"	"Other disorders of optic [2nd] nerve and visual pathways"	"Acute appendicitis"	1	20	71	91
"I35"	"D12"	"Nonrheumatic aortic valve disorders"	"Benign neoplasm of colon, rectum, anus and anal canal"	1	1293	2369	3662
"C71"	"N60"	"Malignant neoplasm of brain"	"Benign mammary dysplasia"	1	0	58	58
"I85"	"M62"	"Esophageal varices"	"Other disorders of muscle"	1	9	232	241
"C24"	"M47"	"Malignant neoplasm of other and unsp parts of biliary tract"	"Spondylosis"	1	2	58	60
"K22"	"L08"	"Other diseases of esophagus"	"Other local infections of skin and subcutaneous tissue"	1	131	226	357
"M19"	"D07"	"Other and unspecified osteoarthritis"	"Carcinoma in situ of other and unspecified genital organs"	1	25	76	101
"H26"	"H80"	"Other cataract"	"Otosclerosis"	1	34	305	339
"E87"	"M75"	"Other disorders of fluid, electrolyte and acid-base balance"	"Shoulder lesions"	1	0	2491	2491
"A49"	"M80"	"Bacterial infection of unspecified site"	"Osteoporosis with current pathological fracture"	1	807	1305	2112
"M48"	"N40"	"Other spondylopathies"	"Benign prostatic hyperplasia"	1	1010	2160	3170
"L02"	"E10"	"Cutaneous abscess, furuncle and carbuncle"	"Type 1 diabetes mellitus"	1	2109	2583	4692
"M48"	"O20"	"Other spondylopathies"	"Hemorrhage in early pregnancy"	1	0	100	100
"C18"	"G35"	"Malignant neoplasm of colon"	"Multiple sclerosis"	1	6	54	60
"E87"	"H83"	"Other disorders of fluid, electrolyte and acid-base balance"	"Other diseases of inner ear"	1	0	653	653
"O14"	"N70"	"Pre-eclampsia"	"Salpingitis and oophoritis"	1	116	257	373
"J32"	"O02"	"Chronic sinusitis"	"Other abnormal products of conception"	1	24	200	224
"O66"	"O20"	"Other obstructed labor"	"Hemorrhage in early pregnancy"	1	699	1835	2534
"K44"	"D24"	"Diaphragmatic hernia"	"Benign neoplasm of breast"	1	127	432	559
"M70"	"D25"	"Soft tissue disorders related to use, overuse and pressure"	"Leiomyoma of uterus"	1	152	696	848
"N19"	"M77"	"Unspecified kidney failure"	"Other enthesopathies"	1	25	130	155
"F13"	"O03"	"Sedative, hypnotic, or anxiolytic related disorders"	"Spontaneous abortion"	1	4	46	50
"G95"	"Q05"	"Other and unspecified diseases of spinal cord"	"Spina bifida"	1	5	63	68
"L95"	"I20"	"Vasculitis limited to skin, not elsewhere classified"	"Angina pectoris"	1	61	214	275
"I48"	"O80"	"Atrial fibrillation and flutter"	"Encounter for full-term uncomplicated delivery"	1	0	433	433
"F41"	"N45"	"Other anxiety disorders"	"Orchitis and epididymitis"	1	47	152	199
"F33"	"H33"	"Major depressive disorder, recurrent"	"Retinal detachments and breaks"	1	24	165	189
"G98"	"J36"	"Other disorders of nervous system not elsewhere classified"	"Peritonsillar abscess"	1	0	29	29
"L97"	"J45"	"Non-pressure chronic ulcer of lower limb, NEC"	"Asthma"	1	120	845	965
"C49"	"D21"	"Malignant neoplasm of other connective and soft tissue"	"Other benign neoplasms of connective and other soft tissue"	1	148	301	449
"H34"	"D17"	"Retinal vascular occlusions"	"Benign lipomatous neoplasm"	1	23	109	132
"C44"	"H33"	"Other and unspecified malignant neoplasm of skin"	"Retinal detachments and breaks"	1	123	469	592
"M81"	"M34"	"Osteoporosis without current pathological fracture"	"Systemic sclerosis [scleroderma]"	1	58	203	261
"E66"	"H50"	"Overweight and obesity"	"Other strabismus"	1	141	669	810
"K92"	"Q53"	"Other diseases of digestive system"	"Undescended and ectopic testicle"	1	2	56	58
"N39"	"N87"	"Other disorders of urinary system"	"Dysplasia of cervix uteri"	1	166	1040	1206
"N13"	"H65"	"Obstructive and reflux uropathy"	"Nonsuppurative otitis media"	1	47	132	179
"N84"	"O04"	"Polyp of female genital tract"	"Complications following (induced) termination of pregnancy"	1	0	1155	1155
"I34"	"H83"	"Nonrheumatic mitral valve disorders"	"Other diseases of inner ear"	1	35	401	436
"C25"	"K85"	"Malignant neoplasm of pancreas"	"Acute pancreatitis"	1	228	745	973
"M75"	"O92"	"Shoulder lesions"	"Oth disord of brst/lactatn assoc w pregnancy and the puerp"	1	88	202	290
"J15"	"D14"	"Bacterial pneumonia, not elsewhere classified"	"Benign neoplasm of middle ear and respiratory system"	1	115	558	673
"C50"	"D25"	"Malignant neoplasm of breast"	"Leiomyoma of uterus"	1	188	1692	1880
"J69"	"F20"	"Pneumonitis due to solids and liquids"	"Schizophrenia"	1	92	186	278
"O99"	"I88"	"Oth maternal diseases classd elsw but compl preg/chldbrth"	"Nonspecific lymphadenitis"	1	90	268	358
"N99"	"C53"	"Intraop and postproc comp and disorders of GU sys, NEC"	"Malignant neoplasm of cervix uteri"	1	22	119	141
"M10"	"K35"	"Gout"	"Acute appendicitis"	1	81	301	382
"B34"	"N60"	"Viral infection of unspecified site"	"Benign mammary dysplasia"	1	58	170	228
"I80"	"O32"	"Phlebitis and thrombophlebitis"	"Maternal care for malpresentation of fetus"	1	37	167	204
"K41"	"O20"	"Femoral hernia"	"Hemorrhage in early pregnancy"	1	0	29	29
"B97"	"C91"	"Viral agents as the cause of diseases classified elsewhere"	"Lymphoid leukemia"	1	1	27	28
"C25"	"C50"	"Malignant neoplasm of pancreas"	"Malignant neoplasm of breast"	1	8	338	346
"H53"	"K44"	"Visual disturbances"	"Diaphragmatic hernia"	1	188	407	595
"I48"	"K61"	"Atrial fibrillation and flutter"	"Abscess of anal and rectal regions"	1	284	737	1021
"F03"	"E27"	"Unspecified dementia"	"Other disorders of adrenal gland"	1	38	103	141
"N17"	"I50"	"Acute kidney failure"	"Heart failure"	1	3637	5577	9214
"M17"	"O90"	"Osteoarthritis of knee"	"Complications of the puerperium, not elsewhere classified"	1	0	71	71
"N39"	"M71"	"Other disorders of urinary system"	"Other bursopathies"	1	180	727	907
"D80"	"O62"	"Immunodeficiency with predominantly antibody defects"	"Abnormalities of forces of labor"	1	5	38	43
"D46"	"K35"	"Myelodysplastic syndromes"	"Acute appendicitis"	1	6	39	45
"N47"	"H65"	"Disorders of prepuce"	"Nonsuppurative otitis media"	1	152	1026	1178
"C71"	"L02"	"Malignant neoplasm of brain"	"Cutaneous abscess, furuncle and carbuncle"	1	29	111	140
"D50"	"E04"	"Iron deficiency anemia"	"Other nontoxic goiter"	1	212	531	743
"N18"	"I60"	"Chronic kidney disease (CKD)"	"Nontraumatic subarachnoid hemorrhage"	1	66	152	218
"H57"	"L20"	"Other disorders of eye and adnexa"	"Atopic dermatitis"	1	19	135	154
"K59"	"D34"	"Other functional intestinal disorders"	"Benign neoplasm of thyroid gland"	1	45	118	163
"J96"	"D25"	"Respiratory failure, not elsewhere classified"	"Leiomyoma of uterus"	1	0	519	519
"C10"	"K44"	"Malignant neoplasm of oropharynx"	"Diaphragmatic hernia"	1	8	59	67
"B96"	"M23"	"Oth bacterial agents as the cause of diseases classd elswhr"	"Internal derangement of knee"	1	20	160	180
"O72"	"N75"	"Postpartum hemorrhage"	"Diseases of Bartholin's gland"	1	322	802	1124
"F15"	"J35"	"Other stimulant related disorders"	"Chronic diseases of tonsils and adenoids"	1	0	30	30
"H01"	"E66"	"Other inflammation of eyelid"	"Overweight and obesity"	1	96	196	292
"K74"	"O68"	"Fibrosis and cirrhosis of liver"	"Labor and delivery comp by abnlt of fetal acid-base balance"	1	0	25	25
"K92"	"C56"	"Other diseases of digestive system"	"Malignant neoplasm of ovary"	1	117	229	346
"K65"	"N18"	"Peritonitis"	"Chronic kidney disease (CKD)"	1	989	2298	3287
"F43"	"O99"	"Reaction to severe stress, and adjustment disorders"	"Oth maternal diseases classd elsw but compl preg/chldbrth"	1	663	1343	2006
"F17"	"O42"	"Nicotine dependence"	"Premature rupture of membranes"	1	117	432	549
"I46"	"E04"	"Cardiac arrest"	"Other nontoxic goiter"	1	1	279	280
"H16"	"O82"	"Keratitis"	"Encounter for cesarean delivery without indication"	1	102	279	381
"L97"	"H40"	"Non-pressure chronic ulcer of lower limb, NEC"	"Glaucoma"	1	119	535	654
"E11"	"M65"	"Type 2 diabetes mellitus"	"Synovitis and tenosynovitis"	1	1398	2015	3413
"I48"	"L43"	"Atrial fibrillation and flutter"	"Lichen planus"	1	76	297	373
"C02"	"M51"	"Malignant neoplasm of other and unspecified parts of tongue"	"Thoracic, thoracolum, and lumbosacral intvrt disc disorders"	1	4	53	57
"J81"	"F10"	"Pulmonary edema"	"Alcohol related disorders"	1	139	817	956
"F33"	"K00"	"Major depressive disorder, recurrent"	"Disorders of tooth development and eruption"	1	0	26	26
"I44"	"H25"	"Atrioventricular and left bundle-branch block"	"Age-related cataract"	1	1964	4366	6330
"J30"	"Q17"	"Vasomotor and allergic rhinitis"	"Other congenital malformations of ear"	1	29	111	140
"J80"	"C50"	"Acute respiratory distress syndrome"	"Malignant neoplasm of breast"	1	2	29	31
"M14"	"H36"	"Arthropathies in other diseases classified elsewhere"	"Retinal disorders in diseases classified elsewhere"	1	108	318	426
"J90"	"N60"	"Pleural effusion, not elsewhere classified"	"Benign mammary dysplasia"	1	0	92	92
"K83"	"O48"	"Other diseases of biliary tract"	"Late pregnancy"	1	0	54	54
"M32"	"O20"	"Systemic lupus erythematosus (SLE)"	"Hemorrhage in early pregnancy"	1	9	59	68
"K63"	"C61"	"Other diseases of intestine"	"Malignant neoplasm of prostate"	1	124	320	444
"K62"	"H27"	"Other diseases of anus and rectum"	"Other disorders of lens"	1	23	147	170
"J47"	"O62"	"Bronchiectasis"	"Abnormalities of forces of labor"	1	0	67	67
"I42"	"K61"	"Cardiomyopathy"	"Abscess of anal and rectal regions"	1	37	105	142
"G47"	"G35"	"Sleep disorders"	"Multiple sclerosis"	1	25	164	189
"M19"	"H71"	"Other and unspecified osteoarthritis"	"Cholesteatoma of middle ear"	1	23	107	130
"J69"	"L98"	"Pneumonitis due to solids and liquids"	"Oth disorders of skin, subcu, not elsewhere classified"	1	54	194	248
"G50"	"K35"	"Disorders of trigeminal nerve"	"Acute appendicitis"	1	19	101	120
"O74"	"O20"	"Complications of anesthesia during labor and delivery"	"Hemorrhage in early pregnancy"	1	28	97	125
"H91"	"I20"	"Other and unspecified hearing loss"	"Angina pectoris"	1	8273	10923	19196
"K83"	"O75"	"Other diseases of biliary tract"	"Oth complications of labor and delivery, NEC"	1	8	44	52
"J18"	"C51"	"Pneumonia, unspecified organism"	"Malignant neoplasm of vulva"	1	69	165	234
"L05"	"L20"	"Pilonidal cyst and sinus"	"Atopic dermatitis"	1	4	64	68
"C78"	"B34"	"Secondary malignant neoplasm of resp and digestive organs"	"Viral infection of unspecified site"	1	22	161	183
"G62"	"I21"	"Other and unspecified polyneuropathies"	"Acute myocardial infarction"	1	540	752	1292
"K90"	"K85"	"Intestinal malabsorption"	"Acute pancreatitis"	1	58	160	218
"O71"	"N97"	"Other obstetric trauma"	"Female infertility"	1	0	5030	5030
"B95"	"D25"	"Strep as the cause of diseases classified elsewhere"	"Leiomyoma of uterus"	1	3	35	38
"K83"	"K20"	"Other diseases of biliary tract"	"Esophagitis"	1	123	273	396
"C14"	"G56"	"Malig neoplasm of sites in the lip, oral cavity and pharynx"	"Mononeuropathies of upper limb"	1	0	26	26
"M46"	"M20"	"Other inflammatory spondylopathies"	"Acquired deformities of fingers and toes"	1	51	157	208
"H02"	"H10"	"Other disorders of eyelid"	"Conjunctivitis"	1	664	925	1589
"K43"	"C67"	"Ventral hernia"	"Malignant neoplasm of bladder"	1	195	451	646
"H25"	"O34"	"Age-related cataract"	"Maternal care for abnormality of pelvic organs"	1	0	29	29
"D69"	"H80"	"Purpura and other hemorrhagic conditions"	"Otosclerosis"	1	1	46	47
"K02"	"Q87"	"Dental caries"	"Oth congenital malform syndromes affecting multiple systems"	1	40	135	175
"J96"	"K25"	"Respiratory failure, not elsewhere classified"	"Gastric ulcer"	1	0	5325	5325
"C67"	"H66"	"Malignant neoplasm of bladder"	"Suppurative and unspecified otitis media"	1	6	53	59
"J91"	"M65"	"Pleural effusion in conditions classified elsewhere"	"Synovitis and tenosynovitis"	1	11	128	139
"B02"	"M17"	"Zoster [herpes zoster]"	"Osteoarthritis of knee"	1	181	513	694
"N28"	"K40"	"Oth disorders of kidney and ureter, not elsewhere classified"	"Inguinal hernia"	1	77	547	624
"M80"	"H91"	"Osteoporosis with current pathological fracture"	"Other and unspecified hearing loss"	1	0	5982	5982
"K27"	"M51"	"Peptic ulcer, site unspecified"	"Thoracic, thoracolum, and lumbosacral intvrt disc disorders"	1	190	412	602
"F01"	"H36"	"Vascular dementia"	"Retinal disorders in diseases classified elsewhere"	1	8	186	194
"M72"	"N84"	"Fibroblastic disorders"	"Polyp of female genital tract"	1	127	248	375
"M19"	"E04"	"Other and unspecified osteoarthritis"	"Other nontoxic goiter"	1	399	1076	1475
"F05"	"D64"	"Delirium due to known physiological condition"	"Other anemias"	1	2122	2771	4893
"F17"	"N94"	"Nicotine dependence"	"Pain and oth cond assoc w fem gntl org and menstrual cycle"	1	389	676	1065
"M77"	"O00"	"Other enthesopathies"	"Ectopic pregnancy"	1	0	154	154
"D12"	"H11"	"Benign neoplasm of colon, rectum, anus and anal canal"	"Other disorders of conjunctiva"	1	126	319	445
"C50"	"O75"	"Malignant neoplasm of breast"	"Oth complications of labor and delivery, NEC"	1	0	130	130
"I73"	"L03"	"Other peripheral vascular diseases"	"Cellulitis and acute lymphangitis"	1	143	617	760
"F32"	"B27"	"Depressive episode"	"Infectious mononucleosis"	1	5	50	55
"I95"	"M06"	"Hypotension"	"Other rheumatoid arthritis"	1	71	325	396
"G95"	"N60"	"Other and unspecified diseases of spinal cord"	"Benign mammary dysplasia"	1	0	88	88
"E86"	"E16"	"Volume depletion"	"Other disorders of pancreatic internal secretion"	1	1435	2238	3673
"E06"	"N60"	"Thyroiditis"	"Benign mammary dysplasia"	1	32	115	147
"K70"	"J34"	"Alcoholic liver disease"	"Other and unspecified disorders of nose and nasal sinuses"	1	5	121	126
"I72"	"H91"	"Other aneurysm"	"Other and unspecified hearing loss"	1	167	607	774
"B96"	"C61"	"Oth bacterial agents as the cause of diseases classd elswhr"	"Malignant neoplasm of prostate"	1	36	120	156
"F40"	"J35"	"Phobic anxiety disorders"	"Chronic diseases of tonsils and adenoids"	1	4	43	47
"K55"	"E04"	"Vascular disorders of intestine"	"Other nontoxic goiter"	1	23	108	131
"I80"	"J30"	"Phlebitis and thrombophlebitis"	"Vasomotor and allergic rhinitis"	1	63	295	358
"A26"	"H91"	"Erysipeloid"	"Other and unspecified hearing loss"	1	3	139	142
"I89"	"N83"	"Oth noninfective disorders of lymphatic vessels and nodes"	"Noninflammatory disord of ovary, fallop and broad ligament"	1	46	139	185
"O36"	"A56"	"Maternal care for other fetal problems"	"Other sexually transmitted chlamydial diseases"	1	19	93	112
"B96"	"C92"	"Oth bacterial agents as the cause of diseases classd elswhr"	"Myeloid leukemia"	1	31	90	121
"I50"	"A63"	"Heart failure"	"Oth predominantly sexually transmitted diseases, NEC"	1	10	140	150
"J91"	"J32"	"Pleural effusion in conditions classified elsewhere"	"Chronic sinusitis"	1	3	36	39
"I44"	"J35"	"Atrioventricular and left bundle-branch block"	"Chronic diseases of tonsils and adenoids"	1	10	56	66
"O64"	"O21"	"Obstructed labor due to malposition and malpresent of fetus"	"Excessive vomiting in pregnancy"	1	503	800	1303
"E21"	"N92"	"Hyperparathyroidism and other disorders of parathyroid gland"	"Excessive, frequent and irregular menstruation"	1	0	457	457
"F33"	"H11"	"Major depressive disorder, recurrent"	"Other disorders of conjunctiva"	1	24	107	131
"N28"	"M17"	"Oth disorders of kidney and ureter, not elsewhere classified"	"Osteoarthritis of knee"	1	93	679	772
"J43"	"M23"	"Emphysema"	"Internal derangement of knee"	1	53	311	364
"I83"	"N71"	"Varicose veins of lower extremities"	"Inflammatory disease of uterus, except cervix"	1	58	218	276
"N13"	"H93"	"Obstructive and reflux uropathy"	"Other disorders of ear, not elsewhere classified"	1	97	449	546
"B44"	"K04"	"Aspergillosis"	"Diseases of pulp and periapical tissues"	1	14	60	74
"N18"	"N62"	"Chronic kidney disease (CKD)"	"Hypertrophy of breast"	1	101	387	488
"C48"	"H91"	"Malignant neoplasm of retroperitoneum and peritoneum"	"Other and unspecified hearing loss"	1	9	67	76
"E13"	"M62"	"Other specified diabetes mellitus"	"Other disorders of muscle"	1	0	205	205
"E27"	"D86"	"Other disorders of adrenal gland"	"Sarcoidosis"	1	8	46	54
"F79"	"J00"	"Unspecified intellectual disabilities"	"Acute nasopharyngitis [common cold]"	1	26	249	275
"M54"	"Q37"	"Dorsalgia"	"Cleft palate with cleft lip"	1	1	44	45
"M81"	"N95"	"Osteoporosis without current pathological fracture"	"Menopausal and other perimenopausal disorders"	1	570	2211	2781
"N39"	"J05"	"Other disorders of urinary system"	"Acute obstructive laryngitis [croup] and epiglottitis"	1	63	331	394
"M65"	"O32"	"Synovitis and tenosynovitis"	"Maternal care for malpresentation of fetus"	1	165	297	462
"F90"	"O62"	"Attention-deficit hyperactivity disorders"	"Abnormalities of forces of labor"	1	8	51	59
"J15"	"K86"	"Bacterial pneumonia, not elsewhere classified"	"Other diseases of pancreas"	1	284	811	1095
"K04"	"K21"	"Diseases of pulp and periapical tissues"	"Gastro-esophageal reflux disease"	1	302	441	743
"M81"	"K51"	"Osteoporosis without current pathological fracture"	"Ulcerative colitis"	1	212	1166	1378
"G63"	"K35"	"Polyneuropathy in diseases classified elsewhere"	"Acute appendicitis"	1	7	48	55
"I80"	"C81"	"Phlebitis and thrombophlebitis"	"Hodgkin lymphoma"	1	63	147	210
"K85"	"M65"	"Acute pancreatitis"	"Synovitis and tenosynovitis"	1	176	329	505
"D64"	"J45"	"Other anemias"	"Asthma"	1	0	4518	4518
"I35"	"H11"	"Nonrheumatic aortic valve disorders"	"Other disorders of conjunctiva"	1	78	223	301
"D46"	"I47"	"Myelodysplastic syndromes"	"Paroxysmal tachycardia"	1	24	141	165
"H52"	"Q87"	"Disorders of refraction and accommodation"	"Oth congenital malform syndromes affecting multiple systems"	1	157	380	537
"M19"	"J36"	"Other and unspecified osteoarthritis"	"Peritonsillar abscess"	1	8	196	204
"G94"	"M23"	"Other disorders of brain in diseases classified elsewhere"	"Internal derangement of knee"	1	9	54	63
"I26"	"N87"	"Pulmonary embolism"	"Dysplasia of cervix uteri"	1	14	138	152
"N89"	"C50"	"Other noninflammatory disorders of vagina"	"Malignant neoplasm of breast"	1	77	170	247
"K59"	"D14"	"Other functional intestinal disorders"	"Benign neoplasm of middle ear and respiratory system"	1	203	603	806
"J69"	"G96"	"Pneumonitis due to solids and liquids"	"Other disorders of central nervous system"	1	137	553	690
"E87"	"K86"	"Other disorders of fluid, electrolyte and acid-base balance"	"Other diseases of pancreas"	1	415	840	1255
"E73"	"K26"	"Lactose intolerance"	"Duodenal ulcer"	1	34	93	127
"O72"	"O14"	"Postpartum hemorrhage"	"Pre-eclampsia"	1	7007	10777	17784
"C56"	"M65"	"Malignant neoplasm of ovary"	"Synovitis and tenosynovitis"	1	47	126	173
"C44"	"K25"	"Other and unspecified malignant neoplasm of skin"	"Gastric ulcer"	1	493	730	1223
"I33"	"C50"	"Acute and subacute endocarditis"	"Malignant neoplasm of breast"	1	15	77	92
"M81"	"H52"	"Osteoporosis without current pathological fracture"	"Disorders of refraction and accommodation"	1	194	704	898
"E11"	"O41"	"Type 2 diabetes mellitus"	"Other disorders of amniotic fluid and membranes"	1	0	68	68
"E78"	"J30"	"Disorders of lipoprotein metabolism and other lipidemias"	"Vasomotor and allergic rhinitis"	1	84	671	755
"D64"	"D06"	"Other anemias"	"Carcinoma in situ of cervix uteri"	1	0	94	94
"I50"	"H10"	"Heart failure"	"Conjunctivitis"	1	240	1403	1643
"K05"	"M24"	"Gingivitis and periodontal diseases"	"Other specific joint derangements"	1	37	103	140
"J96"	"F55"	"Respiratory failure, not elsewhere classified"	"Abuse of non-psychoactive substances"	1	26	76	102
"C79"	"C56"	"Secondary malignant neoplasm of other and unspecified sites"	"Malignant neoplasm of ovary"	1	410	1398	1808
"N46"	"H65"	"Male infertility"	"Nonsuppurative otitis media"	1	3	74	77
"M81"	"C53"	"Osteoporosis without current pathological fracture"	"Malignant neoplasm of cervix uteri"	1	28	196	224
"M79"	"H91"	"Oth and unsp soft tissue disorders, not elsewhere classified"	"Other and unspecified hearing loss"	1	4508	5852	10360
"G95"	"I97"	"Other and unspecified diseases of spinal cord"	"Intraop and postproc comp and disorders of circ sys, NEC"	1	34	92	126
"H54"	"M65"	"Blindness and low vision"	"Synovitis and tenosynovitis"	1	28	162	190
"I47"	"I20"	"Paroxysmal tachycardia"	"Angina pectoris"	1	5590	7464	13054
"M51"	"N83"	"Thoracic, thoracolum, and lumbosacral intvrt disc disorders"	"Noninflammatory disord of ovary, fallop and broad ligament"	1	872	1421	2293
"J15"	"O71"	"Bacterial pneumonia, not elsewhere classified"	"Other obstetric trauma"	1	0	178	178
"C78"	"M72"	"Secondary malignant neoplasm of resp and digestive organs"	"Fibroblastic disorders"	1	0	755	755
"M81"	"M50"	"Osteoporosis without current pathological fracture"	"Cervical disc disorders"	1	266	1220	1486
"I73"	"I10"	"Other peripheral vascular diseases"	"Essential (primary) hypertension"	1	8046	11955	20001
"K44"	"O42"	"Diaphragmatic hernia"	"Premature rupture of membranes"	1	23	215	238
"M81"	"E11"	"Osteoporosis without current pathological fracture"	"Type 2 diabetes mellitus"	1	2435	4728	7163
"J93"	"N40"	"Pneumothorax and air leak"	"Benign prostatic hyperplasia"	1	152	571	723
"I35"	"H40"	"Nonrheumatic aortic valve disorders"	"Glaucoma"	1	265	1067	1332
"C44"	"H25"	"Other and unspecified malignant neoplasm of skin"	"Age-related cataract"	1	3827	6106	9933
"J95"	"C10"	"Intraop and postproc comp and disorders of resp sys, NEC"	"Malignant neoplasm of oropharynx"	1	36	101	137
"K86"	"O42"	"Other diseases of pancreas"	"Premature rupture of membranes"	1	3	30	33
"K92"	"J33"	"Other diseases of digestive system"	"Nasal polyp"	1	34	95	129
"K22"	"K60"	"Other diseases of esophagus"	"Fissure and fistula of anal and rectal regions"	1	82	178	260
"K72"	"J34"	"Hepatic failure, not elsewhere classified"	"Other and unspecified disorders of nose and nasal sinuses"	1	0	34	34
"K63"	"M54"	"Other diseases of intestine"	"Dorsalgia"	1	253	1056	1309
"J43"	"N92"	"Emphysema"	"Excessive, frequent and irregular menstruation"	1	0	158	158
"K62"	"L03"	"Other diseases of anus and rectum"	"Cellulitis and acute lymphangitis"	1	147	686	833
"J14"	"O80"	"Pneumonia due to Hemophilus influenzae"	"Encounter for full-term uncomplicated delivery"	1	11	87	98
"M81"	"J34"	"Osteoporosis without current pathological fracture"	"Other and unspecified disorders of nose and nasal sinuses"	1	23	407	430
"E23"	"E04"	"Hypofunction and other disorders of the pituitary gland"	"Other nontoxic goiter"	1	39	103	142
"M81"	"J82"	"Osteoporosis without current pathological fracture"	"Pulmonary eosinophilia, not elsewhere classified"	1	14	57	71
"H01"	"M23"	"Other inflammation of eyelid"	"Internal derangement of knee"	1	115	326	441
"C90"	"J45"	"Multiple myeloma and malignant plasma cell neoplasms"	"Asthma"	1	31	94	125
"J43"	"N63"	"Emphysema"	"Unspecified lump in breast"	1	10	78	88
"Q61"	"O04"	"Cystic kidney disease"	"Complications following (induced) termination of pregnancy"	1	0	93	93
"I24"	"N92"	"Other acute ischemic heart diseases"	"Excessive, frequent and irregular menstruation"	1	0	89	89
"Q50"	"O04"	"Congen malform of ovaries, fallopian tubes & broad ligaments"	"Complications following (induced) termination of pregnancy"	1	10	88	98
"C71"	"M51"	"Malignant neoplasm of brain"	"Thoracic, thoracolum, and lumbosacral intvrt disc disorders"	1	7	273	280
"F06"	"G56"	"Other mental disorders due to known physiological condition"	"Mononeuropathies of upper limb"	1	15	228	243
"O70"	"F98"	"Perineal laceration during delivery"	"Oth behav/emotn disord w onset usly occur in chldhd and adol"	1	0	39	39
"F32"	"J36"	"Depressive episode"	"Peritonsillar abscess"	1	17	114	131
"H35"	"M77"	"Other retinal disorders"	"Other enthesopathies"	1	191	549	740
"F01"	"C44"	"Vascular dementia"	"Other and unspecified malignant neoplasm of skin"	1	104	306	410
"E03"	"E04"	"Other hypothyroidism"	"Other nontoxic goiter"	1	0	5476	5476
"M47"	"O68"	"Spondylosis"	"Labor and delivery comp by abnlt of fetal acid-base balance"	1	0	265	265
"I73"	"O64"	"Other peripheral vascular diseases"	"Obstructed labor due to malposition and malpresent of fetus"	1	0	30	30
"J06"	"D12"	"Acute upper resp infections of multiple and unsp sites"	"Benign neoplasm of colon, rectum, anus and anal canal"	1	108	208	316
"M80"	"K51"	"Osteoporosis with current pathological fracture"	"Ulcerative colitis"	1	77	453	530
"I20"	"O68"	"Angina pectoris"	"Labor and delivery comp by abnlt of fetal acid-base balance"	1	0	212	212
"I11"	"I65"	"Hypertensive heart disease"	"Occls and stenosis of precerb art, not rslt in cereb infrc"	1	92	195	287
"M20"	"N92"	"Acquired deformities of fingers and toes"	"Excessive, frequent and irregular menstruation"	1	515	2423	2938
"D24"	"O20"	"Benign neoplasm of breast"	"Hemorrhage in early pregnancy"	1	160	752	912
"G47"	"K50"	"Sleep disorders"	"Crohn's disease [regional enteritis]"	1	55	210	265
"J84"	"O03"	"Other interstitial pulmonary diseases"	"Spontaneous abortion"	1	0	30	30
"G47"	"M94"	"Sleep disorders"	"Other disorders of cartilage"	1	12	81	93
"M72"	"N83"	"Fibroblastic disorders"	"Noninflammatory disord of ovary, fallop and broad ligament"	1	104	248	352
"E86"	"K22"	"Volume depletion"	"Other diseases of esophagus"	1	1165	2250	3415
"K57"	"M31"	"Diverticular disease of intestine"	"Other necrotizing vasculopathies"	1	380	554	934
"I48"	"K11"	"Atrial fibrillation and flutter"	"Diseases of salivary glands"	1	319	463	782
"I48"	"M67"	"Atrial fibrillation and flutter"	"Other disorders of synovium and tendon"	1	252	1459	1711
"K91"	"M22"	"Intraop and postproc comp and disorders of dgstv sys, NEC"	"Disorder of patella"	1	0	60	60
"J84"	"M43"	"Other interstitial pulmonary diseases"	"Other deforming dorsopathies"	1	14	112	126
"J69"	"N20"	"Pneumonitis due to solids and liquids"	"Calculus of kidney and ureter"	1	14	209	223
"I71"	"H25"	"Aortic aneurysm and dissection"	"Age-related cataract"	1	1759	3649	5408
"L29"	"K70"	"Pruritus"	"Alcoholic liver disease"	1	33	87	120
"L30"	"N92"	"Other and unspecified dermatitis"	"Excessive, frequent and irregular menstruation"	1	171	750	921
"I87"	"O36"	"Other disorders of veins"	"Maternal care for other fetal problems"	1	3	39	42
"H02"	"G56"	"Other disorders of eyelid"	"Mononeuropathies of upper limb"	1	520	1058	1578
"E41"	"M75"	"Nutritional marasmus"	"Shoulder lesions"	1	0	102	102
"K11"	"O62"	"Diseases of salivary glands"	"Abnormalities of forces of labor"	1	54	237	291
"K21"	"O03"	"Gastro-esophageal reflux disease"	"Spontaneous abortion"	1	0	636	636
"D64"	"H40"	"Other anemias"	"Glaucoma"	1	435	2219	2654
"O99"	"M22"	"Oth maternal diseases classd elsw but compl preg/chldbrth"	"Disorder of patella"	1	0	2715	2715
"M86"	"H83"	"Osteomyelitis"	"Other diseases of inner ear"	1	17	80	97
"E66"	"L04"	"Overweight and obesity"	"Acute lymphadenitis"	1	44	242	286
"E41"	"J44"	"Nutritional marasmus"	"Other chronic obstructive pulmonary disease"	1	159	690	849
"F05"	"N20"	"Delirium due to known physiological condition"	"Calculus of kidney and ureter"	1	11	351	362
"N18"	"G62"	"Chronic kidney disease (CKD)"	"Other and unspecified polyneuropathies"	1	513	893	1406
"B02"	"N95"	"Zoster [herpes zoster]"	"Menopausal and other perimenopausal disorders"	1	45	110	155
"I25"	"N81"	"Chronic ischemic heart disease"	"Female genital prolapse"	1	1446	3041	4487
"K02"	"C85"	"Dental caries"	"Oth and unspecified types of non-Hodgkin lymphoma"	1	96	239	335
"C44"	"O20"	"Other and unspecified malignant neoplasm of skin"	"Hemorrhage in early pregnancy"	1	0	69	69
"K62"	"I25"	"Other diseases of anus and rectum"	"Chronic ischemic heart disease"	1	4036	5768	9804
"E83"	"O32"	"Disorders of mineral metabolism"	"Maternal care for malpresentation of fetus"	1	0	25	25
"N18"	"O36"	"Chronic kidney disease (CKD)"	"Maternal care for other fetal problems"	1	10	106	116
"O75"	"O24"	"Oth complications of labor and delivery, NEC"	"Diabetes in pregnancy, childbirth, and the puerperium"	1	877	1357	2234
"G40"	"Q53"	"Epilepsy and recurrent seizures"	"Undescended and ectopic testicle"	1	121	224	345
"I48"	"J33"	"Atrial fibrillation and flutter"	"Nasal polyp"	1	97	431	528
"D09"	"K29"	"Carcinoma in situ of other and unspecified sites"	"Gastritis and duodenitis"	1	6	125	131
"E88"	"J45"	"Other and unspecified metabolic disorders"	"Asthma"	1	191	317	508
"J34"	"N70"	"Other and unspecified disorders of nose and nasal sinuses"	"Salpingitis and oophoritis"	1	26	95	121
"G30"	"I27"	"Alzheimer's disease"	"Other pulmonary heart diseases"	1	15	58	73
"I50"	"I80"	"Heart failure"	"Phlebitis and thrombophlebitis"	1	2656	4488	7144
"H57"	"I63"	"Other disorders of eye and adnexa"	"Cerebral infarction"	1	417	595	1012
"N64"	"O82"	"Other disorders of breast"	"Encounter for cesarean delivery without indication"	1	621	1725	2346
"L30"	"H60"	"Other and unspecified dermatitis"	"Otitis externa"	1	114	209	323
"C44"	"H93"	"Other and unspecified malignant neoplasm of skin"	"Other disorders of ear, not elsewhere classified"	1	132	1093	1225
"J69"	"J18"	"Pneumonitis due to solids and liquids"	"Pneumonia, unspecified organism"	1	2597	4724	7321
"K91"	"O99"	"Intraop and postproc comp and disorders of dgstv sys, NEC"	"Oth maternal diseases classd elsw but compl preg/chldbrth"	1	87	204	291
"A46"	"M65"	"Erysipelas"	"Synovitis and tenosynovitis"	1	327	866	1193
"I72"	"O80"	"Other aneurysm"	"Encounter for full-term uncomplicated delivery"	1	0	63	63
"G95"	"M23"	"Other and unspecified diseases of spinal cord"	"Internal derangement of knee"	1	24	397	421
"I48"	"E04"	"Atrial fibrillation and flutter"	"Other nontoxic goiter"	1	1083	2042	3125
"H43"	"G56"	"Disorders of vitreous body"	"Mononeuropathies of upper limb"	1	275	540	815
"F41"	"C02"	"Other anxiety disorders"	"Malignant neoplasm of other and unspecified parts of tongue"	1	24	113	137
"M62"	"O80"	"Other disorders of muscle"	"Encounter for full-term uncomplicated delivery"	1	0	9997	9997
"F41"	"C22"	"Other anxiety disorders"	"Malignant neoplasm of liver and intrahepatic bile ducts"	1	128	348	476
"H02"	"O03"	"Other disorders of eyelid"	"Spontaneous abortion"	1	0	214	214
"E13"	"M72"	"Other specified diabetes mellitus"	"Fibroblastic disorders"	1	29	97	126
"J06"	"D16"	"Acute upper resp infections of multiple and unsp sites"	"Benign neoplasm of bone and articular cartilage"	1	13	59	72
"E86"	"N50"	"Volume depletion"	"Other and unspecified disorders of male genital organs"	1	93	301	394
"K62"	"N80"	"Other diseases of anus and rectum"	"Endometriosis"	1	105	483	588
"I11"	"I10"	"Hypertensive heart disease"	"Essential (primary) hypertension"	1	4791	8969	13760
"O21"	"J35"	"Excessive vomiting in pregnancy"	"Chronic diseases of tonsils and adenoids"	1	11	472	483
"F41"	"H50"	"Other anxiety disorders"	"Other strabismus"	1	10	132	142
"L98"	"I10"	"Oth disorders of skin, subcu, not elsewhere classified"	"Essential (primary) hypertension"	1	2046	4338	6384
"I10"	"D36"	"Essential (primary) hypertension"	"Benign neoplasm of other and unspecified sites"	1	183	295	478
"O04"	"M41"	"Complications following (induced) termination of pregnancy"	"Scoliosis"	1	128	405	533
"N81"	"M22"	"Female genital prolapse"	"Disorder of patella"	1	5	376	381
"F31"	"D25"	"Bipolar disorder"	"Leiomyoma of uterus"	1	15	74	89
"E05"	"J36"	"Thyrotoxicosis [hyperthyroidism]"	"Peritonsillar abscess"	1	23	148	171
"I50"	"H80"	"Heart failure"	"Otosclerosis"	1	7	692	699
"N40"	"K40"	"Benign prostatic hyperplasia"	"Inguinal hernia"	1	4942	5787	10729
"K64"	"O26"	"Hemorrhoids and perianal venous thrombosis"	"Maternal care for oth conditions predom related to pregnancy"	1	0	756	756
"G47"	"I25"	"Sleep disorders"	"Chronic ischemic heart disease"	1	1419	3653	5072
"A46"	"C50"	"Erysipelas"	"Malignant neoplasm of breast"	1	331	1914	2245
"M85"	"B18"	"Other disorders of bone density and structure"	"Chronic viral hepatitis"	1	6	77	83
"M81"	"K20"	"Osteoporosis without current pathological fracture"	"Esophagitis"	1	575	1134	1709
"L30"	"D24"	"Other and unspecified dermatitis"	"Benign neoplasm of breast"	1	48	219	267
"G96"	"N95"	"Other disorders of central nervous system"	"Menopausal and other perimenopausal disorders"	1	72	309	381
"J69"	"I95"	"Pneumonitis due to solids and liquids"	"Hypotension"	1	260	419	679
"D09"	"F10"	"Carcinoma in situ of other and unspecified sites"	"Alcohol related disorders"	1	4	107	111
"E83"	"M72"	"Disorders of mineral metabolism"	"Fibroblastic disorders"	1	16	172	188
"M10"	"J45"	"Gout"	"Asthma"	1	446	939	1385
"K72"	"J44"	"Hepatic failure, not elsewhere classified"	"Other chronic obstructive pulmonary disease"	1	427	810	1237
"F41"	"K05"	"Other anxiety disorders"	"Gingivitis and periodontal diseases"	1	138	598	736
"J03"	"O62"	"Acute tonsillitis"	"Abnormalities of forces of labor"	1	1263	2502	3765
"K04"	"O82"	"Diseases of pulp and periapical tissues"	"Encounter for cesarean delivery without indication"	1	37	229	266
"A04"	"M31"	"Other bacterial intestinal infections"	"Other necrotizing vasculopathies"	1	42	219	261
"K62"	"D30"	"Other diseases of anus and rectum"	"Benign neoplasm of urinary organs"	1	256	539	795
"K02"	"J20"	"Dental caries"	"Acute bronchitis"	1	89	464	553
"C15"	"K21"	"Malignant neoplasm of esophagus"	"Gastro-esophageal reflux disease"	1	156	585	741
"G60"	"O62"	"Hereditary and idiopathic neuropathy"	"Abnormalities of forces of labor"	1	2	35	37
"J15"	"K04"	"Bacterial pneumonia, not elsewhere classified"	"Diseases of pulp and periapical tissues"	1	290	1068	1358
"D70"	"O82"	"Neutropenia"	"Encounter for cesarean delivery without indication"	1	2	27	29
"C67"	"D24"	"Malignant neoplasm of bladder"	"Benign neoplasm of breast"	1	2	32	34
"J18"	"M02"	"Pneumonia, unspecified organism"	"Postinfective and reactive arthropathies"	1	674	999	1673
"I48"	"N90"	"Atrial fibrillation and flutter"	"Other noninflammatory disorders of vulva and perineum"	1	64	163	227
"M19"	"M47"	"Other and unspecified osteoarthritis"	"Spondylosis"	1	2184	2567	4751
"H26"	"H43"	"Other cataract"	"Disorders of vitreous body"	1	2259	2901	5160
"H90"	"O20"	"Conductive and sensorineural hearing loss"	"Hemorrhage in early pregnancy"	1	38	223	261
"K05"	"Q18"	"Gingivitis and periodontal diseases"	"Other congenital malformations of face and neck"	1	37	104	141
"C80"	"M48"	"Malignant neoplasm without specification of site"	"Other spondylopathies"	1	47	225	272
"H90"	"O02"	"Conductive and sensorineural hearing loss"	"Other abnormal products of conception"	1	49	229	278
"J18"	"Q28"	"Pneumonia, unspecified organism"	"Other congenital malformations of circulatory system"	1	67	177	244
"H25"	"N43"	"Age-related cataract"	"Hydrocele and spermatocele"	1	305	1341	1646
"G95"	"N84"	"Other and unspecified diseases of spinal cord"	"Polyp of female genital tract"	1	11	110	121
"C56"	"M77"	"Malignant neoplasm of ovary"	"Other enthesopathies"	1	7	82	89
"J18"	"L60"	"Pneumonia, unspecified organism"	"Nail disorders"	1	443	688	1131
"I50"	"H71"	"Heart failure"	"Cholesteatoma of middle ear"	1	21	192	213
"C24"	"M62"	"Malignant neoplasm of other and unsp parts of biliary tract"	"Other disorders of muscle"	1	0	74	74
"J15"	"L05"	"Bacterial pneumonia, not elsewhere classified"	"Pilonidal cyst and sinus"	1	9	203	212
"I35"	"D17"	"Nonrheumatic aortic valve disorders"	"Benign lipomatous neoplasm"	1	52	617	669
"D64"	"C85"	"Other anemias"	"Oth and unspecified types of non-Hodgkin lymphoma"	1	505	696	1201
"D17"	"N83"	"Benign lipomatous neoplasm"	"Noninflammatory disord of ovary, fallop and broad ligament"	1	243	407	650
"J90"	"N35"	"Pleural effusion, not elsewhere classified"	"Urethral stricture"	1	13	116	129
"C18"	"M25"	"Malignant neoplasm of colon"	"Other joint disorder, not elsewhere classified"	1	130	295	425
"C22"	"M65"	"Malignant neoplasm of liver and intrahepatic bile ducts"	"Synovitis and tenosynovitis"	1	0	76	76
"O14"	"F10"	"Pre-eclampsia"	"Alcohol related disorders"	1	32	273	305
"F01"	"I20"	"Vascular dementia"	"Angina pectoris"	1	0	976	976
"F03"	"N43"	"Unspecified dementia"	"Hydrocele and spermatocele"	1	5	294	299
"I26"	"M31"	"Pulmonary embolism"	"Other necrotizing vasculopathies"	1	172	394	566
"I72"	"C50"	"Other aneurysm"	"Malignant neoplasm of breast"	1	28	83	111
"B18"	"F10"	"Chronic viral hepatitis"	"Alcohol related disorders"	1	493	1379	1872
"C71"	"O04"	"Malignant neoplasm of brain"	"Complications following (induced) termination of pregnancy"	1	0	58	58
"E83"	"L50"	"Disorders of mineral metabolism"	"Urticaria"	1	23	82	105
"J18"	"K80"	"Pneumonia, unspecified organism"	"Cholelithiasis"	1	0	14508	14508
"L97"	"M34"	"Non-pressure chronic ulcer of lower limb, NEC"	"Systemic sclerosis [scleroderma]"	1	5	63	68
"L90"	"G40"	"Atrophic disorders of skin"	"Epilepsy and recurrent seizures"	1	103	269	372
"J69"	"M80"	"Pneumonitis due to solids and liquids"	"Osteoporosis with current pathological fracture"	1	170	492	662
"I82"	"D25"	"Other venous embolism and thrombosis"	"Leiomyoma of uterus"	1	30	154	184
"C79"	"K90"	"Secondary malignant neoplasm of other and unspecified sites"	"Intestinal malabsorption"	1	6	49	55
"I85"	"M77"	"Esophageal varices"	"Other enthesopathies"	1	4	50	54
"J15"	"M72"	"Bacterial pneumonia, not elsewhere classified"	"Fibroblastic disorders"	1	13	1068	1081
"J15"	"L43"	"Bacterial pneumonia, not elsewhere classified"	"Lichen planus"	1	13	104	117
"C18"	"M05"	"Malignant neoplasm of colon"	"Rheumatoid arthritis with rheumatoid factor"	1	99	255	354
"A49"	"O80"	"Bacterial infection of unspecified site"	"Encounter for full-term uncomplicated delivery"	1	18	853	871
"M81"	"O70"	"Osteoporosis without current pathological fracture"	"Perineal laceration during delivery"	1	0	224	224
"N19"	"H81"	"Unspecified kidney failure"	"Disorders of vestibular function"	1	104	488	592
"I82"	"N81"	"Other venous embolism and thrombosis"	"Female genital prolapse"	1	25	227	252
"K81"	"N97"	"Cholecystitis"	"Female infertility"	1	21	168	189
"G63"	"M23"	"Polyneuropathy in diseases classified elsewhere"	"Internal derangement of knee"	1	29	157	186
"J18"	"K22"	"Pneumonia, unspecified organism"	"Other diseases of esophagus"	1	2364	3274	5638
"K59"	"J12"	"Other functional intestinal disorders"	"Viral pneumonia, not elsewhere classified"	1	291	762	1053
"D19"	"J90"	"Benign neoplasm of mesothelial tissue"	"Pleural effusion, not elsewhere classified"	1	9	62	71
"M76"	"E30"	"Enthesopathies, lower limb, excluding foot"	"Disorders of puberty, not elsewhere classified"	1	1	39	40
"C44"	"H52"	"Other and unspecified malignant neoplasm of skin"	"Disorders of refraction and accommodation"	1	81	329	410
"M25"	"H80"	"Other joint disorder, not elsewhere classified"	"Otosclerosis"	1	19	126	145
"C67"	"M23"	"Malignant neoplasm of bladder"	"Internal derangement of knee"	1	18	249	267
"C49"	"C54"	"Malignant neoplasm of other connective and soft tissue"	"Malignant neoplasm of corpus uteri"	1	54	255	309
"M07"	"M13"	"Enteropathic arthropathies"	"Other arthritis"	1	565	1068	1633
"F10"	"M92"	"Alcohol related disorders"	"Other juvenile osteochondrosis"	1	31	128	159
"E22"	"J35"	"Hyperfunction of pituitary gland"	"Chronic diseases of tonsils and adenoids"	1	9	249	258
"C90"	"K80"	"Multiple myeloma and malignant plasma cell neoplasms"	"Cholelithiasis"	1	44	170	214
"K63"	"M76"	"Other diseases of intestine"	"Enthesopathies, lower limb, excluding foot"	1	29	116	145
"G44"	"O08"	"Other headache syndromes"	"Complications following ectopic and molar pregnancy"	1	95	204	299
"M85"	"K73"	"Other disorders of bone density and structure"	"Chronic hepatitis, not elsewhere classified"	1	29	186	215
"H05"	"D25"	"Disorders of orbit"	"Leiomyoma of uterus"	1	17	61	78
"I99"	"M51"	"Other and unspecified disorders of circulatory system"	"Thoracic, thoracolum, and lumbosacral intvrt disc disorders"	1	80	164	244
"H26"	"K61"	"Other cataract"	"Abscess of anal and rectal regions"	1	85	233	318
"J86"	"K30"	"Pyothorax"	"Functional dyspepsia"	1	48	128	176
"G62"	"H93"	"Other and unspecified polyneuropathies"	"Other disorders of ear, not elsewhere classified"	1	147	541	688
"M48"	"N75"	"Other spondylopathies"	"Diseases of Bartholin's gland"	1	5	73	78
"M85"	"B07"	"Other disorders of bone density and structure"	"Viral warts"	1	37	100	137
"J18"	"Q03"	"Pneumonia, unspecified organism"	"Congenital hydrocephalus"	1	42	150	192
"G55"	"N40"	"Nerve root and plexus compressions in diseases classd elswhr"	"Benign prostatic hyperplasia"	1	45	134	179
"F32"	"M76"	"Depressive episode"	"Enthesopathies, lower limb, excluding foot"	1	139	243	382
"I35"	"D30"	"Nonrheumatic aortic valve disorders"	"Benign neoplasm of urinary organs"	1	165	620	785
"C85"	"F10"	"Oth and unspecified types of non-Hodgkin lymphoma"	"Alcohol related disorders"	1	44	141	185
"O62"	"B27"	"Abnormalities of forces of labor"	"Infectious mononucleosis"	1	0	333	333
"M81"	"K29"	"Osteoporosis without current pathological fracture"	"Gastritis and duodenitis"	1	1593	3719	5312
"M20"	"O48"	"Acquired deformities of fingers and toes"	"Late pregnancy"	1	18	267	285
"C78"	"K22"	"Secondary malignant neoplasm of resp and digestive organs"	"Other diseases of esophagus"	1	269	730	999
"I49"	"G45"	"Other cardiac arrhythmias"	"Transient cerebral ischemic attacks and related syndromes"	1	1467	2006	3473
"L57"	"K05"	"Skin changes due to chronic expsr to nonionizing radiation"	"Gingivitis and periodontal diseases"	1	25	177	202
"I49"	"N95"	"Other cardiac arrhythmias"	"Menopausal and other perimenopausal disorders"	1	324	510	834
"G98"	"I99"	"Other disorders of nervous system not elsewhere classified"	"Other and unspecified disorders of circulatory system"	1	1	140	141
"F43"	"O70"	"Reaction to severe stress, and adjustment disorders"	"Perineal laceration during delivery"	1	94	1302	1396
"I48"	"H00"	"Atrial fibrillation and flutter"	"Hordeolum and chalazion"	1	59	231	290
"K56"	"I80"	"Paralytic ileus and intestinal obstruction without hernia"	"Phlebitis and thrombophlebitis"	1	723	1139	1862
"O92"	"H10"	"Oth disord of brst/lactatn assoc w pregnancy and the puerp"	"Conjunctivitis"	1	33	150	183
"I20"	"H10"	"Angina pectoris"	"Conjunctivitis"	1	572	1450	2022
"J18"	"M75"	"Pneumonia, unspecified organism"	"Shoulder lesions"	1	0	9710	9710
"J44"	"O68"	"Other chronic obstructive pulmonary disease"	"Labor and delivery comp by abnlt of fetal acid-base balance"	1	0	146	146
"L57"	"B25"	"Skin changes due to chronic expsr to nonionizing radiation"	"Cytomegaloviral disease"	1	2	41	43
"L29"	"K29"	"Pruritus"	"Gastritis and duodenitis"	1	96	300	396
"I50"	"K13"	"Heart failure"	"Other diseases of lip and oral mucosa"	1	116	391	507
"M07"	"K35"	"Enteropathic arthropathies"	"Acute appendicitis"	1	13	162	175
"C50"	"O42"	"Malignant neoplasm of breast"	"Premature rupture of membranes"	1	0	195	195
"G47"	"E05"	"Sleep disorders"	"Thyrotoxicosis [hyperthyroidism]"	1	205	785	990
"I46"	"E03"	"Cardiac arrest"	"Other hypothyroidism"	1	129	652	781
"I46"	"M02"	"Cardiac arrest"	"Postinfective and reactive arthropathies"	1	0	113	113
"I30"	"O20"	"Acute pericarditis"	"Hemorrhage in early pregnancy"	1	1	27	28
"K83"	"K29"	"Other diseases of biliary tract"	"Gastritis and duodenitis"	1	349	1082	1431
"C78"	"C67"	"Secondary malignant neoplasm of resp and digestive organs"	"Malignant neoplasm of bladder"	1	467	1959	2426
"O72"	"M43"	"Postpartum hemorrhage"	"Other deforming dorsopathies"	1	73	198	271
"E87"	"G50"	"Other disorders of fluid, electrolyte and acid-base balance"	"Disorders of trigeminal nerve"	1	81	302	383
"D33"	"O20"	"Benign neoplasm of brain and oth prt central nervous system"	"Hemorrhage in early pregnancy"	1	0	37	37
"J22"	"N92"	"Unspecified acute lower respiratory infection"	"Excessive, frequent and irregular menstruation"	1	0	118	118
"K51"	"H65"	"Ulcerative colitis"	"Nonsuppurative otitis media"	1	12	100	112
"M77"	"N47"	"Other enthesopathies"	"Disorders of prepuce"	1	100	223	323
"G30"	"E66"	"Alzheimer's disease"	"Overweight and obesity"	1	0	263	263
"K50"	"Q53"	"Crohn's disease [regional enteritis]"	"Undescended and ectopic testicle"	1	0	31	31
"I63"	"M67"	"Cerebral infarction"	"Other disorders of synovium and tendon"	1	120	771	891
"L97"	"M10"	"Non-pressure chronic ulcer of lower limb, NEC"	"Gout"	1	458	873	1331
"N99"	"C54"	"Intraop and postproc comp and disorders of GU sys, NEC"	"Malignant neoplasm of corpus uteri"	1	17	187	204
"K83"	"N62"	"Other diseases of biliary tract"	"Hypertrophy of breast"	1	13	81	94
"H68"	"H66"	"Eustachian salpingitis and obstruction"	"Suppurative and unspecified otitis media"	1	195	335	530
"O72"	"M20"	"Postpartum hemorrhage"	"Acquired deformities of fingers and toes"	1	269	1246	1515
"H57"	"K40"	"Other disorders of eye and adnexa"	"Inguinal hernia"	1	85	542	627
"M06"	"O65"	"Other rheumatoid arthritis"	"Obstructed labor due to maternal pelvic abnormality"	1	0	77	77
"C80"	"M05"	"Malignant neoplasm without specification of site"	"Rheumatoid arthritis with rheumatoid factor"	1	3	55	58
"O73"	"G40"	"Retained placenta and membranes, without hemorrhage"	"Epilepsy and recurrent seizures"	1	3	34	37
"H25"	"I47"	"Age-related cataract"	"Paroxysmal tachycardia"	1	2374	4366	6740
"D63"	"M18"	"Anemia in chronic diseases classified elsewhere"	"Osteoarthritis of first carpometacarpal joint"	1	28	95	123
"L97"	"O82"	"Non-pressure chronic ulcer of lower limb, NEC"	"Encounter for cesarean delivery without indication"	1	0	57	57
"I51"	"K40"	"Complications and ill-defined descriptions of heart disease"	"Inguinal hernia"	1	138	753	891
"O34"	"H65"	"Maternal care for abnormality of pelvic organs"	"Nonsuppurative otitis media"	1	8	89	97
"H53"	"N40"	"Visual disturbances"	"Benign prostatic hyperplasia"	1	279	638	917
"H02"	"O80"	"Other disorders of eyelid"	"Encounter for full-term uncomplicated delivery"	1	0	755	755
"O63"	"K35"	"Long labor"	"Acute appendicitis"	1	131	376	507
"B25"	"N18"	"Cytomegaloviral disease"	"Chronic kidney disease (CKD)"	1	80	236	316
"O35"	"O03"	"Maternal care for known or suspected fetal abnlt and damage"	"Spontaneous abortion"	1	375	1147	1522
"I11"	"H40"	"Hypertensive heart disease"	"Glaucoma"	1	103	327	430
"G51"	"F10"	"Facial nerve disorders"	"Alcohol related disorders"	1	126	261	387
"O42"	"J45"	"Premature rupture of membranes"	"Asthma"	1	567	907	1474
"N71"	"O64"	"Inflammatory disease of uterus, except cervix"	"Obstructed labor due to malposition and malpresent of fetus"	1	151	372	523
"C34"	"B34"	"Malignant neoplasm of bronchus and lung"	"Viral infection of unspecified site"	1	51	135	186
"A49"	"M65"	"Bacterial infection of unspecified site"	"Synovitis and tenosynovitis"	1	139	837	976
"M96"	"M48"	"Intraop and postproc comp and disorders of ms sys, NEC"	"Other spondylopathies"	1	498	916	1414
"F33"	"E66"	"Major depressive disorder, recurrent"	"Overweight and obesity"	1	1852	2261	4113
"C73"	"O26"	"Malignant neoplasm of thyroid gland"	"Maternal care for oth conditions predom related to pregnancy"	1	0	53	53
"D68"	"M54"	"Other coagulation defects"	"Dorsalgia"	1	372	828	1200
"K61"	"J35"	"Abscess of anal and rectal regions"	"Chronic diseases of tonsils and adenoids"	1	33	266	299
"I10"	"J35"	"Essential (primary) hypertension"	"Chronic diseases of tonsils and adenoids"	1	82	1251	1333
"F17"	"N97"	"Nicotine dependence"	"Female infertility"	1	67	583	650
"I33"	"L03"	"Acute and subacute endocarditis"	"Cellulitis and acute lymphangitis"	1	35	129	164
"J06"	"O04"	"Acute upper resp infections of multiple and unsp sites"	"Complications following (induced) termination of pregnancy"	1	0	449	449
"G47"	"K29"	"Sleep disorders"	"Gastritis and duodenitis"	1	330	1901	2231
"D63"	"M21"	"Anemia in chronic diseases classified elsewhere"	"Other acquired deformities of limbs"	1	8	118	126
"C61"	"J03"	"Malignant neoplasm of prostate"	"Acute tonsillitis"	1	3	54	57
"M85"	"J44"	"Other disorders of bone density and structure"	"Other chronic obstructive pulmonary disease"	1	1347	3106	4453
"O91"	"O21"	"Infect of breast assoc w pregnancy, the puerp and lactation"	"Excessive vomiting in pregnancy"	1	164	484	648
"J90"	"C16"	"Pleural effusion, not elsewhere classified"	"Malignant neoplasm of stomach"	1	99	260	359
"H36"	"N20"	"Retinal disorders in diseases classified elsewhere"	"Calculus of kidney and ureter"	1	153	357	510
"F41"	"M23"	"Other anxiety disorders"	"Internal derangement of knee"	1	225	1129	1354
"I89"	"N92"	"Oth noninfective disorders of lymphatic vessels and nodes"	"Excessive, frequent and irregular menstruation"	1	10	359	369
"N82"	"C56"	"Fistulae involving female genital tract"	"Malignant neoplasm of ovary"	1	31	157	188
"I69"	"N83"	"Sequelae of cerebrovascular disease"	"Noninflammatory disord of ovary, fallop and broad ligament"	1	152	511	663
"J03"	"Q24"	"Acute tonsillitis"	"Other congenital malformations of heart"	1	71	184	255
"M23"	"Q21"	"Internal derangement of knee"	"Congenital malformations of cardiac septa"	1	24	108	132
"G95"	"I73"	"Other and unspecified diseases of spinal cord"	"Other peripheral vascular diseases"	1	64	182	246
"J38"	"N60"	"Diseases of vocal cords and larynx, not elsewhere classified"	"Benign mammary dysplasia"	1	62	146	208
"O70"	"N96"	"Perineal laceration during delivery"	"Recurrent pregnancy loss"	1	655	1132	1787
"J22"	"D24"	"Unspecified acute lower respiratory infection"	"Benign neoplasm of breast"	1	2	56	58
"I82"	"C20"	"Other venous embolism and thrombosis"	"Malignant neoplasm of rectum"	1	70	246	316
"K59"	"D27"	"Other functional intestinal disorders"	"Benign neoplasm of ovary"	1	320	1381	1701
"O64"	"O04"	"Obstructed labor due to malposition and malpresent of fetus"	"Complications following (induced) termination of pregnancy"	1	1231	1595	2826
"L08"	"N47"	"Other local infections of skin and subcutaneous tissue"	"Disorders of prepuce"	1	176	368	544
"O85"	"M22"	"Puerperal sepsis"	"Disorder of patella"	1	14	107	121
"J69"	"H33"	"Pneumonitis due to solids and liquids"	"Retinal detachments and breaks"	1	0	74	74
"L30"	"K40"	"Other and unspecified dermatitis"	"Inguinal hernia"	1	264	724	988
"D69"	"O20"	"Purpura and other hemorrhagic conditions"	"Hemorrhage in early pregnancy"	1	182	342	524
"K62"	"H10"	"Other diseases of anus and rectum"	"Conjunctivitis"	1	176	945	1121
"I62"	"M75"	"Other and unspecified nontraumatic intracranial hemorrhage"	"Shoulder lesions"	1	21	80	101
"F41"	"J34"	"Other anxiety disorders"	"Other and unspecified disorders of nose and nasal sinuses"	1	70	263	333
"G30"	"G91"	"Alzheimer's disease"	"Hydrocephalus"	1	66	218	284
"L97"	"A46"	"Non-pressure chronic ulcer of lower limb, NEC"	"Erysipelas"	1	2144	3365	5509
"O24"	"O02"	"Diabetes in pregnancy, childbirth, and the puerperium"	"Other abnormal products of conception"	1	857	2414	3271
"D22"	"M17"	"Melanocytic nevi"	"Osteoarthritis of knee"	1	293	467	760
"O62"	"B07"	"Abnormalities of forces of labor"	"Viral warts"	1	65	207	272
"M10"	"K43"	"Gout"	"Ventral hernia"	1	237	382	619
"L50"	"B34"	"Urticaria"	"Viral infection of unspecified site"	1	1015	1363	2378
"I49"	"E11"	"Other cardiac arrhythmias"	"Type 2 diabetes mellitus"	1	2797	3582	6379
"I20"	"J32"	"Angina pectoris"	"Chronic sinusitis"	1	375	545	920
"N64"	"N87"	"Other disorders of breast"	"Dysplasia of cervix uteri"	1	250	536	786
"M19"	"I83"	"Other and unspecified osteoarthritis"	"Varicose veins of lower extremities"	1	658	2530	3188
"C77"	"N95"	"Secondary and unspecified malignant neoplasm of lymph nodes"	"Menopausal and other perimenopausal disorders"	1	95	412	507
"I73"	"I22"	"Other peripheral vascular diseases"	"Subsequent STEMI & NSTEMI mocard infrc"	1	28	87	115
"K22"	"Q25"	"Other diseases of esophagus"	"Congenital malformations of great arteries"	1	17	62	79
"E66"	"O80"	"Overweight and obesity"	"Encounter for full-term uncomplicated delivery"	1	0	36600	36600
"G82"	"H91"	"Paraplegia (paraparesis) and quadriplegia (quadriparesis)"	"Other and unspecified hearing loss"	1	173	346	519
"I20"	"O03"	"Angina pectoris"	"Spontaneous abortion"	1	0	239	239
"K59"	"C06"	"Other functional intestinal disorders"	"Malignant neoplasm of other and unspecified parts of mouth"	1	152	406	558
"K30"	"O60"	"Functional dyspepsia"	"Preterm labor"	1	25	101	126
"J15"	"N63"	"Bacterial pneumonia, not elsewhere classified"	"Unspecified lump in breast"	1	26	593	619
"D64"	"D07"	"Other anemias"	"Carcinoma in situ of other and unspecified genital organs"	1	48	135	183
"I35"	"L02"	"Nonrheumatic aortic valve disorders"	"Cutaneous abscess, furuncle and carbuncle"	1	292	905	1197
"N12"	"N40"	"Tubulo-interstitial nephritis, not spcf as acute or chronic"	"Benign prostatic hyperplasia"	1	106	263	369
"M25"	"N40"	"Other joint disorder, not elsewhere classified"	"Benign prostatic hyperplasia"	1	348	617	965
"F17"	"M16"	"Nicotine dependence"	"Osteoarthritis of hip"	1	403	871	1274
"A46"	"M05"	"Erysipelas"	"Rheumatoid arthritis with rheumatoid factor"	1	219	557	776
"C15"	"M23"	"Malignant neoplasm of esophagus"	"Internal derangement of knee"	1	0	189	189
"K44"	"J34"	"Diaphragmatic hernia"	"Other and unspecified disorders of nose and nasal sinuses"	1	236	457	693
"K62"	"H25"	"Other diseases of anus and rectum"	"Age-related cataract"	1	4493	5262	9755
"K65"	"K35"	"Peritonitis"	"Acute appendicitis"	1	1086	2040	3126
"H57"	"K61"	"Other disorders of eye and adnexa"	"Abscess of anal and rectal regions"	1	21	114	135
"I49"	"K50"	"Other cardiac arrhythmias"	"Crohn's disease [regional enteritis]"	1	68	161	229
"E34"	"Q35"	"Other endocrine disorders"	"Cleft palate"	1	5	38	43
"D23"	"B34"	"Other benign neoplasms of skin"	"Viral infection of unspecified site"	1	138	270	408
"M81"	"A09"	"Osteoporosis without current pathological fracture"	"Infectious gastroenteritis and colitis, unspecified"	1	1574	2099	3673
"G51"	"J05"	"Facial nerve disorders"	"Acute obstructive laryngitis [croup] and epiglottitis"	1	0	43	43
"C34"	"F33"	"Malignant neoplasm of bronchus and lung"	"Major depressive disorder, recurrent"	1	243	411	654
"M19"	"M77"	"Other and unspecified osteoarthritis"	"Other enthesopathies"	1	1820	2426	4246
"M18"	"M20"	"Osteoarthritis of first carpometacarpal joint"	"Acquired deformities of fingers and toes"	1	285	676	961
"G71"	"O62"	"Primary disorders of muscles"	"Abnormalities of forces of labor"	1	2	42	44
"E86"	"A46"	"Volume depletion"	"Erysipelas"	1	2766	4795	7561
"M23"	"Q76"	"Internal derangement of knee"	"Congenital malformations of spine and bony thorax"	1	6	90	96
"M85"	"M24"	"Other disorders of bone density and structure"	"Other specific joint derangements"	1	48	252	300
"D09"	"H40"	"Carcinoma in situ of other and unspecified sites"	"Glaucoma"	1	8	50	58
"C50"	"O13"	"Malignant neoplasm of breast"	"Gestational hypertension without significant proteinuria"	1	0	40	40
"D68"	"M23"	"Other coagulation defects"	"Internal derangement of knee"	1	310	743	1053
"Q40"	"O82"	"Other congenital malformations of upper alimentary tract"	"Encounter for cesarean delivery without indication"	1	5	42	47
"G95"	"H65"	"Other and unspecified diseases of spinal cord"	"Nonsuppurative otitis media"	1	0	63	63
"I25"	"H00"	"Chronic ischemic heart disease"	"Hordeolum and chalazion"	1	71	223	294
"Q61"	"H33"	"Cystic kidney disease"	"Retinal detachments and breaks"	1	16	61	77
"I34"	"M23"	"Nonrheumatic mitral valve disorders"	"Internal derangement of knee"	1	100	583	683
"N31"	"J05"	"Neuromuscular dysfunction of bladder, NEC"	"Acute obstructive laryngitis [croup] and epiglottitis"	1	0	26	26
"E05"	"N94"	"Thyrotoxicosis [hyperthyroidism]"	"Pain and oth cond assoc w fem gntl org and menstrual cycle"	1	164	374	538
"D69"	"I48"	"Purpura and other hemorrhagic conditions"	"Atrial fibrillation and flutter"	1	1005	1607	2612
"B02"	"M16"	"Zoster [herpes zoster]"	"Osteoarthritis of hip"	1	143	398	541
"M81"	"F50"	"Osteoporosis without current pathological fracture"	"Eating disorders"	1	53	181	234
"C79"	"L50"	"Secondary malignant neoplasm of other and unspecified sites"	"Urticaria"	1	4	160	164
"B96"	"H83"	"Oth bacterial agents as the cause of diseases classd elswhr"	"Other diseases of inner ear"	1	0	55	55
"M31"	"O03"	"Other necrotizing vasculopathies"	"Spontaneous abortion"	1	0	25	25
"M75"	"O14"	"Shoulder lesions"	"Pre-eclampsia"	1	0	329	329
"F32"	"I83"	"Depressive episode"	"Varicose veins of lower extremities"	1	334	1198	1532
"K31"	"I10"	"Other diseases of stomach and duodenum"	"Essential (primary) hypertension"	1	816	1728	2544
"M54"	"O65"	"Dorsalgia"	"Obstructed labor due to maternal pelvic abnormality"	1	0	1108	1108
"N19"	"K57"	"Unspecified kidney failure"	"Diverticular disease of intestine"	1	688	1303	1991
"H93"	"O03"	"Other disorders of ear, not elsewhere classified"	"Spontaneous abortion"	1	0	318	318
"H57"	"O41"	"Other disorders of eye and adnexa"	"Other disorders of amniotic fluid and membranes"	1	2	27	29
"N64"	"O03"	"Other disorders of breast"	"Spontaneous abortion"	1	145	852	997
"O72"	"L60"	"Postpartum hemorrhage"	"Nail disorders"	1	31	478	509
"O92"	"E28"	"Oth disord of brst/lactatn assoc w pregnancy and the puerp"	"Ovarian dysfunction"	1	111	394	505
"K83"	"M76"	"Other diseases of biliary tract"	"Enthesopathies, lower limb, excluding foot"	1	27	86	113
"E11"	"L50"	"Type 2 diabetes mellitus"	"Urticaria"	1	340	586	926
"J90"	"M62"	"Pleural effusion, not elsewhere classified"	"Other disorders of muscle"	1	10	576	586
"D50"	"N83"	"Iron deficiency anemia"	"Noninflammatory disord of ovary, fallop and broad ligament"	1	267	500	767
"I46"	"I44"	"Cardiac arrest"	"Atrioventricular and left bundle-branch block"	1	718	982	1700
"G47"	"J90"	"Sleep disorders"	"Pleural effusion, not elsewhere classified"	1	353	761	1114
"O72"	"O99"	"Postpartum hemorrhage"	"Oth maternal diseases classd elsw but compl preg/chldbrth"	1	0	139074	139074
"N17"	"N60"	"Acute kidney failure"	"Benign mammary dysplasia"	1	0	91	91
"O34"	"N96"	"Maternal care for abnormality of pelvic organs"	"Recurrent pregnancy loss"	1	149	507	656
"J42"	"D30"	"Unspecified chronic bronchitis"	"Benign neoplasm of urinary organs"	1	212	341	553
"E11"	"A63"	"Type 2 diabetes mellitus"	"Oth predominantly sexually transmitted diseases, NEC"	1	75	335	410
"N96"	"O00"	"Recurrent pregnancy loss"	"Ectopic pregnancy"	1	131	399	530
"I26"	"N63"	"Pulmonary embolism"	"Unspecified lump in breast"	1	62	282	344
"M84"	"D25"	"Disorder of continuity of bone"	"Leiomyoma of uterus"	1	13	64	77
"O04"	"Q74"	"Complications following (induced) termination of pregnancy"	"Other congenital malformations of limb(s)"	1	9	62	71
"D68"	"I42"	"Other coagulation defects"	"Cardiomyopathy"	1	127	231	358
"M19"	"O70"	"Other and unspecified osteoarthritis"	"Perineal laceration during delivery"	1	0	501	501
"O44"	"F10"	"Placenta previa"	"Alcohol related disorders"	1	0	39	39
"H01"	"O80"	"Other inflammation of eyelid"	"Encounter for full-term uncomplicated delivery"	1	0	233	233
"M48"	"G56"	"Other spondylopathies"	"Mononeuropathies of upper limb"	1	1272	3183	4455
"F34"	"K58"	"Persistent mood [affective] disorders"	"Irritable bowel syndrome"	1	37	104	141
"L08"	"K35"	"Other local infections of skin and subcutaneous tissue"	"Acute appendicitis"	1	222	995	1217
"M81"	"M16"	"Osteoporosis without current pathological fracture"	"Osteoarthritis of hip"	1	2015	4664	6679
"N40"	"H10"	"Benign prostatic hyperplasia"	"Conjunctivitis"	1	319	529	848
"M05"	"O20"	"Rheumatoid arthritis with rheumatoid factor"	"Hemorrhage in early pregnancy"	1	0	127	127
"L97"	"E04"	"Non-pressure chronic ulcer of lower limb, NEC"	"Other nontoxic goiter"	1	41	225	266
"L98"	"O63"	"Oth disorders of skin, subcu, not elsewhere classified"	"Long labor"	1	16	72	88
"J30"	"Q68"	"Vasomotor and allergic rhinitis"	"Other congenital musculoskeletal deformities"	1	0	48	48
"K02"	"C91"	"Dental caries"	"Lymphoid leukemia"	1	39	127	166
"L95"	"K40"	"Vasculitis limited to skin, not elsewhere classified"	"Inguinal hernia"	1	22	70	92
"H34"	"K21"	"Retinal vascular occlusions"	"Gastro-esophageal reflux disease"	1	88	222	310
"A09"	"M31"	"Infectious gastroenteritis and colitis, unspecified"	"Other necrotizing vasculopathies"	1	231	447	678
"C24"	"N95"	"Malignant neoplasm of other and unsp parts of biliary tract"	"Menopausal and other perimenopausal disorders"	1	0	57	57
"B27"	"Q17"	"Infectious mononucleosis"	"Other congenital malformations of ear"	1	19	82	101
"K70"	"K30"	"Alcoholic liver disease"	"Functional dyspepsia"	1	302	633	935
"K64"	"K02"	"Hemorrhoids and perianal venous thrombosis"	"Dental caries"	1	12	138	150
"F02"	"N31"	"Dementia in other diseases classified elsewhere"	"Neuromuscular dysfunction of bladder, NEC"	1	15	73	88
"I26"	"D12"	"Pulmonary embolism"	"Benign neoplasm of colon, rectum, anus and anal canal"	1	832	1129	1961
"A54"	"M65"	"Gonococcal infection"	"Synovitis and tenosynovitis"	1	4	41	45
"I82"	"O32"	"Other venous embolism and thrombosis"	"Maternal care for malpresentation of fetus"	1	2	32	34
"C79"	"M42"	"Secondary malignant neoplasm of other and unspecified sites"	"Spinal osteochondrosis"	1	0	34	34
"A41"	"N20"	"Other sepsis"	"Calculus of kidney and ureter"	1	1662	3612	5274
"K62"	"O68"	"Other diseases of anus and rectum"	"Labor and delivery comp by abnlt of fetal acid-base balance"	1	54	831	885
"H16"	"O48"	"Keratitis"	"Late pregnancy"	1	11	92	103
"N17"	"M79"	"Acute kidney failure"	"Oth and unsp soft tissue disorders, not elsewhere classified"	1	225	1326	1551
"E34"	"Q54"	"Other endocrine disorders"	"Hypospadias"	1	8	90	98
"O80"	"O03"	"Encounter for full-term uncomplicated delivery"	"Spontaneous abortion"	1	19903	24380	44283
"I15"	"K35"	"Secondary hypertension"	"Acute appendicitis"	1	56	153	209
"J44"	"D86"	"Other chronic obstructive pulmonary disease"	"Sarcoidosis"	1	262	470	732
"C48"	"K21"	"Malignant neoplasm of retroperitoneum and peritoneum"	"Gastro-esophageal reflux disease"	1	0	37	37
"I26"	"N95"	"Pulmonary embolism"	"Menopausal and other perimenopausal disorders"	1	111	504	615
"M43"	"N87"	"Other deforming dorsopathies"	"Dysplasia of cervix uteri"	1	19	118	137
"K59"	"M72"	"Other functional intestinal disorders"	"Fibroblastic disorders"	1	293	1484	1777
"D69"	"O62"	"Purpura and other hemorrhagic conditions"	"Abnormalities of forces of labor"	1	204	392	596
"G47"	"C43"	"Sleep disorders"	"Malignant melanoma of skin"	1	146	522	668
"H36"	"K40"	"Retinal disorders in diseases classified elsewhere"	"Inguinal hernia"	1	117	350	467
"L90"	"O00"	"Atrophic disorders of skin"	"Ectopic pregnancy"	1	22	153	175
"M95"	"O64"	"Oth acquired deformities of ms sys and connective tissue"	"Obstructed labor due to malposition and malpresent of fetus"	1	10	50	60
"L89"	"I50"	"Pressure ulcer"	"Heart failure"	1	1445	2867	4312
"H90"	"Q53"	"Conductive and sensorineural hearing loss"	"Undescended and ectopic testicle"	1	40	201	241
"K40"	"M42"	"Inguinal hernia"	"Spinal osteochondrosis"	1	40	120	160
"M23"	"Q52"	"Internal derangement of knee"	"Other congenital malformations of female genitalia"	1	6	41	47
"M81"	"A69"	"Osteoporosis without current pathological fracture"	"Other spirochetal infections"	1	4	133	137
"L89"	"J35"	"Pressure ulcer"	"Chronic diseases of tonsils and adenoids"	1	0	29	29
"J44"	"N85"	"Other chronic obstructive pulmonary disease"	"Other noninflammatory disorders of uterus, except cervix"	1	40	169	209
"N20"	"O85"	"Calculus of kidney and ureter"	"Puerperal sepsis"	1	19	74	93
"C92"	"D17"	"Myeloid leukemia"	"Benign lipomatous neoplasm"	1	8	51	59
"M90"	"G45"	"Osteopathies in diseases classified elsewhere"	"Transient cerebral ischemic attacks and related syndromes"	1	2	29	31
"H54"	"J03"	"Blindness and low vision"	"Acute tonsillitis"	1	36	111	147
"H53"	"D24"	"Visual disturbances"	"Benign neoplasm of breast"	1	33	219	252
"K43"	"K81"	"Ventral hernia"	"Cholecystitis"	1	375	961	1336
"C50"	"O63"	"Malignant neoplasm of breast"	"Long labor"	1	0	101	101
"N82"	"K51"	"Fistulae involving female genital tract"	"Ulcerative colitis"	1	16	123	139
"M35"	"B34"	"Other systemic involvement of connective tissue"	"Viral infection of unspecified site"	1	309	570	879
"G45"	"M76"	"Transient cerebral ischemic attacks and related syndromes"	"Enthesopathies, lower limb, excluding foot"	1	198	339	537
"C34"	"M48"	"Malignant neoplasm of bronchus and lung"	"Other spondylopathies"	1	283	1908	2191
"K20"	"O02"	"Esophagitis"	"Other abnormal products of conception"	1	22	89	111
"B95"	"L03"	"Strep as the cause of diseases classified elsewhere"	"Cellulitis and acute lymphangitis"	1	52	122	174
"D17"	"O68"	"Benign lipomatous neoplasm"	"Labor and delivery comp by abnlt of fetal acid-base balance"	1	35	682	717
"N39"	"G99"	"Other disorders of urinary system"	"Oth disorders of nervous system in diseases classd elswhr"	1	53	175	228
"A49"	"M50"	"Bacterial infection of unspecified site"	"Cervical disc disorders"	1	52	443	495
"E78"	"D06"	"Disorders of lipoprotein metabolism and other lipidemias"	"Carcinoma in situ of cervix uteri"	1	0	98	98
"J91"	"M62"	"Pleural effusion in conditions classified elsewhere"	"Other disorders of muscle"	1	0	227	227
"G47"	"O62"	"Sleep disorders"	"Abnormalities of forces of labor"	1	0	435	435
"G47"	"N62"	"Sleep disorders"	"Hypertrophy of breast"	1	120	538	658
"Q23"	"Q90"	"Congenital malformations of aortic and mitral valves"	"Down syndrome"	1	12	62	74
"H02"	"E66"	"Other disorders of eyelid"	"Overweight and obesity"	1	734	1045	1779
"N46"	"J36"	"Male infertility"	"Peritonsillar abscess"	1	7	128	135
"A04"	"G35"	"Other bacterial intestinal infections"	"Multiple sclerosis"	1	0	43	43
"J18"	"N36"	"Pneumonia, unspecified organism"	"Other disorders of urethra"	1	154	313	467
"Q61"	"F10"	"Cystic kidney disease"	"Alcohol related disorders"	1	27	187	214
"D43"	"M67"	"Neoplasm of uncertain behavior of brain and cnsl"	"Other disorders of synovium and tendon"	1	9	64	73
"F05"	"J34"	"Delirium due to known physiological condition"	"Other and unspecified disorders of nose and nasal sinuses"	1	0	62	62
"K63"	"I47"	"Other diseases of intestine"	"Paroxysmal tachycardia"	1	87	414	501
"L97"	"G50"	"Non-pressure chronic ulcer of lower limb, NEC"	"Disorders of trigeminal nerve"	1	6	60	66
"K91"	"K62"	"Intraop and postproc comp and disorders of dgstv sys, NEC"	"Other diseases of anus and rectum"	1	386	708	1094
"A04"	"C61"	"Other bacterial intestinal infections"	"Malignant neoplasm of prostate"	1	84	341	425
"D68"	"H10"	"Other coagulation defects"	"Conjunctivitis"	1	17	205	222
"O36"	"E28"	"Maternal care for other fetal problems"	"Ovarian dysfunction"	1	332	755	1087
"K83"	"J30"	"Other diseases of biliary tract"	"Vasomotor and allergic rhinitis"	1	7	70	77
"N32"	"C20"	"Other disorders of bladder"	"Malignant neoplasm of rectum"	1	103	266	369
"O10"	"O02"	"Pre-existing hypertension compl preg/chldbrth"	"Other abnormal products of conception"	1	246	589	835
"K44"	"O75"	"Diaphragmatic hernia"	"Oth complications of labor and delivery, NEC"	1	21	104	125
"I42"	"M24"	"Cardiomyopathy"	"Other specific joint derangements"	1	19	68	87
"K59"	"M23"	"Other functional intestinal disorders"	"Internal derangement of knee"	1	0	7241	7241
"F43"	"Q66"	"Reaction to severe stress, and adjustment disorders"	"Congenital deformities of feet"	1	25	120	145
"F43"	"O75"	"Reaction to severe stress, and adjustment disorders"	"Oth complications of labor and delivery, NEC"	1	45	199	244
"M20"	"D48"	"Acquired deformities of fingers and toes"	"Neoplasm of uncertain behavior of other and unsp sites"	1	7	106	113
"H02"	"N81"	"Other disorders of eyelid"	"Female genital prolapse"	1	433	900	1333
"J69"	"E11"	"Pneumonitis due to solids and liquids"	"Type 2 diabetes mellitus"	1	170	1249	1419
"N13"	"K21"	"Obstructive and reflux uropathy"	"Gastro-esophageal reflux disease"	1	254	468	722
"G45"	"M77"	"Transient cerebral ischemic attacks and related syndromes"	"Other enthesopathies"	1	214	480	694
"D18"	"O04"	"Hemangioma and lymphangioma, any site"	"Complications following (induced) termination of pregnancy"	1	32	156	188
"G96"	"E13"	"Other disorders of central nervous system"	"Other specified diabetes mellitus"	1	64	172	236
"H35"	"M72"	"Other retinal disorders"	"Fibroblastic disorders"	1	286	966	1252
"N17"	"I73"	"Acute kidney failure"	"Other peripheral vascular diseases"	1	365	1398	1763
"J91"	"J35"	"Pleural effusion in conditions classified elsewhere"	"Chronic diseases of tonsils and adenoids"	1	1	25	26
"K72"	"D27"	"Hepatic failure, not elsewhere classified"	"Benign neoplasm of ovary"	1	10	59	69
"M81"	"H90"	"Osteoporosis without current pathological fracture"	"Conductive and sensorineural hearing loss"	1	499	1942	2441
"G25"	"D25"	"Other extrapyramidal and movement disorders"	"Leiomyoma of uterus"	1	0	91	91
"I70"	"M20"	"Atherosclerosis"	"Acquired deformities of fingers and toes"	1	591	988	1579
"K62"	"N31"	"Other diseases of anus and rectum"	"Neuromuscular dysfunction of bladder, NEC"	1	237	430	667
"J96"	"M06"	"Respiratory failure, not elsewhere classified"	"Other rheumatoid arthritis"	1	114	1346	1460
"N92"	"J30"	"Excessive, frequent and irregular menstruation"	"Vasomotor and allergic rhinitis"	1	486	696	1182
"I78"	"M51"	"Diseases of capillaries"	"Thoracic, thoracolum, and lumbosacral intvrt disc disorders"	1	154	269	423
"G72"	"M23"	"Other and unspecified myopathies"	"Internal derangement of knee"	1	33	98	131
"C44"	"I70"	"Other and unspecified malignant neoplasm of skin"	"Atherosclerosis"	1	788	1043	1831
"E87"	"K42"	"Other disorders of fluid, electrolyte and acid-base balance"	"Umbilical hernia"	1	161	697	858
"H33"	"M22"	"Retinal detachments and breaks"	"Disorder of patella"	1	0	83	83
"E86"	"H93"	"Volume depletion"	"Other disorders of ear, not elsewhere classified"	1	0	2180	2180
"M76"	"O64"	"Enthesopathies, lower limb, excluding foot"	"Obstructed labor due to malposition and malpresent of fetus"	1	19	161	180
"I70"	"H83"	"Atherosclerosis"	"Other diseases of inner ear"	1	344	1261	1605
"C50"	"N73"	"Malignant neoplasm of breast"	"Other female pelvic inflammatory diseases"	1	5	76	81
"C79"	"I70"	"Secondary malignant neoplasm of other and unspecified sites"	"Atherosclerosis"	1	91	1304	1395
"M43"	"N70"	"Other deforming dorsopathies"	"Salpingitis and oophoritis"	1	1	59	60
"M65"	"F98"	"Synovitis and tenosynovitis"	"Oth behav/emotn disord w onset usly occur in chldhd and adol"	1	3	39	42
"C50"	"O73"	"Malignant neoplasm of breast"	"Retained placenta and membranes, without hemorrhage"	1	0	30	30
"K65"	"M22"	"Peritonitis"	"Disorder of patella"	1	4	85	89
"G20"	"I47"	"Parkinson's disease"	"Paroxysmal tachycardia"	1	108	328	436
"A04"	"K35"	"Other bacterial intestinal infections"	"Acute appendicitis"	1	101	423	524
"K43"	"M67"	"Ventral hernia"	"Other disorders of synovium and tendon"	1	195	378	573
"N47"	"I20"	"Disorders of prepuce"	"Angina pectoris"	1	455	835	1290
"K00"	"Q53"	"Disorders of tooth development and eruption"	"Undescended and ectopic testicle"	1	0	110	110
"I48"	"H27"	"Atrial fibrillation and flutter"	"Other disorders of lens"	1	84	721	805
"D64"	"I70"	"Other anemias"	"Atherosclerosis"	1	2846	6339	9185
"M16"	"O82"	"Osteoarthritis of hip"	"Encounter for cesarean delivery without indication"	1	0	260	260
"J09"	"E66"	"Influenza due to certain identified influenza viruses"	"Overweight and obesity"	1	28	228	256
"J96"	"N70"	"Respiratory failure, not elsewhere classified"	"Salpingitis and oophoritis"	1	0	106	106
"D13"	"K80"	"Benign neoplasm of and ill-defined parts of digestive system"	"Cholelithiasis"	1	618	864	1482
"G95"	"M51"	"Other and unspecified diseases of spinal cord"	"Thoracic, thoracolum, and lumbosacral intvrt disc disorders"	1	298	978	1276
"D12"	"G51"	"Benign neoplasm of colon, rectum, anus and anal canal"	"Facial nerve disorders"	1	87	307	394
"I42"	"M77"	"Cardiomyopathy"	"Other enthesopathies"	1	27	124	151
"C79"	"N43"	"Secondary malignant neoplasm of other and unspecified sites"	"Hydrocele and spermatocele"	1	0	312	312
"A49"	"O62"	"Bacterial infection of unspecified site"	"Abnormalities of forces of labor"	1	41	541	582
"M75"	"M42"	"Shoulder lesions"	"Spinal osteochondrosis"	1	72	429	501
"G45"	"M06"	"Transient cerebral ischemic attacks and related syndromes"	"Other rheumatoid arthritis"	1	343	519	862
"E04"	"O47"	"Other nontoxic goiter"	"False labor"	1	37	420	457
"N63"	"O82"	"Unspecified lump in breast"	"Encounter for cesarean delivery without indication"	1	261	1434	1695
"G30"	"C43"	"Alzheimer's disease"	"Malignant melanoma of skin"	1	5	127	132
"A40"	"N81"	"Streptococcal sepsis"	"Female genital prolapse"	1	17	65	82
"C61"	"J34"	"Malignant neoplasm of prostate"	"Other and unspecified disorders of nose and nasal sinuses"	1	0	242	242
"G93"	"I83"	"Other disorders of brain"	"Varicose veins of lower extremities"	1	38	180	218
"J15"	"M53"	"Bacterial pneumonia, not elsewhere classified"	"Other and unspecified dorsopathies, not elsewhere classified"	1	107	524	631
"O42"	"A09"	"Premature rupture of membranes"	"Infectious gastroenteritis and colitis, unspecified"	1	239	547	786
"O92"	"O12"	"Oth disord of brst/lactatn assoc w pregnancy and the puerp"	"Gestational edema and proteinuria without hypertension"	1	114	326	440
"C64"	"J45"	"Malignant neoplasm of kidney, except renal pelvis"	"Asthma"	1	53	222	275
"C34"	"D13"	"Malignant neoplasm of bronchus and lung"	"Benign neoplasm of and ill-defined parts of digestive system"	1	56	216	272
"J38"	"N92"	"Diseases of vocal cords and larynx, not elsewhere classified"	"Excessive, frequent and irregular menstruation"	1	128	526	654
"C34"	"C30"	"Malignant neoplasm of bronchus and lung"	"Malignant neoplasm of nasal cavity and middle ear"	1	12	61	73
"D09"	"J44"	"Carcinoma in situ of other and unspecified sites"	"Other chronic obstructive pulmonary disease"	1	127	366	493
"L73"	"F10"	"Other follicular disorders"	"Alcohol related disorders"	1	142	254	396
"E27"	"J44"	"Other disorders of adrenal gland"	"Other chronic obstructive pulmonary disease"	1	290	589	879
"I47"	"J35"	"Paroxysmal tachycardia"	"Chronic diseases of tonsils and adenoids"	1	56	354	410
"C34"	"C82"	"Malignant neoplasm of bronchus and lung"	"Follicular lymphoma"	1	33	125	158
"N92"	"O41"	"Excessive, frequent and irregular menstruation"	"Other disorders of amniotic fluid and membranes"	1	0	553	553
"M53"	"D25"	"Other and unspecified dorsopathies, not elsewhere classified"	"Leiomyoma of uterus"	1	203	380	583
"M19"	"O41"	"Other and unspecified osteoarthritis"	"Other disorders of amniotic fluid and membranes"	1	0	29	29
"E86"	"I21"	"Volume depletion"	"Acute myocardial infarction"	1	0	12264	12264
"H26"	"O65"	"Other cataract"	"Obstructed labor due to maternal pelvic abnormality"	1	0	28	28
"K59"	"C25"	"Other functional intestinal disorders"	"Malignant neoplasm of pancreas"	1	1220	1943	3163
"O34"	"N97"	"Maternal care for abnormality of pelvic organs"	"Female infertility"	1	0	6229	6229
"H25"	"N61"	"Age-related cataract"	"Inflammatory disorders of breast"	1	75	297	372
"I20"	"H65"	"Angina pectoris"	"Nonsuppurative otitis media"	1	367	574	941
"C43"	"O80"	"Malignant melanoma of skin"	"Encounter for full-term uncomplicated delivery"	1	0	862	862
"I95"	"M51"	"Hypotension"	"Thoracic, thoracolum, and lumbosacral intvrt disc disorders"	1	50	920	970
"C22"	"K92"	"Malignant neoplasm of liver and intrahepatic bile ducts"	"Other diseases of digestive system"	1	212	424	636
"J18"	"G56"	"Pneumonia, unspecified organism"	"Mononeuropathies of upper limb"	1	0	7265	7265
"A26"	"I63"	"Erysipeloid"	"Cerebral infarction"	1	26	89	115
"H33"	"K58"	"Retinal detachments and breaks"	"Irritable bowel syndrome"	1	73	185	258
"F05"	"L30"	"Delirium due to known physiological condition"	"Other and unspecified dermatitis"	1	58	271	329
"D62"	"M77"	"Acute posthemorrhagic anemia"	"Other enthesopathies"	1	28	92	120
"J06"	"O72"	"Acute upper resp infections of multiple and unsp sites"	"Postpartum hemorrhage"	1	549	1131	1680
"C78"	"I50"	"Secondary malignant neoplasm of resp and digestive organs"	"Heart failure"	1	1167	2987	4154
"H18"	"L20"	"Other disorders of cornea"	"Atopic dermatitis"	1	0	53	53
"L28"	"H83"	"Lichen simplex chronicus and prurigo"	"Other diseases of inner ear"	1	10	54	64
"O86"	"M22"	"Other puerperal infections"	"Disorder of patella"	1	21	193	214
"M05"	"K58"	"Rheumatoid arthritis with rheumatoid factor"	"Irritable bowel syndrome"	1	100	192	292
"G95"	"M19"	"Other and unspecified diseases of spinal cord"	"Other and unspecified osteoarthritis"	1	103	290	393
"K12"	"O04"	"Stomatitis and related lesions"	"Complications following (induced) termination of pregnancy"	1	32	244	276
"J94"	"M17"	"Other pleural conditions"	"Osteoarthritis of knee"	1	45	320	365
"L89"	"I20"	"Pressure ulcer"	"Angina pectoris"	1	0	1504	1504
"O70"	"B07"	"Perineal laceration during delivery"	"Viral warts"	1	16	281	297
"D17"	"N87"	"Benign lipomatous neoplasm"	"Dysplasia of cervix uteri"	1	50	313	363
"K55"	"M65"	"Vascular disorders of intestine"	"Synovitis and tenosynovitis"	1	6	148	154
"C22"	"M67"	"Malignant neoplasm of liver and intrahepatic bile ducts"	"Other disorders of synovium and tendon"	1	0	40	40
"N12"	"M16"	"Tubulo-interstitial nephritis, not spcf as acute or chronic"	"Osteoarthritis of hip"	1	38	177	215
"D63"	"M71"	"Anemia in chronic diseases classified elsewhere"	"Other bursopathies"	1	4	122	126
"M81"	"D14"	"Osteoporosis without current pathological fracture"	"Benign neoplasm of middle ear and respiratory system"	1	147	440	587
"I25"	"O80"	"Chronic ischemic heart disease"	"Encounter for full-term uncomplicated delivery"	1	0	181	181
"J96"	"F20"	"Respiratory failure, not elsewhere classified"	"Schizophrenia"	1	428	919	1347
"K83"	"H90"	"Other diseases of biliary tract"	"Conductive and sensorineural hearing loss"	1	75	278	353
"J44"	"D28"	"Other chronic obstructive pulmonary disease"	"Benign neoplasm of other and unsp female genital organs"	1	20	106	126
"N05"	"M05"	"Unspecified nephritic syndrome"	"Rheumatoid arthritis with rheumatoid factor"	1	48	116	164
"O90"	"E66"	"Complications of the puerperium, not elsewhere classified"	"Overweight and obesity"	1	1687	2868	4555
"G56"	"L03"	"Mononeuropathies of upper limb"	"Cellulitis and acute lymphangitis"	1	332	958	1290
"O70"	"O32"	"Perineal laceration during delivery"	"Maternal care for malpresentation of fetus"	1	5361	6894	12255
"D35"	"N60"	"Benign neoplasm of other and unspecified endocrine glands"	"Benign mammary dysplasia"	1	0	102	102
"C92"	"G45"	"Myeloid leukemia"	"Transient cerebral ischemic attacks and related syndromes"	1	20	126	146
"O08"	"J30"	"Complications following ectopic and molar pregnancy"	"Vasomotor and allergic rhinitis"	1	54	154	208
"C34"	"K65"	"Malignant neoplasm of bronchus and lung"	"Peritonitis"	1	123	218	341
"C67"	"D27"	"Malignant neoplasm of bladder"	"Benign neoplasm of ovary"	1	15	57	72
"K21"	"O04"	"Gastro-esophageal reflux disease"	"Complications following (induced) termination of pregnancy"	1	0	1414	1414
"O68"	"L05"	"Labor and delivery comp by abnlt of fetal acid-base balance"	"Pilonidal cyst and sinus"	1	77	553	630
"L89"	"N13"	"Pressure ulcer"	"Obstructive and reflux uropathy"	1	184	300	484
"J18"	"C53"	"Pneumonia, unspecified organism"	"Malignant neoplasm of cervix uteri"	1	101	505	606
"K31"	"H33"	"Other diseases of stomach and duodenum"	"Retinal detachments and breaks"	1	8	46	54
"K74"	"H35"	"Fibrosis and cirrhosis of liver"	"Other retinal disorders"	1	115	213	328
"C15"	"I48"	"Malignant neoplasm of esophagus"	"Atrial fibrillation and flutter"	1	381	626	1007
"N30"	"M35"	"Cystitis"	"Other systemic involvement of connective tissue"	1	1703	3431	5134
"F03"	"L21"	"Unspecified dementia"	"Seborrheic dermatitis"	1	46	127	173
"O92"	"B27"	"Oth disord of brst/lactatn assoc w pregnancy and the puerp"	"Infectious mononucleosis"	1	0	43	43
"M07"	"N60"	"Enteropathic arthropathies"	"Benign mammary dysplasia"	1	11	124	135
"K59"	"Q05"	"Other functional intestinal disorders"	"Spina bifida"	1	11	158	169
"D25"	"N62"	"Leiomyoma of uterus"	"Hypertrophy of breast"	1	142	279	421
"N20"	"O63"	"Calculus of kidney and ureter"	"Long labor"	1	58	212	270
"I50"	"C61"	"Heart failure"	"Malignant neoplasm of prostate"	1	2288	2717	5005
"I95"	"I48"	"Hypotension"	"Atrial fibrillation and flutter"	1	2710	5338	8048
"M90"	"K80"	"Osteopathies in diseases classified elsewhere"	"Cholelithiasis"	1	3	41	44
"M17"	"Q18"	"Osteoarthritis of knee"	"Other congenital malformations of face and neck"	1	41	134	175
"D47"	"D64"	"Oth neoplm of uncrt behav of lymphoid, hematpoetc & rel tiss"	"Other anemias"	1	843	1109	1952
"N39"	"B18"	"Other disorders of urinary system"	"Chronic viral hepatitis"	1	120	284	404
"I80"	"M23"	"Phlebitis and thrombophlebitis"	"Internal derangement of knee"	1	1561	2728	4289
"M47"	"N80"	"Spondylosis"	"Endometriosis"	1	1	308	309
"K83"	"O03"	"Other diseases of biliary tract"	"Spontaneous abortion"	1	2	100	102
"M47"	"O62"	"Spondylosis"	"Abnormalities of forces of labor"	1	0	368	368
"K43"	"K35"	"Ventral hernia"	"Acute appendicitis"	1	0	2976	2976
"L71"	"K50"	"Rosacea"	"Crohn's disease [regional enteritis]"	1	25	112	137
"K22"	"H10"	"Other diseases of esophagus"	"Conjunctivitis"	1	44	257	301
"L73"	"K61"	"Other follicular disorders"	"Abscess of anal and rectal regions"	1	247	450	697
"C18"	"D23"	"Malignant neoplasm of colon"	"Other benign neoplasms of skin"	1	118	348	466
"C67"	"L03"	"Malignant neoplasm of bladder"	"Cellulitis and acute lymphangitis"	1	19	72	91
"D33"	"O80"	"Benign neoplasm of brain and oth prt central nervous system"	"Encounter for full-term uncomplicated delivery"	1	0	204	204
"I44"	"M20"	"Atrioventricular and left bundle-branch block"	"Acquired deformities of fingers and toes"	1	62	336	398
"L89"	"D25"	"Pressure ulcer"	"Leiomyoma of uterus"	1	0	72	72
"H53"	"G56"	"Visual disturbances"	"Mononeuropathies of upper limb"	1	310	644	954
"G44"	"O64"	"Other headache syndromes"	"Obstructed labor due to malposition and malpresent of fetus"	1	29	253	282
"C14"	"C13"	"Malig neoplasm of sites in the lip, oral cavity and pharynx"	"Malignant neoplasm of hypopharynx"	1	122	267	389
"C02"	"F10"	"Malignant neoplasm of other and unspecified parts of tongue"	"Alcohol related disorders"	1	29	291	320
"K76"	"H66"	"Other diseases of liver"	"Suppurative and unspecified otitis media"	1	10	91	101
"I35"	"K21"	"Nonrheumatic aortic valve disorders"	"Gastro-esophageal reflux disease"	1	346	1569	1915
"F06"	"C61"	"Other mental disorders due to known physiological condition"	"Malignant neoplasm of prostate"	1	44	139	183
"I60"	"D25"	"Nontraumatic subarachnoid hemorrhage"	"Leiomyoma of uterus"	1	21	128	149
"J43"	"N87"	"Emphysema"	"Dysplasia of cervix uteri"	1	0	48	48
"G95"	"D12"	"Other and unspecified diseases of spinal cord"	"Benign neoplasm of colon, rectum, anus and anal canal"	1	130	434	564
"K52"	"N87"	"Other and unsp noninfective gastroenteritis and colitis"	"Dysplasia of cervix uteri"	1	95	313	408
"N13"	"H71"	"Obstructive and reflux uropathy"	"Cholesteatoma of middle ear"	1	1	38	39
"L92"	"O02"	"Granulomatous disorders of skin and subcutaneous tissue"	"Other abnormal products of conception"	1	8	44	52
"D63"	"M16"	"Anemia in chronic diseases classified elsewhere"	"Osteoarthritis of hip"	1	0	1320	1320
"K43"	"N63"	"Ventral hernia"	"Unspecified lump in breast"	1	114	205	319
"J90"	"L02"	"Pleural effusion, not elsewhere classified"	"Cutaneous abscess, furuncle and carbuncle"	1	102	549	651
"K74"	"D24"	"Fibrosis and cirrhosis of liver"	"Benign neoplasm of breast"	1	4	69	73
"N17"	"H52"	"Acute kidney failure"	"Disorders of refraction and accommodation"	1	16	140	156
"J90"	"K35"	"Pleural effusion, not elsewhere classified"	"Acute appendicitis"	1	23	249	272
"I12"	"H93"	"Hypertensive chronic kidney disease"	"Other disorders of ear, not elsewhere classified"	1	15	74	89
"D75"	"O70"	"Other and unsp diseases of blood and blood-forming organs"	"Perineal laceration during delivery"	1	11	68	79
"E87"	"O32"	"Other disorders of fluid, electrolyte and acid-base balance"	"Maternal care for malpresentation of fetus"	1	0	35	35
"G43"	"O86"	"Migraine"	"Other puerperal infections"	1	60	148	208
"D10"	"K40"	"Benign neoplasm of mouth and pharynx"	"Inguinal hernia"	1	119	311	430
"M77"	"G40"	"Other enthesopathies"	"Epilepsy and recurrent seizures"	1	131	248	379
"G43"	"O82"	"Migraine"	"Encounter for cesarean delivery without indication"	1	479	1316	1795
"C61"	"G56"	"Malignant neoplasm of prostate"	"Mononeuropathies of upper limb"	1	230	833	1063
"N28"	"H33"	"Oth disorders of kidney and ureter, not elsewhere classified"	"Retinal detachments and breaks"	1	7	106	113
"H20"	"O80"	"Iridocyclitis"	"Encounter for full-term uncomplicated delivery"	1	66	516	582
"G96"	"H83"	"Other disorders of central nervous system"	"Other diseases of inner ear"	1	0	189	189
"O80"	"J35"	"Encounter for full-term uncomplicated delivery"	"Chronic diseases of tonsils and adenoids"	1	0	6377	6377
"C34"	"A88"	"Malignant neoplasm of bronchus and lung"	"Oth viral infections of central nervous system, NEC"	1	0	48	48
"I46"	"M10"	"Cardiac arrest"	"Gout"	1	132	826	958
"N88"	"O48"	"Other noninflammatory disorders of cervix uteri"	"Late pregnancy"	1	6	43	49
"I35"	"O04"	"Nonrheumatic aortic valve disorders"	"Complications following (induced) termination of pregnancy"	1	0	101	101
"G51"	"O04"	"Facial nerve disorders"	"Complications following (induced) termination of pregnancy"	1	25	354	379
"K56"	"M20"	"Paralytic ileus and intestinal obstruction without hernia"	"Acquired deformities of fingers and toes"	1	145	557	702
"N13"	"A63"	"Obstructive and reflux uropathy"	"Oth predominantly sexually transmitted diseases, NEC"	1	40	106	146
"E89"	"O82"	"Postproc endocrine and metabolic comp and disorders, NEC"	"Encounter for cesarean delivery without indication"	1	36	210	246
"C79"	"F10"	"Secondary malignant neoplasm of other and unspecified sites"	"Alcohol related disorders"	1	20	1123	1143
"M46"	"J45"	"Other inflammatory spondylopathies"	"Asthma"	1	75	266	341
"G47"	"C77"	"Sleep disorders"	"Secondary and unspecified malignant neoplasm of lymph nodes"	1	478	1852	2330
"C18"	"H36"	"Malignant neoplasm of colon"	"Retinal disorders in diseases classified elsewhere"	1	104	280	384
"I73"	"I70"	"Other peripheral vascular diseases"	"Atherosclerosis"	1	8882	12033	20915
"M47"	"K58"	"Spondylosis"	"Irritable bowel syndrome"	1	457	1071	1528
"O72"	"F45"	"Postpartum hemorrhage"	"Somatoform disorders"	1	7	290	297
"C80"	"I47"	"Malignant neoplasm without specification of site"	"Paroxysmal tachycardia"	1	15	129	144
"E78"	"H44"	"Disorders of lipoprotein metabolism and other lipidemias"	"Disorders of globe"	1	116	271	387
"A41"	"L72"	"Other sepsis"	"Follicular cysts of skin and subcutaneous tissue"	1	24	282	306
"F02"	"I48"	"Dementia in other diseases classified elsewhere"	"Atrial fibrillation and flutter"	1	181	417	598
"D50"	"D11"	"Iron deficiency anemia"	"Benign neoplasm of major salivary glands"	1	29	113	142
"C45"	"J94"	"Mesothelioma"	"Other pleural conditions"	1	121	320	441
"F33"	"M67"	"Major depressive disorder, recurrent"	"Other disorders of synovium and tendon"	1	66	380	446
"C34"	"M75"	"Malignant neoplasm of bronchus and lung"	"Shoulder lesions"	1	0	2219	2219
"L02"	"L20"	"Cutaneous abscess, furuncle and carbuncle"	"Atopic dermatitis"	1	201	343	544
"C25"	"M79"	"Malignant neoplasm of pancreas"	"Oth and unsp soft tissue disorders, not elsewhere classified"	1	7	540	547
"I71"	"H11"	"Aortic aneurysm and dissection"	"Other disorders of conjunctiva"	1	24	125	149
"K56"	"O65"	"Paralytic ileus and intestinal obstruction without hernia"	"Obstructed labor due to maternal pelvic abnormality"	1	3	108	111
"I69"	"O68"	"Sequelae of cerebrovascular disease"	"Labor and delivery comp by abnlt of fetal acid-base balance"	1	0	107	107
"K65"	"D23"	"Peritonitis"	"Other benign neoplasms of skin"	1	62	137	199
"I50"	"H33"	"Heart failure"	"Retinal detachments and breaks"	1	248	1066	1314
"M85"	"K35"	"Other disorders of bone density and structure"	"Acute appendicitis"	1	35	466	501
"L85"	"H91"	"Other epidermal thickening"	"Other and unspecified hearing loss"	1	51	129	180
"N17"	"H93"	"Acute kidney failure"	"Other disorders of ear, not elsewhere classified"	1	0	410	410
"G93"	"G56"	"Other disorders of brain"	"Mononeuropathies of upper limb"	1	69	187	256
"N95"	"D28"	"Menopausal and other perimenopausal disorders"	"Benign neoplasm of other and unsp female genital organs"	1	62	176	238
"N60"	"O02"	"Benign mammary dysplasia"	"Other abnormal products of conception"	1	112	687	799
"J18"	"Q90"	"Pneumonia, unspecified organism"	"Down syndrome"	1	204	713	917
"G30"	"K22"	"Alzheimer's disease"	"Other diseases of esophagus"	1	14	130	144
"J11"	"H66"	"Influenza due to unidentified influenza virus"	"Suppurative and unspecified otitis media"	1	227	542	769
"M90"	"H25"	"Osteopathies in diseases classified elsewhere"	"Age-related cataract"	1	47	136	183
"J96"	"N89"	"Respiratory failure, not elsewhere classified"	"Other noninflammatory disorders of vagina"	1	27	108	135
"N19"	"F10"	"Unspecified kidney failure"	"Alcohol related disorders"	1	295	1392	1687
"E64"	"M50"	"Sequelae of malnutrition and other nutritional deficiencies"	"Cervical disc disorders"	1	10	120	130
"C78"	"C73"	"Secondary malignant neoplasm of resp and digestive organs"	"Malignant neoplasm of thyroid gland"	1	74	226	300
"K05"	"O82"	"Gingivitis and periodontal diseases"	"Encounter for cesarean delivery without indication"	1	8	119	127
"I62"	"M17"	"Other and unspecified nontraumatic intracranial hemorrhage"	"Osteoarthritis of knee"	1	13	141	154
"C67"	"K40"	"Malignant neoplasm of bladder"	"Inguinal hernia"	1	286	747	1033
"M23"	"J34"	"Internal derangement of knee"	"Other and unspecified disorders of nose and nasal sinuses"	1	1123	1606	2729
"M81"	"Q87"	"Osteoporosis without current pathological fracture"	"Oth congenital malform syndromes affecting multiple systems"	1	0	34	34
"C78"	"M94"	"Secondary malignant neoplasm of resp and digestive organs"	"Other disorders of cartilage"	1	0	28	28
"N93"	"O71"	"Other abnormal uterine and vaginal bleeding"	"Other obstetric trauma"	1	46	581	627
"B36"	"E11"	"Other superficial mycoses"	"Type 2 diabetes mellitus"	1	90	202	292
"F55"	"L02"	"Abuse of non-psychoactive substances"	"Cutaneous abscess, furuncle and carbuncle"	1	26	84	110
"I82"	"I20"	"Other venous embolism and thrombosis"	"Angina pectoris"	1	133	716	849
"C83"	"N84"	"Non-follicular lymphoma"	"Polyp of female genital tract"	1	10	56	66
"G96"	"E66"	"Other disorders of central nervous system"	"Overweight and obesity"	1	376	1650	2026
"D68"	"I25"	"Other coagulation defects"	"Chronic ischemic heart disease"	1	625	1479	2104
"J43"	"M72"	"Emphysema"	"Fibroblastic disorders"	1	64	185	249
"D18"	"O62"	"Hemangioma and lymphangioma, any site"	"Abnormalities of forces of labor"	1	49	246	295
"J18"	"L71"	"Pneumonia, unspecified organism"	"Rosacea"	1	137	291	428
"H65"	"Q21"	"Nonsuppurative otitis media"	"Congenital malformations of cardiac septa"	1	387	1587	1974
"H26"	"H28"	"Other cataract"	"Cataract in diseases classified elsewhere"	1	104	368	472
"K64"	"C54"	"Hemorrhoids and perianal venous thrombosis"	"Malignant neoplasm of corpus uteri"	1	2	77	79
"K30"	"O62"	"Functional dyspepsia"	"Abnormalities of forces of labor"	1	246	1742	1988
"G47"	"C57"	"Sleep disorders"	"Malignant neoplasm of other and unsp female genital organs"	1	14	60	74
"K64"	"G82"	"Hemorrhoids and perianal venous thrombosis"	"Paraplegia (paraparesis) and quadriplegia (quadriparesis)"	1	0	100	100
"J18"	"M51"	"Pneumonia, unspecified organism"	"Thoracic, thoracolum, and lumbosacral intvrt disc disorders"	1	0	10154	10154
"K59"	"C91"	"Other functional intestinal disorders"	"Lymphoid leukemia"	1	256	448	704
"C79"	"H65"	"Secondary malignant neoplasm of other and unspecified sites"	"Nonsuppurative otitis media"	1	18	158	176
"M50"	"C62"	"Cervical disc disorders"	"Malignant neoplasm of testis"	1	3	44	47
"M67"	"A09"	"Other disorders of synovium and tendon"	"Infectious gastroenteritis and colitis, unspecified"	1	368	866	1234
"I89"	"O70"	"Oth noninfective disorders of lymphatic vessels and nodes"	"Perineal laceration during delivery"	1	0	168	168
"H25"	"N93"	"Age-related cataract"	"Other abnormal uterine and vaginal bleeding"	1	106	208	314
"I20"	"M51"	"Angina pectoris"	"Thoracic, thoracolum, and lumbosacral intvrt disc disorders"	1	3488	5230	8718
"K27"	"O80"	"Peptic ulcer, site unspecified"	"Encounter for full-term uncomplicated delivery"	1	17	143	160
"A41"	"M16"	"Other sepsis"	"Osteoarthritis of hip"	1	0	5523	5523
"N91"	"J35"	"Absent, scanty and rare menstruation"	"Chronic diseases of tonsils and adenoids"	1	8	175	183
"C18"	"M54"	"Malignant neoplasm of colon"	"Dorsalgia"	1	673	1275	1948
"K52"	"C50"	"Other and unsp noninfective gastroenteritis and colitis"	"Malignant neoplasm of breast"	1	335	1212	1547
"G82"	"C50"	"Paraplegia (paraparesis) and quadriplegia (quadriparesis)"	"Malignant neoplasm of breast"	1	52	132	184
"C53"	"O80"	"Malignant neoplasm of cervix uteri"	"Encounter for full-term uncomplicated delivery"	1	0	611	611
"H02"	"H91"	"Other disorders of eyelid"	"Other and unspecified hearing loss"	1	1543	2958	4501
"O35"	"O02"	"Maternal care for known or suspected fetal abnlt and damage"	"Other abnormal products of conception"	1	572	1232	1804
"D30"	"N20"	"Benign neoplasm of urinary organs"	"Calculus of kidney and ureter"	1	459	635	1094
"K05"	"I12"	"Gingivitis and periodontal diseases"	"Hypertensive chronic kidney disease"	1	54	190	244
"I95"	"M20"	"Hypotension"	"Acquired deformities of fingers and toes"	1	22	389	411
"I46"	"G40"	"Cardiac arrest"	"Epilepsy and recurrent seizures"	1	210	1013	1223
"D05"	"O68"	"Carcinoma in situ of breast"	"Labor and delivery comp by abnlt of fetal acid-base balance"	1	0	30	30
"M46"	"N63"	"Other inflammatory spondylopathies"	"Unspecified lump in breast"	1	15	68	83
"M77"	"O80"	"Other enthesopathies"	"Encounter for full-term uncomplicated delivery"	1	0	2167	2167
"L97"	"N40"	"Non-pressure chronic ulcer of lower limb, NEC"	"Benign prostatic hyperplasia"	1	248	1265	1513
"G51"	"K40"	"Facial nerve disorders"	"Inguinal hernia"	1	122	265	387
"H35"	"O64"	"Other retinal disorders"	"Obstructed labor due to malposition and malpresent of fetus"	1	0	48	48
"L12"	"F10"	"Pemphigoid"	"Alcohol related disorders"	1	24	87	111
"K52"	"J34"	"Other and unsp noninfective gastroenteritis and colitis"	"Other and unspecified disorders of nose and nasal sinuses"	1	149	352	501
"K43"	"J45"	"Ventral hernia"	"Asthma"	1	751	1158	1909
"D64"	"N70"	"Other anemias"	"Salpingitis and oophoritis"	1	15	214	229
"C34"	"M66"	"Malignant neoplasm of bronchus and lung"	"Spontaneous rupture of synovium and tendon"	1	4	98	102
"I47"	"N80"	"Paroxysmal tachycardia"	"Endometriosis"	1	67	140	207
"D61"	"I20"	"Oth aplastic anemias and other bone marrow failure syndromes"	"Angina pectoris"	1	32	302	334
"G96"	"I60"	"Other disorders of central nervous system"	"Nontraumatic subarachnoid hemorrhage"	1	225	550	775
"G63"	"H93"	"Polyneuropathy in diseases classified elsewhere"	"Other disorders of ear, not elsewhere classified"	1	28	107	135
"J81"	"M16"	"Pulmonary edema"	"Osteoarthritis of hip"	1	23	889	912
"M53"	"J36"	"Other and unspecified dorsopathies, not elsewhere classified"	"Peritonsillar abscess"	1	12	75	87
"D64"	"I24"	"Other anemias"	"Other acute ischemic heart diseases"	1	479	723	1202
"N17"	"N84"	"Acute kidney failure"	"Polyp of female genital tract"	1	6	144	150
"N20"	"L03"	"Calculus of kidney and ureter"	"Cellulitis and acute lymphangitis"	1	151	417	568
"H26"	"D17"	"Other cataract"	"Benign lipomatous neoplasm"	1	204	630	834
"C67"	"M51"	"Malignant neoplasm of bladder"	"Thoracic, thoracolum, and lumbosacral intvrt disc disorders"	1	70	386	456
"C25"	"C18"	"Malignant neoplasm of pancreas"	"Malignant neoplasm of colon"	1	123	278	401
"G44"	"J05"	"Other headache syndromes"	"Acute obstructive laryngitis [croup] and epiglottitis"	1	0	97	97
"F06"	"J45"	"Other mental disorders due to known physiological condition"	"Asthma"	1	59	303	362
"C77"	"K40"	"Secondary and unspecified malignant neoplasm of lymph nodes"	"Inguinal hernia"	1	44	851	895
"C61"	"K26"	"Malignant neoplasm of prostate"	"Duodenal ulcer"	1	303	531	834
"O66"	"N97"	"Other obstructed labor"	"Female infertility"	1	318	1906	2224
"F45"	"M08"	"Somatoform disorders"	"Juvenile arthritis"	1	5	37	42
"H81"	"N92"	"Disorders of vestibular function"	"Excessive, frequent and irregular menstruation"	1	317	1034	1351
"N94"	"H65"	"Pain and oth cond assoc w fem gntl org and menstrual cycle"	"Nonsuppurative otitis media"	1	10	153	163
"H17"	"J35"	"Corneal scars and opacities"	"Chronic diseases of tonsils and adenoids"	1	2	35	37
"D46"	"D53"	"Myelodysplastic syndromes"	"Other nutritional anemias"	1	44	114	158
"L85"	"O80"	"Other epidermal thickening"	"Encounter for full-term uncomplicated delivery"	1	4	44	48
"C79"	"C67"	"Secondary malignant neoplasm of other and unspecified sites"	"Malignant neoplasm of bladder"	1	447	1997	2444
"D63"	"K45"	"Anemia in chronic diseases classified elsewhere"	"Other abdominal hernia"	1	13	68	81
"N28"	"H28"	"Oth disorders of kidney and ureter, not elsewhere classified"	"Cataract in diseases classified elsewhere"	1	0	25	25
"K92"	"H44"	"Other diseases of digestive system"	"Disorders of globe"	1	45	109	154
"H17"	"O80"	"Corneal scars and opacities"	"Encounter for full-term uncomplicated delivery"	1	4	62	66
"I49"	"K42"	"Other cardiac arrhythmias"	"Umbilical hernia"	1	218	387	605
"I34"	"Q90"	"Nonrheumatic mitral valve disorders"	"Down syndrome"	1	3	37	40
"A41"	"C21"	"Other sepsis"	"Malignant neoplasm of anus and anal canal"	1	47	151	198
"K56"	"M79"	"Paralytic ileus and intestinal obstruction without hernia"	"Oth and unsp soft tissue disorders, not elsewhere classified"	1	830	1614	2444
"C79"	"D41"	"Secondary malignant neoplasm of other and unspecified sites"	"Neoplasm of uncertain behavior of urinary organs"	1	96	319	415
"I44"	"I35"	"Atrioventricular and left bundle-branch block"	"Nonrheumatic aortic valve disorders"	1	2223	2583	4806
"D32"	"J45"	"Benign neoplasm of meninges"	"Asthma"	1	52	140	192
"K90"	"O26"	"Intestinal malabsorption"	"Maternal care for oth conditions predom related to pregnancy"	1	11	121	132
"M51"	"O71"	"Thoracic, thoracolum, and lumbosacral intvrt disc disorders"	"Other obstetric trauma"	1	0	747	747
"G57"	"M54"	"Mononeuropathies of lower limb"	"Dorsalgia"	1	929	1299	2228
"E86"	"C44"	"Volume depletion"	"Other and unspecified malignant neoplasm of skin"	1	0	5192	5192
"D47"	"N84"	"Oth neoplm of uncrt behav of lymphoid, hematpoetc & rel tiss"	"Polyp of female genital tract"	1	6	90	96
"C73"	"O80"	"Malignant neoplasm of thyroid gland"	"Encounter for full-term uncomplicated delivery"	1	0	265	265
"K43"	"K86"	"Ventral hernia"	"Other diseases of pancreas"	1	257	394	651
"I82"	"N97"	"Other venous embolism and thrombosis"	"Female infertility"	1	14	83	97
"L89"	"N43"	"Pressure ulcer"	"Hydrocele and spermatocele"	1	18	146	164
"J43"	"H91"	"Emphysema"	"Other and unspecified hearing loss"	1	503	990	1493
"C34"	"I78"	"Malignant neoplasm of bronchus and lung"	"Diseases of capillaries"	1	19	161	180
"O13"	"O20"	"Gestational hypertension without significant proteinuria"	"Hemorrhage in early pregnancy"	1	534	1506	2040
"A04"	"J44"	"Other bacterial intestinal infections"	"Other chronic obstructive pulmonary disease"	1	854	2630	3484
"G91"	"I47"	"Hydrocephalus"	"Paroxysmal tachycardia"	1	15	111	126
"G93"	"O47"	"Other disorders of brain"	"False labor"	1	5	42	47
"K59"	"J42"	"Other functional intestinal disorders"	"Unspecified chronic bronchitis"	1	1060	2636	3696
"B96"	"A46"	"Oth bacterial agents as the cause of diseases classd elswhr"	"Erysipelas"	1	112	256	368
"C45"	"M51"	"Mesothelioma"	"Thoracic, thoracolum, and lumbosacral intvrt disc disorders"	1	0	68	68
"N18"	"N81"	"Chronic kidney disease (CKD)"	"Female genital prolapse"	1	5	873	878
"M85"	"G35"	"Other disorders of bone density and structure"	"Multiple sclerosis"	1	0	198	198
"H26"	"D27"	"Other cataract"	"Benign neoplasm of ovary"	1	83	418	501
"D13"	"K40"	"Benign neoplasm of and ill-defined parts of digestive system"	"Inguinal hernia"	1	89	297	386
"L57"	"L50"	"Skin changes due to chronic expsr to nonionizing radiation"	"Urticaria"	1	31	125	156
"J86"	"M16"	"Pyothorax"	"Osteoarthritis of hip"	1	69	193	262
"O36"	"N62"	"Maternal care for other fetal problems"	"Hypertrophy of breast"	1	99	215	314
"J96"	"G96"	"Respiratory failure, not elsewhere classified"	"Other disorders of central nervous system"	1	778	1559	2337
"N25"	"H83"	"Disorders resulting from impaired renal tubular function"	"Other diseases of inner ear"	1	0	26	26
"C25"	"N45"	"Malignant neoplasm of pancreas"	"Orchitis and epididymitis"	1	1	72	73
"E66"	"A15"	"Overweight and obesity"	"Respiratory tuberculosis"	1	8	70	78
"C50"	"O14"	"Malignant neoplasm of breast"	"Pre-eclampsia"	1	0	79	79
"G24"	"N92"	"Dystonia"	"Excessive, frequent and irregular menstruation"	1	25	170	195
"J84"	"C18"	"Other interstitial pulmonary diseases"	"Malignant neoplasm of colon"	1	147	275	422
"N81"	"A63"	"Female genital prolapse"	"Oth predominantly sexually transmitted diseases, NEC"	1	19	203	222
"E11"	"H52"	"Type 2 diabetes mellitus"	"Disorders of refraction and accommodation"	1	497	720	1217
"J17"	"I20"	"Pneumonia in diseases classified elsewhere"	"Angina pectoris"	1	23	152	175
"N46"	"C91"	"Male infertility"	"Lymphoid leukemia"	1	6	46	52
"D64"	"A46"	"Other anemias"	"Erysipelas"	1	2884	3386	6270
"M77"	"M23"	"Other enthesopathies"	"Internal derangement of knee"	1	2440	2933	5373
"M81"	"K86"	"Osteoporosis without current pathological fracture"	"Other diseases of pancreas"	1	318	626	944
"O40"	"E10"	"Polyhydramnios"	"Type 1 diabetes mellitus"	1	13	124	137
"G47"	"L92"	"Sleep disorders"	"Granulomatous disorders of skin and subcutaneous tissue"	1	22	71	93
"C50"	"O86"	"Malignant neoplasm of breast"	"Other puerperal infections"	1	0	25	25
"A41"	"Q44"	"Other sepsis"	"Congenital malform of gallbladder, bile ducts and liver"	1	12	88	100
"J31"	"O20"	"Chronic rhinitis, nasopharyngitis and pharyngitis"	"Hemorrhage in early pregnancy"	1	14	72	86
"I51"	"H33"	"Complications and ill-defined descriptions of heart disease"	"Retinal detachments and breaks"	1	14	104	118
"H01"	"B34"	"Other inflammation of eyelid"	"Viral infection of unspecified site"	1	74	189	263
"M16"	"D39"	"Osteoarthritis of hip"	"Neoplasm of uncertain behavior of female genital organs"	1	15	72	87
"E21"	"H33"	"Hyperparathyroidism and other disorders of parathyroid gland"	"Retinal detachments and breaks"	1	11	85	96
"F41"	"M05"	"Other anxiety disorders"	"Rheumatoid arthritis with rheumatoid factor"	1	41	193	234
"N94"	"J36"	"Pain and oth cond assoc w fem gntl org and menstrual cycle"	"Peritonsillar abscess"	1	37	147	184
"K90"	"O47"	"Intestinal malabsorption"	"False labor"	1	14	60	74
"I35"	"C62"	"Nonrheumatic aortic valve disorders"	"Malignant neoplasm of testis"	1	0	47	47
"E03"	"L05"	"Other hypothyroidism"	"Pilonidal cyst and sinus"	1	10	125	135
"K56"	"K20"	"Paralytic ileus and intestinal obstruction without hernia"	"Esophagitis"	1	419	719	1138
"D64"	"H35"	"Other anemias"	"Other retinal disorders"	1	0	8107	8107
"K60"	"O03"	"Fissure and fistula of anal and rectal regions"	"Spontaneous abortion"	1	85	395	480
"E64"	"M20"	"Sequelae of malnutrition and other nutritional deficiencies"	"Acquired deformities of fingers and toes"	1	16	153	169
"N19"	"J32"	"Unspecified kidney failure"	"Chronic sinusitis"	1	27	80	107
"O31"	"N97"	"Complications specific to multiple gestation"	"Female infertility"	1	93	574	667
"C79"	"K62"	"Secondary malignant neoplasm of other and unspecified sites"	"Other diseases of anus and rectum"	1	284	1276	1560
"O63"	"O03"	"Long labor"	"Spontaneous abortion"	1	1514	2073	3587
"O68"	"O00"	"Labor and delivery comp by abnlt of fetal acid-base balance"	"Ectopic pregnancy"	1	1187	1754	2941
"I95"	"G20"	"Hypotension"	"Parkinson's disease"	1	521	808	1329
"H36"	"D17"	"Retinal disorders in diseases classified elsewhere"	"Benign lipomatous neoplasm"	1	96	193	289
"H26"	"N97"	"Other cataract"	"Female infertility"	1	0	78	78
"H25"	"O32"	"Age-related cataract"	"Maternal care for malpresentation of fetus"	1	0	28	28
"M75"	"K29"	"Shoulder lesions"	"Gastritis and duodenitis"	1	1639	3094	4733
"C02"	"M54"	"Malignant neoplasm of other and unspecified parts of tongue"	"Dorsalgia"	1	19	91	110
"G96"	"M32"	"Other disorders of central nervous system"	"Systemic lupus erythematosus (SLE)"	1	9	54	63
"N19"	"O80"	"Unspecified kidney failure"	"Encounter for full-term uncomplicated delivery"	1	0	63	63
"I46"	"N19"	"Cardiac arrest"	"Unspecified kidney failure"	1	538	965	1503
"I80"	"D06"	"Phlebitis and thrombophlebitis"	"Carcinoma in situ of cervix uteri"	1	0	93	93
"C22"	"M06"	"Malignant neoplasm of liver and intrahepatic bile ducts"	"Other rheumatoid arthritis"	1	1	46	47
"K57"	"D24"	"Diverticular disease of intestine"	"Benign neoplasm of breast"	1	0	766	766
"I47"	"K35"	"Paroxysmal tachycardia"	"Acute appendicitis"	1	272	475	747
"M54"	"O64"	"Dorsalgia"	"Obstructed labor due to malposition and malpresent of fetus"	1	193	1064	1257
"K01"	"Q74"	"Embedded and impacted teeth"	"Other congenital malformations of limb(s)"	1	4	46	50
"C24"	"M75"	"Malignant neoplasm of other and unsp parts of biliary tract"	"Shoulder lesions"	1	3	112	115
"K58"	"L68"	"Irritable bowel syndrome"	"Hypertrichosis"	1	47	137	184
"M81"	"K26"	"Osteoporosis without current pathological fracture"	"Duodenal ulcer"	1	855	1811	2666
"I80"	"O62"	"Phlebitis and thrombophlebitis"	"Abnormalities of forces of labor"	1	81	971	1052
"A49"	"C44"	"Bacterial infection of unspecified site"	"Other and unspecified malignant neoplasm of skin"	1	376	1243	1619
"K81"	"F10"	"Cholecystitis"	"Alcohol related disorders"	1	252	600	852
"G93"	"D27"	"Other disorders of brain"	"Benign neoplasm of ovary"	1	15	63	78
"C03"	"I25"	"Malignant neoplasm of gum"	"Chronic ischemic heart disease"	1	13	58	71
"C22"	"K57"	"Malignant neoplasm of liver and intrahepatic bile ducts"	"Diverticular disease of intestine"	1	47	344	391
"N39"	"N75"	"Other disorders of urinary system"	"Diseases of Bartholin's gland"	1	54	286	340
"N30"	"N63"	"Cystitis"	"Unspecified lump in breast"	1	886	1454	2340
"H25"	"N81"	"Age-related cataract"	"Female genital prolapse"	1	0	8665	8665
"M67"	"H80"	"Other disorders of synovium and tendon"	"Otosclerosis"	1	28	101	129
"G98"	"L20"	"Other disorders of nervous system not elsewhere classified"	"Atopic dermatitis"	1	1	41	42
"C34"	"M62"	"Malignant neoplasm of bronchus and lung"	"Other disorders of muscle"	1	0	1625	1625
"N28"	"M67"	"Oth disorders of kidney and ureter, not elsewhere classified"	"Other disorders of synovium and tendon"	1	30	111	141
"K52"	"M20"	"Other and unsp noninfective gastroenteritis and colitis"	"Acquired deformities of fingers and toes"	1	280	794	1074
"I61"	"H90"	"Nontraumatic intracerebral hemorrhage"	"Conductive and sensorineural hearing loss"	1	107	553	660
"I25"	"O72"	"Chronic ischemic heart disease"	"Postpartum hemorrhage"	1	7	85	92
"N61"	"N92"	"Inflammatory disorders of breast"	"Excessive, frequent and irregular menstruation"	1	255	516	771
"D64"	"O13"	"Other anemias"	"Gestational hypertension without significant proteinuria"	1	2	67	69
"J90"	"G57"	"Pleural effusion, not elsewhere classified"	"Mononeuropathies of lower limb"	1	13	84	97
"G24"	"O20"	"Dystonia"	"Hemorrhage in early pregnancy"	1	1	48	49
"H36"	"N97"	"Retinal disorders in diseases classified elsewhere"	"Female infertility"	1	17	141	158
"C83"	"K40"	"Non-follicular lymphoma"	"Inguinal hernia"	1	69	376	445
"I31"	"M20"	"Other diseases of pericardium"	"Acquired deformities of fingers and toes"	1	14	58	72
"C50"	"N94"	"Malignant neoplasm of breast"	"Pain and oth cond assoc w fem gntl org and menstrual cycle"	1	44	372	416
"G62"	"N60"	"Other and unspecified polyneuropathies"	"Benign mammary dysplasia"	1	6	140	146
"L90"	"D23"	"Atrophic disorders of skin"	"Other benign neoplasms of skin"	1	494	789	1283
"O42"	"O00"	"Premature rupture of membranes"	"Ectopic pregnancy"	1	487	890	1377
"M87"	"M31"	"Osteonecrosis"	"Other necrotizing vasculopathies"	1	10	77	87
"E83"	"M24"	"Disorders of mineral metabolism"	"Other specific joint derangements"	1	14	64	78
"I50"	"D48"	"Heart failure"	"Neoplasm of uncertain behavior of other and unsp sites"	1	172	309	481
"G24"	"O02"	"Dystonia"	"Other abnormal products of conception"	1	4	49	53
"J81"	"E11"	"Pulmonary edema"	"Type 2 diabetes mellitus"	1	1022	2871	3893
"N18"	"M24"	"Chronic kidney disease (CKD)"	"Other specific joint derangements"	1	31	182	213
"O64"	"N70"	"Obstructed labor due to malposition and malpresent of fetus"	"Salpingitis and oophoritis"	1	169	276	445
"D32"	"M20"	"Benign neoplasm of meninges"	"Acquired deformities of fingers and toes"	1	32	100	132
"E23"	"N81"	"Hypofunction and other disorders of the pituitary gland"	"Female genital prolapse"	1	19	86	105
"C24"	"G45"	"Malignant neoplasm of other and unsp parts of biliary tract"	"Transient cerebral ischemic attacks and related syndromes"	1	10	91	101
"C61"	"D11"	"Malignant neoplasm of prostate"	"Benign neoplasm of major salivary glands"	1	31	125	156
"C22"	"I47"	"Malignant neoplasm of liver and intrahepatic bile ducts"	"Paroxysmal tachycardia"	1	5	113	118
"E04"	"O75"	"Other nontoxic goiter"	"Oth complications of labor and delivery, NEC"	1	30	364	394
"F32"	"M70"	"Depressive episode"	"Soft tissue disorders related to use, overuse and pressure"	1	332	604	936
"J70"	"I10"	"Respiratory conditions due to other external agents"	"Essential (primary) hypertension"	1	93	221	314
"L12"	"M16"	"Pemphigoid"	"Osteoarthritis of hip"	1	10	129	139
"K55"	"K62"	"Vascular disorders of intestine"	"Other diseases of anus and rectum"	1	507	918	1425
"K22"	"J36"	"Other diseases of esophagus"	"Peritonsillar abscess"	1	1	53	54
"C38"	"J90"	"Malignant neoplasm of heart, mediastinum and pleura"	"Pleural effusion, not elsewhere classified"	1	181	441	622
"O75"	"Q66"	"Oth complications of labor and delivery, NEC"	"Congenital deformities of feet"	1	7	42	49
"K04"	"K70"	"Diseases of pulp and periapical tissues"	"Alcoholic liver disease"	1	140	251	391
"O70"	"N91"	"Perineal laceration during delivery"	"Absent, scanty and rare menstruation"	1	324	644	968
"C16"	"M71"	"Malignant neoplasm of stomach"	"Other bursopathies"	1	0	44	44
"M80"	"K30"	"Osteoporosis with current pathological fracture"	"Functional dyspepsia"	1	289	1465	1754
"E89"	"N80"	"Postproc endocrine and metabolic comp and disorders, NEC"	"Endometriosis"	1	1	61	62
"C24"	"C61"	"Malignant neoplasm of other and unsp parts of biliary tract"	"Malignant neoplasm of prostate"	1	10	66	76
"D64"	"O26"	"Other anemias"	"Maternal care for oth conditions predom related to pregnancy"	1	25	419	444
"N13"	"K42"	"Obstructive and reflux uropathy"	"Umbilical hernia"	1	107	213	320
"C34"	"C09"	"Malignant neoplasm of bronchus and lung"	"Malignant neoplasm of tonsil"	1	34	213	247
"N19"	"E11"	"Unspecified kidney failure"	"Type 2 diabetes mellitus"	1	0	6898	6898
"D10"	"N80"	"Benign neoplasm of mouth and pharynx"	"Endometriosis"	1	3	42	45
"E15"	"E10"	"Nondiabetic hypoglycemic coma"	"Type 1 diabetes mellitus"	1	360	2045	2405
"I35"	"C53"	"Nonrheumatic aortic valve disorders"	"Malignant neoplasm of cervix uteri"	1	9	69	78
"K85"	"H10"	"Acute pancreatitis"	"Conjunctivitis"	1	67	228	295
"I63"	"I86"	"Cerebral infarction"	"Varicose veins of other sites"	1	27	93	120
"B95"	"C50"	"Strep as the cause of diseases classified elsewhere"	"Malignant neoplasm of breast"	1	3	70	73
"I87"	"N97"	"Other disorders of veins"	"Female infertility"	1	0	31	31
"F43"	"N97"	"Reaction to severe stress, and adjustment disorders"	"Female infertility"	1	28	465	493
"M86"	"D30"	"Osteomyelitis"	"Benign neoplasm of urinary organs"	1	13	56	69
"H60"	"O04"	"Otitis externa"	"Complications following (induced) termination of pregnancy"	1	97	421	518
"I26"	"D21"	"Pulmonary embolism"	"Other benign neoplasms of connective and other soft tissue"	1	22	71	93
"K55"	"K92"	"Vascular disorders of intestine"	"Other diseases of digestive system"	1	650	886	1536
"F03"	"C67"	"Unspecified dementia"	"Malignant neoplasm of bladder"	1	86	371	457
"D24"	"H65"	"Benign neoplasm of breast"	"Nonsuppurative otitis media"	1	39	101	140
"H36"	"J42"	"Retinal disorders in diseases classified elsewhere"	"Unspecified chronic bronchitis"	1	81	220	301
"I46"	"D21"	"Cardiac arrest"	"Other benign neoplasms of connective and other soft tissue"	1	0	50	50
"C43"	"K80"	"Malignant melanoma of skin"	"Cholelithiasis"	1	239	464	703
"I48"	"N81"	"Atrial fibrillation and flutter"	"Female genital prolapse"	1	0	4875	4875
"C34"	"M20"	"Malignant neoplasm of bronchus and lung"	"Acquired deformities of fingers and toes"	1	0	808	808
"N18"	"D16"	"Chronic kidney disease (CKD)"	"Benign neoplasm of bone and articular cartilage"	1	5	88	93
"M79"	"D27"	"Oth and unsp soft tissue disorders, not elsewhere classified"	"Benign neoplasm of ovary"	1	503	1131	1634
"F33"	"N60"	"Major depressive disorder, recurrent"	"Benign mammary dysplasia"	1	17	248	265
"E53"	"N40"	"Deficiency of other B group vitamins"	"Benign prostatic hyperplasia"	1	102	328	430
"I60"	"O03"	"Nontraumatic subarachnoid hemorrhage"	"Spontaneous abortion"	1	0	71	71
"L30"	"O32"	"Other and unspecified dermatitis"	"Maternal care for malpresentation of fetus"	1	41	124	165
"K62"	"A63"	"Other diseases of anus and rectum"	"Oth predominantly sexually transmitted diseases, NEC"	1	159	484	643
"I26"	"O02"	"Pulmonary embolism"	"Other abnormal products of conception"	1	28	126	154
"B44"	"M06"	"Aspergillosis"	"Other rheumatoid arthritis"	1	1	29	30
"D27"	"O04"	"Benign neoplasm of ovary"	"Complications following (induced) termination of pregnancy"	1	232	1653	1885
"D50"	"H33"	"Iron deficiency anemia"	"Retinal detachments and breaks"	1	34	290	324
"E83"	"O34"	"Disorders of mineral metabolism"	"Maternal care for abnormality of pelvic organs"	1	1	27	28
"F33"	"H04"	"Major depressive disorder, recurrent"	"Disorders of lacrimal system"	1	18	73	91
"I85"	"H93"	"Esophageal varices"	"Other disorders of ear, not elsewhere classified"	1	25	102	127
"C79"	"I10"	"Secondary malignant neoplasm of other and unspecified sites"	"Essential (primary) hypertension"	1	0	9106	9106
"D38"	"N92"	"Neoplm of uncrt behav of mid ear & resp and intrathorac org"	"Excessive, frequent and irregular menstruation"	1	2	41	43
"H25"	"M32"	"Age-related cataract"	"Systemic lupus erythematosus (SLE)"	1	57	214	271
"G35"	"O68"	"Multiple sclerosis"	"Labor and delivery comp by abnlt of fetal acid-base balance"	1	37	270	307
"C78"	"B35"	"Secondary malignant neoplasm of resp and digestive organs"	"Dermatophytosis"	1	5	38	43
"M19"	"N81"	"Other and unspecified osteoarthritis"	"Female genital prolapse"	1	671	1967	2638
"M05"	"O30"	"Rheumatoid arthritis with rheumatoid factor"	"Multiple gestation"	1	3	34	37
"M75"	"J03"	"Shoulder lesions"	"Acute tonsillitis"	1	308	1050	1358
"F73"	"H66"	"Profound intellectual disabilities"	"Suppurative and unspecified otitis media"	1	5	54	59
"C25"	"M05"	"Malignant neoplasm of pancreas"	"Rheumatoid arthritis with rheumatoid factor"	1	8	94	102
"F32"	"M35"	"Depressive episode"	"Other systemic involvement of connective tissue"	1	493	1064	1557
"J06"	"D17"	"Acute upper resp infections of multiple and unsp sites"	"Benign lipomatous neoplasm"	1	51	135	186
"I35"	"L93"	"Nonrheumatic aortic valve disorders"	"Lupus erythematosus"	1	12	72	84
"C49"	"O80"	"Malignant neoplasm of other connective and soft tissue"	"Encounter for full-term uncomplicated delivery"	1	0	120	120
"A41"	"D06"	"Other sepsis"	"Carcinoma in situ of cervix uteri"	1	0	67	67
"K05"	"N94"	"Gingivitis and periodontal diseases"	"Pain and oth cond assoc w fem gntl org and menstrual cycle"	1	21	75	96
"M13"	"O48"	"Other arthritis"	"Late pregnancy"	1	0	126	126
"E78"	"K21"	"Disorders of lipoprotein metabolism and other lipidemias"	"Gastro-esophageal reflux disease"	1	2658	4059	6717
"G96"	"E10"	"Other disorders of central nervous system"	"Type 1 diabetes mellitus"	1	239	976	1215
"J06"	"Q40"	"Acute upper resp infections of multiple and unsp sites"	"Other congenital malformations of upper alimentary tract"	1	21	104	125
"J84"	"K40"	"Other interstitial pulmonary diseases"	"Inguinal hernia"	1	98	621	719
"J84"	"M22"	"Other interstitial pulmonary diseases"	"Disorder of patella"	1	0	47	47
"A49"	"N45"	"Bacterial infection of unspecified site"	"Orchitis and epididymitis"	1	106	345	451
"I83"	"H10"	"Varicose veins of lower extremities"	"Conjunctivitis"	1	246	713	959
"C61"	"L23"	"Malignant neoplasm of prostate"	"Allergic contact dermatitis"	1	10	68	78
"H35"	"M67"	"Other retinal disorders"	"Other disorders of synovium and tendon"	1	230	697	927
"I80"	"N92"	"Phlebitis and thrombophlebitis"	"Excessive, frequent and irregular menstruation"	1	449	1010	1459
"O87"	"O46"	"Venous complications and hemorrhoids in the puerperium"	"Antepartum hemorrhage, not elsewhere classified"	1	93	177	270
"G12"	"G57"	"Spinal muscular atrophy and related syndromes"	"Mononeuropathies of lower limb"	1	21	75	96
"J95"	"C09"	"Intraop and postproc comp and disorders of resp sys, NEC"	"Malignant neoplasm of tonsil"	1	12	60	72
"A46"	"N81"	"Erysipelas"	"Female genital prolapse"	1	180	793	973
"G95"	"C20"	"Other and unspecified diseases of spinal cord"	"Malignant neoplasm of rectum"	1	56	364	420
"H52"	"J36"	"Disorders of refraction and accommodation"	"Peritonsillar abscess"	1	43	131	174
"H54"	"N81"	"Blindness and low vision"	"Female genital prolapse"	1	25	190	215
"E68"	"K60"	"Sequelae of hyperalimentation"	"Fissure and fistula of anal and rectal regions"	1	25	88	113
"D68"	"O64"	"Other coagulation defects"	"Obstructed labor due to malposition and malpresent of fetus"	1	67	150	217
"J81"	"D25"	"Pulmonary edema"	"Leiomyoma of uterus"	1	0	50	50
"F06"	"M72"	"Other mental disorders due to known physiological condition"	"Fibroblastic disorders"	1	2	104	106
"A41"	"N36"	"Other sepsis"	"Other disorders of urethra"	1	121	227	348
"L97"	"L72"	"Non-pressure chronic ulcer of lower limb, NEC"	"Follicular cysts of skin and subcutaneous tissue"	1	12	76	88
"E13"	"M19"	"Other specified diabetes mellitus"	"Other and unspecified osteoarthritis"	1	81	170	251
"D47"	"G40"	"Oth neoplm of uncrt behav of lymphoid, hematpoetc & rel tiss"	"Epilepsy and recurrent seizures"	1	38	120	158
"E34"	"K42"	"Other endocrine disorders"	"Umbilical hernia"	1	18	102	120
"N28"	"A46"	"Oth disorders of kidney and ureter, not elsewhere classified"	"Erysipelas"	1	259	481	740
"L90"	"K80"	"Atrophic disorders of skin"	"Cholelithiasis"	1	428	892	1320
"K04"	"O42"	"Diseases of pulp and periapical tissues"	"Premature rupture of membranes"	1	27	86	113
"M35"	"H10"	"Other systemic involvement of connective tissue"	"Conjunctivitis"	1	258	517	775
"C71"	"H93"	"Malignant neoplasm of brain"	"Other disorders of ear, not elsewhere classified"	1	20	173	193
"C92"	"N43"	"Myeloid leukemia"	"Hydrocele and spermatocele"	1	3	40	43
"N87"	"O70"	"Dysplasia of cervix uteri"	"Perineal laceration during delivery"	1	2290	2873	5163
"N47"	"J35"	"Disorders of prepuce"	"Chronic diseases of tonsils and adenoids"	1	506	1085	1591
"M24"	"K35"	"Other specific joint derangements"	"Acute appendicitis"	1	234	519	753
"M46"	"E66"	"Other inflammatory spondylopathies"	"Overweight and obesity"	1	215	473	688
"D50"	"I48"	"Iron deficiency anemia"	"Atrial fibrillation and flutter"	1	3460	5414	8874
"C64"	"M16"	"Malignant neoplasm of kidney, except renal pelvis"	"Osteoarthritis of hip"	1	94	425	519
"E86"	"O26"	"Volume depletion"	"Maternal care for oth conditions predom related to pregnancy"	1	59	183	242
"J18"	"O44"	"Pneumonia, unspecified organism"	"Placenta previa"	1	25	92	117
"I82"	"O80"	"Other venous embolism and thrombosis"	"Encounter for full-term uncomplicated delivery"	1	0	301	301
"L89"	"G40"	"Pressure ulcer"	"Epilepsy and recurrent seizures"	1	251	773	1024
"M51"	"O72"	"Thoracic, thoracolum, and lumbosacral intvrt disc disorders"	"Postpartum hemorrhage"	1	1283	1645	2928
"N49"	"G82"	"Inflammatory disorders of male genital organs, NEC"	"Paraplegia (paraparesis) and quadriplegia (quadriparesis)"	1	8	45	53
"C24"	"I25"	"Malignant neoplasm of other and unsp parts of biliary tract"	"Chronic ischemic heart disease"	1	35	296	331
"F23"	"F10"	"Brief psychotic disorder"	"Alcohol related disorders"	1	287	629	916
"L72"	"O62"	"Follicular cysts of skin and subcutaneous tissue"	"Abnormalities of forces of labor"	1	0	358	358
"E87"	"F45"	"Other disorders of fluid, electrolyte and acid-base balance"	"Somatoform disorders"	1	59	136	195
"J98"	"C50"	"Other respiratory disorders"	"Malignant neoplasm of breast"	1	122	359	481
"F05"	"G60"	"Delirium due to known physiological condition"	"Hereditary and idiopathic neuropathy"	1	5	39	44
"I89"	"G43"	"Oth noninfective disorders of lymphatic vessels and nodes"	"Migraine"	1	29	86	115
"I48"	"H02"	"Atrial fibrillation and flutter"	"Other disorders of eyelid"	1	1633	2340	3973
"K55"	"N63"	"Vascular disorders of intestine"	"Unspecified lump in breast"	1	0	55	55
"J81"	"C54"	"Pulmonary edema"	"Malignant neoplasm of corpus uteri"	1	12	96	108
"I95"	"G45"	"Hypotension"	"Transient cerebral ischemic attacks and related syndromes"	1	532	1697	2229
"K30"	"H65"	"Functional dyspepsia"	"Nonsuppurative otitis media"	1	116	372	488
"O36"	"A09"	"Maternal care for other fetal problems"	"Infectious gastroenteritis and colitis, unspecified"	1	279	594	873
"D22"	"O48"	"Melanocytic nevi"	"Late pregnancy"	1	25	314	339
"E87"	"G43"	"Other disorders of fluid, electrolyte and acid-base balance"	"Migraine"	1	53	505	558
"M51"	"N46"	"Thoracic, thoracolum, and lumbosacral intvrt disc disorders"	"Male infertility"	1	388	600	988
"E88"	"O80"	"Other and unspecified metabolic disorders"	"Encounter for full-term uncomplicated delivery"	1	0	238	238
"J15"	"D21"	"Bacterial pneumonia, not elsewhere classified"	"Other benign neoplasms of connective and other soft tissue"	1	46	187	233
"H57"	"M65"	"Other disorders of eye and adnexa"	"Synovitis and tenosynovitis"	1	134	396	530
"L93"	"O62"	"Lupus erythematosus"	"Abnormalities of forces of labor"	1	10	48	58
"C83"	"M67"	"Non-follicular lymphoma"	"Other disorders of synovium and tendon"	1	12	95	107
"K21"	"O82"	"Gastro-esophageal reflux disease"	"Encounter for cesarean delivery without indication"	1	130	825	955
"O72"	"L40"	"Postpartum hemorrhage"	"Psoriasis"	1	162	299	461
"M41"	"J05"	"Scoliosis"	"Acute obstructive laryngitis [croup] and epiglottitis"	1	0	118	118
"O70"	"Q51"	"Perineal laceration during delivery"	"Congenital malformations of uterus and cervix"	1	148	328	476
"C80"	"H36"	"Malignant neoplasm without specification of site"	"Retinal disorders in diseases classified elsewhere"	1	5	57	62
"G20"	"D12"	"Parkinson's disease"	"Benign neoplasm of colon, rectum, anus and anal canal"	1	168	524	692
"C34"	"H02"	"Malignant neoplasm of bronchus and lung"	"Other disorders of eyelid"	1	156	946	1102
"D64"	"K29"	"Other anemias"	"Gastritis and duodenitis"	1	5038	6666	11704
"C71"	"J20"	"Malignant neoplasm of brain"	"Acute bronchitis"	1	18	64	82
"K35"	"Q53"	"Acute appendicitis"	"Undescended and ectopic testicle"	1	7	293	300
"J96"	"J61"	"Respiratory failure, not elsewhere classified"	"Pneumoconiosis due to asbestos and other mineral fibers"	1	88	201	289
"C78"	"N40"	"Secondary malignant neoplasm of resp and digestive organs"	"Benign prostatic hyperplasia"	1	0	2976	2976
"N61"	"L05"	"Inflammatory disorders of breast"	"Pilonidal cyst and sinus"	1	14	70	84
"E53"	"M35"	"Deficiency of other B group vitamins"	"Other systemic involvement of connective tissue"	1	56	146	202
"D59"	"I83"	"Acquired hemolytic anemia"	"Varicose veins of lower extremities"	1	16	72	88
"I46"	"H36"	"Cardiac arrest"	"Retinal disorders in diseases classified elsewhere"	1	27	665	692
"L98"	"A46"	"Oth disorders of skin, subcu, not elsewhere classified"	"Erysipelas"	1	1215	1901	3116
"G95"	"J35"	"Other and unspecified diseases of spinal cord"	"Chronic diseases of tonsils and adenoids"	1	0	53	53
"C79"	"D13"	"Secondary malignant neoplasm of other and unspecified sites"	"Benign neoplasm of and ill-defined parts of digestive system"	1	25	150	175
"D62"	"I50"	"Acute posthemorrhagic anemia"	"Heart failure"	1	2019	2509	4528
"K92"	"G45"	"Other diseases of digestive system"	"Transient cerebral ischemic attacks and related syndromes"	1	768	2679	3447
"F45"	"O80"	"Somatoform disorders"	"Encounter for full-term uncomplicated delivery"	1	80	278	358
"F17"	"O70"	"Nicotine dependence"	"Perineal laceration during delivery"	1	287	1175	1462
"D12"	"C62"	"Benign neoplasm of colon, rectum, anus and anal canal"	"Malignant neoplasm of testis"	1	0	68	68
"E16"	"M47"	"Other disorders of pancreatic internal secretion"	"Spondylosis"	1	109	255	364
"C78"	"I83"	"Secondary malignant neoplasm of resp and digestive organs"	"Varicose veins of lower extremities"	1	0	1193	1193
"D32"	"M17"	"Benign neoplasm of meninges"	"Osteoarthritis of knee"	1	98	300	398
"D32"	"E66"	"Benign neoplasm of meninges"	"Overweight and obesity"	1	112	223	335
"N31"	"H66"	"Neuromuscular dysfunction of bladder, NEC"	"Suppurative and unspecified otitis media"	1	19	99	118
"E86"	"I44"	"Volume depletion"	"Atrioventricular and left bundle-branch block"	1	1367	3193	4560
"M87"	"N92"	"Osteonecrosis"	"Excessive, frequent and irregular menstruation"	1	0	72	72
"E86"	"C31"	"Volume depletion"	"Malignant neoplasm of accessory sinuses"	1	24	96	120
"G95"	"N13"	"Other and unspecified diseases of spinal cord"	"Obstructive and reflux uropathy"	1	215	382	597
"N20"	"O68"	"Calculus of kidney and ureter"	"Labor and delivery comp by abnlt of fetal acid-base balance"	1	256	960	1216
"F20"	"J35"	"Schizophrenia"	"Chronic diseases of tonsils and adenoids"	1	0	105	105
"K29"	"B27"	"Gastritis and duodenitis"	"Infectious mononucleosis"	1	32	122	154
"K59"	"J41"	"Other functional intestinal disorders"	"Simple and mucopurulent chronic bronchitis"	1	239	659	898
"H53"	"N80"	"Visual disturbances"	"Endometriosis"	1	26	103	129
"G12"	"M16"	"Spinal muscular atrophy and related syndromes"	"Osteoarthritis of hip"	1	17	96	113
"D17"	"L20"	"Benign lipomatous neoplasm"	"Atopic dermatitis"	1	14	79	93
"N84"	"O13"	"Polyp of female genital tract"	"Gestational hypertension without significant proteinuria"	1	9	96	105
"G30"	"M16"	"Alzheimer's disease"	"Osteoarthritis of hip"	1	0	806	806
"H91"	"N84"	"Other and unspecified hearing loss"	"Polyp of female genital tract"	1	487	812	1299
"M17"	"J36"	"Osteoarthritis of knee"	"Peritonsillar abscess"	1	31	273	304
"O72"	"D24"	"Postpartum hemorrhage"	"Benign neoplasm of breast"	1	648	2198	2846
"C71"	"N48"	"Malignant neoplasm of brain"	"Other disorders of penis"	1	4	39	43
"G93"	"M23"	"Other disorders of brain"	"Internal derangement of knee"	1	79	315	394
"G40"	"I10"	"Epilepsy and recurrent seizures"	"Essential (primary) hypertension"	1	6848	7478	14326
"A49"	"H80"	"Bacterial infection of unspecified site"	"Otosclerosis"	1	0	113	113
"C16"	"H81"	"Malignant neoplasm of stomach"	"Disorders of vestibular function"	1	13	136	149
"K59"	"M94"	"Other functional intestinal disorders"	"Other disorders of cartilage"	1	39	145	184
"E68"	"O04"	"Sequelae of hyperalimentation"	"Complications following (induced) termination of pregnancy"	1	0	520	520
"M80"	"M22"	"Osteoporosis with current pathological fracture"	"Disorder of patella"	1	0	72	72
"G56"	"C62"	"Mononeuropathies of upper limb"	"Malignant neoplasm of testis"	1	10	72	82
"N03"	"N00"	"Chronic nephritic syndrome"	"Acute nephritic syndrome"	1	264	551	815
"M99"	"O24"	"Biomechanical lesions, not elsewhere classified"	"Diabetes in pregnancy, childbirth, and the puerperium"	1	1	29	30
"F32"	"M77"	"Depressive episode"	"Other enthesopathies"	1	213	396	609
"O47"	"B27"	"False labor"	"Infectious mononucleosis"	1	0	102	102
"K08"	"J35"	"Other disorders of teeth and supporting structures"	"Chronic diseases of tonsils and adenoids"	1	24	257	281
"J15"	"C73"	"Bacterial pneumonia, not elsewhere classified"	"Malignant neoplasm of thyroid gland"	1	18	97	115
"J90"	"M25"	"Pleural effusion, not elsewhere classified"	"Other joint disorder, not elsewhere classified"	1	73	232	305
"D22"	"M62"	"Melanocytic nevi"	"Other disorders of muscle"	1	174	607	781
"K25"	"H80"	"Gastric ulcer"	"Otosclerosis"	1	32	195	227
"I74"	"J45"	"Arterial embolism and thrombosis"	"Asthma"	1	125	271	396
"F41"	"H11"	"Other anxiety disorders"	"Other disorders of conjunctiva"	1	35	114	149
"C69"	"C50"	"Malignant neoplasm of eye and adnexa"	"Malignant neoplasm of breast"	1	28	83	111
"K55"	"C61"	"Vascular disorders of intestine"	"Malignant neoplasm of prostate"	1	49	156	205
"F01"	"I99"	"Vascular dementia"	"Other and unspecified disorders of circulatory system"	1	35	125	160
"C34"	"I65"	"Malignant neoplasm of bronchus and lung"	"Occls and stenosis of precerb art, not rslt in cereb infrc"	1	19	529	548
"N20"	"L05"	"Calculus of kidney and ureter"	"Pilonidal cyst and sinus"	1	61	275	336
"N95"	"H80"	"Menopausal and other perimenopausal disorders"	"Otosclerosis"	1	19	171	190
"J85"	"M54"	"Abscess of lung and mediastinum"	"Dorsalgia"	1	69	164	233
"J84"	"M23"	"Other interstitial pulmonary diseases"	"Internal derangement of knee"	1	32	398	430
"D47"	"N20"	"Oth neoplm of uncrt behav of lymphoid, hematpoetc & rel tiss"	"Calculus of kidney and ureter"	1	21	159	180
"I27"	"H43"	"Other pulmonary heart diseases"	"Disorders of vitreous body"	1	39	100	139
"E83"	"O02"	"Disorders of mineral metabolism"	"Other abnormal products of conception"	1	0	54	54
"M75"	"N31"	"Shoulder lesions"	"Neuromuscular dysfunction of bladder, NEC"	1	245	427	672
"I51"	"M71"	"Complications and ill-defined descriptions of heart disease"	"Other bursopathies"	1	8	81	89
"J10"	"G62"	"Influenza due to other identified influenza virus"	"Other and unspecified polyneuropathies"	1	26	84	110
"H91"	"H71"	"Other and unspecified hearing loss"	"Cholesteatoma of middle ear"	1	520	1150	1670
"H72"	"B34"	"Perforation of tympanic membrane"	"Viral infection of unspecified site"	1	68	321	389
"I63"	"N70"	"Cerebral infarction"	"Salpingitis and oophoritis"	1	0	89	89
"F01"	"I83"	"Vascular dementia"	"Varicose veins of lower extremities"	1	4	340	344
"E87"	"O03"	"Other disorders of fluid, electrolyte and acid-base balance"	"Spontaneous abortion"	1	0	86	86
"J22"	"D86"	"Unspecified acute lower respiratory infection"	"Sarcoidosis"	1	10	57	67
"O92"	"O03"	"Oth disord of brst/lactatn assoc w pregnancy and the puerp"	"Spontaneous abortion"	1	631	1786	2417
"M80"	"C44"	"Osteoporosis with current pathological fracture"	"Other and unspecified malignant neoplasm of skin"	1	612	1025	1637
"D80"	"C91"	"Immunodeficiency with predominantly antibody defects"	"Lymphoid leukemia"	1	5	88	93
"F20"	"O04"	"Schizophrenia"	"Complications following (induced) termination of pregnancy"	1	7	265	272
"C79"	"N64"	"Secondary malignant neoplasm of other and unspecified sites"	"Other disorders of breast"	1	7	162	169
"H15"	"O62"	"Disorders of sclera"	"Abnormalities of forces of labor"	1	6	72	78
"J90"	"N83"	"Pleural effusion, not elsewhere classified"	"Noninflammatory disord of ovary, fallop and broad ligament"	1	38	161	199
"C34"	"C67"	"Malignant neoplasm of bronchus and lung"	"Malignant neoplasm of bladder"	1	147	833	980
"M80"	"D12"	"Osteoporosis with current pathological fracture"	"Benign neoplasm of colon, rectum, anus and anal canal"	1	415	1766	2181
"G31"	"G45"	"Oth degenerative diseases of nervous system, NEC"	"Transient cerebral ischemic attacks and related syndromes"	1	176	546	722
"K74"	"M43"	"Fibrosis and cirrhosis of liver"	"Other deforming dorsopathies"	1	10	61	71
"K21"	"N80"	"Gastro-esophageal reflux disease"	"Endometriosis"	1	87	359	446
"I70"	"J37"	"Atherosclerosis"	"Chronic laryngitis and laryngotracheitis"	1	65	188	253
"F33"	"K21"	"Major depressive disorder, recurrent"	"Gastro-esophageal reflux disease"	1	365	1093	1458
"E27"	"O80"	"Other disorders of adrenal gland"	"Encounter for full-term uncomplicated delivery"	1	0	126	126
"K80"	"L05"	"Cholelithiasis"	"Pilonidal cyst and sinus"	1	56	430	486
"A46"	"M79"	"Erysipelas"	"Oth and unsp soft tissue disorders, not elsewhere classified"	1	2019	2982	5001
"M75"	"O65"	"Shoulder lesions"	"Obstructed labor due to maternal pelvic abnormality"	1	0	345	345
"A04"	"H91"	"Other bacterial intestinal infections"	"Other and unspecified hearing loss"	1	0	1581	1581
"D61"	"I10"	"Oth aplastic anemias and other bone marrow failure syndromes"	"Essential (primary) hypertension"	1	249	671	920
"H25"	"K35"	"Age-related cataract"	"Acute appendicitis"	1	472	1579	2051
"M19"	"M05"	"Other and unspecified osteoarthritis"	"Rheumatoid arthritis with rheumatoid factor"	1	869	1199	2068
"J01"	"O99"	"Acute sinusitis"	"Oth maternal diseases classd elsw but compl preg/chldbrth"	1	297	904	1201
"C13"	"G56"	"Malignant neoplasm of hypopharynx"	"Mononeuropathies of upper limb"	1	1	42	43
"D64"	"A63"	"Other anemias"	"Oth predominantly sexually transmitted diseases, NEC"	1	30	201	231
"J15"	"D86"	"Bacterial pneumonia, not elsewhere classified"	"Sarcoidosis"	1	110	340	450
"C34"	"K44"	"Malignant neoplasm of bronchus and lung"	"Diaphragmatic hernia"	1	127	1434	1561
"O61"	"O24"	"Failed induction of labor"	"Diabetes in pregnancy, childbirth, and the puerperium"	1	199	489	688
"B02"	"H91"	"Zoster [herpes zoster]"	"Other and unspecified hearing loss"	1	376	874	1250
"M54"	"H94"	"Dorsalgia"	"Other disorders of ear in diseases classified elsewhere"	1	31	121	152
"F17"	"J34"	"Nicotine dependence"	"Other and unspecified disorders of nose and nasal sinuses"	1	47	507	554
"K72"	"K92"	"Hepatic failure, not elsewhere classified"	"Other diseases of digestive system"	1	959	1763	2722
"M47"	"N20"	"Spondylosis"	"Calculus of kidney and ureter"	1	518	986	1504
"G47"	"J98"	"Sleep disorders"	"Other respiratory disorders"	1	361	588	949
"L89"	"N30"	"Pressure ulcer"	"Cystitis"	1	2251	4029	6280
"K22"	"N97"	"Other diseases of esophagus"	"Female infertility"	1	10	64	74
"I42"	"L03"	"Cardiomyopathy"	"Cellulitis and acute lymphangitis"	1	40	196	236
"M84"	"K35"	"Disorder of continuity of bone"	"Acute appendicitis"	1	24	93	117
"C61"	"E78"	"Malignant neoplasm of prostate"	"Disorders of lipoprotein metabolism and other lipidemias"	1	1128	2435	3563
"F05"	"I47"	"Delirium due to known physiological condition"	"Paroxysmal tachycardia"	1	36	649	685
"M51"	"J35"	"Thoracic, thoracolum, and lumbosacral intvrt disc disorders"	"Chronic diseases of tonsils and adenoids"	1	55	1213	1268
"C16"	"I48"	"Malignant neoplasm of stomach"	"Atrial fibrillation and flutter"	1	446	723	1169
"K05"	"K30"	"Gingivitis and periodontal diseases"	"Functional dyspepsia"	1	163	381	544
"M17"	"J35"	"Osteoarthritis of knee"	"Chronic diseases of tonsils and adenoids"	1	0	598	598
"K05"	"M51"	"Gingivitis and periodontal diseases"	"Thoracic, thoracolum, and lumbosacral intvrt disc disorders"	1	159	629	788
"N28"	"I35"	"Oth disorders of kidney and ureter, not elsewhere classified"	"Nonrheumatic aortic valve disorders"	1	388	566	954
"J18"	"C18"	"Pneumonia, unspecified organism"	"Malignant neoplasm of colon"	1	3101	4000	7101
"C15"	"C61"	"Malignant neoplasm of esophagus"	"Malignant neoplasm of prostate"	1	60	178	238
"J14"	"M51"	"Pneumonia due to Hemophilus influenzae"	"Thoracic, thoracolum, and lumbosacral intvrt disc disorders"	1	19	147	166
"M31"	"I83"	"Other necrotizing vasculopathies"	"Varicose veins of lower extremities"	1	166	310	476
"B01"	"C91"	"Varicella [chickenpox]"	"Lymphoid leukemia"	1	23	98	121
"E46"	"K29"	"Unspecified protein-calorie malnutrition"	"Gastritis and duodenitis"	1	21	164	185
"C80"	"H81"	"Malignant neoplasm without specification of site"	"Disorders of vestibular function"	1	7	105	112
"C80"	"K57"	"Malignant neoplasm without specification of site"	"Diverticular disease of intestine"	1	39	363	402
"I48"	"M21"	"Atrial fibrillation and flutter"	"Other acquired deformities of limbs"	1	347	1102	1449
"H47"	"Q02"	"Other disorders of optic [2nd] nerve and visual pathways"	"Microcephaly"	1	13	66	79
"D35"	"G35"	"Benign neoplasm of other and unspecified endocrine glands"	"Multiple sclerosis"	1	5	117	122
"H90"	"O62"	"Conductive and sensorineural hearing loss"	"Abnormalities of forces of labor"	1	123	596	719
"E83"	"J35"	"Disorders of mineral metabolism"	"Chronic diseases of tonsils and adenoids"	1	0	64	64
"H25"	"D25"	"Age-related cataract"	"Leiomyoma of uterus"	1	0	1555	1555
"J96"	"N75"	"Respiratory failure, not elsewhere classified"	"Diseases of Bartholin's gland"	1	0	88	88
"G82"	"O62"	"Paraplegia (paraparesis) and quadriplegia (quadriparesis)"	"Abnormalities of forces of labor"	1	3	64	67
"M80"	"J45"	"Osteoporosis with current pathological fracture"	"Asthma"	1	397	2119	2516
"C78"	"D86"	"Secondary malignant neoplasm of resp and digestive organs"	"Sarcoidosis"	1	27	129	156
"E83"	"O62"	"Disorders of mineral metabolism"	"Abnormalities of forces of labor"	1	0	107	107
"M75"	"O24"	"Shoulder lesions"	"Diabetes in pregnancy, childbirth, and the puerperium"	1	0	461	461
"Q61"	"J45"	"Cystic kidney disease"	"Asthma"	1	84	200	284
"N18"	"Q44"	"Chronic kidney disease (CKD)"	"Congenital malform of gallbladder, bile ducts and liver"	1	4	39	43
"M48"	"N95"	"Other spondylopathies"	"Menopausal and other perimenopausal disorders"	1	299	1004	1303
"K29"	"L05"	"Gastritis and duodenitis"	"Pilonidal cyst and sinus"	1	124	217	341
"M85"	"K60"	"Other disorders of bone density and structure"	"Fissure and fistula of anal and rectal regions"	1	27	333	360
"K65"	"O70"	"Peritonitis"	"Perineal laceration during delivery"	1	61	187	248
"E63"	"N81"	"Other nutritional deficiencies"	"Female genital prolapse"	1	1	44	45
"C67"	"H93"	"Malignant neoplasm of bladder"	"Other disorders of ear, not elsewhere classified"	1	91	266	357
"D63"	"N50"	"Anemia in chronic diseases classified elsewhere"	"Other and unspecified disorders of male genital organs"	1	20	101	121
"M75"	"B34"	"Shoulder lesions"	"Viral infection of unspecified site"	1	419	586	1005
"M96"	"M23"	"Intraop and postproc comp and disorders of ms sys, NEC"	"Internal derangement of knee"	1	153	302	455
"E05"	"O68"	"Thyrotoxicosis [hyperthyroidism]"	"Labor and delivery comp by abnlt of fetal acid-base balance"	1	301	1311	1612
"H26"	"O75"	"Other cataract"	"Oth complications of labor and delivery, NEC"	1	0	30	30
"D14"	"O48"	"Benign neoplasm of middle ear and respiratory system"	"Late pregnancy"	1	1	28	29
"C34"	"N71"	"Malignant neoplasm of bronchus and lung"	"Inflammatory disease of uterus, except cervix"	1	0	49	49
"K43"	"H80"	"Ventral hernia"	"Otosclerosis"	1	6	94	100
"M34"	"O80"	"Systemic sclerosis [scleroderma]"	"Encounter for full-term uncomplicated delivery"	1	0	63	63
"C61"	"N40"	"Malignant neoplasm of prostate"	"Benign prostatic hyperplasia"	1	0	16236	16236
"D13"	"M67"	"Benign neoplasm of and ill-defined parts of digestive system"	"Other disorders of synovium and tendon"	1	50	131	181
"J10"	"K80"	"Influenza due to other identified influenza virus"	"Cholelithiasis"	1	0	183	183
"G93"	"O20"	"Other disorders of brain"	"Hemorrhage in early pregnancy"	1	0	69	69
"I89"	"D05"	"Oth noninfective disorders of lymphatic vessels and nodes"	"Carcinoma in situ of breast"	1	14	94	108
"K04"	"I12"	"Diseases of pulp and periapical tissues"	"Hypertensive chronic kidney disease"	1	39	116	155
"F41"	"K52"	"Other anxiety disorders"	"Other and unsp noninfective gastroenteritis and colitis"	1	452	962	1414
"A26"	"M23"	"Erysipeloid"	"Internal derangement of knee"	1	7	119	126
"M62"	"O70"	"Other disorders of muscle"	"Perineal laceration during delivery"	1	2315	3152	5467
"C10"	"I83"	"Malignant neoplasm of oropharynx"	"Varicose veins of lower extremities"	1	5	59	64
"C13"	"M79"	"Malignant neoplasm of hypopharynx"	"Oth and unsp soft tissue disorders, not elsewhere classified"	1	14	63	77
"F02"	"M51"	"Dementia in other diseases classified elsewhere"	"Thoracic, thoracolum, and lumbosacral intvrt disc disorders"	1	1	135	136
"D24"	"O32"	"Benign neoplasm of breast"	"Maternal care for malpresentation of fetus"	1	116	301	417
"I46"	"D62"	"Cardiac arrest"	"Acute posthemorrhagic anemia"	1	226	442	668
"K91"	"O70"	"Intraop and postproc comp and disorders of dgstv sys, NEC"	"Perineal laceration during delivery"	1	8	142	150
"D63"	"C81"	"Anemia in chronic diseases classified elsewhere"	"Hodgkin lymphoma"	1	43	145	188
"M77"	"Q17"	"Other enthesopathies"	"Other congenital malformations of ear"	1	0	63	63
"K31"	"H83"	"Other diseases of stomach and duodenum"	"Other diseases of inner ear"	1	4	135	139
"C44"	"M24"	"Other and unspecified malignant neoplasm of skin"	"Other specific joint derangements"	1	55	208	263
"H90"	"N60"	"Conductive and sensorineural hearing loss"	"Benign mammary dysplasia"	1	101	364	465
"O08"	"O20"	"Complications following ectopic and molar pregnancy"	"Hemorrhage in early pregnancy"	1	1309	2458	3767
"I26"	"E66"	"Pulmonary embolism"	"Overweight and obesity"	1	1236	1917	3153
"J15"	"K25"	"Bacterial pneumonia, not elsewhere classified"	"Gastric ulcer"	1	1204	3676	4880
"A09"	"M16"	"Infectious gastroenteritis and colitis, unspecified"	"Osteoarthritis of hip"	1	934	1697	2631
"M19"	"O28"	"Other and unspecified osteoarthritis"	"Abnormal findings on antenatal screening of mother"	1	0	45	45
"K21"	"K30"	"Gastro-esophageal reflux disease"	"Functional dyspepsia"	1	5097	5801	10898
"I49"	"K40"	"Other cardiac arrhythmias"	"Inguinal hernia"	1	788	2085	2873
"N30"	"K25"	"Cystitis"	"Gastric ulcer"	1	3772	5285	9057
"F03"	"I47"	"Unspecified dementia"	"Paroxysmal tachycardia"	1	215	1529	1744
"I46"	"E11"	"Cardiac arrest"	"Type 2 diabetes mellitus"	1	0	4569	4569
"D63"	"E10"	"Anemia in chronic diseases classified elsewhere"	"Type 1 diabetes mellitus"	1	382	1396	1778
"K63"	"N95"	"Other diseases of intestine"	"Menopausal and other perimenopausal disorders"	1	64	230	294
"J32"	"O64"	"Chronic sinusitis"	"Obstructed labor due to malposition and malpresent of fetus"	1	7	109	116
"D86"	"C62"	"Sarcoidosis"	"Malignant neoplasm of testis"	1	8	63	71
"C82"	"O80"	"Follicular lymphoma"	"Encounter for full-term uncomplicated delivery"	1	0	29	29
"F05"	"M54"	"Delirium due to known physiological condition"	"Dorsalgia"	1	0	2352	2352
"J18"	"H25"	"Pneumonia, unspecified organism"	"Age-related cataract"	1	0	50473	50473
"O40"	"J35"	"Polyhydramnios"	"Chronic diseases of tonsils and adenoids"	1	0	118	118
"N30"	"M76"	"Cystitis"	"Enthesopathies, lower limb, excluding foot"	1	611	944	1555
"M16"	"N43"	"Osteoarthritis of hip"	"Hydrocele and spermatocele"	1	280	591	871
"L98"	"K51"	"Oth disorders of skin, subcu, not elsewhere classified"	"Ulcerative colitis"	1	68	321	389
"H25"	"N46"	"Age-related cataract"	"Male infertility"	1	2	82	84
"I26"	"O00"	"Pulmonary embolism"	"Ectopic pregnancy"	1	3	50	53
"K63"	"G51"	"Other diseases of intestine"	"Facial nerve disorders"	1	10	48	58
"G35"	"O20"	"Multiple sclerosis"	"Hemorrhage in early pregnancy"	1	11	183	194
"F01"	"K35"	"Vascular dementia"	"Acute appendicitis"	1	6	65	71
"M46"	"M51"	"Other inflammatory spondylopathies"	"Thoracic, thoracolum, and lumbosacral intvrt disc disorders"	1	881	1498	2379
"K52"	"N62"	"Other and unsp noninfective gastroenteritis and colitis"	"Hypertrophy of breast"	1	136	315	451
"K44"	"I20"	"Diaphragmatic hernia"	"Angina pectoris"	1	2954	4055	7009
"K58"	"O00"	"Irritable bowel syndrome"	"Ectopic pregnancy"	1	45	141	186
"H35"	"J35"	"Other retinal disorders"	"Chronic diseases of tonsils and adenoids"	1	130	234	364
"E13"	"M79"	"Other specified diabetes mellitus"	"Oth and unsp soft tissue disorders, not elsewhere classified"	1	112	384	496
"K58"	"K00"	"Irritable bowel syndrome"	"Disorders of tooth development and eruption"	1	17	125	142
"F17"	"I70"	"Nicotine dependence"	"Atherosclerosis"	1	829	1109	1938
"E29"	"N45"	"Testicular dysfunction"	"Orchitis and epididymitis"	1	23	111	134
"E86"	"D21"	"Volume depletion"	"Other benign neoplasms of connective and other soft tissue"	1	43	208	251
"J90"	"D25"	"Pleural effusion, not elsewhere classified"	"Leiomyoma of uterus"	1	0	170	170
"H25"	"I20"	"Age-related cataract"	"Angina pectoris"	1	0	25255	25255
"K60"	"O68"	"Fissure and fistula of anal and rectal regions"	"Labor and delivery comp by abnlt of fetal acid-base balance"	1	239	817	1056
"M94"	"M62"	"Other disorders of cartilage"	"Other disorders of muscle"	1	137	245	382
"M80"	"N60"	"Osteoporosis with current pathological fracture"	"Benign mammary dysplasia"	1	0	205	205
"J44"	"M22"	"Other chronic obstructive pulmonary disease"	"Disorder of patella"	1	0	374	374
"K25"	"O24"	"Gastric ulcer"	"Diabetes in pregnancy, childbirth, and the puerperium"	1	7	42	49
"J81"	"G44"	"Pulmonary edema"	"Other headache syndromes"	1	10	64	74
"M80"	"K76"	"Osteoporosis with current pathological fracture"	"Other diseases of liver"	1	192	356	548
"J94"	"M47"	"Other pleural conditions"	"Spondylosis"	1	32	113	145
"N90"	"O20"	"Other noninflammatory disorders of vulva and perineum"	"Hemorrhage in early pregnancy"	1	76	288	364
"I26"	"A69"	"Pulmonary embolism"	"Other spirochetal infections"	1	8	58	66
"I69"	"O03"	"Sequelae of cerebrovascular disease"	"Spontaneous abortion"	1	0	87	87
"L57"	"N40"	"Skin changes due to chronic expsr to nonionizing radiation"	"Benign prostatic hyperplasia"	1	43	626	669
"K50"	"K35"	"Crohn's disease [regional enteritis]"	"Acute appendicitis"	1	251	634	885
"E87"	"L05"	"Other disorders of fluid, electrolyte and acid-base balance"	"Pilonidal cyst and sinus"	1	1	105	106
"J81"	"C43"	"Pulmonary edema"	"Malignant melanoma of skin"	1	29	110	139
"J45"	"O62"	"Asthma"	"Abnormalities of forces of labor"	1	1394	1932	3326
"H52"	"Q22"	"Disorders of refraction and accommodation"	"Congenital malformations of pulmonary and tricuspid valves"	1	10	79	89
"I50"	"O68"	"Heart failure"	"Labor and delivery comp by abnlt of fetal acid-base balance"	1	0	79	79
"D64"	"C50"	"Other anemias"	"Malignant neoplasm of breast"	1	0	3697	3697
"I21"	"N81"	"Acute myocardial infarction"	"Female genital prolapse"	1	567	1635	2202
"I25"	"I21"	"Chronic ischemic heart disease"	"Acute myocardial infarction"	1	0	143765	143765
"M85"	"I83"	"Other disorders of bone density and structure"	"Varicose veins of lower extremities"	1	0	1847	1847
"C51"	"M17"	"Malignant neoplasm of vulva"	"Osteoarthritis of knee"	1	22	76	98
"N18"	"I20"	"Chronic kidney disease (CKD)"	"Angina pectoris"	1	0	8785	8785
"M67"	"L20"	"Other disorders of synovium and tendon"	"Atopic dermatitis"	1	30	264	294
"H26"	"N84"	"Other cataract"	"Polyp of female genital tract"	1	128	434	562
"H20"	"O48"	"Iridocyclitis"	"Late pregnancy"	1	6	60	66
"I49"	"M75"	"Other cardiac arrhythmias"	"Shoulder lesions"	1	1187	1760	2947
"C48"	"I10"	"Malignant neoplasm of retroperitoneum and peritoneum"	"Essential (primary) hypertension"	1	110	327	437
"E04"	"M22"	"Other nontoxic goiter"	"Disorder of patella"	1	40	430	470
"I27"	"D86"	"Other pulmonary heart diseases"	"Sarcoidosis"	1	14	140	154
"E41"	"G40"	"Nutritional marasmus"	"Epilepsy and recurrent seizures"	1	11	110	121
"D64"	"N99"	"Other anemias"	"Intraop and postproc comp and disorders of GU sys, NEC"	1	200	659	859
"I82"	"O70"	"Other venous embolism and thrombosis"	"Perineal laceration during delivery"	1	35	168	203
"M17"	"O99"	"Osteoarthritis of knee"	"Oth maternal diseases classd elsw but compl preg/chldbrth"	1	0	834	834
"H95"	"H65"	"Intraop and postproc comp and disorders of ear/mastd, NEC"	"Nonsuppurative otitis media"	1	68	281	349
"M80"	"L90"	"Osteoporosis with current pathological fracture"	"Atrophic disorders of skin"	1	90	202	292
"I82"	"H81"	"Other venous embolism and thrombosis"	"Disorders of vestibular function"	1	62	153	215
"N92"	"N62"	"Excessive, frequent and irregular menstruation"	"Hypertrophy of breast"	1	354	795	1149
"E64"	"G35"	"Sequelae of malnutrition and other nutritional deficiencies"	"Multiple sclerosis"	1	2	42	44
"I48"	"M72"	"Atrial fibrillation and flutter"	"Fibroblastic disorders"	1	633	2588	3221
"K29"	"N87"	"Gastritis and duodenitis"	"Dysplasia of cervix uteri"	1	196	327	523
"E27"	"I20"	"Other disorders of adrenal gland"	"Angina pectoris"	1	76	461	537
"L73"	"O68"	"Other follicular disorders"	"Labor and delivery comp by abnlt of fetal acid-base balance"	1	124	224	348
"J96"	"L72"	"Respiratory failure, not elsewhere classified"	"Follicular cysts of skin and subcutaneous tissue"	1	15	269	284
"G94"	"D25"	"Other disorders of brain in diseases classified elsewhere"	"Leiomyoma of uterus"	1	1	27	28
"H54"	"M20"	"Blindness and low vision"	"Acquired deformities of fingers and toes"	1	32	142	174
"E64"	"I49"	"Sequelae of malnutrition and other nutritional deficiencies"	"Other cardiac arrhythmias"	1	80	230	310
"E63"	"C50"	"Other nutritional deficiencies"	"Malignant neoplasm of breast"	1	6	72	78
"K83"	"J37"	"Other diseases of biliary tract"	"Chronic laryngitis and laryngotracheitis"	1	0	29	29
"I49"	"L03"	"Other cardiac arrhythmias"	"Cellulitis and acute lymphangitis"	1	83	384	467
"H20"	"H10"	"Iridocyclitis"	"Conjunctivitis"	1	730	990	1720
"J86"	"I10"	"Pyothorax"	"Essential (primary) hypertension"	1	680	1026	1706
"H53"	"N43"	"Visual disturbances"	"Hydrocele and spermatocele"	1	42	138	180
"E03"	"L68"	"Other hypothyroidism"	"Hypertrichosis"	1	35	183	218
"E83"	"H35"	"Disorders of mineral metabolism"	"Other retinal disorders"	1	123	575	698
"M85"	"O72"	"Other disorders of bone density and structure"	"Postpartum hemorrhage"	1	124	333	457
"G96"	"O04"	"Other disorders of central nervous system"	"Complications following (induced) termination of pregnancy"	1	0	494	494
"M07"	"O04"	"Enteropathic arthropathies"	"Complications following (induced) termination of pregnancy"	1	0	218	218
"I63"	"O47"	"Cerebral infarction"	"False labor"	1	0	73	73
"K83"	"M51"	"Other diseases of biliary tract"	"Thoracic, thoracolum, and lumbosacral intvrt disc disorders"	1	93	561	654
"Q50"	"O62"	"Congen malform of ovaries, fallopian tubes & broad ligaments"	"Abnormalities of forces of labor"	1	42	108	150
"C80"	"E05"	"Malignant neoplasm without specification of site"	"Thyrotoxicosis [hyperthyroidism]"	1	11	136	147
"C76"	"I25"	"Malignant neoplasm of other and ill-defined sites"	"Chronic ischemic heart disease"	1	157	319	476
"K02"	"K40"	"Dental caries"	"Inguinal hernia"	1	155	469	624
"G62"	"O62"	"Other and unspecified polyneuropathies"	"Abnormalities of forces of labor"	1	0	117	117
"F40"	"O04"	"Phobic anxiety disorders"	"Complications following (induced) termination of pregnancy"	1	39	198	237
"O42"	"O30"	"Premature rupture of membranes"	"Multiple gestation"	1	1859	2725	4584
"E66"	"B50"	"Overweight and obesity"	"Plasmodium falciparum malaria"	1	1	25	26
"O92"	"A63"	"Oth disord of brst/lactatn assoc w pregnancy and the puerp"	"Oth predominantly sexually transmitted diseases, NEC"	1	0	287	287
"D50"	"O63"	"Iron deficiency anemia"	"Long labor"	1	0	94	94
"K76"	"O71"	"Other diseases of liver"	"Other obstetric trauma"	1	0	52	52
"O72"	"M92"	"Postpartum hemorrhage"	"Other juvenile osteochondrosis"	1	0	115	115
"J81"	"G35"	"Pulmonary edema"	"Multiple sclerosis"	1	0	57	57
"N30"	"L68"	"Cystitis"	"Hypertrichosis"	1	116	295	411
"M25"	"N83"	"Other joint disorder, not elsewhere classified"	"Noninflammatory disord of ovary, fallop and broad ligament"	1	412	914	1326
"J33"	"O68"	"Nasal polyp"	"Labor and delivery comp by abnlt of fetal acid-base balance"	1	27	83	110
"C77"	"I83"	"Secondary and unspecified malignant neoplasm of lymph nodes"	"Varicose veins of lower extremities"	1	6	721	727
"A41"	"C06"	"Other sepsis"	"Malignant neoplasm of other and unspecified parts of mouth"	1	95	195	290
"G47"	"D24"	"Sleep disorders"	"Benign neoplasm of breast"	1	0	350	350
"A41"	"M06"	"Other sepsis"	"Other rheumatoid arthritis"	1	301	1942	2243
"H61"	"O80"	"Other disorders of external ear"	"Encounter for full-term uncomplicated delivery"	1	44	148	192
"L89"	"K51"	"Pressure ulcer"	"Ulcerative colitis"	1	32	170	202
"D75"	"H83"	"Other and unsp diseases of blood and blood-forming organs"	"Other diseases of inner ear"	1	13	73	86
"D32"	"N63"	"Benign neoplasm of meninges"	"Unspecified lump in breast"	1	13	61	74
"D46"	"D30"	"Myelodysplastic syndromes"	"Benign neoplasm of urinary organs"	1	8	71	79
"F44"	"F10"	"Dissociative and conversion disorders"	"Alcohol related disorders"	1	79	208	287
"E83"	"H81"	"Disorders of mineral metabolism"	"Disorders of vestibular function"	1	46	270	316
"I12"	"E11"	"Hypertensive chronic kidney disease"	"Type 2 diabetes mellitus"	1	416	645	1061
"K02"	"F10"	"Dental caries"	"Alcohol related disorders"	1	277	1214	1491
"J44"	"M96"	"Other chronic obstructive pulmonary disease"	"Intraop and postproc comp and disorders of ms sys, NEC"	1	111	204	315
"E11"	"O65"	"Type 2 diabetes mellitus"	"Obstructed labor due to maternal pelvic abnormality"	1	0	122	122
"D64"	"I50"	"Other anemias"	"Heart failure"	1	12689	15110	27799
"K58"	"Q17"	"Irritable bowel syndrome"	"Other congenital malformations of ear"	1	0	97	97
"M22"	"F98"	"Disorder of patella"	"Oth behav/emotn disord w onset usly occur in chldhd and adol"	1	0	69	69
"G47"	"N75"	"Sleep disorders"	"Diseases of Bartholin's gland"	1	2	94	96
"F43"	"D23"	"Reaction to severe stress, and adjustment disorders"	"Other benign neoplasms of skin"	1	104	196	300
"B37"	"M50"	"Candidiasis"	"Cervical disc disorders"	1	65	191	256
"C34"	"I70"	"Malignant neoplasm of bronchus and lung"	"Atherosclerosis"	1	0	3974	3974
"I27"	"J45"	"Other pulmonary heart diseases"	"Asthma"	1	349	1029	1378
"F05"	"K35"	"Delirium due to known physiological condition"	"Acute appendicitis"	1	6	177	183
"A46"	"O14"	"Erysipelas"	"Pre-eclampsia"	1	0	76	76
"H66"	"Q20"	"Suppurative and unspecified otitis media"	"Congenital malformations of cardiac chambers and connections"	1	44	156	200
"N13"	"M02"	"Obstructive and reflux uropathy"	"Postinfective and reactive arthropathies"	1	31	98	129
"K75"	"K85"	"Other inflammatory liver diseases"	"Acute pancreatitis"	1	94	190	284
"I78"	"N97"	"Diseases of capillaries"	"Female infertility"	1	35	111	146
"I80"	"O65"	"Phlebitis and thrombophlebitis"	"Obstructed labor due to maternal pelvic abnormality"	1	0	147	147
"C24"	"I63"	"Malignant neoplasm of other and unsp parts of biliary tract"	"Cerebral infarction"	1	39	103	142
"K80"	"M23"	"Cholelithiasis"	"Internal derangement of knee"	1	2734	3518	6252
"D17"	"O62"	"Benign lipomatous neoplasm"	"Abnormalities of forces of labor"	1	0	1184	1184
"A46"	"C43"	"Erysipelas"	"Malignant melanoma of skin"	1	181	402	583
"I73"	"I21"	"Other peripheral vascular diseases"	"Acute myocardial infarction"	1	2531	4481	7012
"K83"	"J38"	"Other diseases of biliary tract"	"Diseases of vocal cords and larynx, not elsewhere classified"	1	18	74	92
"F17"	"F10"	"Nicotine dependence"	"Alcohol related disorders"	1	4358	7530	11888
"L08"	"F10"	"Other local infections of skin and subcutaneous tissue"	"Alcohol related disorders"	1	858	2157	3015
"I69"	"I73"	"Sequelae of cerebrovascular disease"	"Other peripheral vascular diseases"	1	2050	2816	4866
"K43"	"M22"	"Ventral hernia"	"Disorder of patella"	1	5	236	241
"G44"	"O41"	"Other headache syndromes"	"Other disorders of amniotic fluid and membranes"	1	24	91	115
"F17"	"Q66"	"Nicotine dependence"	"Congenital deformities of feet"	1	8	66	74
"M13"	"N87"	"Other arthritis"	"Dysplasia of cervix uteri"	1	54	190	244
"G31"	"I49"	"Oth degenerative diseases of nervous system, NEC"	"Other cardiac arrhythmias"	1	46	172	218
"M19"	"N80"	"Other and unspecified osteoarthritis"	"Endometriosis"	1	0	291	291
"K27"	"M17"	"Peptic ulcer, site unspecified"	"Osteoarthritis of knee"	1	305	580	885
"K82"	"K21"	"Other diseases of gallbladder"	"Gastro-esophageal reflux disease"	1	48	125	173
"O92"	"K35"	"Oth disord of brst/lactatn assoc w pregnancy and the puerp"	"Acute appendicitis"	1	15	326	341
"L89"	"N32"	"Pressure ulcer"	"Other disorders of bladder"	1	59	136	195
"J15"	"C84"	"Bacterial pneumonia, not elsewhere classified"	"Mature T/NK-cell lymphomas"	1	52	123	175
"M17"	"D28"	"Osteoarthritis of knee"	"Benign neoplasm of other and unsp female genital organs"	1	23	182	205
"M19"	"O90"	"Other and unspecified osteoarthritis"	"Complications of the puerperium, not elsewhere classified"	1	0	48	48
"J69"	"G98"	"Pneumonitis due to solids and liquids"	"Other disorders of nervous system not elsewhere classified"	1	31	99	130
"G21"	"H83"	"Secondary parkinsonism"	"Other diseases of inner ear"	1	0	55	55
"K59"	"D37"	"Other functional intestinal disorders"	"Neoplasm of uncrt behavior of oral cavity and dgstv organs"	1	226	504	730
"J98"	"M16"	"Other respiratory disorders"	"Osteoarthritis of hip"	1	210	603	813
"I35"	"A69"	"Nonrheumatic aortic valve disorders"	"Other spirochetal infections"	1	6	96	102
"C78"	"H00"	"Secondary malignant neoplasm of resp and digestive organs"	"Hordeolum and chalazion"	1	0	47	47
"N39"	"J44"	"Other disorders of urinary system"	"Other chronic obstructive pulmonary disease"	1	7533	11404	18937
"F43"	"O04"	"Reaction to severe stress, and adjustment disorders"	"Complications following (induced) termination of pregnancy"	1	64	1164	1228
"C79"	"H33"	"Secondary malignant neoplasm of other and unspecified sites"	"Retinal detachments and breaks"	1	18	281	299
"K22"	"C09"	"Other diseases of esophagus"	"Malignant neoplasm of tonsil"	1	24	87	111
"C34"	"J95"	"Malignant neoplasm of bronchus and lung"	"Intraop and postproc comp and disorders of resp sys, NEC"	1	287	459	746
"E27"	"J45"	"Other disorders of adrenal gland"	"Asthma"	1	68	423	491
"O72"	"D23"	"Postpartum hemorrhage"	"Other benign neoplasms of skin"	1	308	1005	1313
"C16"	"J20"	"Malignant neoplasm of stomach"	"Acute bronchitis"	1	12	70	82
"O90"	"N62"	"Complications of the puerperium, not elsewhere classified"	"Hypertrophy of breast"	1	15	85	100
"M23"	"O02"	"Internal derangement of knee"	"Other abnormal products of conception"	1	586	1170	1756
"I71"	"L03"	"Aortic aneurysm and dissection"	"Cellulitis and acute lymphangitis"	1	12	198	210
"E16"	"H83"	"Other disorders of pancreatic internal secretion"	"Other diseases of inner ear"	1	16	259	275
"G20"	"N84"	"Parkinson's disease"	"Polyp of female genital tract"	1	13	79	92
"C79"	"H10"	"Secondary malignant neoplasm of other and unspecified sites"	"Conjunctivitis"	1	0	299	299
"C25"	"E05"	"Malignant neoplasm of pancreas"	"Thyrotoxicosis [hyperthyroidism]"	1	31	285	316
"M92"	"H65"	"Other juvenile osteochondrosis"	"Nonsuppurative otitis media"	1	0	92	92
"I48"	"H18"	"Atrial fibrillation and flutter"	"Other disorders of cornea"	1	543	785	1328
"K92"	"M19"	"Other diseases of digestive system"	"Other and unspecified osteoarthritis"	1	1004	1340	2344
"J69"	"K21"	"Pneumonitis due to solids and liquids"	"Gastro-esophageal reflux disease"	1	36	465	501
"C83"	"O70"	"Non-follicular lymphoma"	"Perineal laceration during delivery"	1	0	31	31
"L85"	"K40"	"Other epidermal thickening"	"Inguinal hernia"	1	22	71	93
"K85"	"O42"	"Acute pancreatitis"	"Premature rupture of membranes"	1	40	169	209
"G56"	"O70"	"Mononeuropathies of upper limb"	"Perineal laceration during delivery"	1	0	3286	3286
"K76"	"M24"	"Other diseases of liver"	"Other specific joint derangements"	1	29	136	165
"I40"	"O80"	"Acute myocarditis"	"Encounter for full-term uncomplicated delivery"	1	0	33	33
"G30"	"D51"	"Alzheimer's disease"	"Vitamin B12 deficiency anemia"	1	51	152	203
"D62"	"D17"	"Acute posthemorrhagic anemia"	"Benign lipomatous neoplasm"	1	42	141	183
"O70"	"M41"	"Perineal laceration during delivery"	"Scoliosis"	1	0	408	408
"J33"	"O02"	"Nasal polyp"	"Other abnormal products of conception"	1	13	61	74
"F20"	"H91"	"Schizophrenia"	"Other and unspecified hearing loss"	1	89	178	267
"A09"	"K40"	"Infectious gastroenteritis and colitis, unspecified"	"Inguinal hernia"	1	1146	1940	3086
"K80"	"B27"	"Cholelithiasis"	"Infectious mononucleosis"	1	21	220	241
"C78"	"M43"	"Secondary malignant neoplasm of resp and digestive organs"	"Other deforming dorsopathies"	1	4	297	301
"M05"	"O48"	"Rheumatoid arthritis with rheumatoid factor"	"Late pregnancy"	1	0	62	62
"J91"	"K42"	"Pleural effusion in conditions classified elsewhere"	"Umbilical hernia"	1	23	84	107
"N82"	"O80"	"Fistulae involving female genital tract"	"Encounter for full-term uncomplicated delivery"	1	0	218	218
"D64"	"O20"	"Other anemias"	"Hemorrhage in early pregnancy"	1	6	469	475
"C16"	"M54"	"Malignant neoplasm of stomach"	"Dorsalgia"	1	57	410	467
"N12"	"J44"	"Tubulo-interstitial nephritis, not spcf as acute or chronic"	"Other chronic obstructive pulmonary disease"	1	197	316	513
"J15"	"L50"	"Bacterial pneumonia, not elsewhere classified"	"Urticaria"	1	206	576	782
"K72"	"A46"	"Hepatic failure, not elsewhere classified"	"Erysipelas"	1	272	623	895
"A49"	"N47"	"Bacterial infection of unspecified site"	"Disorders of prepuce"	1	148	429	577
"D24"	"O71"	"Benign neoplasm of breast"	"Other obstetric trauma"	1	101	360	461
"M24"	"O80"	"Other specific joint derangements"	"Encounter for full-term uncomplicated delivery"	1	409	893	1302
"F05"	"M72"	"Delirium due to known physiological condition"	"Fibroblastic disorders"	1	0	328	328
"H35"	"N80"	"Other retinal disorders"	"Endometriosis"	1	7	100	107
"I35"	"D16"	"Nonrheumatic aortic valve disorders"	"Benign neoplasm of bone and articular cartilage"	1	3	91	94
"M08"	"J20"	"Juvenile arthritis"	"Acute bronchitis"	1	4	132	136
"I80"	"J32"	"Phlebitis and thrombophlebitis"	"Chronic sinusitis"	1	104	245	349
"J06"	"K35"	"Acute upper resp infections of multiple and unsp sites"	"Acute appendicitis"	1	40	415	455
"F05"	"M86"	"Delirium due to known physiological condition"	"Osteomyelitis"	1	52	118	170
"O71"	"N98"	"Other obstetric trauma"	"Complications associated with artificial fertilization"	1	65	142	207
"K02"	"K70"	"Dental caries"	"Alcoholic liver disease"	1	141	353	494
"C34"	"I73"	"Malignant neoplasm of bronchus and lung"	"Other peripheral vascular diseases"	1	0	3358	3358
"K70"	"N87"	"Alcoholic liver disease"	"Dysplasia of cervix uteri"	1	0	96	96
"L98"	"N83"	"Oth disorders of skin, subcu, not elsewhere classified"	"Noninflammatory disord of ovary, fallop and broad ligament"	1	104	244	348
"I78"	"I20"	"Diseases of capillaries"	"Angina pectoris"	1	460	1116	1576
"C78"	"K25"	"Secondary malignant neoplasm of resp and digestive organs"	"Gastric ulcer"	1	435	1878	2313
"A49"	"C85"	"Bacterial infection of unspecified site"	"Oth and unspecified types of non-Hodgkin lymphoma"	1	145	457	602
"J15"	"D48"	"Bacterial pneumonia, not elsewhere classified"	"Neoplasm of uncertain behavior of other and unsp sites"	1	16	193	209
"C16"	"C20"	"Malignant neoplasm of stomach"	"Malignant neoplasm of rectum"	1	31	86	117
"N08"	"E10"	"Glomerular disorders in diseases classified elsewhere"	"Type 1 diabetes mellitus"	1	37	599	636
"G82"	"F10"	"Paraplegia (paraparesis) and quadriplegia (quadriparesis)"	"Alcohol related disorders"	1	98	324	422
"N80"	"O03"	"Endometriosis"	"Spontaneous abortion"	1	240	745	985
"H35"	"J38"	"Other retinal disorders"	"Diseases of vocal cords and larynx, not elsewhere classified"	1	132	401	533
"I47"	"Q66"	"Paroxysmal tachycardia"	"Congenital deformities of feet"	1	19	69	88
"O91"	"O64"	"Infect of breast assoc w pregnancy, the puerp and lactation"	"Obstructed labor due to malposition and malpresent of fetus"	1	202	898	1100
"D43"	"F10"	"Neoplasm of uncertain behavior of brain and cnsl"	"Alcohol related disorders"	1	32	139	171
"N94"	"O66"	"Pain and oth cond assoc w fem gntl org and menstrual cycle"	"Other obstructed labor"	1	101	297	398
"F33"	"H25"	"Major depressive disorder, recurrent"	"Age-related cataract"	1	0	4055	4055
"C06"	"M79"	"Malignant neoplasm of other and unspecified parts of mouth"	"Oth and unsp soft tissue disorders, not elsewhere classified"	1	25	100	125
"J03"	"K35"	"Acute tonsillitis"	"Acute appendicitis"	1	676	942	1618
"A41"	"H61"	"Other sepsis"	"Other disorders of external ear"	1	76	436	512
"J18"	"G43"	"Pneumonia, unspecified organism"	"Migraine"	1	691	1293	1984
"K46"	"O03"	"Unspecified abdominal hernia"	"Spontaneous abortion"	1	0	37	37
"E11"	"O08"	"Type 2 diabetes mellitus"	"Complications following ectopic and molar pregnancy"	1	10	92	102
"G43"	"K35"	"Migraine"	"Acute appendicitis"	1	335	886	1221
"G25"	"O04"	"Other extrapyramidal and movement disorders"	"Complications following (induced) termination of pregnancy"	1	0	48	48
"I11"	"C50"	"Hypertensive heart disease"	"Malignant neoplasm of breast"	1	193	389	582
"I33"	"I15"	"Acute and subacute endocarditis"	"Secondary hypertension"	1	36	124	160
"I10"	"H83"	"Essential (primary) hypertension"	"Other diseases of inner ear"	1	0	6977	6977
"C16"	"H91"	"Malignant neoplasm of stomach"	"Other and unspecified hearing loss"	1	78	996	1074
"I44"	"M50"	"Atrioventricular and left bundle-branch block"	"Cervical disc disorders"	1	12	234	246
"D64"	"H49"	"Other anemias"	"Paralytic strabismus"	1	88	248	336
"K56"	"N80"	"Paralytic ileus and intestinal obstruction without hernia"	"Endometriosis"	1	92	331	423
"C25"	"M65"	"Malignant neoplasm of pancreas"	"Synovitis and tenosynovitis"	1	0	212	212
"O80"	"Q17"	"Encounter for full-term uncomplicated delivery"	"Other congenital malformations of ear"	1	0	461	461
"I48"	"N48"	"Atrial fibrillation and flutter"	"Other disorders of penis"	1	373	804	1177
"C90"	"M50"	"Multiple myeloma and malignant plasma cell neoplasms"	"Cervical disc disorders"	1	12	70	82
"I35"	"L05"	"Nonrheumatic aortic valve disorders"	"Pilonidal cyst and sinus"	1	9	60	69
"I73"	"N92"	"Other peripheral vascular diseases"	"Excessive, frequent and irregular menstruation"	1	0	624	624
"K76"	"I20"	"Other diseases of liver"	"Angina pectoris"	1	434	1147	1581
"I50"	"N63"	"Heart failure"	"Unspecified lump in breast"	1	153	774	927
"I45"	"O80"	"Other conduction disorders"	"Encounter for full-term uncomplicated delivery"	1	75	224	299
"K43"	"K26"	"Ventral hernia"	"Duodenal ulcer"	1	439	1099	1538
"E78"	"O65"	"Disorders of lipoprotein metabolism and other lipidemias"	"Obstructed labor due to maternal pelvic abnormality"	1	0	43	43
"L98"	"O62"	"Oth disorders of skin, subcu, not elsewhere classified"	"Abnormalities of forces of labor"	1	28	533	561
"M76"	"Q53"	"Enthesopathies, lower limb, excluding foot"	"Undescended and ectopic testicle"	1	0	74	74
"O44"	"O02"	"Placenta previa"	"Other abnormal products of conception"	1	240	1142	1382
"O36"	"N97"	"Maternal care for other fetal problems"	"Female infertility"	1	0	8592	8592
"D07"	"N95"	"Carcinoma in situ of other and unspecified genital organs"	"Menopausal and other perimenopausal disorders"	1	252	731	983
"O72"	"Q68"	"Postpartum hemorrhage"	"Other congenital musculoskeletal deformities"	1	0	45	45
"M85"	"D07"	"Other disorders of bone density and structure"	"Carcinoma in situ of other and unspecified genital organs"	1	11	60	71
"J91"	"C50"	"Pleural effusion in conditions classified elsewhere"	"Malignant neoplasm of breast"	1	79	1110	1189
"J18"	"J32"	"Pneumonia, unspecified organism"	"Chronic sinusitis"	1	523	1107	1630
"M86"	"M02"	"Osteomyelitis"	"Postinfective and reactive arthropathies"	1	99	217	316
"M54"	"O63"	"Dorsalgia"	"Long labor"	1	287	700	987
"E11"	"N60"	"Type 2 diabetes mellitus"	"Benign mammary dysplasia"	1	108	593	701
"K80"	"K40"	"Cholelithiasis"	"Inguinal hernia"	1	1481	1973	3454
"C57"	"K80"	"Malignant neoplasm of other and unsp female genital organs"	"Cholelithiasis"	1	4	53	57
"G23"	"E10"	"Other degenerative diseases of basal ganglia"	"Type 1 diabetes mellitus"	1	3	47	50
"D64"	"C49"	"Other anemias"	"Malignant neoplasm of other connective and soft tissue"	1	199	344	543
"J96"	"N88"	"Respiratory failure, not elsewhere classified"	"Other noninflammatory disorders of cervix uteri"	1	0	29	29
"C34"	"C61"	"Malignant neoplasm of bronchus and lung"	"Malignant neoplasm of prostate"	1	393	1041	1434
"G31"	"M67"	"Oth degenerative diseases of nervous system, NEC"	"Other disorders of synovium and tendon"	1	3	49	52
"I21"	"M77"	"Acute myocardial infarction"	"Other enthesopathies"	1	271	646	917
"A49"	"J98"	"Bacterial infection of unspecified site"	"Other respiratory disorders"	1	374	567	941
"C77"	"M21"	"Secondary and unspecified malignant neoplasm of lymph nodes"	"Other acquired deformities of limbs"	1	17	154	171
"E46"	"C50"	"Unspecified protein-calorie malnutrition"	"Malignant neoplasm of breast"	1	2	48	50
"F33"	"H52"	"Major depressive disorder, recurrent"	"Disorders of refraction and accommodation"	1	81	233	314
"K56"	"I21"	"Paralytic ileus and intestinal obstruction without hernia"	"Acute myocardial infarction"	1	1100	1759	2859
"M17"	"N46"	"Osteoarthritis of knee"	"Male infertility"	1	43	311	354
"C71"	"H91"	"Malignant neoplasm of brain"	"Other and unspecified hearing loss"	1	128	633	761
"E83"	"J03"	"Disorders of mineral metabolism"	"Acute tonsillitis"	1	16	71	87
"N39"	"I80"	"Other disorders of urinary system"	"Phlebitis and thrombophlebitis"	1	2074	3992	6066
"I35"	"D14"	"Nonrheumatic aortic valve disorders"	"Benign neoplasm of middle ear and respiratory system"	1	53	263	316
"H91"	"O99"	"Other and unspecified hearing loss"	"Oth maternal diseases classd elsw but compl preg/chldbrth"	1	255	442	697
"K31"	"H91"	"Other diseases of stomach and duodenum"	"Other and unspecified hearing loss"	1	187	622	809
"M07"	"D25"	"Enteropathic arthropathies"	"Leiomyoma of uterus"	1	30	211	241
"I46"	"M31"	"Cardiac arrest"	"Other necrotizing vasculopathies"	1	13	233	246
"C44"	"M48"	"Other and unspecified malignant neoplasm of skin"	"Other spondylopathies"	1	757	1088	1845
"I25"	"M47"	"Chronic ischemic heart disease"	"Spondylosis"	1	2577	3245	5822
"C80"	"M75"	"Malignant neoplasm without specification of site"	"Shoulder lesions"	1	6	249	255
"O42"	"B27"	"Premature rupture of membranes"	"Infectious mononucleosis"	1	0	84	84
"K62"	"M22"	"Other diseases of anus and rectum"	"Disorder of patella"	1	19	590	609
"F90"	"K40"	"Attention-deficit hyperactivity disorders"	"Inguinal hernia"	1	1	120	121
"H90"	"N92"	"Conductive and sensorineural hearing loss"	"Excessive, frequent and irregular menstruation"	1	171	971	1142
"G47"	"K20"	"Sleep disorders"	"Esophagitis"	1	96	637	733
"J90"	"J44"	"Pleural effusion, not elsewhere classified"	"Other chronic obstructive pulmonary disease"	1	2139	2591	4730
"G20"	"K80"	"Parkinson's disease"	"Cholelithiasis"	1	164	440	604
"L05"	"F10"	"Pilonidal cyst and sinus"	"Alcohol related disorders"	1	355	509	864
"M85"	"H25"	"Other disorders of bone density and structure"	"Age-related cataract"	1	2569	3318	5887
"E68"	"O03"	"Sequelae of hyperalimentation"	"Spontaneous abortion"	1	0	257	257
"O92"	"O36"	"Oth disord of brst/lactatn assoc w pregnancy and the puerp"	"Maternal care for other fetal problems"	1	2118	2490	4608
"Q23"	"K40"	"Congenital malformations of aortic and mitral valves"	"Inguinal hernia"	1	15	127	142
"J96"	"O99"	"Respiratory failure, not elsewhere classified"	"Oth maternal diseases classd elsw but compl preg/chldbrth"	1	104	343	447
"H25"	"B18"	"Age-related cataract"	"Chronic viral hepatitis"	1	88	218	306
"I70"	"D06"	"Atherosclerosis"	"Carcinoma in situ of cervix uteri"	1	0	57	57
"L08"	"B27"	"Other local infections of skin and subcutaneous tissue"	"Infectious mononucleosis"	1	17	133	150
"N18"	"K44"	"Chronic kidney disease (CKD)"	"Diaphragmatic hernia"	1	283	1592	1875
"A46"	"J32"	"Erysipelas"	"Chronic sinusitis"	1	68	239	307
"K20"	"D24"	"Esophagitis"	"Benign neoplasm of breast"	1	46	124	170
"E68"	"O91"	"Sequelae of hyperalimentation"	"Infect of breast assoc w pregnancy, the puerp and lactation"	1	2	35	37
"K57"	"D17"	"Diverticular disease of intestine"	"Benign lipomatous neoplasm"	1	315	1319	1634
"C91"	"D72"	"Lymphoid leukemia"	"Other disorders of white blood cells"	1	142	288	430
"D23"	"F10"	"Other benign neoplasms of skin"	"Alcohol related disorders"	1	369	556	925
"J18"	"K62"	"Pneumonia, unspecified organism"	"Other diseases of anus and rectum"	1	4941	7219	12160
"M19"	"C62"	"Other and unspecified osteoarthritis"	"Malignant neoplasm of testis"	1	0	38	38
"C16"	"G43"	"Malignant neoplasm of stomach"	"Migraine"	1	1	28	29
"I26"	"H83"	"Pulmonary embolism"	"Other diseases of inner ear"	1	0	534	534
"J15"	"L93"	"Bacterial pneumonia, not elsewhere classified"	"Lupus erythematosus"	1	24	89	113
"C25"	"I50"	"Malignant neoplasm of pancreas"	"Heart failure"	1	234	758	992
"G96"	"C44"	"Other disorders of central nervous system"	"Other and unspecified malignant neoplasm of skin"	1	232	491	723
"C92"	"E66"	"Myeloid leukemia"	"Overweight and obesity"	1	33	140	173
"E04"	"H66"	"Other nontoxic goiter"	"Suppurative and unspecified otitis media"	1	38	142	180
"J18"	"H80"	"Pneumonia, unspecified organism"	"Otosclerosis"	1	0	1023	1023
"C14"	"M75"	"Malig neoplasm of sites in the lip, oral cavity and pharynx"	"Shoulder lesions"	1	9	46	55
"C79"	"C18"	"Secondary malignant neoplasm of other and unspecified sites"	"Malignant neoplasm of colon"	1	880	2667	3547
"J96"	"I11"	"Respiratory failure, not elsewhere classified"	"Hypertensive heart disease"	1	1186	1737	2923
"I74"	"O70"	"Arterial embolism and thrombosis"	"Perineal laceration during delivery"	1	5	38	43
"K64"	"F10"	"Hemorrhoids and perianal venous thrombosis"	"Alcohol related disorders"	1	0	978	978
"C48"	"C18"	"Malignant neoplasm of retroperitoneum and peritoneum"	"Malignant neoplasm of colon"	1	35	123	158
"K59"	"C65"	"Other functional intestinal disorders"	"Malignant neoplasm of renal pelvis"	1	137	286	423
"D64"	"K26"	"Other anemias"	"Duodenal ulcer"	1	3375	4159	7534
"A04"	"K51"	"Other bacterial intestinal infections"	"Ulcerative colitis"	1	453	841	1294
"I46"	"I11"	"Cardiac arrest"	"Hypertensive heart disease"	1	204	649	853
"M31"	"N84"	"Other necrotizing vasculopathies"	"Polyp of female genital tract"	1	32	88	120
"N12"	"D25"	"Tubulo-interstitial nephritis, not spcf as acute or chronic"	"Leiomyoma of uterus"	1	22	80	102
"F02"	"M17"	"Dementia in other diseases classified elsewhere"	"Osteoarthritis of knee"	1	1	188	189
"G62"	"M42"	"Other and unspecified polyneuropathies"	"Spinal osteochondrosis"	1	17	79	96
"K62"	"Q53"	"Other diseases of anus and rectum"	"Undescended and ectopic testicle"	1	10	113	123
"D09"	"H35"	"Carcinoma in situ of other and unspecified sites"	"Other retinal disorders"	1	61	177	238
"J03"	"Q66"	"Acute tonsillitis"	"Congenital deformities of feet"	1	249	399	648
"J96"	"C60"	"Respiratory failure, not elsewhere classified"	"Malignant neoplasm of penis"	1	6	48	54
"K56"	"D39"	"Paralytic ileus and intestinal obstruction without hernia"	"Neoplasm of uncertain behavior of female genital organs"	1	80	178	258
"M80"	"M17"	"Osteoporosis with current pathological fracture"	"Osteoarthritis of knee"	1	0	3428	3428
"F33"	"H00"	"Major depressive disorder, recurrent"	"Hordeolum and chalazion"	1	0	49	49
"J15"	"C18"	"Bacterial pneumonia, not elsewhere classified"	"Malignant neoplasm of colon"	1	825	1674	2499
"G81"	"I65"	"Hemiplegia and hemiparesis"	"Occls and stenosis of precerb art, not rslt in cereb infrc"	1	19	68	87
"J06"	"K42"	"Acute upper resp infections of multiple and unsp sites"	"Umbilical hernia"	1	107	353	460
"O12"	"E10"	"Gestational edema and proteinuria without hypertension"	"Type 1 diabetes mellitus"	1	11	49	60
"J96"	"H44"	"Respiratory failure, not elsewhere classified"	"Disorders of globe"	1	37	216	253
"I85"	"K60"	"Esophageal varices"	"Fissure and fistula of anal and rectal regions"	1	18	80	98
"M86"	"K40"	"Osteomyelitis"	"Inguinal hernia"	1	77	201	278
"J01"	"O04"	"Acute sinusitis"	"Complications following (induced) termination of pregnancy"	1	0	573	573
"M48"	"N92"	"Other spondylopathies"	"Excessive, frequent and irregular menstruation"	1	0	1271	1271
"G47"	"C85"	"Sleep disorders"	"Oth and unspecified types of non-Hodgkin lymphoma"	1	61	138	199
"G47"	"N20"	"Sleep disorders"	"Calculus of kidney and ureter"	1	308	1372	1680
"J84"	"H02"	"Other interstitial pulmonary diseases"	"Other disorders of eyelid"	1	75	177	252
"G44"	"O62"	"Other headache syndromes"	"Abnormalities of forces of labor"	1	0	1685	1685
"K64"	"H25"	"Hemorrhoids and perianal venous thrombosis"	"Age-related cataract"	1	485	2364	2849
"M18"	"H80"	"Osteoarthritis of first carpometacarpal joint"	"Otosclerosis"	1	3	42	45
"I69"	"D06"	"Sequelae of cerebrovascular disease"	"Carcinoma in situ of cervix uteri"	1	0	52	52
"D25"	"O87"	"Leiomyoma of uterus"	"Venous complications and hemorrhoids in the puerperium"	1	0	30	30
"E86"	"F11"	"Volume depletion"	"Opioid related disorders"	1	169	338	507
"I46"	"F60"	"Cardiac arrest"	"Specific personality disorders"	1	9	79	88
"H90"	"M23"	"Conductive and sensorineural hearing loss"	"Internal derangement of knee"	1	948	1669	2617
"M75"	"K35"	"Shoulder lesions"	"Acute appendicitis"	1	429	2141	2570
"H54"	"H40"	"Blindness and low vision"	"Glaucoma"	1	455	1013	1468
"A26"	"I70"	"Erysipeloid"	"Atherosclerosis"	1	40	111	151
"C34"	"N45"	"Malignant neoplasm of bronchus and lung"	"Orchitis and epididymitis"	1	10	394	404
"I95"	"N95"	"Hypotension"	"Menopausal and other perimenopausal disorders"	1	66	342	408
"E28"	"G40"	"Ovarian dysfunction"	"Epilepsy and recurrent seizures"	1	13	110	123
"N28"	"M77"	"Oth disorders of kidney and ureter, not elsewhere classified"	"Other enthesopathies"	1	24	86	110
"I73"	"H72"	"Other peripheral vascular diseases"	"Perforation of tympanic membrane"	1	28	113	141
"G23"	"H25"	"Other degenerative diseases of basal ganglia"	"Age-related cataract"	1	54	219	273
"E21"	"O80"	"Hyperparathyroidism and other disorders of parathyroid gland"	"Encounter for full-term uncomplicated delivery"	1	0	214	214
"K59"	"E05"	"Other functional intestinal disorders"	"Thyrotoxicosis [hyperthyroidism]"	1	1043	2464	3507
"D84"	"O68"	"Other immunodeficiencies"	"Labor and delivery comp by abnlt of fetal acid-base balance"	1	1	36	37
"H81"	"N60"	"Disorders of vestibular function"	"Benign mammary dysplasia"	1	115	322	437
"J84"	"N81"	"Other interstitial pulmonary diseases"	"Female genital prolapse"	1	23	230	253
"F32"	"L02"	"Depressive episode"	"Cutaneous abscess, furuncle and carbuncle"	1	626	1017	1643
"J94"	"I35"	"Other pleural conditions"	"Nonrheumatic aortic valve disorders"	1	240	482	722
"J98"	"N40"	"Other respiratory disorders"	"Benign prostatic hyperplasia"	1	226	715	941
"I63"	"N81"	"Cerebral infarction"	"Female genital prolapse"	1	0	2153	2153
"F41"	"C18"	"Other anxiety disorders"	"Malignant neoplasm of colon"	1	340	1526	1866
"E66"	"K09"	"Overweight and obesity"	"Cysts of oral region, not elsewhere classified"	1	26	86	112
"C85"	"H83"	"Oth and unspecified types of non-Hodgkin lymphoma"	"Other diseases of inner ear"	1	23	142	165
"M25"	"D25"	"Other joint disorder, not elsewhere classified"	"Leiomyoma of uterus"	1	380	1114	1494
"D62"	"J32"	"Acute posthemorrhagic anemia"	"Chronic sinusitis"	1	8	51	59
"K05"	"Q21"	"Gingivitis and periodontal diseases"	"Congenital malformations of cardiac septa"	1	10	67	77
"E13"	"O20"	"Other specified diabetes mellitus"	"Hemorrhage in early pregnancy"	1	0	25	25
"H57"	"C54"	"Other disorders of eye and adnexa"	"Malignant neoplasm of corpus uteri"	1	7	42	49
"N10"	"M65"	"Acute pyelonephritis"	"Synovitis and tenosynovitis"	1	230	360	590
"C78"	"B07"	"Secondary malignant neoplasm of resp and digestive organs"	"Viral warts"	1	0	42	42
"O72"	"F99"	"Postpartum hemorrhage"	"Mental disorder, not otherwise specified"	1	6	164	170
"F32"	"O65"	"Depressive episode"	"Obstructed labor due to maternal pelvic abnormality"	1	0	98	98
"F33"	"M76"	"Major depressive disorder, recurrent"	"Enthesopathies, lower limb, excluding foot"	1	52	230	282
"M15"	"M16"	"Polyosteoarthritis"	"Osteoarthritis of hip"	1	935	1478	2413
"O92"	"N97"	"Oth disord of brst/lactatn assoc w pregnancy and the puerp"	"Female infertility"	1	0	2839	2839
"L02"	"H71"	"Cutaneous abscess, furuncle and carbuncle"	"Cholesteatoma of middle ear"	1	44	112	156
"L30"	"E11"	"Other and unspecified dermatitis"	"Type 2 diabetes mellitus"	1	791	1200	1991
"F79"	"K40"	"Unspecified intellectual disabilities"	"Inguinal hernia"	1	49	132	181
"E04"	"N62"	"Other nontoxic goiter"	"Hypertrophy of breast"	1	105	225	330
"D69"	"K30"	"Purpura and other hemorrhagic conditions"	"Functional dyspepsia"	1	136	335	471
"J47"	"M72"	"Bronchiectasis"	"Fibroblastic disorders"	1	20	87	107
"M45"	"O03"	"Ankylosing spondylitis"	"Spontaneous abortion"	1	2	40	42
"I71"	"N95"	"Aortic aneurysm and dissection"	"Menopausal and other perimenopausal disorders"	1	22	212	234
"G47"	"N44"	"Sleep disorders"	"Noninflammatory disorders of testis"	1	4	68	72
"M16"	"K21"	"Osteoarthritis of hip"	"Gastro-esophageal reflux disease"	1	1150	1655	2805
"I71"	"K04"	"Aortic aneurysm and dissection"	"Diseases of pulp and periapical tissues"	1	146	287	433
"O08"	"O00"	"Complications following ectopic and molar pregnancy"	"Ectopic pregnancy"	1	396	574	970
"A41"	"C84"	"Other sepsis"	"Mature T/NK-cell lymphomas"	1	163	403	566
"O70"	"B50"	"Perineal laceration during delivery"	"Plasmodium falciparum malaria"	1	0	35	35
"C61"	"H36"	"Malignant neoplasm of prostate"	"Retinal disorders in diseases classified elsewhere"	1	113	249	362
"D69"	"N40"	"Purpura and other hemorrhagic conditions"	"Benign prostatic hyperplasia"	1	128	542	670
"E66"	"A56"	"Overweight and obesity"	"Other sexually transmitted chlamydial diseases"	1	48	210	258
"J06"	"M65"	"Acute upper resp infections of multiple and unsp sites"	"Synovitis and tenosynovitis"	1	63	386	449
"H53"	"O80"	"Visual disturbances"	"Encounter for full-term uncomplicated delivery"	1	15	887	902
"K58"	"A63"	"Irritable bowel syndrome"	"Oth predominantly sexually transmitted diseases, NEC"	1	118	371	489
"I31"	"K05"	"Other diseases of pericardium"	"Gingivitis and periodontal diseases"	1	69	280	349
"M51"	"K35"	"Thoracic, thoracolum, and lumbosacral intvrt disc disorders"	"Acute appendicitis"	1	509	1363	1872
"J10"	"E11"	"Influenza due to other identified influenza virus"	"Type 2 diabetes mellitus"	1	40	333	373
"K52"	"O02"	"Other and unsp noninfective gastroenteritis and colitis"	"Other abnormal products of conception"	1	154	317	471
"J32"	"O32"	"Chronic sinusitis"	"Maternal care for malpresentation of fetus"	1	14	118	132
"O82"	"O26"	"Encounter for cesarean delivery without indication"	"Maternal care for oth conditions predom related to pregnancy"	1	7610	10379	17989
"N17"	"D75"	"Acute kidney failure"	"Other and unsp diseases of blood and blood-forming organs"	1	48	140	188
"M76"	"J36"	"Enthesopathies, lower limb, excluding foot"	"Peritonsillar abscess"	1	49	146	195
"E83"	"K04"	"Disorders of mineral metabolism"	"Diseases of pulp and periapical tissues"	1	102	222	324
"I21"	"H33"	"Acute myocardial infarction"	"Retinal detachments and breaks"	1	380	591	971
"M48"	"M25"	"Other spondylopathies"	"Other joint disorder, not elsewhere classified"	1	724	1282	2006
"K83"	"O00"	"Other diseases of biliary tract"	"Ectopic pregnancy"	1	1	24	25
"N39"	"I88"	"Other disorders of urinary system"	"Nonspecific lymphadenitis"	1	90	260	350
"Q40"	"O04"	"Other congenital malformations of upper alimentary tract"	"Complications following (induced) termination of pregnancy"	1	0	48	48
"I65"	"H83"	"Occls and stenosis of precerb art, not rslt in cereb infrc"	"Other diseases of inner ear"	1	75	249	324
"G51"	"M22"	"Facial nerve disorders"	"Disorder of patella"	1	10	115	125
"J93"	"M72"	"Pneumothorax and air leak"	"Fibroblastic disorders"	1	55	182	237
"C76"	"J42"	"Malignant neoplasm of other and ill-defined sites"	"Unspecified chronic bronchitis"	1	38	97	135
"C71"	"C61"	"Malignant neoplasm of brain"	"Malignant neoplasm of prostate"	1	48	167	215
"I48"	"N97"	"Atrial fibrillation and flutter"	"Female infertility"	1	0	105	105
"K61"	"J36"	"Abscess of anal and rectal regions"	"Peritonsillar abscess"	1	43	107	150
"C78"	"J40"	"Secondary malignant neoplasm of resp and digestive organs"	"Bronchitis, not specified as acute or chronic"	1	24	99	123
"E89"	"K35"	"Postproc endocrine and metabolic comp and disorders, NEC"	"Acute appendicitis"	1	12	85	97
"O24"	"O21"	"Diabetes in pregnancy, childbirth, and the puerperium"	"Excessive vomiting in pregnancy"	1	332	576	908
"C53"	"O64"	"Malignant neoplasm of cervix uteri"	"Obstructed labor due to malposition and malpresent of fetus"	1	0	54	54
"I70"	"O47"	"Atherosclerosis"	"False labor"	1	0	26	26
"C25"	"H26"	"Malignant neoplasm of pancreas"	"Other cataract"	1	31	455	486
"M75"	"H65"	"Shoulder lesions"	"Nonsuppurative otitis media"	1	77	611	688
"J69"	"C61"	"Pneumonitis due to solids and liquids"	"Malignant neoplasm of prostate"	1	35	276	311
"K74"	"M67"	"Fibrosis and cirrhosis of liver"	"Other disorders of synovium and tendon"	1	0	100	100
"K62"	"H83"	"Other diseases of anus and rectum"	"Other diseases of inner ear"	1	188	1062	1250
"N19"	"I44"	"Unspecified kidney failure"	"Atrioventricular and left bundle-branch block"	1	609	858	1467
"I31"	"K01"	"Other diseases of pericardium"	"Embedded and impacted teeth"	1	17	62	79
"J96"	"L04"	"Respiratory failure, not elsewhere classified"	"Acute lymphadenitis"	1	14	128	142
"I10"	"N62"	"Essential (primary) hypertension"	"Hypertrophy of breast"	1	995	1752	2747
"I26"	"M18"	"Pulmonary embolism"	"Osteoarthritis of first carpometacarpal joint"	1	61	142	203
"C78"	"G45"	"Secondary malignant neoplasm of resp and digestive organs"	"Transient cerebral ischemic attacks and related syndromes"	1	0	1557	1557
"I51"	"E11"	"Complications and ill-defined descriptions of heart disease"	"Type 2 diabetes mellitus"	1	599	1617	2216
"D21"	"O62"	"Other benign neoplasms of connective and other soft tissue"	"Abnormalities of forces of labor"	1	11	305	316
"D64"	"M51"	"Other anemias"	"Thoracic, thoracolum, and lumbosacral intvrt disc disorders"	1	0	4295	4295
"H26"	"K29"	"Other cataract"	"Gastritis and duodenitis"	1	973	1436	2409
"I46"	"J05"	"Cardiac arrest"	"Acute obstructive laryngitis [croup] and epiglottitis"	1	1	27	28
"H34"	"E11"	"Retinal vascular occlusions"	"Type 2 diabetes mellitus"	1	618	947	1565
"N18"	"L93"	"Chronic kidney disease (CKD)"	"Lupus erythematosus"	1	19	72	91
"C43"	"O23"	"Malignant melanoma of skin"	"Infections of genitourinary tract in pregnancy"	1	8	51	59
"J96"	"O64"	"Respiratory failure, not elsewhere classified"	"Obstructed labor due to malposition and malpresent of fetus"	1	0	48	48
"C90"	"M79"	"Multiple myeloma and malignant plasma cell neoplasms"	"Oth and unsp soft tissue disorders, not elsewhere classified"	1	91	227	318
"J84"	"E05"	"Other interstitial pulmonary diseases"	"Thyrotoxicosis [hyperthyroidism]"	1	110	233	343
"F32"	"G56"	"Depressive episode"	"Mononeuropathies of upper limb"	1	604	1195	1799
"K05"	"N81"	"Gingivitis and periodontal diseases"	"Female genital prolapse"	1	86	179	265
"C82"	"L04"	"Follicular lymphoma"	"Acute lymphadenitis"	1	28	140	168
"E21"	"M50"	"Hyperparathyroidism and other disorders of parathyroid gland"	"Cervical disc disorders"	1	30	128	158
"D61"	"C50"	"Oth aplastic anemias and other bone marrow failure syndromes"	"Malignant neoplasm of breast"	1	21	102	123
"K80"	"D48"	"Cholelithiasis"	"Neoplasm of uncertain behavior of other and unsp sites"	1	73	193	266
"M81"	"K42"	"Osteoporosis without current pathological fracture"	"Umbilical hernia"	1	183	491	674
"I20"	"O66"	"Angina pectoris"	"Other obstructed labor"	1	0	30	30
"M65"	"D28"	"Synovitis and tenosynovitis"	"Benign neoplasm of other and unsp female genital organs"	1	33	97	130
"J96"	"I63"	"Respiratory failure, not elsewhere classified"	"Cerebral infarction"	1	0	8083	8083
"O42"	"F10"	"Premature rupture of membranes"	"Alcohol related disorders"	1	19	606	625
"O91"	"N97"	"Infect of breast assoc w pregnancy, the puerp and lactation"	"Female infertility"	1	194	1438	1632
"N82"	"O62"	"Fistulae involving female genital tract"	"Abnormalities of forces of labor"	1	4	196	200
"C49"	"D23"	"Malignant neoplasm of other connective and soft tissue"	"Other benign neoplasms of skin"	1	71	221	292
"I50"	"C44"	"Heart failure"	"Other and unspecified malignant neoplasm of skin"	1	2229	3151	5380
"K81"	"M16"	"Cholecystitis"	"Osteoarthritis of hip"	1	344	607	951
"K75"	"F10"	"Other inflammatory liver diseases"	"Alcohol related disorders"	1	81	234	315
"M81"	"N93"	"Osteoporosis without current pathological fracture"	"Other abnormal uterine and vaginal bleeding"	1	29	169	198
"M54"	"O32"	"Dorsalgia"	"Maternal care for malpresentation of fetus"	1	284	917	1201
"K29"	"O20"	"Gastritis and duodenitis"	"Hemorrhage in early pregnancy"	1	230	622	852
"K64"	"M76"	"Hemorrhoids and perianal venous thrombosis"	"Enthesopathies, lower limb, excluding foot"	1	43	642	685
"C78"	"M42"	"Secondary malignant neoplasm of resp and digestive organs"	"Spinal osteochondrosis"	1	0	35	35
"C85"	"D11"	"Oth and unspecified types of non-Hodgkin lymphoma"	"Benign neoplasm of major salivary glands"	1	52	157	209
"C61"	"H91"	"Malignant neoplasm of prostate"	"Other and unspecified hearing loss"	1	0	6377	6377
"J12"	"I25"	"Viral pneumonia, not elsewhere classified"	"Chronic ischemic heart disease"	1	66	156	222
"M21"	"N92"	"Other acquired deformities of limbs"	"Excessive, frequent and irregular menstruation"	1	216	869	1085
"I61"	"K44"	"Nontraumatic intracerebral hemorrhage"	"Diaphragmatic hernia"	1	105	497	602
"N39"	"O04"	"Other disorders of urinary system"	"Complications following (induced) termination of pregnancy"	1	0	2452	2452
"M23"	"A08"	"Internal derangement of knee"	"Viral and other specified intestinal infections"	1	156	561	717
"N92"	"O35"	"Excessive, frequent and irregular menstruation"	"Maternal care for known or suspected fetal abnlt and damage"	1	97	389	486
"M72"	"O32"	"Fibroblastic disorders"	"Maternal care for malpresentation of fetus"	1	0	78	78
"I21"	"O36"	"Acute myocardial infarction"	"Maternal care for other fetal problems"	1	0	67	67
"E13"	"M31"	"Other specified diabetes mellitus"	"Other necrotizing vasculopathies"	1	26	76	102
"D14"	"M51"	"Benign neoplasm of middle ear and respiratory system"	"Thoracic, thoracolum, and lumbosacral intvrt disc disorders"	1	186	406	592
"K92"	"O20"	"Other diseases of digestive system"	"Hemorrhage in early pregnancy"	1	50	191	241
"H36"	"M71"	"Retinal disorders in diseases classified elsewhere"	"Other bursopathies"	1	29	87	116
"O72"	"H91"	"Postpartum hemorrhage"	"Other and unspecified hearing loss"	1	171	426	597
"M33"	"N92"	"Dermatopolymyositis"	"Excessive, frequent and irregular menstruation"	1	3	31	34
"B37"	"M32"	"Candidiasis"	"Systemic lupus erythematosus (SLE)"	1	18	63	81
"K70"	"H83"	"Alcoholic liver disease"	"Other diseases of inner ear"	1	42	200	242
"O10"	"J35"	"Pre-existing hypertension compl preg/chldbrth"	"Chronic diseases of tonsils and adenoids"	1	0	94	94
"K71"	"K29"	"Toxic liver disease"	"Gastritis and duodenitis"	1	162	313	475
"C22"	"N30"	"Malignant neoplasm of liver and intrahepatic bile ducts"	"Cystitis"	1	134	409	543
"G30"	"E03"	"Alzheimer's disease"	"Other hypothyroidism"	1	149	504	653
"J86"	"I21"	"Pyothorax"	"Acute myocardial infarction"	1	159	279	438
"I71"	"E66"	"Aortic aneurysm and dissection"	"Overweight and obesity"	1	407	810	1217
"K76"	"G35"	"Other diseases of liver"	"Multiple sclerosis"	1	14	70	84
"I27"	"M21"	"Other pulmonary heart diseases"	"Other acquired deformities of limbs"	1	14	63	77
"K20"	"H10"	"Esophagitis"	"Conjunctivitis"	1	110	284	394
"N60"	"O82"	"Benign mammary dysplasia"	"Encounter for cesarean delivery without indication"	1	231	1021	1252
"G44"	"N92"	"Other headache syndromes"	"Excessive, frequent and irregular menstruation"	1	709	1403	2112
"M75"	"O00"	"Shoulder lesions"	"Ectopic pregnancy"	1	0	304	304
"K22"	"C32"	"Other diseases of esophagus"	"Malignant neoplasm of larynx"	1	63	294	357
"A41"	"C53"	"Other sepsis"	"Malignant neoplasm of cervix uteri"	1	46	544	590
"J15"	"E11"	"Bacterial pneumonia, not elsewhere classified"	"Type 2 diabetes mellitus"	1	0	12366	12366
"K22"	"I20"	"Other diseases of esophagus"	"Angina pectoris"	1	565	1917	2482
"I20"	"O90"	"Angina pectoris"	"Complications of the puerperium, not elsewhere classified"	1	0	43	43
"C78"	"H43"	"Secondary malignant neoplasm of resp and digestive organs"	"Disorders of vitreous body"	1	21	414	435
"C22"	"N81"	"Malignant neoplasm of liver and intrahepatic bile ducts"	"Female genital prolapse"	1	0	79	79
"O91"	"N10"	"Infect of breast assoc w pregnancy, the puerp and lactation"	"Acute pyelonephritis"	1	17	91	108
"J15"	"D12"	"Bacterial pneumonia, not elsewhere classified"	"Benign neoplasm of colon, rectum, anus and anal canal"	1	1092	3286	4378
"I10"	"J30"	"Essential (primary) hypertension"	"Vasomotor and allergic rhinitis"	1	317	1496	1813
"K57"	"G45"	"Diverticular disease of intestine"	"Transient cerebral ischemic attacks and related syndromes"	1	1539	2444	3983
"C34"	"C56"	"Malignant neoplasm of bronchus and lung"	"Malignant neoplasm of ovary"	1	54	139	193
"H35"	"N63"	"Other retinal disorders"	"Unspecified lump in breast"	1	104	568	672
"I70"	"K80"	"Atherosclerosis"	"Cholelithiasis"	1	1456	1802	3258
"I48"	"L40"	"Atrial fibrillation and flutter"	"Psoriasis"	1	458	952	1410
"J06"	"O14"	"Acute upper resp infections of multiple and unsp sites"	"Pre-eclampsia"	1	9	92	101
"D63"	"H71"	"Anemia in chronic diseases classified elsewhere"	"Cholesteatoma of middle ear"	1	0	25	25
"J18"	"H71"	"Pneumonia, unspecified organism"	"Cholesteatoma of middle ear"	1	63	359	422
"O60"	"O21"	"Preterm labor"	"Excessive vomiting in pregnancy"	1	173	323	496
"A49"	"D50"	"Bacterial infection of unspecified site"	"Iron deficiency anemia"	1	817	1345	2162
"L82"	"I21"	"Seborrheic keratosis"	"Acute myocardial infarction"	1	79	192	271
"C79"	"N94"	"Secondary malignant neoplasm of other and unspecified sites"	"Pain and oth cond assoc w fem gntl org and menstrual cycle"	1	0	130	130
"I44"	"H80"	"Atrioventricular and left bundle-branch block"	"Otosclerosis"	1	0	116	116
"G54"	"O48"	"Nerve root and plexus disorders"	"Late pregnancy"	1	1	41	42
"A49"	"H04"	"Bacterial infection of unspecified site"	"Disorders of lacrimal system"	1	31	132	163
"K04"	"C85"	"Diseases of pulp and periapical tissues"	"Oth and unspecified types of non-Hodgkin lymphoma"	1	135	290	425
"G31"	"M65"	"Oth degenerative diseases of nervous system, NEC"	"Synovitis and tenosynovitis"	1	0	84	84
"K65"	"I25"	"Peritonitis"	"Chronic ischemic heart disease"	1	866	1393	2259
"E78"	"K60"	"Disorders of lipoprotein metabolism and other lipidemias"	"Fissure and fistula of anal and rectal regions"	1	452	1002	1454
"N32"	"N81"	"Other disorders of bladder"	"Female genital prolapse"	1	313	527	840
"F41"	"C30"	"Other anxiety disorders"	"Malignant neoplasm of nasal cavity and middle ear"	1	2	32	34
"F03"	"M23"	"Unspecified dementia"	"Internal derangement of knee"	1	0	530	530
"J96"	"I45"	"Respiratory failure, not elsewhere classified"	"Other conduction disorders"	1	320	864	1184
"I25"	"N60"	"Chronic ischemic heart disease"	"Benign mammary dysplasia"	1	61	599	660
"J38"	"D24"	"Diseases of vocal cords and larynx, not elsewhere classified"	"Benign neoplasm of breast"	1	64	160	224
"C16"	"N20"	"Malignant neoplasm of stomach"	"Calculus of kidney and ureter"	1	29	107	136
"H16"	"O80"	"Keratitis"	"Encounter for full-term uncomplicated delivery"	1	163	858	1021
"F41"	"K56"	"Other anxiety disorders"	"Paralytic ileus and intestinal obstruction without hernia"	1	434	943	1377
"K72"	"K80"	"Hepatic failure, not elsewhere classified"	"Cholelithiasis"	1	234	586	820
"C25"	"H18"	"Malignant neoplasm of pancreas"	"Other disorders of cornea"	1	3	54	57
"K76"	"O03"	"Other diseases of liver"	"Spontaneous abortion"	1	0	136	136
"M66"	"O70"	"Spontaneous rupture of synovium and tendon"	"Perineal laceration during delivery"	1	4	65	69
"J44"	"O86"	"Other chronic obstructive pulmonary disease"	"Other puerperal infections"	1	0	30	30
"G47"	"M16"	"Sleep disorders"	"Osteoarthritis of hip"	1	670	1566	2236
"K21"	"M62"	"Gastro-esophageal reflux disease"	"Other disorders of muscle"	1	1349	3426	4775
"L97"	"M54"	"Non-pressure chronic ulcer of lower limb, NEC"	"Dorsalgia"	1	319	1640	1959
"G47"	"K40"	"Sleep disorders"	"Inguinal hernia"	1	0	2534	2534
"G57"	"M23"	"Mononeuropathies of lower limb"	"Internal derangement of knee"	1	675	1088	1763
"G35"	"G96"	"Multiple sclerosis"	"Other disorders of central nervous system"	1	402	926	1328
"H91"	"M22"	"Other and unspecified hearing loss"	"Disorder of patella"	1	73	620	693
"J70"	"M23"	"Respiratory conditions due to other external agents"	"Internal derangement of knee"	1	5	40	45
"I69"	"Q82"	"Sequelae of cerebrovascular disease"	"Other congenital malformations of skin"	1	19	74	93
"C78"	"K40"	"Secondary malignant neoplasm of resp and digestive organs"	"Inguinal hernia"	1	0	2263	2263
"O21"	"K35"	"Excessive vomiting in pregnancy"	"Acute appendicitis"	1	100	347	447
"E89"	"O71"	"Postproc endocrine and metabolic comp and disorders, NEC"	"Other obstetric trauma"	1	0	77	77
"I80"	"C53"	"Phlebitis and thrombophlebitis"	"Malignant neoplasm of cervix uteri"	1	117	284	401
"C48"	"N81"	"Malignant neoplasm of retroperitoneum and peritoneum"	"Female genital prolapse"	1	0	38	38
"C10"	"M50"	"Malignant neoplasm of oropharynx"	"Cervical disc disorders"	1	1	28	29
"E78"	"M16"	"Disorders of lipoprotein metabolism and other lipidemias"	"Osteoarthritis of hip"	1	3366	4999	8365
"N19"	"G40"	"Unspecified kidney failure"	"Epilepsy and recurrent seizures"	1	296	492	788
"K57"	"E04"	"Diverticular disease of intestine"	"Other nontoxic goiter"	1	455	1453	1908
"O72"	"K66"	"Postpartum hemorrhage"	"Other disorders of peritoneum"	1	77	165	242
"G56"	"K01"	"Mononeuropathies of upper limb"	"Embedded and impacted teeth"	1	42	132	174
"E86"	"I48"	"Volume depletion"	"Atrial fibrillation and flutter"	1	0	34738	34738
"B95"	"K80"	"Strep as the cause of diseases classified elsewhere"	"Cholelithiasis"	1	35	146	181
"D84"	"J44"	"Other immunodeficiencies"	"Other chronic obstructive pulmonary disease"	1	59	184	243
"N39"	"G61"	"Other disorders of urinary system"	"Inflammatory polyneuropathy"	1	82	228	310
"H90"	"O82"	"Conductive and sensorineural hearing loss"	"Encounter for cesarean delivery without indication"	1	107	368	475
"I10"	"N64"	"Essential (primary) hypertension"	"Other disorders of breast"	1	739	971	1710
"L02"	"O71"	"Cutaneous abscess, furuncle and carbuncle"	"Other obstetric trauma"	1	138	322	460
"H93"	"O30"	"Other disorders of ear, not elsewhere classified"	"Multiple gestation"	1	6	65	71
"C77"	"O48"	"Secondary and unspecified malignant neoplasm of lymph nodes"	"Late pregnancy"	1	0	39	39
"H91"	"O48"	"Other and unspecified hearing loss"	"Late pregnancy"	1	0	158	158
"C77"	"D25"	"Secondary and unspecified malignant neoplasm of lymph nodes"	"Leiomyoma of uterus"	1	0	428	428
"A49"	"N85"	"Bacterial infection of unspecified site"	"Other noninflammatory disorders of uterus, except cervix"	1	4	65	69
"O99"	"J30"	"Oth maternal diseases classd elsw but compl preg/chldbrth"	"Vasomotor and allergic rhinitis"	1	463	1162	1625
"M23"	"D27"	"Internal derangement of knee"	"Benign neoplasm of ovary"	1	481	850	1331
"G60"	"E10"	"Hereditary and idiopathic neuropathy"	"Type 1 diabetes mellitus"	1	38	98	136
"J10"	"M72"	"Influenza due to other identified influenza virus"	"Fibroblastic disorders"	1	1	44	45
"O72"	"M84"	"Postpartum hemorrhage"	"Disorder of continuity of bone"	1	22	105	127
"E86"	"Q66"	"Volume depletion"	"Congenital deformities of feet"	1	175	285	460
"A41"	"D62"	"Other sepsis"	"Acute posthemorrhagic anemia"	1	1296	1719	3015
"C53"	"J35"	"Malignant neoplasm of cervix uteri"	"Chronic diseases of tonsils and adenoids"	1	0	47	47
"E11"	"N75"	"Type 2 diabetes mellitus"	"Diseases of Bartholin's gland"	1	51	143	194
"L89"	"K21"	"Pressure ulcer"	"Gastro-esophageal reflux disease"	1	50	435	485
"C44"	"M20"	"Other and unspecified malignant neoplasm of skin"	"Acquired deformities of fingers and toes"	1	161	803	964
"F01"	"I69"	"Vascular dementia"	"Sequelae of cerebrovascular disease"	1	2889	3555	6444
"C92"	"D12"	"Myeloid leukemia"	"Benign neoplasm of colon, rectum, anus and anal canal"	1	48	225	273
"O44"	"O70"	"Placenta previa"	"Perineal laceration during delivery"	1	666	878	1544
"D63"	"C62"	"Anemia in chronic diseases classified elsewhere"	"Malignant neoplasm of testis"	1	11	141	152
"E64"	"K85"	"Sequelae of malnutrition and other nutritional deficiencies"	"Acute pancreatitis"	1	41	246	287
"M51"	"O20"	"Thoracic, thoracolum, and lumbosacral intvrt disc disorders"	"Hemorrhage in early pregnancy"	1	0	1387	1387
"D47"	"E66"	"Oth neoplm of uncrt behav of lymphoid, hematpoetc & rel tiss"	"Overweight and obesity"	1	67	345	412
"K83"	"O34"	"Other diseases of biliary tract"	"Maternal care for abnormality of pelvic organs"	1	13	53	66
"D68"	"H25"	"Other coagulation defects"	"Age-related cataract"	1	552	866	1418
"A04"	"I21"	"Other bacterial intestinal infections"	"Acute myocardial infarction"	1	307	1252	1559
"I60"	"N92"	"Nontraumatic subarachnoid hemorrhage"	"Excessive, frequent and irregular menstruation"	1	65	266	331
"O10"	"M22"	"Pre-existing hypertension compl preg/chldbrth"	"Disorder of patella"	1	0	76	76
"H93"	"O71"	"Other disorders of ear, not elsewhere classified"	"Other obstetric trauma"	1	0	118	118
"C78"	"H26"	"Secondary malignant neoplasm of resp and digestive organs"	"Other cataract"	1	134	1470	1604
"D12"	"M05"	"Benign neoplasm of colon, rectum, anus and anal canal"	"Rheumatoid arthritis with rheumatoid factor"	1	286	577	863
"Q65"	"O04"	"Congenital deformities of hip"	"Complications following (induced) termination of pregnancy"	1	54	192	246
"O75"	"O02"	"Oth complications of labor and delivery, NEC"	"Other abnormal products of conception"	1	1578	3376	4954
"I46"	"N40"	"Cardiac arrest"	"Benign prostatic hyperplasia"	1	0	1798	1798
"J96"	"M76"	"Respiratory failure, not elsewhere classified"	"Enthesopathies, lower limb, excluding foot"	1	0	392	392
"O70"	"Q52"	"Perineal laceration during delivery"	"Other congenital malformations of female genitalia"	1	5	108	113
"J44"	"N62"	"Other chronic obstructive pulmonary disease"	"Hypertrophy of breast"	1	349	651	1000
"D64"	"O14"	"Other anemias"	"Pre-eclampsia"	1	1	192	193
"M96"	"O80"	"Intraop and postproc comp and disorders of ms sys, NEC"	"Encounter for full-term uncomplicated delivery"	1	0	87	87
"I21"	"H71"	"Acute myocardial infarction"	"Cholesteatoma of middle ear"	1	29	144	173
"F31"	"K40"	"Bipolar disorder"	"Inguinal hernia"	1	46	149	195
"E87"	"M71"	"Other disorders of fluid, electrolyte and acid-base balance"	"Other bursopathies"	1	21	429	450
"I34"	"N80"	"Nonrheumatic mitral valve disorders"	"Endometriosis"	1	7	40	47
"B44"	"I20"	"Aspergillosis"	"Angina pectoris"	1	11	73	84
"E78"	"N45"	"Disorders of lipoprotein metabolism and other lipidemias"	"Orchitis and epididymitis"	1	441	738	1179
"J69"	"K02"	"Pneumonitis due to solids and liquids"	"Dental caries"	1	35	223	258
"F01"	"N30"	"Vascular dementia"	"Cystitis"	1	1605	1949	3554
"M06"	"O64"	"Other rheumatoid arthritis"	"Obstructed labor due to malposition and malpresent of fetus"	1	5	66	71
"N18"	"D10"	"Chronic kidney disease (CKD)"	"Benign neoplasm of mouth and pharynx"	1	68	176	244
"N81"	"J03"	"Female genital prolapse"	"Acute tonsillitis"	1	71	155	226
"F84"	"J45"	"Pervasive developmental disorders"	"Asthma"	1	52	356	408
"K27"	"H91"	"Peptic ulcer, site unspecified"	"Other and unspecified hearing loss"	1	498	1169	1667
"M70"	"D06"	"Soft tissue disorders related to use, overuse and pressure"	"Carcinoma in situ of cervix uteri"	1	0	71	71
"N18"	"I99"	"Chronic kidney disease (CKD)"	"Other and unspecified disorders of circulatory system"	1	155	285	440
"N84"	"L02"	"Polyp of female genital tract"	"Cutaneous abscess, furuncle and carbuncle"	1	204	339	543
"I27"	"N81"	"Other pulmonary heart diseases"	"Female genital prolapse"	1	46	240	286
"O92"	"O30"	"Oth disord of brst/lactatn assoc w pregnancy and the puerp"	"Multiple gestation"	1	340	1030	1370
"C20"	"D37"	"Malignant neoplasm of rectum"	"Neoplasm of uncrt behavior of oral cavity and dgstv organs"	1	311	541	852
"G40"	"I60"	"Epilepsy and recurrent seizures"	"Nontraumatic subarachnoid hemorrhage"	1	659	1053	1712
"J22"	"M16"	"Unspecified acute lower respiratory infection"	"Osteoarthritis of hip"	1	12	569	581
"J84"	"D27"	"Other interstitial pulmonary diseases"	"Benign neoplasm of ovary"	1	9	82	91
"K70"	"K61"	"Alcoholic liver disease"	"Abscess of anal and rectal regions"	1	68	263	331
"M19"	"L20"	"Other and unspecified osteoarthritis"	"Atopic dermatitis"	1	3	113	116
"I35"	"N97"	"Nonrheumatic aortic valve disorders"	"Female infertility"	1	0	57	57
"A04"	"L08"	"Other bacterial intestinal infections"	"Other local infections of skin and subcutaneous tissue"	1	205	422	627
"G44"	"N47"	"Other headache syndromes"	"Disorders of prepuce"	1	69	189	258
"E55"	"C67"	"Vitamin D deficiency"	"Malignant neoplasm of bladder"	1	9	69	78
"M80"	"D25"	"Osteoporosis with current pathological fracture"	"Leiomyoma of uterus"	1	0	236	236
"M47"	"D48"	"Spondylosis"	"Neoplasm of uncertain behavior of other and unsp sites"	1	28	90	118
"J18"	"C02"	"Pneumonia, unspecified organism"	"Malignant neoplasm of other and unspecified parts of tongue"	1	176	322	498
"E15"	"K86"	"Nondiabetic hypoglycemic coma"	"Other diseases of pancreas"	1	38	113	151
"L08"	"K80"	"Other local infections of skin and subcutaneous tissue"	"Cholelithiasis"	1	585	953	1538
"G21"	"I83"	"Secondary parkinsonism"	"Varicose veins of lower extremities"	1	12	54	66
"Q61"	"M23"	"Cystic kidney disease"	"Internal derangement of knee"	1	61	360	421
"L30"	"Q53"	"Other and unspecified dermatitis"	"Undescended and ectopic testicle"	1	11	80	91
"I89"	"I21"	"Oth noninfective disorders of lymphatic vessels and nodes"	"Acute myocardial infarction"	1	109	201	310
"O90"	"O45"	"Complications of the puerperium, not elsewhere classified"	"Premature separation of placenta [abruptio placentae]"	1	158	265	423
"A49"	"O23"	"Bacterial infection of unspecified site"	"Infections of genitourinary tract in pregnancy"	1	36	118	154
"E04"	"O64"	"Other nontoxic goiter"	"Obstructed labor due to malposition and malpresent of fetus"	1	3	393	396
"C34"	"I51"	"Malignant neoplasm of bronchus and lung"	"Complications and ill-defined descriptions of heart disease"	1	150	281	431
"J18"	"M06"	"Pneumonia, unspecified organism"	"Other rheumatoid arthritis"	1	1773	4191	5964
"F43"	"M65"	"Reaction to severe stress, and adjustment disorders"	"Synovitis and tenosynovitis"	1	242	442	684
"N83"	"O48"	"Noninflammatory disord of ovary, fallop and broad ligament"	"Late pregnancy"	1	164	664	828
"J06"	"F20"	"Acute upper resp infections of multiple and unsp sites"	"Schizophrenia"	1	22	78	100
"B37"	"C44"	"Candidiasis"	"Other and unspecified malignant neoplasm of skin"	1	234	393	627
"I82"	"M51"	"Other venous embolism and thrombosis"	"Thoracic, thoracolum, and lumbosacral intvrt disc disorders"	1	82	513	595
"N30"	"G80"	"Cystitis"	"Cerebral palsy"	1	164	292	456
"I70"	"O70"	"Atherosclerosis"	"Perineal laceration during delivery"	1	4	53	57
"I10"	"G57"	"Essential (primary) hypertension"	"Mononeuropathies of lower limb"	1	828	1228	2056
"C34"	"C51"	"Malignant neoplasm of bronchus and lung"	"Malignant neoplasm of vulva"	1	6	47	53
"E83"	"M43"	"Disorders of mineral metabolism"	"Other deforming dorsopathies"	1	15	108	123
"N83"	"O42"	"Noninflammatory disord of ovary, fallop and broad ligament"	"Premature rupture of membranes"	1	511	755	1266
"E03"	"M72"	"Other hypothyroidism"	"Fibroblastic disorders"	1	188	368	556
"J91"	"D17"	"Pleural effusion in conditions classified elsewhere"	"Benign lipomatous neoplasm"	1	4	108	112
"G98"	"L05"	"Other disorders of nervous system not elsewhere classified"	"Pilonidal cyst and sinus"	1	4	54	58
"D64"	"O42"	"Other anemias"	"Premature rupture of membranes"	1	22	249	271
"D12"	"M13"	"Benign neoplasm of colon, rectum, anus and anal canal"	"Other arthritis"	1	422	644	1066
"G57"	"O62"	"Mononeuropathies of lower limb"	"Abnormalities of forces of labor"	1	9	363	372
"G55"	"O80"	"Nerve root and plexus compressions in diseases classd elswhr"	"Encounter for full-term uncomplicated delivery"	1	0	77	77
"E86"	"D51"	"Volume depletion"	"Vitamin B12 deficiency anemia"	1	1082	1471	2553
"M51"	"E28"	"Thoracic, thoracolum, and lumbosacral intvrt disc disorders"	"Ovarian dysfunction"	1	118	217	335
"E64"	"F10"	"Sequelae of malnutrition and other nutritional deficiencies"	"Alcohol related disorders"	1	235	1051	1286
"I10"	"M65"	"Essential (primary) hypertension"	"Synovitis and tenosynovitis"	1	3148	6551	9699
"D61"	"I83"	"Oth aplastic anemias and other bone marrow failure syndromes"	"Varicose veins of lower extremities"	1	13	102	115
"C44"	"I21"	"Other and unspecified malignant neoplasm of skin"	"Acute myocardial infarction"	1	965	1583	2548
"M80"	"M42"	"Osteoporosis with current pathological fracture"	"Spinal osteochondrosis"	1	32	94	126
"O64"	"M41"	"Obstructed labor due to malposition and malpresent of fetus"	"Scoliosis"	1	4	44	48
"O46"	"L20"	"Antepartum hemorrhage, not elsewhere classified"	"Atopic dermatitis"	1	12	64	76
"C16"	"M35"	"Malignant neoplasm of stomach"	"Other systemic involvement of connective tissue"	1	21	100	121
"K60"	"J36"	"Fissure and fistula of anal and rectal regions"	"Peritonsillar abscess"	1	31	118	149
"D69"	"D27"	"Purpura and other hemorrhagic conditions"	"Benign neoplasm of ovary"	1	35	94	129
"I11"	"J34"	"Hypertensive heart disease"	"Other and unspecified disorders of nose and nasal sinuses"	1	16	80	96
"E86"	"G20"	"Volume depletion"	"Parkinson's disease"	1	1600	3044	4644
"M17"	"K35"	"Osteoarthritis of knee"	"Acute appendicitis"	1	412	1213	1625
"J18"	"C19"	"Pneumonia, unspecified organism"	"Malignant neoplasm of rectosigmoid junction"	1	58	136	194
"M54"	"B07"	"Dorsalgia"	"Viral warts"	1	140	268	408
"K72"	"F10"	"Hepatic failure, not elsewhere classified"	"Alcohol related disorders"	1	0	5031	5031
"I61"	"C43"	"Nontraumatic intracerebral hemorrhage"	"Malignant melanoma of skin"	1	79	236	315
"G96"	"H81"	"Other disorders of central nervous system"	"Disorders of vestibular function"	1	401	957	1358
"O03"	"O04"	"Spontaneous abortion"	"Complications following (induced) termination of pregnancy"	1	4284	6267	10551
"N50"	"B34"	"Other and unspecified disorders of male genital organs"	"Viral infection of unspecified site"	1	62	224	286
"C34"	"M72"	"Malignant neoplasm of bronchus and lung"	"Fibroblastic disorders"	1	0	939	939
"J93"	"H35"	"Pneumothorax and air leak"	"Other retinal disorders"	1	197	399	596
"E78"	"M40"	"Disorders of lipoprotein metabolism and other lipidemias"	"Kyphosis and lordosis"	1	28	109	137
"I95"	"I45"	"Hypotension"	"Other conduction disorders"	1	288	454	742
"O64"	"B27"	"Obstructed labor due to malposition and malpresent of fetus"	"Infectious mononucleosis"	1	0	45	45
"J69"	"J44"	"Pneumonitis due to solids and liquids"	"Other chronic obstructive pulmonary disease"	1	709	1551	2260
"D64"	"M72"	"Other anemias"	"Fibroblastic disorders"	1	64	1313	1377
"D25"	"J36"	"Leiomyoma of uterus"	"Peritonsillar abscess"	1	41	108	149
"E89"	"O62"	"Postproc endocrine and metabolic comp and disorders, NEC"	"Abnormalities of forces of labor"	1	31	366	397
"K52"	"C20"	"Other and unsp noninfective gastroenteritis and colitis"	"Malignant neoplasm of rectum"	1	376	1005	1381
"M20"	"H83"	"Acquired deformities of fingers and toes"	"Other diseases of inner ear"	1	154	325	479
"D63"	"M76"	"Anemia in chronic diseases classified elsewhere"	"Enthesopathies, lower limb, excluding foot"	1	2	100	102
"M77"	"O71"	"Other enthesopathies"	"Other obstetric trauma"	1	0	292	292
"M54"	"J35"	"Dorsalgia"	"Chronic diseases of tonsils and adenoids"	1	0	3310	3310
"M31"	"M75"	"Other necrotizing vasculopathies"	"Shoulder lesions"	1	209	430	639
"J96"	"N21"	"Respiratory failure, not elsewhere classified"	"Calculus of lower urinary tract"	1	68	382	450
"M07"	"N97"	"Enteropathic arthropathies"	"Female infertility"	1	2	100	102
"I89"	"I70"	"Oth noninfective disorders of lymphatic vessels and nodes"	"Atherosclerosis"	1	203	380	583
"K80"	"O63"	"Cholelithiasis"	"Long labor"	1	137	1190	1327
"N28"	"G56"	"Oth disorders of kidney and ureter, not elsewhere classified"	"Mononeuropathies of upper limb"	1	87	291	378
"L08"	"N60"	"Other local infections of skin and subcutaneous tissue"	"Benign mammary dysplasia"	1	67	201	268
"C83"	"M70"	"Non-follicular lymphoma"	"Soft tissue disorders related to use, overuse and pressure"	1	35	102	137
"G25"	"H90"	"Other extrapyramidal and movement disorders"	"Conductive and sensorineural hearing loss"	1	48	127	175
"D12"	"N84"	"Benign neoplasm of colon, rectum, anus and anal canal"	"Polyp of female genital tract"	1	224	1001	1225
"L57"	"K80"	"Skin changes due to chronic expsr to nonionizing radiation"	"Cholelithiasis"	1	75	424	499
"K65"	"M32"	"Peritonitis"	"Systemic lupus erythematosus (SLE)"	1	3	45	48
"J47"	"J42"	"Bronchiectasis"	"Unspecified chronic bronchitis"	1	175	321	496
"H25"	"K80"	"Age-related cataract"	"Cholelithiasis"	1	3434	6898	10332
"F23"	"O80"	"Brief psychotic disorder"	"Encounter for full-term uncomplicated delivery"	1	12	62	74
"J02"	"Q21"	"Acute pharyngitis"	"Congenital malformations of cardiac septa"	1	31	114	145
"K56"	"N62"	"Paralytic ileus and intestinal obstruction without hernia"	"Hypertrophy of breast"	1	88	230	318
"J47"	"O02"	"Bronchiectasis"	"Other abnormal products of conception"	1	0	38	38
"K76"	"H90"	"Other diseases of liver"	"Conductive and sensorineural hearing loss"	1	114	207	321
"E68"	"K42"	"Sequelae of hyperalimentation"	"Umbilical hernia"	1	78	158	236
"H81"	"I83"	"Disorders of vestibular function"	"Varicose veins of lower extremities"	1	457	720	1177
"I48"	"C53"	"Atrial fibrillation and flutter"	"Malignant neoplasm of cervix uteri"	1	58	265	323
"G98"	"D25"	"Other disorders of nervous system not elsewhere classified"	"Leiomyoma of uterus"	1	0	180	180
"G62"	"N47"	"Other and unspecified polyneuropathies"	"Disorders of prepuce"	1	107	205	312
"K14"	"N92"	"Diseases of tongue"	"Excessive, frequent and irregular menstruation"	1	7	70	77
"D50"	"C56"	"Iron deficiency anemia"	"Malignant neoplasm of ovary"	1	71	156	227
"I87"	"I10"	"Other disorders of veins"	"Essential (primary) hypertension"	1	1014	1563	2577
"O34"	"K01"	"Maternal care for abnormality of pelvic organs"	"Embedded and impacted teeth"	1	0	69	69
"N90"	"M22"	"Other noninflammatory disorders of vulva and perineum"	"Disorder of patella"	1	33	117	150
"J91"	"I34"	"Pleural effusion in conditions classified elsewhere"	"Nonrheumatic mitral valve disorders"	1	135	253	388
"G47"	"C53"	"Sleep disorders"	"Malignant neoplasm of cervix uteri"	1	19	232	251
"J06"	"O82"	"Acute upper resp infections of multiple and unsp sites"	"Encounter for cesarean delivery without indication"	1	11	440	451
"J06"	"Q20"	"Acute upper resp infections of multiple and unsp sites"	"Congenital malformations of cardiac chambers and connections"	1	11	95	106
"C92"	"N20"	"Myeloid leukemia"	"Calculus of kidney and ureter"	1	18	90	108
"O26"	"B27"	"Maternal care for oth conditions predom related to pregnancy"	"Infectious mononucleosis"	1	0	146	146
"G47"	"B07"	"Sleep disorders"	"Viral warts"	1	22	107	129
"O74"	"N97"	"Complications of anesthesia during labor and delivery"	"Female infertility"	1	13	94	107
"E34"	"L02"	"Other endocrine disorders"	"Cutaneous abscess, furuncle and carbuncle"	1	69	154	223
"K45"	"O03"	"Other abdominal hernia"	"Spontaneous abortion"	1	0	145	145
"E03"	"N91"	"Other hypothyroidism"	"Absent, scanty and rare menstruation"	1	58	191	249
"D64"	"K58"	"Other anemias"	"Irritable bowel syndrome"	1	252	1198	1450
"F17"	"M20"	"Nicotine dependence"	"Acquired deformities of fingers and toes"	1	172	497	669
"J96"	"I87"	"Respiratory failure, not elsewhere classified"	"Other disorders of veins"	1	249	598	847
"D52"	"M23"	"Folate deficiency anemia"	"Internal derangement of knee"	1	2	35	37
"C34"	"C91"	"Malignant neoplasm of bronchus and lung"	"Lymphoid leukemia"	1	97	257	354
"E85"	"K70"	"Amyloidosis"	"Alcoholic liver disease"	1	49	127	176
"M05"	"D24"	"Rheumatoid arthritis with rheumatoid factor"	"Benign neoplasm of breast"	1	28	155	183
"I48"	"K60"	"Atrial fibrillation and flutter"	"Fissure and fistula of anal and rectal regions"	1	349	796	1145
"O68"	"E28"	"Labor and delivery comp by abnlt of fetal acid-base balance"	"Ovarian dysfunction"	1	723	1435	2158
"I35"	"H50"	"Nonrheumatic aortic valve disorders"	"Other strabismus"	1	19	190	209
"L05"	"A08"	"Pilonidal cyst and sinus"	"Viral and other specified intestinal infections"	1	6	62	68
"G56"	"N70"	"Mononeuropathies of upper limb"	"Salpingitis and oophoritis"	1	0	512	512
"G96"	"L30"	"Other disorders of central nervous system"	"Other and unspecified dermatitis"	1	159	332	491
"C79"	"H18"	"Secondary malignant neoplasm of other and unspecified sites"	"Other disorders of cornea"	1	26	128	154
"K22"	"L02"	"Other diseases of esophagus"	"Cutaneous abscess, furuncle and carbuncle"	1	194	427	621
"J95"	"E66"	"Intraop and postproc comp and disorders of resp sys, NEC"	"Overweight and obesity"	1	88	207	295
"L89"	"M51"	"Pressure ulcer"	"Thoracic, thoracolum, and lumbosacral intvrt disc disorders"	1	0	639	639
"M76"	"O03"	"Enthesopathies, lower limb, excluding foot"	"Spontaneous abortion"	1	44	313	357
"I44"	"M16"	"Atrioventricular and left bundle-branch block"	"Osteoarthritis of hip"	1	272	1598	1870
"A46"	"O47"	"Erysipelas"	"False labor"	1	11	109	120
"I97"	"D48"	"Intraop and postproc comp and disorders of circ sys, NEC"	"Neoplasm of uncertain behavior of other and unsp sites"	1	4	67	71
"J69"	"E16"	"Pneumonitis due to solids and liquids"	"Other disorders of pancreatic internal secretion"	1	51	255	306
"N92"	"O64"	"Excessive, frequent and irregular menstruation"	"Obstructed labor due to malposition and malpresent of fetus"	1	0	1605	1605
"I71"	"H16"	"Aortic aneurysm and dissection"	"Keratitis"	1	25	86	111
"E55"	"M23"	"Vitamin D deficiency"	"Internal derangement of knee"	1	83	543	626
"D25"	"O42"	"Leiomyoma of uterus"	"Premature rupture of membranes"	1	0	435	435
"E11"	"N63"	"Type 2 diabetes mellitus"	"Unspecified lump in breast"	1	359	776	1135
"E13"	"E16"	"Other specified diabetes mellitus"	"Other disorders of pancreatic internal secretion"	1	312	492	804
"D13"	"M23"	"Benign neoplasm of and ill-defined parts of digestive system"	"Internal derangement of knee"	1	104	372	476
"D47"	"I10"	"Oth neoplm of uncrt behav of lymphoid, hematpoetc & rel tiss"	"Essential (primary) hypertension"	1	556	2221	2777
"N99"	"N20"	"Intraop and postproc comp and disorders of GU sys, NEC"	"Calculus of kidney and ureter"	1	193	327	520
"F31"	"O03"	"Bipolar disorder"	"Spontaneous abortion"	1	0	38	38
"I13"	"M17"	"Hypertensive heart and chronic kidney disease"	"Osteoarthritis of knee"	1	26	82	108
"N17"	"M25"	"Acute kidney failure"	"Other joint disorder, not elsewhere classified"	1	88	333	421
"C78"	"K80"	"Secondary malignant neoplasm of resp and digestive organs"	"Cholelithiasis"	1	0	3023	3023
"M83"	"O04"	"Adult osteomalacia"	"Complications following (induced) termination of pregnancy"	1	18	74	92
"G47"	"H11"	"Sleep disorders"	"Other disorders of conjunctiva"	1	95	244	339
"H02"	"N84"	"Other disorders of eyelid"	"Polyp of female genital tract"	1	173	389	562
"N18"	"H33"	"Chronic kidney disease (CKD)"	"Retinal detachments and breaks"	1	37	592	629
"K29"	"M22"	"Gastritis and duodenitis"	"Disorder of patella"	1	201	792	993
"O21"	"A63"	"Excessive vomiting in pregnancy"	"Oth predominantly sexually transmitted diseases, NEC"	1	35	240	275
"C90"	"I20"	"Multiple myeloma and malignant plasma cell neoplasms"	"Angina pectoris"	1	77	469	546
"E78"	"O08"	"Disorders of lipoprotein metabolism and other lipidemias"	"Complications following ectopic and molar pregnancy"	1	0	53	53
"D46"	"F10"	"Myelodysplastic syndromes"	"Alcohol related disorders"	1	24	151	175
"D61"	"H91"	"Oth aplastic anemias and other bone marrow failure syndromes"	"Other and unspecified hearing loss"	1	65	334	399
"K64"	"K62"	"Hemorrhoids and perianal venous thrombosis"	"Other diseases of anus and rectum"	1	3917	5165	9082
"M99"	"H52"	"Biomechanical lesions, not elsewhere classified"	"Disorders of refraction and accommodation"	1	43	111	154
"M16"	"O30"	"Osteoarthritis of hip"	"Multiple gestation"	1	0	28	28
"M81"	"J03"	"Osteoporosis without current pathological fracture"	"Acute tonsillitis"	1	43	220	263
"M79"	"G80"	"Oth and unsp soft tissue disorders, not elsewhere classified"	"Cerebral palsy"	1	63	287	350
"K80"	"O35"	"Cholelithiasis"	"Maternal care for known or suspected fetal abnlt and damage"	1	124	226	350
"M46"	"M08"	"Other inflammatory spondylopathies"	"Juvenile arthritis"	1	4	48	52
"J44"	"N94"	"Other chronic obstructive pulmonary disease"	"Pain and oth cond assoc w fem gntl org and menstrual cycle"	1	17	450	467
"N12"	"I21"	"Tubulo-interstitial nephritis, not spcf as acute or chronic"	"Acute myocardial infarction"	1	92	208	300
"F03"	"H52"	"Unspecified dementia"	"Disorders of refraction and accommodation"	1	0	239	239
"J86"	"N40"	"Pyothorax"	"Benign prostatic hyperplasia"	1	83	280	363
"J15"	"G43"	"Bacterial pneumonia, not elsewhere classified"	"Migraine"	1	84	448	532
"I74"	"H93"	"Arterial embolism and thrombosis"	"Other disorders of ear, not elsewhere classified"	1	46	162	208
"H57"	"J20"	"Other disorders of eye and adnexa"	"Acute bronchitis"	1	16	426	442
"M48"	"M21"	"Other spondylopathies"	"Other acquired deformities of limbs"	1	405	603	1008
"M21"	"O14"	"Other acquired deformities of limbs"	"Pre-eclampsia"	1	17	66	83
"M48"	"H50"	"Other spondylopathies"	"Other strabismus"	1	84	202	286
"N43"	"H65"	"Hydrocele and spermatocele"	"Nonsuppurative otitis media"	1	120	223	343
"J18"	"O14"	"Pneumonia, unspecified organism"	"Pre-eclampsia"	1	64	385	449
"H26"	"C50"	"Other cataract"	"Malignant neoplasm of breast"	1	639	1207	1846
"J81"	"E78"	"Pulmonary edema"	"Disorders of lipoprotein metabolism and other lipidemias"	1	754	1656	2410
"I10"	"O65"	"Essential (primary) hypertension"	"Obstructed labor due to maternal pelvic abnormality"	1	0	233	233
"B02"	"C90"	"Zoster [herpes zoster]"	"Multiple myeloma and malignant plasma cell neoplasms"	1	69	314	383
"I73"	"N43"	"Other peripheral vascular diseases"	"Hydrocele and spermatocele"	1	68	359	427
"J81"	"K40"	"Pulmonary edema"	"Inguinal hernia"	1	106	824	930
"H53"	"M79"	"Visual disturbances"	"Oth and unsp soft tissue disorders, not elsewhere classified"	1	742	1191	1933
"E04"	"O14"	"Other nontoxic goiter"	"Pre-eclampsia"	1	1	286	287
"E78"	"O20"	"Disorders of lipoprotein metabolism and other lipidemias"	"Hemorrhage in early pregnancy"	1	0	213	213
"J18"	"C00"	"Pneumonia, unspecified organism"	"Malignant neoplasm of lip"	1	28	172	200
"K55"	"I15"	"Vascular disorders of intestine"	"Secondary hypertension"	1	56	163	219
"G37"	"O62"	"Other demyelinating diseases of central nervous system"	"Abnormalities of forces of labor"	1	8	155	163
"I61"	"M16"	"Nontraumatic intracerebral hemorrhage"	"Osteoarthritis of hip"	1	128	1157	1285
"B96"	"J18"	"Oth bacterial agents as the cause of diseases classd elswhr"	"Pneumonia, unspecified organism"	1	751	1370	2121
"E83"	"M48"	"Disorders of mineral metabolism"	"Other spondylopathies"	1	168	442	610
"J95"	"M65"	"Intraop and postproc comp and disorders of resp sys, NEC"	"Synovitis and tenosynovitis"	1	0	68	68
"E89"	"M23"	"Postproc endocrine and metabolic comp and disorders, NEC"	"Internal derangement of knee"	1	96	261	357
"I25"	"O64"	"Chronic ischemic heart disease"	"Obstructed labor due to malposition and malpresent of fetus"	1	0	28	28
"I34"	"I80"	"Nonrheumatic mitral valve disorders"	"Phlebitis and thrombophlebitis"	1	241	402	643
"I69"	"H10"	"Sequelae of cerebrovascular disease"	"Conjunctivitis"	1	139	1033	1172
"G44"	"M67"	"Other headache syndromes"	"Other disorders of synovium and tendon"	1	420	582	1002
"H35"	"O42"	"Other retinal disorders"	"Premature rupture of membranes"	1	8	76	84
"I80"	"J35"	"Phlebitis and thrombophlebitis"	"Chronic diseases of tonsils and adenoids"	1	8	362	370
"O34"	"O02"	"Maternal care for abnormality of pelvic organs"	"Other abnormal products of conception"	1	0	6517	6517
"M85"	"E68"	"Other disorders of bone density and structure"	"Sequelae of hyperalimentation"	1	21	89	110
"B00"	"I20"	"Herpesviral [herpes simplex] infections"	"Angina pectoris"	1	95	205	300
"C22"	"D64"	"Malignant neoplasm of liver and intrahepatic bile ducts"	"Other anemias"	1	319	577	896
"F03"	"F43"	"Unspecified dementia"	"Reaction to severe stress, and adjustment disorders"	1	147	260	407
"C15"	"M17"	"Malignant neoplasm of esophagus"	"Osteoarthritis of knee"	1	0	365	365
"O82"	"K01"	"Encounter for cesarean delivery without indication"	"Embedded and impacted teeth"	1	10	285	295
"M07"	"J36"	"Enteropathic arthropathies"	"Peritonsillar abscess"	1	3	37	40
"G62"	"H91"	"Other and unspecified polyneuropathies"	"Other and unspecified hearing loss"	1	801	1777	2578
"H81"	"H66"	"Disorders of vestibular function"	"Suppurative and unspecified otitis media"	1	200	372	572
"J15"	"L02"	"Bacterial pneumonia, not elsewhere classified"	"Cutaneous abscess, furuncle and carbuncle"	1	0	2992	2992
"C15"	"G44"	"Malignant neoplasm of esophagus"	"Other headache syndromes"	1	0	29	29
"I61"	"G99"	"Nontraumatic intracerebral hemorrhage"	"Oth disorders of nervous system in diseases classd elswhr"	1	24	74	98
"K59"	"O41"	"Other functional intestinal disorders"	"Other disorders of amniotic fluid and membranes"	1	50	139	189
"C61"	"K44"	"Malignant neoplasm of prostate"	"Diaphragmatic hernia"	1	232	781	1013
"M50"	"O36"	"Cervical disc disorders"	"Maternal care for other fetal problems"	1	0	209	209
"K04"	"O64"	"Diseases of pulp and periapical tissues"	"Obstructed labor due to malposition and malpresent of fetus"	1	2	42	44
"L30"	"N87"	"Other and unspecified dermatitis"	"Dysplasia of cervix uteri"	1	58	169	227
"D84"	"O70"	"Other immunodeficiencies"	"Perineal laceration during delivery"	1	5	63	68
"F03"	"H18"	"Unspecified dementia"	"Other disorders of cornea"	1	18	313	331
"E05"	"I20"	"Thyrotoxicosis [hyperthyroidism]"	"Angina pectoris"	1	1962	2584	4546
"J93"	"I83"	"Pneumothorax and air leak"	"Varicose veins of lower extremities"	1	65	264	329
"F05"	"I20"	"Delirium due to known physiological condition"	"Angina pectoris"	1	0	1608	1608
"I82"	"H33"	"Other venous embolism and thrombosis"	"Retinal detachments and breaks"	1	14	78	92
"D06"	"O62"	"Carcinoma in situ of cervix uteri"	"Abnormalities of forces of labor"	1	390	585	975
"M17"	"O14"	"Osteoarthritis of knee"	"Pre-eclampsia"	1	0	135	135
"D05"	"O03"	"Carcinoma in situ of breast"	"Spontaneous abortion"	1	0	31	31
"E23"	"D27"	"Hypofunction and other disorders of the pituitary gland"	"Benign neoplasm of ovary"	1	10	54	64
"F05"	"F10"	"Delirium due to known physiological condition"	"Alcohol related disorders"	1	701	2448	3149
"M71"	"O68"	"Other bursopathies"	"Labor and delivery comp by abnlt of fetal acid-base balance"	1	37	118	155
"E27"	"M32"	"Other disorders of adrenal gland"	"Systemic lupus erythematosus (SLE)"	1	2	47	49
"F02"	"K80"	"Dementia in other diseases classified elsewhere"	"Cholelithiasis"	1	31	96	127
"E55"	"M05"	"Vitamin D deficiency"	"Rheumatoid arthritis with rheumatoid factor"	1	73	149	222
"M70"	"D24"	"Soft tissue disorders related to use, overuse and pressure"	"Benign neoplasm of breast"	1	102	391	493
"K60"	"H10"	"Fissure and fistula of anal and rectal regions"	"Conjunctivitis"	1	152	371	523
"K56"	"D23"	"Paralytic ileus and intestinal obstruction without hernia"	"Other benign neoplasms of skin"	1	122	323	445
"O70"	"N30"	"Perineal laceration during delivery"	"Cystitis"	1	2660	3707	6367
"M17"	"O80"	"Osteoarthritis of knee"	"Encounter for full-term uncomplicated delivery"	1	0	1230	1230
"G57"	"O20"	"Mononeuropathies of lower limb"	"Hemorrhage in early pregnancy"	1	0	135	135
"E87"	"N45"	"Other disorders of fluid, electrolyte and acid-base balance"	"Orchitis and epididymitis"	1	99	409	508
"L08"	"O14"	"Other local infections of skin and subcutaneous tissue"	"Pre-eclampsia"	1	50	118	168
"I51"	"I74"	"Complications and ill-defined descriptions of heart disease"	"Arterial embolism and thrombosis"	1	90	173	263
"M19"	"D24"	"Other and unspecified osteoarthritis"	"Benign neoplasm of breast"	1	22	694	716
"E86"	"M79"	"Volume depletion"	"Oth and unsp soft tissue disorders, not elsewhere classified"	1	0	8330	8330
"I85"	"E66"	"Esophageal varices"	"Overweight and obesity"	1	134	255	389
"C83"	"I21"	"Non-follicular lymphoma"	"Acute myocardial infarction"	1	126	278	404
"M54"	"N87"	"Dorsalgia"	"Dysplasia of cervix uteri"	1	728	1495	2223
"I69"	"J31"	"Sequelae of cerebrovascular disease"	"Chronic rhinitis, nasopharyngitis and pharyngitis"	1	25	82	107
"G93"	"M70"	"Other disorders of brain"	"Soft tissue disorders related to use, overuse and pressure"	1	38	132	170
"I15"	"C50"	"Secondary hypertension"	"Malignant neoplasm of breast"	1	101	198	299
"E86"	"Q43"	"Volume depletion"	"Other congenital malformations of intestine"	1	55	140	195
"I50"	"M21"	"Heart failure"	"Other acquired deformities of limbs"	1	241	768	1009
"O70"	"L91"	"Perineal laceration during delivery"	"Hypertrophic disorders of skin"	1	47	148	195
"G30"	"I67"	"Alzheimer's disease"	"Other cerebrovascular diseases"	1	66	160	226
"D32"	"D25"	"Benign neoplasm of meninges"	"Leiomyoma of uterus"	1	1	160	161
"O72"	"F10"	"Postpartum hemorrhage"	"Alcohol related disorders"	1	0	2312	2312
"H25"	"M21"	"Age-related cataract"	"Other acquired deformities of limbs"	1	672	1447	2119
"M70"	"N62"	"Soft tissue disorders related to use, overuse and pressure"	"Hypertrophy of breast"	1	185	359	544
"E68"	"J35"	"Sequelae of hyperalimentation"	"Chronic diseases of tonsils and adenoids"	1	0	170	170
"M75"	"Q82"	"Shoulder lesions"	"Other congenital malformations of skin"	1	75	256	331
"B34"	"I20"	"Viral infection of unspecified site"	"Angina pectoris"	1	383	893	1276
"D13"	"I10"	"Benign neoplasm of and ill-defined parts of digestive system"	"Essential (primary) hypertension"	1	1023	1561	2584
"F41"	"C71"	"Other anxiety disorders"	"Malignant neoplasm of brain"	1	119	525	644
"F01"	"H25"	"Vascular dementia"	"Age-related cataract"	1	0	2599	2599
"D69"	"M72"	"Purpura and other hemorrhagic conditions"	"Fibroblastic disorders"	1	71	157	228
"E03"	"H25"	"Other hypothyroidism"	"Age-related cataract"	1	2875	4170	7045
"K76"	"L03"	"Other diseases of liver"	"Cellulitis and acute lymphangitis"	1	27	175	202
"I35"	"N84"	"Nonrheumatic aortic valve disorders"	"Polyp of female genital tract"	1	48	355	403
"K08"	"C85"	"Other disorders of teeth and supporting structures"	"Oth and unspecified types of non-Hodgkin lymphoma"	1	72	148	220
"G95"	"H83"	"Other and unspecified diseases of spinal cord"	"Other diseases of inner ear"	1	0	161	161
"A41"	"Q07"	"Other sepsis"	"Other congenital malformations of nervous system"	1	1	32	33
"C44"	"D25"	"Other and unspecified malignant neoplasm of skin"	"Leiomyoma of uterus"	1	0	512	512
"A46"	"M62"	"Erysipelas"	"Other disorders of muscle"	1	266	1797	2063
"F41"	"C50"	"Other anxiety disorders"	"Malignant neoplasm of breast"	1	103	1384	1487
"E21"	"E10"	"Hyperparathyroidism and other disorders of parathyroid gland"	"Type 1 diabetes mellitus"	1	226	399	625
"K70"	"O03"	"Alcoholic liver disease"	"Spontaneous abortion"	1	0	26	26
"G35"	"J35"	"Multiple sclerosis"	"Chronic diseases of tonsils and adenoids"	1	0	82	82
"O75"	"O82"	"Oth complications of labor and delivery, NEC"	"Encounter for cesarean delivery without indication"	1	10777	11960	22737
"M62"	"H65"	"Other disorders of muscle"	"Nonsuppurative otitis media"	1	222	641	863
"E64"	"M47"	"Sequelae of malnutrition and other nutritional deficiencies"	"Spondylosis"	1	42	228	270
"M20"	"K40"	"Acquired deformities of fingers and toes"	"Inguinal hernia"	1	550	861	1411
"L89"	"K86"	"Pressure ulcer"	"Other diseases of pancreas"	1	59	197	256
"H91"	"O75"	"Other and unspecified hearing loss"	"Oth complications of labor and delivery, NEC"	1	29	117	146
"C85"	"K80"	"Oth and unspecified types of non-Hodgkin lymphoma"	"Cholelithiasis"	1	124	270	394
"I95"	"I83"	"Hypotension"	"Varicose veins of lower extremities"	1	81	749	830
"I15"	"N92"	"Secondary hypertension"	"Excessive, frequent and irregular menstruation"	1	50	341	391
"J96"	"M21"	"Respiratory failure, not elsewhere classified"	"Other acquired deformities of limbs"	1	98	548	646
"N28"	"N97"	"Oth disorders of kidney and ureter, not elsewhere classified"	"Female infertility"	1	9	48	57
"K56"	"E65"	"Paralytic ileus and intestinal obstruction without hernia"	"Localized adiposity"	1	101	220	321
"I26"	"J35"	"Pulmonary embolism"	"Chronic diseases of tonsils and adenoids"	1	2	147	149
"C17"	"I20"	"Malignant neoplasm of small intestine"	"Angina pectoris"	1	10	134	144
"F17"	"O68"	"Nicotine dependence"	"Labor and delivery comp by abnlt of fetal acid-base balance"	1	38	845	883
"L98"	"M77"	"Oth disorders of skin, subcu, not elsewhere classified"	"Other enthesopathies"	1	124	249	373
"L98"	"M16"	"Oth disorders of skin, subcu, not elsewhere classified"	"Osteoarthritis of hip"	1	274	1058	1332
"M80"	"M13"	"Osteoporosis with current pathological fracture"	"Other arthritis"	1	207	528	735
"M85"	"O04"	"Other disorders of bone density and structure"	"Complications following (induced) termination of pregnancy"	1	0	214	214
"K57"	"G35"	"Diverticular disease of intestine"	"Multiple sclerosis"	1	23	143	166
"E34"	"H25"	"Other endocrine disorders"	"Age-related cataract"	1	160	369	529
"M07"	"O75"	"Enteropathic arthropathies"	"Oth complications of labor and delivery, NEC"	1	1	62	63
"I69"	"N20"	"Sequelae of cerebrovascular disease"	"Calculus of kidney and ureter"	1	425	1439	1864
"J84"	"M47"	"Other interstitial pulmonary diseases"	"Spondylosis"	1	103	356	459
"K63"	"K70"	"Other diseases of intestine"	"Alcoholic liver disease"	1	165	270	435
"N19"	"M51"	"Unspecified kidney failure"	"Thoracic, thoracolum, and lumbosacral intvrt disc disorders"	1	40	787	827
"H25"	"C62"	"Age-related cataract"	"Malignant neoplasm of testis"	1	0	63	63
"G96"	"D23"	"Other disorders of central nervous system"	"Other benign neoplasms of skin"	1	42	250	292
"C78"	"I15"	"Secondary malignant neoplasm of resp and digestive organs"	"Secondary hypertension"	1	89	343	432
"H93"	"Q53"	"Other disorders of ear, not elsewhere classified"	"Undescended and ectopic testicle"	1	4	63	67
"K46"	"O02"	"Unspecified abdominal hernia"	"Other abnormal products of conception"	1	0	37	37
"M13"	"J34"	"Other arthritis"	"Other and unspecified disorders of nose and nasal sinuses"	1	64	185	249
"M20"	"N47"	"Acquired deformities of fingers and toes"	"Disorders of prepuce"	1	85	166	251
"E66"	"L24"	"Overweight and obesity"	"Irritant contact dermatitis"	1	57	249	306
"O72"	"E10"	"Postpartum hemorrhage"	"Type 1 diabetes mellitus"	1	30	431	461
"M13"	"O23"	"Other arthritis"	"Infections of genitourinary tract in pregnancy"	1	25	96	121
"C18"	"H81"	"Malignant neoplasm of colon"	"Disorders of vestibular function"	1	199	518	717
"C77"	"C34"	"Secondary and unspecified malignant neoplasm of lymph nodes"	"Malignant neoplasm of bronchus and lung"	1	2904	6138	9042
"A49"	"K30"	"Bacterial infection of unspecified site"	"Functional dyspepsia"	1	74	1274	1348
"D50"	"O82"	"Iron deficiency anemia"	"Encounter for cesarean delivery without indication"	1	0	732	732
"D62"	"J45"	"Acute posthemorrhagic anemia"	"Asthma"	1	209	527	736
"C78"	"M17"	"Secondary malignant neoplasm of resp and digestive organs"	"Osteoarthritis of knee"	1	0	2453	2453
"C20"	"O70"	"Malignant neoplasm of rectum"	"Perineal laceration during delivery"	1	0	30	30
"K59"	"I48"	"Other functional intestinal disorders"	"Atrial fibrillation and flutter"	1	7496	11234	18730
"O91"	"J36"	"Infect of breast assoc w pregnancy, the puerp and lactation"	"Peritonsillar abscess"	1	8	49	57
"K43"	"A63"	"Ventral hernia"	"Oth predominantly sexually transmitted diseases, NEC"	1	12	144	156
"M47"	"A63"	"Spondylosis"	"Oth predominantly sexually transmitted diseases, NEC"	1	17	164	181
"F90"	"G40"	"Attention-deficit hyperactivity disorders"	"Epilepsy and recurrent seizures"	1	243	426	669
"M15"	"K29"	"Polyosteoarthritis"	"Gastritis and duodenitis"	1	358	537	895
"A41"	"C41"	"Other sepsis"	"Malignant neoplasm of bone/artic cartl of and unsp sites"	1	102	202	304
"L89"	"C90"	"Pressure ulcer"	"Multiple myeloma and malignant plasma cell neoplasms"	1	36	120	156
"K29"	"J35"	"Gastritis and duodenitis"	"Chronic diseases of tonsils and adenoids"	1	198	678	876
"N92"	"O30"	"Excessive, frequent and irregular menstruation"	"Multiple gestation"	1	0	1070	1070
"N97"	"K01"	"Female infertility"	"Embedded and impacted teeth"	1	3	175	178
"D63"	"M72"	"Anemia in chronic diseases classified elsewhere"	"Fibroblastic disorders"	1	0	307	307
"E87"	"O68"	"Other disorders of fluid, electrolyte and acid-base balance"	"Labor and delivery comp by abnlt of fetal acid-base balance"	1	0	141	141
"E03"	"Q96"	"Other hypothyroidism"	"Turner's syndrome"	1	2	31	33
"F41"	"O70"	"Other anxiety disorders"	"Perineal laceration during delivery"	1	315	776	1091
"I46"	"I71"	"Cardiac arrest"	"Aortic aneurysm and dissection"	1	451	1057	1508
"G30"	"K80"	"Alzheimer's disease"	"Cholelithiasis"	1	0	472	472
"J91"	"K21"	"Pleural effusion in conditions classified elsewhere"	"Gastro-esophageal reflux disease"	1	58	239	297
"I63"	"H34"	"Cerebral infarction"	"Retinal vascular occlusions"	1	634	945	1579
"G37"	"J35"	"Other demyelinating diseases of central nervous system"	"Chronic diseases of tonsils and adenoids"	1	6	44	50
"O34"	"N76"	"Maternal care for abnormality of pelvic organs"	"Other inflammation of vagina and vulva"	1	118	234	352
"I67"	"N60"	"Other cerebrovascular diseases"	"Benign mammary dysplasia"	1	2	62	64
"I82"	"K40"	"Other venous embolism and thrombosis"	"Inguinal hernia"	1	50	372	422
"H04"	"M51"	"Disorders of lacrimal system"	"Thoracic, thoracolum, and lumbosacral intvrt disc disorders"	1	94	250	344
"I49"	"M21"	"Other cardiac arrhythmias"	"Other acquired deformities of limbs"	1	142	265	407
"O34"	"J35"	"Maternal care for abnormality of pelvic organs"	"Chronic diseases of tonsils and adenoids"	1	0	549	549
"I80"	"H50"	"Phlebitis and thrombophlebitis"	"Other strabismus"	1	80	192	272
"C71"	"K26"	"Malignant neoplasm of brain"	"Duodenal ulcer"	1	27	107	134
"I21"	"M67"	"Acute myocardial infarction"	"Other disorders of synovium and tendon"	1	276	740	1016
"F17"	"M54"	"Nicotine dependence"	"Dorsalgia"	1	0	4580	4580
"N39"	"M16"	"Other disorders of urinary system"	"Osteoarthritis of hip"	1	0	8346	8346
"K52"	"N20"	"Other and unsp noninfective gastroenteritis and colitis"	"Calculus of kidney and ureter"	1	458	786	1244
"H35"	"D48"	"Other retinal disorders"	"Neoplasm of uncertain behavior of other and unsp sites"	1	28	142	170
"E86"	"D23"	"Volume depletion"	"Other benign neoplasms of skin"	1	149	1194	1343
"M07"	"M71"	"Enteropathic arthropathies"	"Other bursopathies"	1	54	126	180
"E86"	"I35"	"Volume depletion"	"Nonrheumatic aortic valve disorders"	1	2530	5409	7939
"J10"	"K35"	"Influenza due to other identified influenza virus"	"Acute appendicitis"	1	10	68	78
"A09"	"Q42"	"Infectious gastroenteritis and colitis, unspecified"	"Congenital absence, atresia and stenosis of large intestine"	1	18	112	130
"N64"	"J35"	"Other disorders of breast"	"Chronic diseases of tonsils and adenoids"	1	83	668	751
"N18"	"O23"	"Chronic kidney disease (CKD)"	"Infections of genitourinary tract in pregnancy"	1	4	60	64
"M96"	"M51"	"Intraop and postproc comp and disorders of ms sys, NEC"	"Thoracic, thoracolum, and lumbosacral intvrt disc disorders"	1	0	3723	3723
"O23"	"O03"	"Infections of genitourinary tract in pregnancy"	"Spontaneous abortion"	1	1271	3254	4525
"J90"	"N94"	"Pleural effusion, not elsewhere classified"	"Pain and oth cond assoc w fem gntl org and menstrual cycle"	1	1	47	48
"H35"	"I10"	"Other retinal disorders"	"Essential (primary) hypertension"	1	11313	13307	24620
"M77"	"M62"	"Other enthesopathies"	"Other disorders of muscle"	1	2396	2766	5162
"H26"	"M72"	"Other cataract"	"Fibroblastic disorders"	1	289	779	1068
"E83"	"H90"	"Disorders of mineral metabolism"	"Conductive and sensorineural hearing loss"	1	48	267	315
"E78"	"N84"	"Disorders of lipoprotein metabolism and other lipidemias"	"Polyp of female genital tract"	1	723	1343	2066
"K75"	"O04"	"Other inflammatory liver diseases"	"Complications following (induced) termination of pregnancy"	1	0	30	30
"C56"	"K58"	"Malignant neoplasm of ovary"	"Irritable bowel syndrome"	1	45	113	158
"A40"	"M62"	"Streptococcal sepsis"	"Other disorders of muscle"	1	24	175	199
"L92"	"J35"	"Granulomatous disorders of skin and subcutaneous tissue"	"Chronic diseases of tonsils and adenoids"	1	18	68	86
"H36"	"K30"	"Retinal disorders in diseases classified elsewhere"	"Functional dyspepsia"	1	236	495	731
"A49"	"K51"	"Bacterial infection of unspecified site"	"Ulcerative colitis"	1	54	517	571
"O21"	"O03"	"Excessive vomiting in pregnancy"	"Spontaneous abortion"	1	841	1588	2429
"I61"	"J32"	"Nontraumatic intracerebral hemorrhage"	"Chronic sinusitis"	1	12	76	88
"D35"	"O70"	"Benign neoplasm of other and unspecified endocrine glands"	"Perineal laceration during delivery"	1	11	143	154
"E87"	"F99"	"Other disorders of fluid, electrolyte and acid-base balance"	"Mental disorder, not otherwise specified"	1	83	243	326
"E89"	"M67"	"Postproc endocrine and metabolic comp and disorders, NEC"	"Other disorders of synovium and tendon"	1	33	96	129
"K83"	"M65"	"Other diseases of biliary tract"	"Synovitis and tenosynovitis"	1	54	222	276
"K63"	"J35"	"Other diseases of intestine"	"Chronic diseases of tonsils and adenoids"	1	2	127	129
"N80"	"N71"	"Endometriosis"	"Inflammatory disease of uterus, except cervix"	1	326	488	814
"N30"	"H65"	"Cystitis"	"Nonsuppurative otitis media"	1	265	1494	1759
"L98"	"K58"	"Oth disorders of skin, subcu, not elsewhere classified"	"Irritable bowel syndrome"	1	103	318	421
"I44"	"C50"	"Atrioventricular and left bundle-branch block"	"Malignant neoplasm of breast"	1	105	399	504
"N40"	"L03"	"Benign prostatic hyperplasia"	"Cellulitis and acute lymphangitis"	1	258	470	728
"I97"	"K40"	"Intraop and postproc comp and disorders of circ sys, NEC"	"Inguinal hernia"	1	13	74	87
"K25"	"D25"	"Gastric ulcer"	"Leiomyoma of uterus"	1	109	357	466
"E64"	"D25"	"Sequelae of malnutrition and other nutritional deficiencies"	"Leiomyoma of uterus"	1	2	90	92
"N19"	"M72"	"Unspecified kidney failure"	"Fibroblastic disorders"	1	41	313	354
"J06"	"O32"	"Acute upper resp infections of multiple and unsp sites"	"Maternal care for malpresentation of fetus"	1	9	137	146
"I95"	"J44"	"Hypotension"	"Other chronic obstructive pulmonary disease"	1	1516	2995	4511
"J01"	"O68"	"Acute sinusitis"	"Labor and delivery comp by abnlt of fetal acid-base balance"	1	104	822	926
"E25"	"M16"	"Adrenogenital disorders"	"Osteoarthritis of hip"	1	6	65	71
"E60"	"I20"	"Dietary zinc deficiency"	"Angina pectoris"	1	1	41	42
"J43"	"H33"	"Emphysema"	"Retinal detachments and breaks"	1	29	81	110
"I95"	"D30"	"Hypotension"	"Benign neoplasm of urinary organs"	1	22	275	297
"D63"	"I30"	"Anemia in chronic diseases classified elsewhere"	"Acute pericarditis"	1	25	86	111
"M13"	"J30"	"Other arthritis"	"Vasomotor and allergic rhinitis"	1	69	165	234
"G35"	"J30"	"Multiple sclerosis"	"Vasomotor and allergic rhinitis"	1	20	69	89
"K76"	"O32"	"Other diseases of liver"	"Maternal care for malpresentation of fetus"	1	2	57	59
"H35"	"M76"	"Other retinal disorders"	"Enthesopathies, lower limb, excluding foot"	1	179	397	576
"E65"	"O68"	"Localized adiposity"	"Labor and delivery comp by abnlt of fetal acid-base balance"	1	2	730	732
"D05"	"M62"	"Carcinoma in situ of breast"	"Other disorders of muscle"	1	21	114	135
"C77"	"N20"	"Secondary and unspecified malignant neoplasm of lymph nodes"	"Calculus of kidney and ureter"	1	40	308	348
"M23"	"N47"	"Internal derangement of knee"	"Disorders of prepuce"	1	551	979	1530
"J91"	"C43"	"Pleural effusion in conditions classified elsewhere"	"Malignant melanoma of skin"	1	33	111	144
"C44"	"K21"	"Other and unspecified malignant neoplasm of skin"	"Gastro-esophageal reflux disease"	1	285	995	1280
"I69"	"K41"	"Sequelae of cerebrovascular disease"	"Femoral hernia"	1	59	192	251
"N17"	"N81"	"Acute kidney failure"	"Female genital prolapse"	1	0	386	386
"C83"	"K44"	"Non-follicular lymphoma"	"Diaphragmatic hernia"	1	57	210	267
"J18"	"I15"	"Pneumonia, unspecified organism"	"Secondary hypertension"	1	1774	2095	3869
"M21"	"N70"	"Other acquired deformities of limbs"	"Salpingitis and oophoritis"	1	11	85	96
"L98"	"H52"	"Oth disorders of skin, subcu, not elsewhere classified"	"Disorders of refraction and accommodation"	1	104	193	297
"L97"	"K58"	"Non-pressure chronic ulcer of lower limb, NEC"	"Irritable bowel syndrome"	1	20	235	255
"J69"	"F03"	"Pneumonitis due to solids and liquids"	"Unspecified dementia"	1	539	1076	1615
"C90"	"F10"	"Multiple myeloma and malignant plasma cell neoplasms"	"Alcohol related disorders"	1	13	105	118
"E89"	"H83"	"Postproc endocrine and metabolic comp and disorders, NEC"	"Other diseases of inner ear"	1	10	54	64
"C25"	"G56"	"Malignant neoplasm of pancreas"	"Mononeuropathies of upper limb"	1	0	310	310
"K57"	"I83"	"Diverticular disease of intestine"	"Varicose veins of lower extremities"	1	0	3272	3272
"K57"	"O64"	"Diverticular disease of intestine"	"Obstructed labor due to malposition and malpresent of fetus"	1	0	37	37
"M85"	"I80"	"Other disorders of bone density and structure"	"Phlebitis and thrombophlebitis"	1	276	650	926
"C88"	"M72"	"Malig immunoproliferative dis and certain oth B-cell lymph"	"Fibroblastic disorders"	1	4	36	40
"I69"	"O02"	"Sequelae of cerebrovascular disease"	"Other abnormal products of conception"	1	0	86	86
"C16"	"K21"	"Malignant neoplasm of stomach"	"Gastro-esophageal reflux disease"	1	122	514	636
"I24"	"M16"	"Other acute ischemic heart diseases"	"Osteoarthritis of hip"	1	164	301	465
"H57"	"O65"	"Other disorders of eye and adnexa"	"Obstructed labor due to maternal pelvic abnormality"	1	0	52	52
"N45"	"Q66"	"Orchitis and epididymitis"	"Congenital deformities of feet"	1	10	49	59
"F50"	"Q25"	"Eating disorders"	"Congenital malformations of great arteries"	1	16	71	87
"G40"	"G35"	"Epilepsy and recurrent seizures"	"Multiple sclerosis"	1	135	315	450
"N60"	"O80"	"Benign mammary dysplasia"	"Encounter for full-term uncomplicated delivery"	1	0	4229	4229
"C22"	"M17"	"Malignant neoplasm of liver and intrahepatic bile ducts"	"Osteoarthritis of knee"	1	0	328	328
"E89"	"O99"	"Postproc endocrine and metabolic comp and disorders, NEC"	"Oth maternal diseases classd elsw but compl preg/chldbrth"	1	276	552	828
"F33"	"D25"	"Major depressive disorder, recurrent"	"Leiomyoma of uterus"	1	96	510	606
"N20"	"M93"	"Calculus of kidney and ureter"	"Other osteochondropathies"	1	15	77	92
"F02"	"M81"	"Dementia in other diseases classified elsewhere"	"Osteoporosis without current pathological fracture"	1	109	222	331
"K44"	"D27"	"Diaphragmatic hernia"	"Benign neoplasm of ovary"	1	144	334	478
"D63"	"I20"	"Anemia in chronic diseases classified elsewhere"	"Angina pectoris"	1	0	2604	2604
"K90"	"K59"	"Intestinal malabsorption"	"Other functional intestinal disorders"	1	979	1226	2205
"I65"	"G56"	"Occls and stenosis of precerb art, not rslt in cereb infrc"	"Mononeuropathies of upper limb"	1	162	270	432
"A46"	"I20"	"Erysipelas"	"Angina pectoris"	1	0	4986	4986
"M87"	"C79"	"Osteonecrosis"	"Secondary malignant neoplasm of other and unspecified sites"	1	73	164	237
"K56"	"M31"	"Paralytic ileus and intestinal obstruction without hernia"	"Other necrotizing vasculopathies"	1	98	226	324
"M51"	"L04"	"Thoracic, thoracolum, and lumbosacral intvrt disc disorders"	"Acute lymphadenitis"	1	61	161	222
"C73"	"E05"	"Malignant neoplasm of thyroid gland"	"Thyrotoxicosis [hyperthyroidism]"	1	106	276	382
"M46"	"I20"	"Other inflammatory spondylopathies"	"Angina pectoris"	1	125	373	498
"C43"	"I20"	"Malignant melanoma of skin"	"Angina pectoris"	1	329	736	1065
"K63"	"K60"	"Other diseases of intestine"	"Fissure and fistula of anal and rectal regions"	1	223	401	624
"J18"	"N95"	"Pneumonia, unspecified organism"	"Menopausal and other perimenopausal disorders"	1	821	2786	3607
"C79"	"C15"	"Secondary malignant neoplasm of other and unspecified sites"	"Malignant neoplasm of esophagus"	1	225	639	864
"I63"	"M71"	"Cerebral infarction"	"Other bursopathies"	1	73	430	503
"G62"	"H72"	"Other and unspecified polyneuropathies"	"Perforation of tympanic membrane"	1	8	68	76
"J22"	"J34"	"Unspecified acute lower respiratory infection"	"Other and unspecified disorders of nose and nasal sinuses"	1	1	61	62
"M85"	"N64"	"Other disorders of bone density and structure"	"Other disorders of breast"	1	106	257	363
"K60"	"L05"	"Fissure and fistula of anal and rectal regions"	"Pilonidal cyst and sinus"	1	524	775	1299
"D64"	"Q18"	"Other anemias"	"Other congenital malformations of face and neck"	1	10	88	98
"M85"	"D11"	"Other disorders of bone density and structure"	"Benign neoplasm of major salivary glands"	1	31	106	137
"J22"	"K50"	"Unspecified acute lower respiratory infection"	"Crohn's disease [regional enteritis]"	1	7	60	67
"H57"	"G40"	"Other disorders of eye and adnexa"	"Epilepsy and recurrent seizures"	1	134	647	781
"I73"	"M20"	"Other peripheral vascular diseases"	"Acquired deformities of fingers and toes"	1	269	777	1046
"N19"	"M67"	"Unspecified kidney failure"	"Other disorders of synovium and tendon"	1	20	141	161
"N30"	"K50"	"Cystitis"	"Crohn's disease [regional enteritis]"	1	456	689	1145
"A41"	"O70"	"Other sepsis"	"Perineal laceration during delivery"	1	55	469	524
"M95"	"O65"	"Oth acquired deformities of ms sys and connective tissue"	"Obstructed labor due to maternal pelvic abnormality"	1	7	42	49
"G91"	"M54"	"Hydrocephalus"	"Dorsalgia"	1	127	392	519
"K44"	"C62"	"Diaphragmatic hernia"	"Malignant neoplasm of testis"	1	9	46	55
"I70"	"N81"	"Atherosclerosis"	"Female genital prolapse"	1	632	1266	1898
"M35"	"O62"	"Other systemic involvement of connective tissue"	"Abnormalities of forces of labor"	1	215	612	827
"I82"	"G35"	"Other venous embolism and thrombosis"	"Multiple sclerosis"	1	0	34	34
"I69"	"O48"	"Sequelae of cerebrovascular disease"	"Late pregnancy"	1	0	30	30
"N17"	"J32"	"Acute kidney failure"	"Chronic sinusitis"	1	11	102	113
"E21"	"H52"	"Hyperparathyroidism and other disorders of parathyroid gland"	"Disorders of refraction and accommodation"	1	27	114	141
"I63"	"L02"	"Cerebral infarction"	"Cutaneous abscess, furuncle and carbuncle"	1	611	1564	2175
"E68"	"O44"	"Sequelae of hyperalimentation"	"Placenta previa"	1	2	29	31
"E66"	"Q65"	"Overweight and obesity"	"Congenital deformities of hip"	1	125	283	408
"H25"	"M17"	"Age-related cataract"	"Osteoarthritis of knee"	1	0	20542	20542
"K42"	"O70"	"Umbilical hernia"	"Perineal laceration during delivery"	1	0	1777	1777
"G31"	"K70"	"Oth degenerative diseases of nervous system, NEC"	"Alcoholic liver disease"	1	354	654	1008
"N64"	"H72"	"Other disorders of breast"	"Perforation of tympanic membrane"	1	19	68	87
"O14"	"O04"	"Pre-eclampsia"	"Complications following (induced) termination of pregnancy"	1	890	1285	2175
"E04"	"H83"	"Other nontoxic goiter"	"Other diseases of inner ear"	1	99	221	320
"C22"	"K51"	"Malignant neoplasm of liver and intrahepatic bile ducts"	"Ulcerative colitis"	1	0	72	72
"E78"	"O21"	"Disorders of lipoprotein metabolism and other lipidemias"	"Excessive vomiting in pregnancy"	1	0	47	47
"K80"	"O72"	"Cholelithiasis"	"Postpartum hemorrhage"	1	3332	3761	7093
"I62"	"N81"	"Other and unspecified nontraumatic intracranial hemorrhage"	"Female genital prolapse"	1	2	37	39
"F32"	"M75"	"Depressive episode"	"Shoulder lesions"	1	932	1398	2330
"C92"	"M77"	"Myeloid leukemia"	"Other enthesopathies"	1	2	32	34
"E66"	"N96"	"Overweight and obesity"	"Recurrent pregnancy loss"	1	316	498	814
"G37"	"O80"	"Other demyelinating diseases of central nervous system"	"Encounter for full-term uncomplicated delivery"	1	0	278	278
"H92"	"Q21"	"Otalgia and effusion of ear"	"Congenital malformations of cardiac septa"	1	2	37	39
"B34"	"O42"	"Viral infection of unspecified site"	"Premature rupture of membranes"	1	197	364	561
"N17"	"K70"	"Acute kidney failure"	"Alcoholic liver disease"	1	635	929	1564
"N30"	"N43"	"Cystitis"	"Hydrocele and spermatocele"	1	341	966	1307
"D11"	"O03"	"Benign neoplasm of major salivary glands"	"Spontaneous abortion"	1	1	53	54
"J84"	"M76"	"Other interstitial pulmonary diseases"	"Enthesopathies, lower limb, excluding foot"	1	16	95	111
"E21"	"I10"	"Hyperparathyroidism and other disorders of parathyroid gland"	"Essential (primary) hypertension"	1	1513	2889	4402
"O30"	"O03"	"Multiple gestation"	"Spontaneous abortion"	1	672	2159	2831
"E10"	"H65"	"Type 1 diabetes mellitus"	"Nonsuppurative otitis media"	1	142	280	422
"J95"	"M23"	"Intraop and postproc comp and disorders of resp sys, NEC"	"Internal derangement of knee"	1	0	129	129
"M79"	"N81"	"Oth and unsp soft tissue disorders, not elsewhere classified"	"Female genital prolapse"	1	1593	2142	3735
"I35"	"N92"	"Nonrheumatic aortic valve disorders"	"Excessive, frequent and irregular menstruation"	1	0	490	490
"M79"	"K26"	"Oth and unsp soft tissue disorders, not elsewhere classified"	"Duodenal ulcer"	1	723	1260	1983
"K72"	"C91"	"Hepatic failure, not elsewhere classified"	"Lymphoid leukemia"	1	9	49	58
"K80"	"N46"	"Cholelithiasis"	"Male infertility"	1	85	236	321
"O73"	"M22"	"Retained placenta and membranes, without hemorrhage"	"Disorder of patella"	1	2	115	117
"C45"	"D12"	"Mesothelioma"	"Benign neoplasm of colon, rectum, anus and anal canal"	1	18	88	106
"L40"	"N47"	"Psoriasis"	"Disorders of prepuce"	1	64	136	200
"K56"	"O80"	"Paralytic ileus and intestinal obstruction without hernia"	"Encounter for full-term uncomplicated delivery"	1	0	505	505
"H91"	"C62"	"Other and unspecified hearing loss"	"Malignant neoplasm of testis"	1	64	411	475
"C79"	"H44"	"Secondary malignant neoplasm of other and unspecified sites"	"Disorders of globe"	1	7	93	100
"M34"	"O62"	"Systemic sclerosis [scleroderma]"	"Abnormalities of forces of labor"	1	1	38	39
"N18"	"D75"	"Chronic kidney disease (CKD)"	"Other and unsp diseases of blood and blood-forming organs"	1	118	227	345
"I81"	"K40"	"Portal vein thrombosis"	"Inguinal hernia"	1	11	57	68
"H47"	"K40"	"Other disorders of optic [2nd] nerve and visual pathways"	"Inguinal hernia"	1	42	138	180
"J21"	"Q25"	"Acute bronchiolitis"	"Congenital malformations of great arteries"	1	70	171	241
"N12"	"I10"	"Tubulo-interstitial nephritis, not spcf as acute or chronic"	"Essential (primary) hypertension"	1	422	951	1373
"F41"	"C04"	"Other anxiety disorders"	"Malignant neoplasm of floor of mouth"	1	21	89	110
"C50"	"D48"	"Malignant neoplasm of breast"	"Neoplasm of uncertain behavior of other and unsp sites"	1	680	1434	2114
"J96"	"D61"	"Respiratory failure, not elsewhere classified"	"Oth aplastic anemias and other bone marrow failure syndromes"	1	219	345	564
"M15"	"H83"	"Polyosteoarthritis"	"Other diseases of inner ear"	1	37	158	195
"I71"	"M79"	"Aortic aneurysm and dissection"	"Oth and unsp soft tissue disorders, not elsewhere classified"	1	396	1180	1576
"H81"	"O63"	"Disorders of vestibular function"	"Long labor"	1	15	92	107
"O23"	"L68"	"Infections of genitourinary tract in pregnancy"	"Hypertrichosis"	1	56	128	184
"J96"	"B18"	"Respiratory failure, not elsewhere classified"	"Chronic viral hepatitis"	1	120	466	586
"C78"	"N89"	"Secondary malignant neoplasm of resp and digestive organs"	"Other noninflammatory disorders of vagina"	1	5	87	92
"N95"	"O70"	"Menopausal and other perimenopausal disorders"	"Perineal laceration during delivery"	1	0	105	105
"G47"	"A69"	"Sleep disorders"	"Other spirochetal infections"	1	21	104	125
"I49"	"L05"	"Other cardiac arrhythmias"	"Pilonidal cyst and sinus"	1	14	89	103
"G44"	"O30"	"Other headache syndromes"	"Multiple gestation"	1	28	143	171
"G62"	"K85"	"Other and unspecified polyneuropathies"	"Acute pancreatitis"	1	162	323	485
"E53"	"H81"	"Deficiency of other B group vitamins"	"Disorders of vestibular function"	1	154	268	422
"E66"	"Q37"	"Overweight and obesity"	"Cleft palate with cleft lip"	1	4	39	43
"H91"	"J36"	"Other and unspecified hearing loss"	"Peritonsillar abscess"	1	70	241	311
"M23"	"L04"	"Internal derangement of knee"	"Acute lymphadenitis"	1	86	274	360
"N92"	"O75"	"Excessive, frequent and irregular menstruation"	"Oth complications of labor and delivery, NEC"	1	0	1439	1439
"M16"	"K42"	"Osteoarthritis of hip"	"Umbilical hernia"	1	470	641	1111
"K21"	"O70"	"Gastro-esophageal reflux disease"	"Perineal laceration during delivery"	1	207	1144	1351
"G45"	"M62"	"Transient cerebral ischemic attacks and related syndromes"	"Other disorders of muscle"	1	699	2059	2758
"N99"	"N92"	"Intraop and postproc comp and disorders of GU sys, NEC"	"Excessive, frequent and irregular menstruation"	1	226	876	1102
"M53"	"N97"	"Other and unspecified dorsopathies, not elsewhere classified"	"Female infertility"	1	44	376	420
"K86"	"I20"	"Other diseases of pancreas"	"Angina pectoris"	1	382	744	1126
"I74"	"M23"	"Arterial embolism and thrombosis"	"Internal derangement of knee"	1	90	248	338
"C43"	"M62"	"Malignant melanoma of skin"	"Other disorders of muscle"	1	98	371	469
"G44"	"O75"	"Other headache syndromes"	"Oth complications of labor and delivery, NEC"	1	88	209	297
"G47"	"K35"	"Sleep disorders"	"Acute appendicitis"	1	61	1007	1068
"J96"	"O04"	"Respiratory failure, not elsewhere classified"	"Complications following (induced) termination of pregnancy"	1	0	267	267
"J91"	"M51"	"Pleural effusion in conditions classified elsewhere"	"Thoracic, thoracolum, and lumbosacral intvrt disc disorders"	1	10	268	278
"C64"	"K20"	"Malignant neoplasm of kidney, except renal pelvis"	"Esophagitis"	1	30	96	126
"I87"	"O42"	"Other disorders of veins"	"Premature rupture of membranes"	1	3	39	42
"I63"	"M20"	"Cerebral infarction"	"Acquired deformities of fingers and toes"	1	287	1205	1492
"D63"	"M70"	"Anemia in chronic diseases classified elsewhere"	"Soft tissue disorders related to use, overuse and pressure"	1	32	291	323
"I50"	"N43"	"Heart failure"	"Hydrocele and spermatocele"	1	248	1152	1400
"M79"	"Q37"	"Oth and unsp soft tissue disorders, not elsewhere classified"	"Cleft palate with cleft lip"	1	4	65	69
"C34"	"H20"	"Malignant neoplasm of bronchus and lung"	"Iridocyclitis"	1	6	201	207
"I26"	"D17"	"Pulmonary embolism"	"Benign lipomatous neoplasm"	1	86	400	486
"C53"	"O65"	"Malignant neoplasm of cervix uteri"	"Obstructed labor due to maternal pelvic abnormality"	1	0	47	47
"K05"	"C07"	"Gingivitis and periodontal diseases"	"Malignant neoplasm of parotid gland"	1	63	150	213
"I33"	"M75"	"Acute and subacute endocarditis"	"Shoulder lesions"	1	58	156	214
"O91"	"O35"	"Infect of breast assoc w pregnancy, the puerp and lactation"	"Maternal care for known or suspected fetal abnlt and damage"	1	112	226	338
"O13"	"A63"	"Gestational hypertension without significant proteinuria"	"Oth predominantly sexually transmitted diseases, NEC"	1	1	216	217
"H40"	"O02"	"Glaucoma"	"Other abnormal products of conception"	1	0	47	47
"O64"	"O02"	"Obstructed labor due to malposition and malpresent of fetus"	"Other abnormal products of conception"	1	1744	2690	4434
"Q61"	"M67"	"Cystic kidney disease"	"Other disorders of synovium and tendon"	1	31	129	160
"J90"	"L05"	"Pleural effusion, not elsewhere classified"	"Pilonidal cyst and sinus"	1	1	32	33
"K35"	"Q74"	"Acute appendicitis"	"Other congenital malformations of limb(s)"	1	10	56	66
"J96"	"L93"	"Respiratory failure, not elsewhere classified"	"Lupus erythematosus"	1	8	100	108
"M79"	"O47"	"Oth and unsp soft tissue disorders, not elsewhere classified"	"False labor"	1	557	1096	1653
"O70"	"Q21"	"Perineal laceration during delivery"	"Congenital malformations of cardiac septa"	1	94	196	290
"I71"	"K57"	"Aortic aneurysm and dissection"	"Diverticular disease of intestine"	1	1008	1493	2501
"C79"	"K58"	"Secondary malignant neoplasm of other and unspecified sites"	"Irritable bowel syndrome"	1	0	315	315
"O35"	"M22"	"Maternal care for known or suspected fetal abnlt and damage"	"Disorder of patella"	1	0	175	175
"C71"	"K80"	"Malignant neoplasm of brain"	"Cholelithiasis"	1	34	250	284
"E87"	"C73"	"Other disorders of fluid, electrolyte and acid-base balance"	"Malignant neoplasm of thyroid gland"	1	21	90	111
"C61"	"M72"	"Malignant neoplasm of prostate"	"Fibroblastic disorders"	1	176	870	1046
"O92"	"N30"	"Oth disord of brst/lactatn assoc w pregnancy and the puerp"	"Cystitis"	1	186	536	722
"K56"	"G82"	"Paralytic ileus and intestinal obstruction without hernia"	"Paraplegia (paraparesis) and quadriplegia (quadriparesis)"	1	112	234	346
"K41"	"O04"	"Femoral hernia"	"Complications following (induced) termination of pregnancy"	1	0	74	74
"D12"	"K44"	"Benign neoplasm of colon, rectum, anus and anal canal"	"Diaphragmatic hernia"	1	1822	3028	4850
"K61"	"K51"	"Abscess of anal and rectal regions"	"Ulcerative colitis"	1	297	519	816
"K80"	"G40"	"Cholelithiasis"	"Epilepsy and recurrent seizures"	1	752	969	1721
"I70"	"N60"	"Atherosclerosis"	"Benign mammary dysplasia"	1	65	217	282
"K51"	"O04"	"Ulcerative colitis"	"Complications following (induced) termination of pregnancy"	1	103	608	711
"C85"	"O62"	"Oth and unspecified types of non-Hodgkin lymphoma"	"Abnormalities of forces of labor"	1	1	34	35
"H36"	"O63"	"Retinal disorders in diseases classified elsewhere"	"Long labor"	1	1	33	34
"N46"	"H66"	"Male infertility"	"Suppurative and unspecified otitis media"	1	1	59	60
"H57"	"K35"	"Other disorders of eye and adnexa"	"Acute appendicitis"	1	44	412	456
"K70"	"I10"	"Alcoholic liver disease"	"Essential (primary) hypertension"	1	2047	2460	4507
"I69"	"L30"	"Sequelae of cerebrovascular disease"	"Other and unspecified dermatitis"	1	540	749	1289
"J91"	"D24"	"Pleural effusion in conditions classified elsewhere"	"Benign neoplasm of breast"	1	0	53	53
"C78"	"D68"	"Secondary malignant neoplasm of resp and digestive organs"	"Other coagulation defects"	1	85	217	302
"N31"	"Q42"	"Neuromuscular dysfunction of bladder, NEC"	"Congenital absence, atresia and stenosis of large intestine"	1	0	45	45
"H57"	"M16"	"Other disorders of eye and adnexa"	"Osteoarthritis of hip"	1	168	430	598
"O33"	"O64"	"Maternal care for disproportion"	"Obstructed labor due to malposition and malpresent of fetus"	1	131	258	389
"K85"	"N92"	"Acute pancreatitis"	"Excessive, frequent and irregular menstruation"	1	133	420	553
"J41"	"H83"	"Simple and mucopurulent chronic bronchitis"	"Other diseases of inner ear"	1	44	134	178
"O99"	"A56"	"Oth maternal diseases classd elsw but compl preg/chldbrth"	"Other sexually transmitted chlamydial diseases"	1	40	416	456
"N94"	"O68"	"Pain and oth cond assoc w fem gntl org and menstrual cycle"	"Labor and delivery comp by abnlt of fetal acid-base balance"	1	890	1987	2877
"A41"	"H54"	"Other sepsis"	"Blindness and low vision"	1	437	706	1143
"K56"	"O47"	"Paralytic ileus and intestinal obstruction without hernia"	"False labor"	1	33	159	192
"G62"	"Q54"	"Other and unspecified polyneuropathies"	"Hypospadias"	1	2	32	34
"K56"	"M50"	"Paralytic ileus and intestinal obstruction without hernia"	"Cervical disc disorders"	1	77	380	457
"M17"	"O03"	"Osteoarthritis of knee"	"Spontaneous abortion"	1	0	363	363
"C92"	"C61"	"Myeloid leukemia"	"Malignant neoplasm of prostate"	1	23	85	108
"D09"	"G56"	"Carcinoma in situ of other and unspecified sites"	"Mononeuropathies of upper limb"	1	11	153	164
"K59"	"C90"	"Other functional intestinal disorders"	"Multiple myeloma and malignant plasma cell neoplasms"	1	265	519	784
"C10"	"I21"	"Malignant neoplasm of oropharynx"	"Acute myocardial infarction"	1	17	67	84
"I69"	"L50"	"Sequelae of cerebrovascular disease"	"Urticaria"	1	107	416	523
"J95"	"I83"	"Intraop and postproc comp and disorders of resp sys, NEC"	"Varicose veins of lower extremities"	1	3	103	106
"M17"	"N20"	"Osteoarthritis of knee"	"Calculus of kidney and ureter"	1	1022	1695	2717
"M76"	"D25"	"Enthesopathies, lower limb, excluding foot"	"Leiomyoma of uterus"	1	183	544	727
"C80"	"I69"	"Malignant neoplasm without specification of site"	"Sequelae of cerebrovascular disease"	1	69	254	323
"E21"	"N97"	"Hyperparathyroidism and other disorders of parathyroid gland"	"Female infertility"	1	0	63	63
"A49"	"I73"	"Bacterial infection of unspecified site"	"Other peripheral vascular diseases"	1	416	1725	2141
"I25"	"H91"	"Chronic ischemic heart disease"	"Other and unspecified hearing loss"	1	0	26357	26357
"O82"	"M08"	"Encounter for cesarean delivery without indication"	"Juvenile arthritis"	1	0	47	47
"F17"	"M62"	"Nicotine dependence"	"Other disorders of muscle"	1	0	2495	2495
"N63"	"O66"	"Unspecified lump in breast"	"Other obstructed labor"	1	36	139	175
"J93"	"H93"	"Pneumothorax and air leak"	"Other disorders of ear, not elsewhere classified"	1	55	192	247
"N17"	"J38"	"Acute kidney failure"	"Diseases of vocal cords and larynx, not elsewhere classified"	1	46	168	214
"O72"	"N73"	"Postpartum hemorrhage"	"Other female pelvic inflammatory diseases"	1	168	413	581
"J39"	"O04"	"Other diseases of upper respiratory tract"	"Complications following (induced) termination of pregnancy"	1	13	80	93
"K29"	"Q53"	"Gastritis and duodenitis"	"Undescended and ectopic testicle"	1	18	69	87
"E66"	"L02"	"Overweight and obesity"	"Cutaneous abscess, furuncle and carbuncle"	1	2269	3058	5327
"D63"	"K58"	"Anemia in chronic diseases classified elsewhere"	"Irritable bowel syndrome"	1	3	243	246
"E86"	"G56"	"Volume depletion"	"Mononeuropathies of upper limb"	1	0	2843	2843
"H60"	"H66"	"Otitis externa"	"Suppurative and unspecified otitis media"	1	1195	1498	2693
"A41"	"N60"	"Other sepsis"	"Benign mammary dysplasia"	1	0	370	370
"C34"	"G50"	"Malignant neoplasm of bronchus and lung"	"Disorders of trigeminal nerve"	1	24	171	195
"K70"	"E78"	"Alcoholic liver disease"	"Disorders of lipoprotein metabolism and other lipidemias"	1	611	807	1418
"L02"	"O45"	"Cutaneous abscess, furuncle and carbuncle"	"Premature separation of placenta [abruptio placentae]"	1	19	88	107
"H57"	"F79"	"Other disorders of eye and adnexa"	"Unspecified intellectual disabilities"	1	50	120	170
"F17"	"H80"	"Nicotine dependence"	"Otosclerosis"	1	0	78	78
"D64"	"O47"	"Other anemias"	"False labor"	1	40	271	311
"H57"	"Q54"	"Other disorders of eye and adnexa"	"Hypospadias"	1	0	43	43
"J18"	"K41"	"Pneumonia, unspecified organism"	"Femoral hernia"	1	263	599	862
"K92"	"J05"	"Other diseases of digestive system"	"Acute obstructive laryngitis [croup] and epiglottitis"	1	15	72	87
"I49"	"J34"	"Other cardiac arrhythmias"	"Other and unspecified disorders of nose and nasal sinuses"	1	87	310	397
"E66"	"D16"	"Overweight and obesity"	"Benign neoplasm of bone and articular cartilage"	1	107	280	387
"C78"	"C10"	"Secondary malignant neoplasm of resp and digestive organs"	"Malignant neoplasm of oropharynx"	1	78	251	329
"J96"	"C44"	"Respiratory failure, not elsewhere classified"	"Other and unspecified malignant neoplasm of skin"	1	480	2123	2603
"A49"	"O36"	"Bacterial infection of unspecified site"	"Maternal care for other fetal problems"	1	56	162	218
"E16"	"K21"	"Other disorders of pancreatic internal secretion"	"Gastro-esophageal reflux disease"	1	288	428	716
"N28"	"I70"	"Oth disorders of kidney and ureter, not elsewhere classified"	"Atherosclerosis"	1	346	750	1096
"G54"	"N97"	"Nerve root and plexus disorders"	"Female infertility"	1	5	63	68
"C77"	"M71"	"Secondary and unspecified malignant neoplasm of lymph nodes"	"Other bursopathies"	1	6	71	77
"J01"	"D25"	"Acute sinusitis"	"Leiomyoma of uterus"	1	77	164	241
"C49"	"H83"	"Malignant neoplasm of other connective and soft tissue"	"Other diseases of inner ear"	1	7	47	54
"C78"	"O82"	"Secondary malignant neoplasm of resp and digestive organs"	"Encounter for cesarean delivery without indication"	1	0	107	107
"G21"	"M16"	"Secondary parkinsonism"	"Osteoarthritis of hip"	1	22	162	184
"C16"	"M50"	"Malignant neoplasm of stomach"	"Cervical disc disorders"	1	0	81	81
"E83"	"N87"	"Disorders of mineral metabolism"	"Dysplasia of cervix uteri"	1	0	62	62
"I26"	"M50"	"Pulmonary embolism"	"Cervical disc disorders"	1	49	387	436
"I80"	"K61"	"Phlebitis and thrombophlebitis"	"Abscess of anal and rectal regions"	1	159	326	485
"C61"	"K61"	"Malignant neoplasm of prostate"	"Abscess of anal and rectal regions"	1	37	176	213
"E78"	"M70"	"Disorders of lipoprotein metabolism and other lipidemias"	"Soft tissue disorders related to use, overuse and pressure"	1	1200	1932	3132
"M51"	"O47"	"Thoracic, thoracolum, and lumbosacral intvrt disc disorders"	"False labor"	1	34	939	973
"H36"	"M79"	"Retinal disorders in diseases classified elsewhere"	"Oth and unsp soft tissue disorders, not elsewhere classified"	1	577	777	1354
"E86"	"C16"	"Volume depletion"	"Malignant neoplasm of stomach"	1	573	1519	2092
"J98"	"D27"	"Other respiratory disorders"	"Benign neoplasm of ovary"	1	34	107	141
"C15"	"I20"	"Malignant neoplasm of esophagus"	"Angina pectoris"	1	19	663	682
"J98"	"O64"	"Other respiratory disorders"	"Obstructed labor due to malposition and malpresent of fetus"	1	2	26	28
"J15"	"I63"	"Bacterial pneumonia, not elsewhere classified"	"Cerebral infarction"	1	3332	6769	10101
"I49"	"H91"	"Other cardiac arrhythmias"	"Other and unspecified hearing loss"	1	2026	4167	6193
"M71"	"O48"	"Other bursopathies"	"Late pregnancy"	1	4	41	45
"H25"	"G71"	"Age-related cataract"	"Primary disorders of muscles"	1	54	125	179
"C71"	"M43"	"Malignant neoplasm of brain"	"Other deforming dorsopathies"	1	1	30	31
"H35"	"J36"	"Other retinal disorders"	"Peritonsillar abscess"	1	19	101	120
"G95"	"M35"	"Other and unspecified diseases of spinal cord"	"Other systemic involvement of connective tissue"	1	39	151	190
"C85"	"J45"	"Oth and unspecified types of non-Hodgkin lymphoma"	"Asthma"	1	73	175	248
"I21"	"M17"	"Acute myocardial infarction"	"Osteoarthritis of knee"	1	2369	4561	6930
"K21"	"O41"	"Gastro-esophageal reflux disease"	"Other disorders of amniotic fluid and membranes"	1	13	74	87
"I97"	"O62"	"Intraop and postproc comp and disorders of circ sys, NEC"	"Abnormalities of forces of labor"	1	0	29	29
"E87"	"D25"	"Other disorders of fluid, electrolyte and acid-base balance"	"Leiomyoma of uterus"	1	0	558	558
"I85"	"M65"	"Esophageal varices"	"Synovitis and tenosynovitis"	1	11	95	106
"C25"	"M81"	"Malignant neoplasm of pancreas"	"Osteoporosis without current pathological fracture"	1	108	571	679
"F14"	"O04"	"Cocaine related disorders"	"Complications following (induced) termination of pregnancy"	1	15	110	125
"I85"	"I10"	"Esophageal varices"	"Essential (primary) hypertension"	1	591	1027	1618
"L57"	"Q61"	"Skin changes due to chronic expsr to nonionizing radiation"	"Cystic kidney disease"	1	2	81	83
"J15"	"C44"	"Bacterial pneumonia, not elsewhere classified"	"Other and unspecified malignant neoplasm of skin"	1	889	2500	3389
"G45"	"O99"	"Transient cerebral ischemic attacks and related syndromes"	"Oth maternal diseases classd elsw but compl preg/chldbrth"	1	44	281	325
"K56"	"H35"	"Paralytic ileus and intestinal obstruction without hernia"	"Other retinal disorders"	1	673	1386	2059
"L50"	"J20"	"Urticaria"	"Acute bronchitis"	1	298	895	1193
"H53"	"J35"	"Visual disturbances"	"Chronic diseases of tonsils and adenoids"	1	41	483	524
"C96"	"I10"	"Oth & unsp malig neoplm of lymphoid, hematpoetc and rel tiss"	"Essential (primary) hypertension"	1	22	90	112
"I20"	"O64"	"Angina pectoris"	"Obstructed labor due to malposition and malpresent of fetus"	1	0	73	73
"I48"	"H52"	"Atrial fibrillation and flutter"	"Disorders of refraction and accommodation"	1	294	940	1234
"E03"	"D30"	"Other hypothyroidism"	"Benign neoplasm of urinary organs"	1	115	249	364
"G03"	"O62"	"Meningitis due to other and unspecified causes"	"Abnormalities of forces of labor"	1	16	111	127
"C34"	"M76"	"Malignant neoplasm of bronchus and lung"	"Enthesopathies, lower limb, excluding foot"	1	7	256	263
"O91"	"F50"	"Infect of breast assoc w pregnancy, the puerp and lactation"	"Eating disorders"	1	0	34	34
"N30"	"G40"	"Cystitis"	"Epilepsy and recurrent seizures"	1	2867	4740	7607
"C90"	"N20"	"Multiple myeloma and malignant plasma cell neoplasms"	"Calculus of kidney and ureter"	1	20	106	126
"E86"	"C48"	"Volume depletion"	"Malignant neoplasm of retroperitoneum and peritoneum"	1	73	165	238
"D63"	"H53"	"Anemia in chronic diseases classified elsewhere"	"Visual disturbances"	1	80	200	280
"M72"	"N60"	"Fibroblastic disorders"	"Benign mammary dysplasia"	1	28	256	284
"M48"	"O14"	"Other spondylopathies"	"Pre-eclampsia"	1	0	25	25
"K02"	"M72"	"Dental caries"	"Fibroblastic disorders"	1	45	121	166
"F07"	"F10"	"Personality & behavrl disorders due to known physiol cond"	"Alcohol related disorders"	1	124	288	412
"N73"	"K35"	"Other female pelvic inflammatory diseases"	"Acute appendicitis"	1	218	340	558
"K56"	"M71"	"Paralytic ileus and intestinal obstruction without hernia"	"Other bursopathies"	1	49	155	204
"H60"	"H80"	"Otitis externa"	"Otosclerosis"	1	79	172	251
"I69"	"Q28"	"Sequelae of cerebrovascular disease"	"Other congenital malformations of circulatory system"	1	209	450	659
"I73"	"C50"	"Other peripheral vascular diseases"	"Malignant neoplasm of breast"	1	215	567	782
"N13"	"N97"	"Obstructive and reflux uropathy"	"Female infertility"	1	67	237	304
"G96"	"O70"	"Other disorders of central nervous system"	"Perineal laceration during delivery"	1	21	652	673
"F03"	"M71"	"Unspecified dementia"	"Other bursopathies"	1	4	264	268
"E35"	"E11"	"Disorders of endocrine glands in diseases classd elswhr"	"Type 2 diabetes mellitus"	1	34	122	156
"M80"	"K50"	"Osteoporosis with current pathological fracture"	"Crohn's disease [regional enteritis]"	1	60	236	296
"I26"	"H44"	"Pulmonary embolism"	"Disorders of globe"	1	20	80	100
"M16"	"O80"	"Osteoarthritis of hip"	"Encounter for full-term uncomplicated delivery"	1	0	508	508
"O75"	"O20"	"Oth complications of labor and delivery, NEC"	"Hemorrhage in early pregnancy"	1	1620	4039	5659
"E23"	"L02"	"Hypofunction and other disorders of the pituitary gland"	"Cutaneous abscess, furuncle and carbuncle"	1	50	118	168
"I46"	"D86"	"Cardiac arrest"	"Sarcoidosis"	1	1	87	88
"M16"	"H83"	"Osteoarthritis of hip"	"Other diseases of inner ear"	1	480	1520	2000
"K80"	"O34"	"Cholelithiasis"	"Maternal care for abnormality of pelvic organs"	1	509	1139	1648
"A41"	"C49"	"Other sepsis"	"Malignant neoplasm of other connective and soft tissue"	1	136	353	489
"E11"	"I20"	"Type 2 diabetes mellitus"	"Angina pectoris"	1	12406	13414	25820
"M05"	"O70"	"Rheumatoid arthritis with rheumatoid factor"	"Perineal laceration during delivery"	1	17	404	421
"H25"	"I83"	"Age-related cataract"	"Varicose veins of lower extremities"	1	0	7772	7772
"I26"	"N45"	"Pulmonary embolism"	"Orchitis and epididymitis"	1	68	202	270
"E16"	"K29"	"Other disorders of pancreatic internal secretion"	"Gastritis and duodenitis"	1	498	863	1361
"J35"	"Q68"	"Chronic diseases of tonsils and adenoids"	"Other congenital musculoskeletal deformities"	1	65	174	239
"K42"	"D06"	"Umbilical hernia"	"Carcinoma in situ of cervix uteri"	1	0	35	35
"J20"	"O80"	"Acute bronchitis"	"Encounter for full-term uncomplicated delivery"	1	272	493	765
"O67"	"O02"	"Labor and delivery comp by intrapartum hemorrhage, NEC"	"Other abnormal products of conception"	1	136	365	501
"N18"	"M13"	"Chronic kidney disease (CKD)"	"Other arthritis"	1	442	695	1137
"E83"	"O47"	"Disorders of mineral metabolism"	"False labor"	1	0	30	30
"E10"	"H10"	"Type 1 diabetes mellitus"	"Conjunctivitis"	1	317	544	861
"N39"	"H33"	"Other disorders of urinary system"	"Retinal detachments and breaks"	1	176	856	1032
"G61"	"O04"	"Inflammatory polyneuropathy"	"Complications following (induced) termination of pregnancy"	1	5	48	53
"H36"	"D25"	"Retinal disorders in diseases classified elsewhere"	"Leiomyoma of uterus"	1	16	186	202
"E78"	"L40"	"Disorders of lipoprotein metabolism and other lipidemias"	"Psoriasis"	1	732	988	1720
"D65"	"K29"	"Disseminated intravascular coagulation"	"Gastritis and duodenitis"	1	22	84	106
"A09"	"Q37"	"Infectious gastroenteritis and colitis, unspecified"	"Cleft palate with cleft lip"	1	22	79	101
"F03"	"L30"	"Unspecified dementia"	"Other and unspecified dermatitis"	1	205	517	722
"C90"	"K29"	"Multiple myeloma and malignant plasma cell neoplasms"	"Gastritis and duodenitis"	1	97	210	307
"N83"	"O60"	"Noninflammatory disord of ovary, fallop and broad ligament"	"Preterm labor"	1	66	181	247
"O70"	"M22"	"Perineal laceration during delivery"	"Disorder of patella"	1	0	3721	3721
"M67"	"Q17"	"Other disorders of synovium and tendon"	"Other congenital malformations of ear"	1	4	171	175
"M72"	"O68"	"Fibroblastic disorders"	"Labor and delivery comp by abnlt of fetal acid-base balance"	1	0	227	227
"F05"	"C77"	"Delirium due to known physiological condition"	"Secondary and unspecified malignant neoplasm of lymph nodes"	1	161	523	684
"H02"	"D11"	"Other disorders of eyelid"	"Benign neoplasm of major salivary glands"	1	67	159	226
"N39"	"C18"	"Other disorders of urinary system"	"Malignant neoplasm of colon"	1	1213	1997	3210
"I21"	"L04"	"Acute myocardial infarction"	"Acute lymphadenitis"	1	24	77	101
"M76"	"F10"	"Enthesopathies, lower limb, excluding foot"	"Alcohol related disorders"	1	317	512	829
"K27"	"N92"	"Peptic ulcer, site unspecified"	"Excessive, frequent and irregular menstruation"	1	63	179	242
"E61"	"I20"	"Deficiency of other nutrient elements"	"Angina pectoris"	1	6	157	163
"I48"	"O04"	"Atrial fibrillation and flutter"	"Complications following (induced) termination of pregnancy"	1	0	218	218
"M80"	"N47"	"Osteoporosis with current pathological fracture"	"Disorders of prepuce"	1	49	145	194
"O89"	"O04"	"Complications of anesthesia during the puerperium"	"Complications following (induced) termination of pregnancy"	1	22	89	111
"K86"	"O02"	"Other diseases of pancreas"	"Other abnormal products of conception"	1	0	34	34
"O90"	"G40"	"Complications of the puerperium, not elsewhere classified"	"Epilepsy and recurrent seizures"	1	8	118	126
"C91"	"G56"	"Lymphoid leukemia"	"Mononeuropathies of upper limb"	1	43	130	173
"G44"	"J36"	"Other headache syndromes"	"Peritonsillar abscess"	1	29	125	154
"K83"	"K26"	"Other diseases of biliary tract"	"Duodenal ulcer"	1	314	505	819
"M75"	"O04"	"Shoulder lesions"	"Complications following (induced) termination of pregnancy"	1	0	2786	2786
"I74"	"M51"	"Arterial embolism and thrombosis"	"Thoracic, thoracolum, and lumbosacral intvrt disc disorders"	1	96	375	471
"I21"	"N63"	"Acute myocardial infarction"	"Unspecified lump in breast"	1	136	388	524
"I50"	"D14"	"Heart failure"	"Benign neoplasm of middle ear and respiratory system"	1	204	555	759
"L08"	"H71"	"Other local infections of skin and subcutaneous tissue"	"Cholesteatoma of middle ear"	1	11	61	72
"J15"	"K02"	"Bacterial pneumonia, not elsewhere classified"	"Dental caries"	1	325	810	1135
"N30"	"L40"	"Cystitis"	"Psoriasis"	1	464	976	1440
"I35"	"D22"	"Nonrheumatic aortic valve disorders"	"Melanocytic nevi"	1	79	174	253
"J44"	"Q79"	"Other chronic obstructive pulmonary disease"	"Congenital malformations of musculoskeletal system, NEC"	1	13	55	68
"D18"	"O70"	"Hemangioma and lymphangioma, any site"	"Perineal laceration during delivery"	1	129	230	359
"C49"	"E78"	"Malignant neoplasm of other connective and soft tissue"	"Disorders of lipoprotein metabolism and other lipidemias"	1	71	173	244
"Q50"	"O80"	"Congen malform of ovaries, fallopian tubes & broad ligaments"	"Encounter for full-term uncomplicated delivery"	1	52	162	214
"D64"	"J36"	"Other anemias"	"Peritonsillar abscess"	1	8	161	169
"K44"	"O36"	"Diaphragmatic hernia"	"Maternal care for other fetal problems"	1	28	182	210
"I46"	"N03"	"Cardiac arrest"	"Chronic nephritic syndrome"	1	4	88	92
"I82"	"O26"	"Other venous embolism and thrombosis"	"Maternal care for oth conditions predom related to pregnancy"	1	10	73	83
"M54"	"O02"	"Dorsalgia"	"Other abnormal products of conception"	1	698	2170	2868
"O72"	"E73"	"Postpartum hemorrhage"	"Lactose intolerance"	1	97	319	416
"E03"	"J03"	"Other hypothyroidism"	"Acute tonsillitis"	1	133	334	467
"G44"	"K29"	"Other headache syndromes"	"Gastritis and duodenitis"	1	572	937	1509
"K43"	"N40"	"Ventral hernia"	"Benign prostatic hyperplasia"	1	634	1104	1738
"C34"	"J01"	"Malignant neoplasm of bronchus and lung"	"Acute sinusitis"	1	7	98	105
"M75"	"M02"	"Shoulder lesions"	"Postinfective and reactive arthropathies"	1	221	550	771
"J18"	"J33"	"Pneumonia, unspecified organism"	"Nasal polyp"	1	229	643	872
"K80"	"O36"	"Cholelithiasis"	"Maternal care for other fetal problems"	1	537	1803	2340
"J96"	"N95"	"Respiratory failure, not elsewhere classified"	"Menopausal and other perimenopausal disorders"	1	32	1062	1094
"M20"	"K30"	"Acquired deformities of fingers and toes"	"Functional dyspepsia"	1	726	938	1664
"G57"	"J35"	"Mononeuropathies of lower limb"	"Chronic diseases of tonsils and adenoids"	1	14	142	156
"N20"	"N92"	"Calculus of kidney and ureter"	"Excessive, frequent and irregular menstruation"	1	678	1216	1894
"M48"	"M50"	"Other spondylopathies"	"Cervical disc disorders"	1	2048	3123	5171
"M50"	"O44"	"Cervical disc disorders"	"Placenta previa"	1	0	28	28
"M17"	"N76"	"Osteoarthritis of knee"	"Other inflammation of vagina and vulva"	1	190	386	576
"L97"	"M77"	"Non-pressure chronic ulcer of lower limb, NEC"	"Other enthesopathies"	1	33	249	282
"K62"	"H71"	"Other diseases of anus and rectum"	"Cholesteatoma of middle ear"	1	18	89	107
"D50"	"K51"	"Iron deficiency anemia"	"Ulcerative colitis"	1	233	538	771
"E87"	"K61"	"Other disorders of fluid, electrolyte and acid-base balance"	"Abscess of anal and rectal regions"	1	33	491	524
"C25"	"M20"	"Malignant neoplasm of pancreas"	"Acquired deformities of fingers and toes"	1	0	207	207
"A46"	"K44"	"Erysipelas"	"Diaphragmatic hernia"	1	370	900	1270
"I42"	"H80"	"Cardiomyopathy"	"Otosclerosis"	1	0	50	50
"D61"	"K57"	"Oth aplastic anemias and other bone marrow failure syndromes"	"Diverticular disease of intestine"	1	66	153	219
"N10"	"M51"	"Acute pyelonephritis"	"Thoracic, thoracolum, and lumbosacral intvrt disc disorders"	1	370	648	1018
"C25"	"K08"	"Malignant neoplasm of pancreas"	"Other disorders of teeth and supporting structures"	1	2	82	84
"I49"	"K51"	"Other cardiac arrhythmias"	"Ulcerative colitis"	1	139	322	461
"J22"	"O47"	"Unspecified acute lower respiratory infection"	"False labor"	1	3	34	37
"C80"	"K08"	"Malignant neoplasm without specification of site"	"Other disorders of teeth and supporting structures"	1	43	120	163
"C67"	"M16"	"Malignant neoplasm of bladder"	"Osteoarthritis of hip"	1	205	525	730
"F32"	"C67"	"Depressive episode"	"Malignant neoplasm of bladder"	1	136	378	514
"G43"	"O48"	"Migraine"	"Late pregnancy"	1	34	406	440
"L97"	"H91"	"Non-pressure chronic ulcer of lower limb, NEC"	"Other and unspecified hearing loss"	1	0	3042	3042
"C62"	"N45"	"Malignant neoplasm of testis"	"Orchitis and epididymitis"	1	159	276	435
"M50"	"O99"	"Cervical disc disorders"	"Oth maternal diseases classd elsw but compl preg/chldbrth"	1	15	774	789
"J84"	"N20"	"Other interstitial pulmonary diseases"	"Calculus of kidney and ureter"	1	43	214	257
"M00"	"E11"	"Pyogenic arthritis"	"Type 2 diabetes mellitus"	1	326	490	816
"I95"	"J36"	"Hypotension"	"Peritonsillar abscess"	1	3	41	44
"K44"	"M62"	"Diaphragmatic hernia"	"Other disorders of muscle"	1	1059	2077	3136
"C79"	"I45"	"Secondary malignant neoplasm of other and unspecified sites"	"Other conduction disorders"	1	30	170	200
"C34"	"M67"	"Malignant neoplasm of bronchus and lung"	"Other disorders of synovium and tendon"	1	0	542	542
"C43"	"N76"	"Malignant melanoma of skin"	"Other inflammation of vagina and vulva"	1	14	55	69
"K21"	"O13"	"Gastro-esophageal reflux disease"	"Gestational hypertension without significant proteinuria"	1	26	85	111
"I62"	"C50"	"Other and unspecified nontraumatic intracranial hemorrhage"	"Malignant neoplasm of breast"	1	7	46	53
"N12"	"K40"	"Tubulo-interstitial nephritis, not spcf as acute or chronic"	"Inguinal hernia"	1	28	155	183
"O72"	"M93"	"Postpartum hemorrhage"	"Other osteochondropathies"	1	0	145	145
"D63"	"K85"	"Anemia in chronic diseases classified elsewhere"	"Acute pancreatitis"	1	52	243	295
"F43"	"O68"	"Reaction to severe stress, and adjustment disorders"	"Labor and delivery comp by abnlt of fetal acid-base balance"	1	87	835	922
"M19"	"K50"	"Other and unspecified osteoarthritis"	"Crohn's disease [regional enteritis]"	1	102	212	314
"K59"	"N80"	"Other functional intestinal disorders"	"Endometriosis"	1	312	879	1191
"N13"	"I70"	"Obstructive and reflux uropathy"	"Atherosclerosis"	1	445	727	1172
"J47"	"O68"	"Bronchiectasis"	"Labor and delivery comp by abnlt of fetal acid-base balance"	1	0	53	53
"J10"	"K05"	"Influenza due to other identified influenza virus"	"Gingivitis and periodontal diseases"	1	7	75	82
"K83"	"M22"	"Other diseases of biliary tract"	"Disorder of patella"	1	0	83	83
"D62"	"C20"	"Acute posthemorrhagic anemia"	"Malignant neoplasm of rectum"	1	110	242	352
"E86"	"G43"	"Volume depletion"	"Migraine"	1	199	620	819
"E86"	"K42"	"Volume depletion"	"Umbilical hernia"	1	182	1088	1270
"C79"	"K70"	"Secondary malignant neoplasm of other and unspecified sites"	"Alcoholic liver disease"	1	25	291	316
"K22"	"M17"	"Other diseases of esophagus"	"Osteoarthritis of knee"	1	473	1126	1599
"N46"	"K00"	"Male infertility"	"Disorders of tooth development and eruption"	1	0	55	55
"M51"	"O86"	"Thoracic, thoracolum, and lumbosacral intvrt disc disorders"	"Other puerperal infections"	1	11	245	256
"I61"	"G56"	"Nontraumatic intracerebral hemorrhage"	"Mononeuropathies of upper limb"	1	72	545	617
"M35"	"K30"	"Other systemic involvement of connective tissue"	"Functional dyspepsia"	1	580	841	1421
"I60"	"I47"	"Nontraumatic subarachnoid hemorrhage"	"Paroxysmal tachycardia"	1	55	143	198
"I35"	"M17"	"Nonrheumatic aortic valve disorders"	"Osteoarthritis of knee"	1	0	5208	5208
"L97"	"N81"	"Non-pressure chronic ulcer of lower limb, NEC"	"Female genital prolapse"	1	36	500	536
"J90"	"C91"	"Pleural effusion, not elsewhere classified"	"Lymphoid leukemia"	1	70	185	255
"K65"	"J34"	"Peritonitis"	"Other and unspecified disorders of nose and nasal sinuses"	1	20	73	93
"J98"	"N95"	"Other respiratory disorders"	"Menopausal and other perimenopausal disorders"	1	82	175	257
"E87"	"B18"	"Other disorders of fluid, electrolyte and acid-base balance"	"Chronic viral hepatitis"	1	76	299	375
"C61"	"N31"	"Malignant neoplasm of prostate"	"Neuromuscular dysfunction of bladder, NEC"	1	98	248	346
"J44"	"M31"	"Other chronic obstructive pulmonary disease"	"Other necrotizing vasculopathies"	1	550	835	1385
"F43"	"E10"	"Reaction to severe stress, and adjustment disorders"	"Type 1 diabetes mellitus"	1	237	610	847
"A49"	"F10"	"Bacterial infection of unspecified site"	"Alcohol related disorders"	1	0	3088	3088
"K64"	"D25"	"Hemorrhoids and perianal venous thrombosis"	"Leiomyoma of uterus"	1	0	717	717
"I48"	"G56"	"Atrial fibrillation and flutter"	"Mononeuropathies of upper limb"	1	0	5868	5868
"K91"	"O47"	"Intraop and postproc comp and disorders of dgstv sys, NEC"	"False labor"	1	4	50	54
"D63"	"D64"	"Anemia in chronic diseases classified elsewhere"	"Other anemias"	1	4144	7715	11859
"N12"	"C20"	"Tubulo-interstitial nephritis, not spcf as acute or chronic"	"Malignant neoplasm of rectum"	1	15	61	76
"H66"	"Q39"	"Suppurative and unspecified otitis media"	"Congenital malformations of esophagus"	1	10	58	68
"J18"	"H33"	"Pneumonia, unspecified organism"	"Retinal detachments and breaks"	1	394	1603	1997
"C78"	"M46"	"Secondary malignant neoplasm of resp and digestive organs"	"Other inflammatory spondylopathies"	1	32	133	165
"H01"	"O62"	"Other inflammation of eyelid"	"Abnormalities of forces of labor"	1	6	148	154
"E27"	"M51"	"Other disorders of adrenal gland"	"Thoracic, thoracolum, and lumbosacral intvrt disc disorders"	1	51	289	340
"N50"	"L05"	"Other and unspecified disorders of male genital organs"	"Pilonidal cyst and sinus"	1	50	148	198
"Q18"	"J20"	"Other congenital malformations of face and neck"	"Acute bronchitis"	1	40	105	145
"I42"	"D27"	"Cardiomyopathy"	"Benign neoplasm of ovary"	1	15	85	100
"I63"	"M23"	"Cerebral infarction"	"Internal derangement of knee"	1	0	2970	2970
"J22"	"M47"	"Unspecified acute lower respiratory infection"	"Spondylosis"	1	11	259	270
"I35"	"O32"	"Nonrheumatic aortic valve disorders"	"Maternal care for malpresentation of fetus"	1	0	33	33
"D46"	"N35"	"Myelodysplastic syndromes"	"Urethral stricture"	1	0	37	37
"J44"	"K50"	"Other chronic obstructive pulmonary disease"	"Crohn's disease [regional enteritis]"	1	314	578	892
"F41"	"M06"	"Other anxiety disorders"	"Other rheumatoid arthritis"	1	68	257	325
"K90"	"N92"	"Intestinal malabsorption"	"Excessive, frequent and irregular menstruation"	1	88	243	331
"I26"	"L03"	"Pulmonary embolism"	"Cellulitis and acute lymphangitis"	1	69	301	370
"J18"	"G45"	"Pneumonia, unspecified organism"	"Transient cerebral ischemic attacks and related syndromes"	1	0	14707	14707
"I73"	"H90"	"Other peripheral vascular diseases"	"Conductive and sensorineural hearing loss"	1	311	902	1213
"B95"	"N31"	"Strep as the cause of diseases classified elsewhere"	"Neuromuscular dysfunction of bladder, NEC"	1	5	40	45
"E78"	"D16"	"Disorders of lipoprotein metabolism and other lipidemias"	"Benign neoplasm of bone and articular cartilage"	1	66	272	338
"M19"	"K40"	"Other and unspecified osteoarthritis"	"Inguinal hernia"	1	1231	2528	3759
"C25"	"H10"	"Malignant neoplasm of pancreas"	"Conjunctivitis"	1	0	112	112
"C06"	"M62"	"Malignant neoplasm of other and unspecified parts of mouth"	"Other disorders of muscle"	1	9	78	87
"K31"	"M79"	"Other diseases of stomach and duodenum"	"Oth and unsp soft tissue disorders, not elsewhere classified"	1	175	349	524
"M96"	"N92"	"Intraop and postproc comp and disorders of ms sys, NEC"	"Excessive, frequent and irregular menstruation"	1	34	219	253
"I48"	"D16"	"Atrial fibrillation and flutter"	"Benign neoplasm of bone and articular cartilage"	1	38	272	310
"N49"	"N44"	"Inflammatory disorders of male genital organs, NEC"	"Noninflammatory disorders of testis"	1	56	130	186
"N46"	"L05"	"Male infertility"	"Pilonidal cyst and sinus"	1	31	292	323
"E05"	"A63"	"Thyrotoxicosis [hyperthyroidism]"	"Oth predominantly sexually transmitted diseases, NEC"	1	32	202	234
"D72"	"O62"	"Other disorders of white blood cells"	"Abnormalities of forces of labor"	1	0	73	73
"E23"	"O68"	"Hypofunction and other disorders of the pituitary gland"	"Labor and delivery comp by abnlt of fetal acid-base balance"	1	8	74	82
"G47"	"M45"	"Sleep disorders"	"Ankylosing spondylitis"	1	26	104	130
"L57"	"K50"	"Skin changes due to chronic expsr to nonionizing radiation"	"Crohn's disease [regional enteritis]"	1	2	72	74
"C77"	"K30"	"Secondary and unspecified malignant neoplasm of lymph nodes"	"Functional dyspepsia"	1	73	611	684
"I10"	"F10"	"Essential (primary) hypertension"	"Alcohol related disorders"	1	8685	9555	18240
"C34"	"Q54"	"Malignant neoplasm of bronchus and lung"	"Hypospadias"	1	0	62	62
"H93"	"N92"	"Other disorders of ear, not elsewhere classified"	"Excessive, frequent and irregular menstruation"	1	201	1298	1499
"M48"	"M51"	"Other spondylopathies"	"Thoracic, thoracolum, and lumbosacral intvrt disc disorders"	1	15427	17497	32924
"B37"	"I49"	"Candidiasis"	"Other cardiac arrhythmias"	1	230	379	609
"L97"	"K51"	"Non-pressure chronic ulcer of lower limb, NEC"	"Ulcerative colitis"	1	44	207	251
"J06"	"O64"	"Acute upper resp infections of multiple and unsp sites"	"Obstructed labor due to malposition and malpresent of fetus"	1	0	101	101
"C22"	"N48"	"Malignant neoplasm of liver and intrahepatic bile ducts"	"Other disorders of penis"	1	0	31	31
"K59"	"C16"	"Other functional intestinal disorders"	"Malignant neoplasm of stomach"	1	624	1553	2177
"K59"	"N92"	"Other functional intestinal disorders"	"Excessive, frequent and irregular menstruation"	1	0	4964	4964
"N97"	"D06"	"Female infertility"	"Carcinoma in situ of cervix uteri"	1	156	345	501
"K05"	"N40"	"Gingivitis and periodontal diseases"	"Benign prostatic hyperplasia"	1	259	494	753
"J15"	"D30"	"Bacterial pneumonia, not elsewhere classified"	"Benign neoplasm of urinary organs"	1	68	1045	1113
"F32"	"M71"	"Depressive episode"	"Other bursopathies"	1	67	237	304
"N28"	"J35"	"Oth disorders of kidney and ureter, not elsewhere classified"	"Chronic diseases of tonsils and adenoids"	1	0	44	44
"G47"	"M25"	"Sleep disorders"	"Other joint disorder, not elsewhere classified"	1	434	1324	1758
"C45"	"M54"	"Mesothelioma"	"Dorsalgia"	1	17	96	113
"M75"	"K51"	"Shoulder lesions"	"Ulcerative colitis"	1	395	902	1297
"H91"	"C09"	"Other and unspecified hearing loss"	"Malignant neoplasm of tonsil"	1	164	305	469
"N46"	"M41"	"Male infertility"	"Scoliosis"	1	0	45	45
"C78"	"H47"	"Secondary malignant neoplasm of resp and digestive organs"	"Other disorders of optic [2nd] nerve and visual pathways"	1	20	85	105
"I63"	"N60"	"Cerebral infarction"	"Benign mammary dysplasia"	1	2	439	441
"M81"	"G35"	"Osteoporosis without current pathological fracture"	"Multiple sclerosis"	1	0	388	388
"K83"	"K80"	"Other diseases of biliary tract"	"Cholelithiasis"	1	4728	6960	11688
"N64"	"O02"	"Other disorders of breast"	"Other abnormal products of conception"	1	302	795	1097
"D62"	"O48"	"Acute posthemorrhagic anemia"	"Late pregnancy"	1	0	68	68
"L89"	"K92"	"Pressure ulcer"	"Other diseases of digestive system"	1	605	887	1492
"G44"	"O99"	"Other headache syndromes"	"Oth maternal diseases classd elsw but compl preg/chldbrth"	1	699	1075	1774
"N48"	"J35"	"Other disorders of penis"	"Chronic diseases of tonsils and adenoids"	1	92	189	281
"K25"	"O65"	"Gastric ulcer"	"Obstructed labor due to maternal pelvic abnormality"	1	0	45	45
"F41"	"D25"	"Other anxiety disorders"	"Leiomyoma of uterus"	1	56	458	514
"I35"	"O70"	"Nonrheumatic aortic valve disorders"	"Perineal laceration during delivery"	1	0	121	121
"H02"	"N97"	"Other disorders of eyelid"	"Female infertility"	1	0	228	228
"D35"	"M79"	"Benign neoplasm of other and unspecified endocrine glands"	"Oth and unsp soft tissue disorders, not elsewhere classified"	1	145	425	570
"O91"	"O65"	"Infect of breast assoc w pregnancy, the puerp and lactation"	"Obstructed labor due to maternal pelvic abnormality"	1	119	754	873
"G55"	"M54"	"Nerve root and plexus compressions in diseases classd elswhr"	"Dorsalgia"	1	558	799	1357
"D53"	"E11"	"Other nutritional anemias"	"Type 2 diabetes mellitus"	1	82	207	289
"C80"	"H35"	"Malignant neoplasm without specification of site"	"Other retinal disorders"	1	28	230	258
"J91"	"C61"	"Pleural effusion in conditions classified elsewhere"	"Malignant neoplasm of prostate"	1	78	256	334
"C24"	"F10"	"Malignant neoplasm of other and unsp parts of biliary tract"	"Alcohol related disorders"	1	9	114	123
"K65"	"O62"	"Peritonitis"	"Abnormalities of forces of labor"	1	28	269	297
"G47"	"B02"	"Sleep disorders"	"Zoster [herpes zoster]"	1	54	161	215
"J10"	"N18"	"Influenza due to other identified influenza virus"	"Chronic kidney disease (CKD)"	1	65	198	263
"D61"	"O62"	"Oth aplastic anemias and other bone marrow failure syndromes"	"Abnormalities of forces of labor"	1	1	27	28
"J13"	"M06"	"Pneumonia due to Streptococcus pneumoniae"	"Other rheumatoid arthritis"	1	74	150	224
"J15"	"O63"	"Bacterial pneumonia, not elsewhere classified"	"Long labor"	1	3	117	120
"I82"	"O36"	"Other venous embolism and thrombosis"	"Maternal care for other fetal problems"	1	12	70	82
"K20"	"O04"	"Esophagitis"	"Complications following (induced) termination of pregnancy"	1	11	235	246
"M51"	"O62"	"Thoracic, thoracolum, and lumbosacral intvrt disc disorders"	"Abnormalities of forces of labor"	1	0	3194	3194
"I35"	"I65"	"Nonrheumatic aortic valve disorders"	"Occls and stenosis of precerb art, not rslt in cereb infrc"	1	247	644	891
"N48"	"N20"	"Other disorders of penis"	"Calculus of kidney and ureter"	1	191	339	530
"M72"	"J45"	"Fibroblastic disorders"	"Asthma"	1	422	689	1111
"F03"	"D24"	"Unspecified dementia"	"Benign neoplasm of breast"	1	0	154	154
"E78"	"L20"	"Disorders of lipoprotein metabolism and other lipidemias"	"Atopic dermatitis"	1	41	168	209
"G45"	"O47"	"Transient cerebral ischemic attacks and related syndromes"	"False labor"	1	0	86	86
"N39"	"I20"	"Other disorders of urinary system"	"Angina pectoris"	1	0	12308	12308
"H43"	"O47"	"Disorders of vitreous body"	"False labor"	1	0	29	29
"M17"	"N60"	"Osteoarthritis of knee"	"Benign mammary dysplasia"	1	167	1249	1416
"G95"	"H10"	"Other and unspecified diseases of spinal cord"	"Conjunctivitis"	1	0	113	113
"O20"	"Q17"	"Hemorrhage in early pregnancy"	"Other congenital malformations of ear"	1	0	78	78
"K75"	"M51"	"Other inflammatory liver diseases"	"Thoracic, thoracolum, and lumbosacral intvrt disc disorders"	1	40	121	161
"C67"	"K29"	"Malignant neoplasm of bladder"	"Gastritis and duodenitis"	1	193	317	510
"F43"	"H50"	"Reaction to severe stress, and adjustment disorders"	"Other strabismus"	1	48	131	179
"A46"	"M76"	"Erysipelas"	"Enthesopathies, lower limb, excluding foot"	1	173	380	553
"C18"	"C32"	"Malignant neoplasm of colon"	"Malignant neoplasm of larynx"	1	21	77	98
"G62"	"E78"	"Other and unspecified polyneuropathies"	"Disorders of lipoprotein metabolism and other lipidemias"	1	1268	1835	3103
"J81"	"F32"	"Pulmonary edema"	"Depressive episode"	1	342	754	1096
"L20"	"J00"	"Atopic dermatitis"	"Acute nasopharyngitis [common cold]"	1	337	787	1124
"M43"	"O04"	"Other deforming dorsopathies"	"Complications following (induced) termination of pregnancy"	1	22	311	333
"D64"	"H91"	"Other anemias"	"Other and unspecified hearing loss"	1	0	15575	15575
"O00"	"O04"	"Ectopic pregnancy"	"Complications following (induced) termination of pregnancy"	1	804	1817	2621
"N50"	"N44"	"Other and unspecified disorders of male genital organs"	"Noninflammatory disorders of testis"	1	601	934	1535
"C78"	"I78"	"Secondary malignant neoplasm of resp and digestive organs"	"Diseases of capillaries"	1	11	164	175
"I11"	"N87"	"Hypertensive heart disease"	"Dysplasia of cervix uteri"	1	0	30	30
"K62"	"M79"	"Other diseases of anus and rectum"	"Oth and unsp soft tissue disorders, not elsewhere classified"	1	2227	2994	5221
"E83"	"H43"	"Disorders of mineral metabolism"	"Disorders of vitreous body"	1	22	114	136
"E86"	"M43"	"Volume depletion"	"Other deforming dorsopathies"	1	71	962	1033
"E86"	"M75"	"Volume depletion"	"Shoulder lesions"	1	0	3413	3413
"I49"	"N80"	"Other cardiac arrhythmias"	"Endometriosis"	1	28	141	169
"O87"	"O03"	"Venous complications and hemorrhoids in the puerperium"	"Spontaneous abortion"	1	170	394	564
"N18"	"M70"	"Chronic kidney disease (CKD)"	"Soft tissue disorders related to use, overuse and pressure"	1	186	935	1121
"F33"	"N43"	"Major depressive disorder, recurrent"	"Hydrocele and spermatocele"	1	18	117	135
"J13"	"N40"	"Pneumonia due to Streptococcus pneumoniae"	"Benign prostatic hyperplasia"	1	113	338	451
"E87"	"N80"	"Other disorders of fluid, electrolyte and acid-base balance"	"Endometriosis"	1	0	135	135
"F17"	"H52"	"Nicotine dependence"	"Disorders of refraction and accommodation"	1	110	331	441
"M81"	"N91"	"Osteoporosis without current pathological fracture"	"Absent, scanty and rare menstruation"	1	17	115	132
"L29"	"H91"	"Pruritus"	"Other and unspecified hearing loss"	1	126	381	507
"G80"	"J20"	"Cerebral palsy"	"Acute bronchitis"	1	172	332	504
"E65"	"O99"	"Localized adiposity"	"Oth maternal diseases classd elsw but compl preg/chldbrth"	1	230	1205	1435
"D40"	"C61"	"Neoplasm of uncertain behavior of male genital organs"	"Malignant neoplasm of prostate"	1	208	377	585
"J90"	"D33"	"Pleural effusion, not elsewhere classified"	"Benign neoplasm of brain and oth prt central nervous system"	1	1	46	47
"H35"	"K51"	"Other retinal disorders"	"Ulcerative colitis"	1	152	459	611
"K21"	"L05"	"Gastro-esophageal reflux disease"	"Pilonidal cyst and sinus"	1	101	302	403
"M20"	"M62"	"Acquired deformities of fingers and toes"	"Other disorders of muscle"	1	652	1470	2122
"I51"	"K04"	"Complications and ill-defined descriptions of heart disease"	"Diseases of pulp and periapical tissues"	1	97	243	340
"I80"	"H83"	"Phlebitis and thrombophlebitis"	"Other diseases of inner ear"	1	130	766	896
"M67"	"J35"	"Other disorders of synovium and tendon"	"Chronic diseases of tonsils and adenoids"	1	123	1388	1511
"C25"	"M31"	"Malignant neoplasm of pancreas"	"Other necrotizing vasculopathies"	1	7	82	89
"K59"	"O08"	"Other functional intestinal disorders"	"Complications following ectopic and molar pregnancy"	1	234	400	634
"H26"	"D30"	"Other cataract"	"Benign neoplasm of urinary organs"	1	210	431	641
"N18"	"M25"	"Chronic kidney disease (CKD)"	"Other joint disorder, not elsewhere classified"	1	315	670	985
"C77"	"M47"	"Secondary and unspecified malignant neoplasm of lymph nodes"	"Spondylosis"	1	68	396	464
"J06"	"N60"	"Acute upper resp infections of multiple and unsp sites"	"Benign mammary dysplasia"	1	0	86	86
"K25"	"D30"	"Gastric ulcer"	"Benign neoplasm of urinary organs"	1	235	472	707
"J47"	"J20"	"Bronchiectasis"	"Acute bronchitis"	1	247	445	692
"L72"	"M62"	"Follicular cysts of skin and subcutaneous tissue"	"Other disorders of muscle"	1	99	268	367
"N28"	"N30"	"Oth disorders of kidney and ureter, not elsewhere classified"	"Cystitis"	1	1166	1583	2749
"A41"	"G31"	"Other sepsis"	"Oth degenerative diseases of nervous system, NEC"	1	442	667	1109
"E87"	"N20"	"Other disorders of fluid, electrolyte and acid-base balance"	"Calculus of kidney and ureter"	1	231	1202	1433
"M13"	"L02"	"Other arthritis"	"Cutaneous abscess, furuncle and carbuncle"	1	398	703	1101
"E86"	"M93"	"Volume depletion"	"Other osteochondropathies"	1	0	49	49
"I80"	"D16"	"Phlebitis and thrombophlebitis"	"Benign neoplasm of bone and articular cartilage"	1	41	111	152
"E24"	"O80"	"Cushing's syndrome"	"Encounter for full-term uncomplicated delivery"	1	0	33	33
"O47"	"K35"	"False labor"	"Acute appendicitis"	1	223	782	1005
"K42"	"N97"	"Umbilical hernia"	"Female infertility"	1	0	357	357
"M75"	"N97"	"Shoulder lesions"	"Female infertility"	1	0	1225	1225
"N20"	"O00"	"Calculus of kidney and ureter"	"Ectopic pregnancy"	1	48	179	227
"M25"	"Q18"	"Other joint disorder, not elsewhere classified"	"Other congenital malformations of face and neck"	1	30	96	126
"K80"	"N70"	"Cholelithiasis"	"Salpingitis and oophoritis"	1	80	811	891
"H57"	"B27"	"Other disorders of eye and adnexa"	"Infectious mononucleosis"	1	4	67	71
"K80"	"H80"	"Cholelithiasis"	"Otosclerosis"	1	108	334	442
"K92"	"H65"	"Other diseases of digestive system"	"Nonsuppurative otitis media"	1	45	341	386
"O91"	"O73"	"Infect of breast assoc w pregnancy, the puerp and lactation"	"Retained placenta and membranes, without hemorrhage"	1	128	270	398
"K72"	"B18"	"Hepatic failure, not elsewhere classified"	"Chronic viral hepatitis"	1	198	631	829
"I48"	"K05"	"Atrial fibrillation and flutter"	"Gingivitis and periodontal diseases"	1	1156	1535	2691
"C71"	"K40"	"Malignant neoplasm of brain"	"Inguinal hernia"	1	0	333	333
"G61"	"O80"	"Inflammatory polyneuropathy"	"Encounter for full-term uncomplicated delivery"	1	20	98	118
"M45"	"H20"	"Ankylosing spondylitis"	"Iridocyclitis"	1	183	345	528
"G93"	"K86"	"Other disorders of brain"	"Other diseases of pancreas"	1	25	85	110
"K52"	"K29"	"Other and unsp noninfective gastroenteritis and colitis"	"Gastritis and duodenitis"	1	1477	2806	4283
"I82"	"M67"	"Other venous embolism and thrombosis"	"Other disorders of synovium and tendon"	1	50	147	197
"O26"	"Q52"	"Maternal care for oth conditions predom related to pregnancy"	"Other congenital malformations of female genitalia"	1	1	28	29
"I63"	"H36"	"Cerebral infarction"	"Retinal disorders in diseases classified elsewhere"	1	758	1258	2016
"K80"	"O32"	"Cholelithiasis"	"Maternal care for malpresentation of fetus"	1	234	1246	1480
"K21"	"G43"	"Gastro-esophageal reflux disease"	"Migraine"	1	573	770	1343
"L82"	"H25"	"Seborrheic keratosis"	"Age-related cataract"	1	411	583	994
"G24"	"J35"	"Dystonia"	"Chronic diseases of tonsils and adenoids"	1	7	108	115
"C16"	"M06"	"Malignant neoplasm of stomach"	"Other rheumatoid arthritis"	1	17	101	118
"I71"	"M19"	"Aortic aneurysm and dissection"	"Other and unspecified osteoarthritis"	1	232	739	971
"O60"	"O02"	"Preterm labor"	"Other abnormal products of conception"	1	471	846	1317
"A04"	"Q61"	"Other bacterial intestinal infections"	"Cystic kidney disease"	1	26	108	134
"E15"	"E16"	"Nondiabetic hypoglycemic coma"	"Other disorders of pancreatic internal secretion"	1	739	1306	2045
"C50"	"H80"	"Malignant neoplasm of breast"	"Otosclerosis"	1	40	218	258
"O68"	"K35"	"Labor and delivery comp by abnlt of fetal acid-base balance"	"Acute appendicitis"	1	533	1459	1992
"C88"	"M23"	"Malig immunoproliferative dis and certain oth B-cell lymph"	"Internal derangement of knee"	1	5	66	71
"L88"	"I10"	"Pyoderma gangrenosum"	"Essential (primary) hypertension"	1	74	199	273
"D12"	"K30"	"Benign neoplasm of colon, rectum, anus and anal canal"	"Functional dyspepsia"	1	0	4406	4406
"G95"	"M70"	"Other and unspecified diseases of spinal cord"	"Soft tissue disorders related to use, overuse and pressure"	1	36	198	234
"L97"	"M24"	"Non-pressure chronic ulcer of lower limb, NEC"	"Other specific joint derangements"	1	40	136	176
"M48"	"M72"	"Other spondylopathies"	"Fibroblastic disorders"	1	287	775	1062
"M72"	"J34"	"Fibroblastic disorders"	"Other and unspecified disorders of nose and nasal sinuses"	1	69	306	375
"H35"	"N84"	"Other retinal disorders"	"Polyp of female genital tract"	1	175	524	699
"M80"	"N43"	"Osteoporosis with current pathological fracture"	"Hydrocele and spermatocele"	1	0	129	129
"K41"	"K40"	"Femoral hernia"	"Inguinal hernia"	1	1682	2938	4620
"C56"	"D27"	"Malignant neoplasm of ovary"	"Benign neoplasm of ovary"	1	448	962	1410
"C80"	"D17"	"Malignant neoplasm without specification of site"	"Benign lipomatous neoplasm"	1	1	114	115
"E83"	"N47"	"Disorders of mineral metabolism"	"Disorders of prepuce"	1	26	81	107
"H91"	"O71"	"Other and unspecified hearing loss"	"Other obstetric trauma"	1	5	145	150
"G47"	"O64"	"Sleep disorders"	"Obstructed labor due to malposition and malpresent of fetus"	1	0	86	86
"C20"	"N87"	"Malignant neoplasm of rectum"	"Dysplasia of cervix uteri"	1	0	42	42
"M79"	"O32"	"Oth and unsp soft tissue disorders, not elsewhere classified"	"Maternal care for malpresentation of fetus"	1	242	643	885
"O99"	"J34"	"Oth maternal diseases classd elsw but compl preg/chldbrth"	"Other and unspecified disorders of nose and nasal sinuses"	1	333	570	903
"J09"	"C61"	"Influenza due to certain identified influenza viruses"	"Malignant neoplasm of prostate"	1	4	62	66
"K81"	"O00"	"Cholecystitis"	"Ectopic pregnancy"	1	2	46	48
"I21"	"D16"	"Acute myocardial infarction"	"Benign neoplasm of bone and articular cartilage"	1	47	116	163
"J90"	"K51"	"Pleural effusion, not elsewhere classified"	"Ulcerative colitis"	1	32	177	209
"C15"	"A46"	"Malignant neoplasm of esophagus"	"Erysipelas"	1	25	180	205
"I51"	"H93"	"Complications and ill-defined descriptions of heart disease"	"Other disorders of ear, not elsewhere classified"	1	38	229	267
"C06"	"M70"	"Malignant neoplasm of other and unspecified parts of mouth"	"Soft tissue disorders related to use, overuse and pressure"	1	5	44	49
"C25"	"N99"	"Malignant neoplasm of pancreas"	"Intraop and postproc comp and disorders of GU sys, NEC"	1	1	54	55
"J98"	"J44"	"Other respiratory disorders"	"Other chronic obstructive pulmonary disease"	1	2893	3404	6297
"E51"	"M23"	"Thiamine deficiency"	"Internal derangement of knee"	1	3	37	40
"M16"	"M62"	"Osteoarthritis of hip"	"Other disorders of muscle"	1	1246	3019	4265
"I80"	"N81"	"Phlebitis and thrombophlebitis"	"Female genital prolapse"	1	422	1035	1457
"L58"	"C50"	"Radiodermatitis"	"Malignant neoplasm of breast"	1	14	175	189
"N30"	"D12"	"Cystitis"	"Benign neoplasm of colon, rectum, anus and anal canal"	1	3055	4448	7503
"J96"	"F99"	"Respiratory failure, not elsewhere classified"	"Mental disorder, not otherwise specified"	1	33	317	350
"Q74"	"J20"	"Other congenital malformations of limb(s)"	"Acute bronchitis"	1	40	133	173
"K91"	"J34"	"Intraop and postproc comp and disorders of dgstv sys, NEC"	"Other and unspecified disorders of nose and nasal sinuses"	1	6	56	62
"C61"	"F10"	"Malignant neoplasm of prostate"	"Alcohol related disorders"	1	155	825	980
"C93"	"E66"	"Monocytic leukemia"	"Overweight and obesity"	1	1	32	33
"D63"	"C16"	"Anemia in chronic diseases classified elsewhere"	"Malignant neoplasm of stomach"	1	392	1212	1604
"C92"	"M47"	"Myeloid leukemia"	"Spondylosis"	1	10	81	91
"M81"	"D25"	"Osteoporosis without current pathological fracture"	"Leiomyoma of uterus"	1	0	1120	1120
"A26"	"L08"	"Erysipeloid"	"Other local infections of skin and subcutaneous tissue"	1	64	153	217
"I69"	"N50"	"Sequelae of cerebrovascular disease"	"Other and unspecified disorders of male genital organs"	1	122	240	362
"B37"	"I20"	"Candidiasis"	"Angina pectoris"	1	219	1516	1735
"J81"	"D30"	"Pulmonary edema"	"Benign neoplasm of urinary organs"	1	25	298	323
"I27"	"O62"	"Other pulmonary heart diseases"	"Abnormalities of forces of labor"	1	0	30	30
"L57"	"D25"	"Skin changes due to chronic expsr to nonionizing radiation"	"Leiomyoma of uterus"	1	13	236	249
"K42"	"N94"	"Umbilical hernia"	"Pain and oth cond assoc w fem gntl org and menstrual cycle"	1	58	191	249
"N60"	"J35"	"Benign mammary dysplasia"	"Chronic diseases of tonsils and adenoids"	1	52	316	368
"J81"	"J44"	"Pulmonary edema"	"Other chronic obstructive pulmonary disease"	1	2341	3359	5700
"D63"	"K80"	"Anemia in chronic diseases classified elsewhere"	"Cholelithiasis"	1	123	1083	1206
"O68"	"M41"	"Labor and delivery comp by abnlt of fetal acid-base balance"	"Scoliosis"	1	0	213	213
"I26"	"K35"	"Pulmonary embolism"	"Acute appendicitis"	1	100	462	562
"J94"	"N92"	"Other pleural conditions"	"Excessive, frequent and irregular menstruation"	1	0	71	71
"I46"	"G71"	"Cardiac arrest"	"Primary disorders of muscles"	1	0	49	49
"C43"	"K58"	"Malignant melanoma of skin"	"Irritable bowel syndrome"	1	64	172	236
"D23"	"C50"	"Other benign neoplasms of skin"	"Malignant neoplasm of breast"	1	416	647	1063
"J45"	"Q68"	"Asthma"	"Other congenital musculoskeletal deformities"	1	97	212	309
"K81"	"M65"	"Cholecystitis"	"Synovitis and tenosynovitis"	1	140	296	436
"G47"	"H71"	"Sleep disorders"	"Cholesteatoma of middle ear"	1	21	133	154
"C77"	"K86"	"Secondary and unspecified malignant neoplasm of lymph nodes"	"Other diseases of pancreas"	1	24	151	175
"K56"	"H40"	"Paralytic ileus and intestinal obstruction without hernia"	"Glaucoma"	1	191	522	713
"I51"	"M19"	"Complications and ill-defined descriptions of heart disease"	"Other and unspecified osteoarthritis"	1	247	433	680
"K05"	"O99"	"Gingivitis and periodontal diseases"	"Oth maternal diseases classd elsw but compl preg/chldbrth"	1	62	135	197
"O24"	"K35"	"Diabetes in pregnancy, childbirth, and the puerperium"	"Acute appendicitis"	1	40	280	320
"F05"	"G96"	"Delirium due to known physiological condition"	"Other disorders of central nervous system"	1	221	565	786
"O90"	"H50"	"Complications of the puerperium, not elsewhere classified"	"Other strabismus"	1	2	35	37
"C91"	"M62"	"Lymphoid leukemia"	"Other disorders of muscle"	1	30	145	175
"I51"	"E10"	"Complications and ill-defined descriptions of heart disease"	"Type 1 diabetes mellitus"	1	299	713	1012
"H46"	"O62"	"Optic neuritis"	"Abnormalities of forces of labor"	1	18	147	165
"M67"	"F10"	"Other disorders of synovium and tendon"	"Alcohol related disorders"	1	616	1046	1662
"K02"	"J35"	"Dental caries"	"Chronic diseases of tonsils and adenoids"	1	248	469	717
"O72"	"F14"	"Postpartum hemorrhage"	"Cocaine related disorders"	1	14	63	77
"L02"	"O14"	"Cutaneous abscess, furuncle and carbuncle"	"Pre-eclampsia"	1	119	259	378
"J69"	"M81"	"Pneumonitis due to solids and liquids"	"Osteoporosis without current pathological fracture"	1	226	819	1045
"G91"	"M79"	"Hydrocephalus"	"Oth and unsp soft tissue disorders, not elsewhere classified"	1	140	241	381
"N20"	"J05"	"Calculus of kidney and ureter"	"Acute obstructive laryngitis [croup] and epiglottitis"	1	0	49	49
"D63"	"H26"	"Anemia in chronic diseases classified elsewhere"	"Other cataract"	1	141	835	976
"K51"	"J05"	"Ulcerative colitis"	"Acute obstructive laryngitis [croup] and epiglottitis"	1	0	31	31
"C77"	"N80"	"Secondary and unspecified malignant neoplasm of lymph nodes"	"Endometriosis"	1	0	63	63
"G47"	"M77"	"Sleep disorders"	"Other enthesopathies"	1	223	1027	1250
"A41"	"H35"	"Other sepsis"	"Other retinal disorders"	1	0	5822	5822
"E66"	"Q67"	"Overweight and obesity"	"Congenital ms deformities of head, face, spine and chest"	1	8	85	93
"I69"	"J30"	"Sequelae of cerebrovascular disease"	"Vasomotor and allergic rhinitis"	1	9	214	223
"C53"	"O42"	"Malignant neoplasm of cervix uteri"	"Premature rupture of membranes"	1	15	81	96
"M46"	"O32"	"Other inflammatory spondylopathies"	"Maternal care for malpresentation of fetus"	1	2	55	57
"N94"	"H10"	"Pain and oth cond assoc w fem gntl org and menstrual cycle"	"Conjunctivitis"	1	166	341	507
"J44"	"H26"	"Other chronic obstructive pulmonary disease"	"Other cataract"	1	2949	3745	6694
"I80"	"N97"	"Phlebitis and thrombophlebitis"	"Female infertility"	1	65	379	444
"M81"	"O02"	"Osteoporosis without current pathological fracture"	"Other abnormal products of conception"	1	0	88	88
"I65"	"M23"	"Occls and stenosis of precerb art, not rslt in cereb infrc"	"Internal derangement of knee"	1	89	237	326
"N39"	"I30"	"Other disorders of urinary system"	"Acute pericarditis"	1	111	234	345
"D11"	"O68"	"Benign neoplasm of major salivary glands"	"Labor and delivery comp by abnlt of fetal acid-base balance"	1	11	95	106
"H43"	"M24"	"Disorders of vitreous body"	"Other specific joint derangements"	1	46	112	158
"E65"	"E28"	"Localized adiposity"	"Ovarian dysfunction"	1	49	139	188
"J43"	"N20"	"Emphysema"	"Calculus of kidney and ureter"	1	62	146	208
"I21"	"N46"	"Acute myocardial infarction"	"Male infertility"	1	0	123	123
"A46"	"O00"	"Erysipelas"	"Ectopic pregnancy"	1	0	45	45
"E34"	"C18"	"Other endocrine disorders"	"Malignant neoplasm of colon"	1	141	403	544
"D63"	"N81"	"Anemia in chronic diseases classified elsewhere"	"Female genital prolapse"	1	3	419	422
"N93"	"O82"	"Other abnormal uterine and vaginal bleeding"	"Encounter for cesarean delivery without indication"	1	410	1571	1981
"H53"	"G40"	"Visual disturbances"	"Epilepsy and recurrent seizures"	1	601	1029	1630
"K83"	"H80"	"Other diseases of biliary tract"	"Otosclerosis"	1	1	44	45
"O14"	"M41"	"Pre-eclampsia"	"Scoliosis"	1	0	38	38
"A41"	"N94"	"Other sepsis"	"Pain and oth cond assoc w fem gntl org and menstrual cycle"	1	13	278	291
"M19"	"B91"	"Other and unspecified osteoarthritis"	"Sequelae of poliomyelitis"	1	38	99	137
"M81"	"O32"	"Osteoporosis without current pathological fracture"	"Maternal care for malpresentation of fetus"	1	0	47	47
"I73"	"M23"	"Other peripheral vascular diseases"	"Internal derangement of knee"	1	312	1538	1850
"I10"	"O47"	"Essential (primary) hypertension"	"False labor"	1	0	503	503
"C95"	"C91"	"Leukemia of unspecified cell type"	"Lymphoid leukemia"	1	482	743	1225
"O00"	"M22"	"Ectopic pregnancy"	"Disorder of patella"	1	66	229	295
"M23"	"M62"	"Internal derangement of knee"	"Other disorders of muscle"	1	2701	4525	7226
"L97"	"J01"	"Non-pressure chronic ulcer of lower limb, NEC"	"Acute sinusitis"	1	9	60	69
"D64"	"L23"	"Other anemias"	"Allergic contact dermatitis"	1	25	259	284
"K92"	"F10"	"Other diseases of digestive system"	"Alcohol related disorders"	1	0	11046	11046
"H91"	"D24"	"Other and unspecified hearing loss"	"Benign neoplasm of breast"	1	150	939	1089
"N13"	"M77"	"Obstructive and reflux uropathy"	"Other enthesopathies"	1	78	179	257
"H34"	"F10"	"Retinal vascular occlusions"	"Alcohol related disorders"	1	87	203	290
"H26"	"D25"	"Other cataract"	"Leiomyoma of uterus"	1	15	589	604
"I80"	"M17"	"Phlebitis and thrombophlebitis"	"Osteoarthritis of knee"	1	2639	3849	6488
"C83"	"M23"	"Non-follicular lymphoma"	"Internal derangement of knee"	1	24	302	326
"D68"	"O41"	"Other coagulation defects"	"Other disorders of amniotic fluid and membranes"	1	55	126	181
"I46"	"N47"	"Cardiac arrest"	"Disorders of prepuce"	1	5	285	290
"F17"	"J41"	"Nicotine dependence"	"Simple and mucopurulent chronic bronchitis"	1	48	120	168
"J10"	"J44"	"Influenza due to other identified influenza virus"	"Other chronic obstructive pulmonary disease"	1	176	572	748
"C18"	"D50"	"Malignant neoplasm of colon"	"Iron deficiency anemia"	1	1726	3191	4917
"E89"	"K40"	"Postproc endocrine and metabolic comp and disorders, NEC"	"Inguinal hernia"	1	23	147	170
"K57"	"H16"	"Diverticular disease of intestine"	"Keratitis"	1	132	276	408
"N28"	"D24"	"Oth disorders of kidney and ureter, not elsewhere classified"	"Benign neoplasm of breast"	1	5	47	52
"D64"	"M75"	"Other anemias"	"Shoulder lesions"	1	0	4121	4121
"K74"	"M77"	"Fibrosis and cirrhosis of liver"	"Other enthesopathies"	1	12	93	105
"M11"	"E11"	"Other crystal arthropathies"	"Type 2 diabetes mellitus"	1	122	223	345
"A49"	"L08"	"Bacterial infection of unspecified site"	"Other local infections of skin and subcutaneous tissue"	1	971	1439	2410
"I80"	"N46"	"Phlebitis and thrombophlebitis"	"Male infertility"	1	32	109	141
"F41"	"N83"	"Other anxiety disorders"	"Noninflammatory disord of ovary, fallop and broad ligament"	1	146	561	707
"E88"	"O48"	"Other and unspecified metabolic disorders"	"Late pregnancy"	1	0	28	28
"D43"	"O62"	"Neoplasm of uncertain behavior of brain and cnsl"	"Abnormalities of forces of labor"	1	0	60	60
"J95"	"K02"	"Intraop and postproc comp and disorders of resp sys, NEC"	"Dental caries"	1	64	220	284
"F33"	"K62"	"Major depressive disorder, recurrent"	"Other diseases of anus and rectum"	1	502	855	1357
"M53"	"M23"	"Other and unspecified dorsopathies, not elsewhere classified"	"Internal derangement of knee"	1	886	1553	2439
"C17"	"I83"	"Malignant neoplasm of small intestine"	"Varicose veins of lower extremities"	1	0	40	40
"J04"	"O04"	"Acute laryngitis and tracheitis"	"Complications following (induced) termination of pregnancy"	1	43	140	183
"E41"	"K08"	"Nutritional marasmus"	"Other disorders of teeth and supporting structures"	1	15	76	91
"E68"	"O64"	"Sequelae of hyperalimentation"	"Obstructed labor due to malposition and malpresent of fetus"	1	0	145	145
"C77"	"M22"	"Secondary and unspecified malignant neoplasm of lymph nodes"	"Disorder of patella"	1	0	96	96
"M75"	"E30"	"Shoulder lesions"	"Disorders of puberty, not elsewhere classified"	1	0	30	30
"F41"	"G51"	"Other anxiety disorders"	"Facial nerve disorders"	1	40	125	165
"Q40"	"O62"	"Other congenital malformations of upper alimentary tract"	"Abnormalities of forces of labor"	1	0	62	62
"H53"	"O02"	"Visual disturbances"	"Other abnormal products of conception"	1	33	180	213
"N39"	"L02"	"Other disorders of urinary system"	"Cutaneous abscess, furuncle and carbuncle"	1	1050	2875	3925
"G93"	"O42"	"Other disorders of brain"	"Premature rupture of membranes"	1	3	41	44
"I48"	"M20"	"Atrial fibrillation and flutter"	"Acquired deformities of fingers and toes"	1	0	3144	3144
"G98"	"N83"	"Other disorders of nervous system not elsewhere classified"	"Noninflammatory disord of ovary, fallop and broad ligament"	1	0	169	169
"I61"	"L50"	"Nontraumatic intracerebral hemorrhage"	"Urticaria"	1	23	84	107
"D13"	"M20"	"Benign neoplasm of and ill-defined parts of digestive system"	"Acquired deformities of fingers and toes"	1	58	136	194
"I63"	"H93"	"Cerebral infarction"	"Other disorders of ear, not elsewhere classified"	1	338	1969	2307
"N50"	"M51"	"Other and unspecified disorders of male genital organs"	"Thoracic, thoracolum, and lumbosacral intvrt disc disorders"	1	376	623	999
"A49"	"L04"	"Bacterial infection of unspecified site"	"Acute lymphadenitis"	1	81	172	253
"C77"	"L50"	"Secondary and unspecified malignant neoplasm of lymph nodes"	"Urticaria"	1	25	85	110
"I82"	"L05"	"Other venous embolism and thrombosis"	"Pilonidal cyst and sinus"	1	2	36	38
"N99"	"C67"	"Intraop and postproc comp and disorders of GU sys, NEC"	"Malignant neoplasm of bladder"	1	209	480	689
"C78"	"I30"	"Secondary malignant neoplasm of resp and digestive organs"	"Acute pericarditis"	1	50	157	207
"D50"	"M51"	"Iron deficiency anemia"	"Thoracic, thoracolum, and lumbosacral intvrt disc disorders"	1	206	1514	1720
"I50"	"E04"	"Heart failure"	"Other nontoxic goiter"	1	613	1475	2088
"I21"	"E04"	"Acute myocardial infarction"	"Other nontoxic goiter"	1	460	766	1226
"K04"	"E10"	"Diseases of pulp and periapical tissues"	"Type 1 diabetes mellitus"	1	271	543	814
"I50"	"E66"	"Heart failure"	"Overweight and obesity"	1	5576	6458	12034
"I52"	"I10"	"Other heart disorders in diseases classified elsewhere"	"Essential (primary) hypertension"	1	28	113	141
"M46"	"I83"	"Other inflammatory spondylopathies"	"Varicose veins of lower extremities"	1	81	203	284
"C79"	"M16"	"Secondary malignant neoplasm of other and unspecified sites"	"Osteoarthritis of hip"	1	0	1862	1862
"O23"	"K35"	"Infections of genitourinary tract in pregnancy"	"Acute appendicitis"	1	162	559	721
"G47"	"D23"	"Sleep disorders"	"Other benign neoplasms of skin"	1	192	824	1016
"O80"	"L20"	"Encounter for full-term uncomplicated delivery"	"Atopic dermatitis"	1	362	1082	1444
"C79"	"C50"	"Secondary malignant neoplasm of other and unspecified sites"	"Malignant neoplasm of breast"	1	0	10230	10230
"G91"	"I21"	"Hydrocephalus"	"Acute myocardial infarction"	1	101	213	314
"G72"	"J35"	"Other and unspecified myopathies"	"Chronic diseases of tonsils and adenoids"	1	4	41	45
"B44"	"K80"	"Aspergillosis"	"Cholelithiasis"	1	5	45	50
"I46"	"M19"	"Cardiac arrest"	"Other and unspecified osteoarthritis"	1	34	717	751
"J22"	"M31"	"Unspecified acute lower respiratory infection"	"Other necrotizing vasculopathies"	1	39	139	178
"N18"	"N85"	"Chronic kidney disease (CKD)"	"Other noninflammatory disorders of uterus, except cervix"	1	2	56	58
"D61"	"C61"	"Oth aplastic anemias and other bone marrow failure syndromes"	"Malignant neoplasm of prostate"	1	45	184	229
"C71"	"M47"	"Malignant neoplasm of brain"	"Spondylosis"	1	25	140	165
"C61"	"M20"	"Malignant neoplasm of prostate"	"Acquired deformities of fingers and toes"	1	81	322	403
"K55"	"K51"	"Vascular disorders of intestine"	"Ulcerative colitis"	1	144	255	399
"J93"	"I10"	"Pneumothorax and air leak"	"Essential (primary) hypertension"	1	1222	1925	3147
"J98"	"G56"	"Other respiratory disorders"	"Mononeuropathies of upper limb"	1	143	403	546
"O26"	"F10"	"Maternal care for oth conditions predom related to pregnancy"	"Alcohol related disorders"	1	143	870	1013
"H43"	"O68"	"Disorders of vitreous body"	"Labor and delivery comp by abnlt of fetal acid-base balance"	1	0	69	69
"N93"	"O46"	"Other abnormal uterine and vaginal bleeding"	"Antepartum hemorrhage, not elsewhere classified"	1	117	344	461
"A41"	"C83"	"Other sepsis"	"Non-follicular lymphoma"	1	833	2240	3073
"J13"	"G35"	"Pneumonia due to Streptococcus pneumoniae"	"Multiple sclerosis"	1	5	38	43
"C34"	"M99"	"Malignant neoplasm of bronchus and lung"	"Biomechanical lesions, not elsewhere classified"	1	26	276	302
"N17"	"N50"	"Acute kidney failure"	"Other and unspecified disorders of male genital organs"	1	28	82	110
"I83"	"O20"	"Varicose veins of lower extremities"	"Hemorrhage in early pregnancy"	1	0	1459	1459
"H95"	"H72"	"Intraop and postproc comp and disorders of ear/mastd, NEC"	"Perforation of tympanic membrane"	1	38	106	144
"J96"	"C45"	"Respiratory failure, not elsewhere classified"	"Mesothelioma"	1	91	245	336
"M08"	"J45"	"Juvenile arthritis"	"Asthma"	1	86	240	326
"C22"	"H26"	"Malignant neoplasm of liver and intrahepatic bile ducts"	"Other cataract"	1	4	210	214
"H16"	"D25"	"Keratitis"	"Leiomyoma of uterus"	1	63	139	202
"C88"	"M75"	"Malig immunoproliferative dis and certain oth B-cell lymph"	"Shoulder lesions"	1	17	70	87
"C80"	"K05"	"Malignant neoplasm without specification of site"	"Gingivitis and periodontal diseases"	1	73	273	346
"B34"	"M62"	"Viral infection of unspecified site"	"Other disorders of muscle"	1	719	1194	1913
"K74"	"M54"	"Fibrosis and cirrhosis of liver"	"Dorsalgia"	1	170	571	741
"K59"	"O26"	"Other functional intestinal disorders"	"Maternal care for oth conditions predom related to pregnancy"	1	401	1171	1572
"O72"	"F98"	"Postpartum hemorrhage"	"Oth behav/emotn disord w onset usly occur in chldhd and adol"	1	0	50	50
"M41"	"Q75"	"Scoliosis"	"Other congenital malformations of skull and face bones"	1	2	35	37
"F20"	"F23"	"Schizophrenia"	"Brief psychotic disorder"	1	124	219	343
"E05"	"M22"	"Thyrotoxicosis [hyperthyroidism]"	"Disorder of patella"	1	34	413	447
"D12"	"O72"	"Benign neoplasm of colon, rectum, anus and anal canal"	"Postpartum hemorrhage"	1	103	368	471
"I46"	"F33"	"Cardiac arrest"	"Major depressive disorder, recurrent"	1	119	505	624
"I46"	"I51"	"Cardiac arrest"	"Complications and ill-defined descriptions of heart disease"	1	221	381	602
"J15"	"M17"	"Bacterial pneumonia, not elsewhere classified"	"Osteoarthritis of knee"	1	0	4731	4731
"I50"	"H18"	"Heart failure"	"Other disorders of cornea"	1	379	701	1080
"E78"	"H20"	"Disorders of lipoprotein metabolism and other lipidemias"	"Iridocyclitis"	1	148	388	536
"C77"	"M05"	"Secondary and unspecified malignant neoplasm of lymph nodes"	"Rheumatoid arthritis with rheumatoid factor"	1	42	143	185
"K00"	"Q87"	"Disorders of tooth development and eruption"	"Oth congenital malform syndromes affecting multiple systems"	1	30	131	161
"N18"	"M99"	"Chronic kidney disease (CKD)"	"Biomechanical lesions, not elsewhere classified"	1	34	248	282
"C67"	"D41"	"Malignant neoplasm of bladder"	"Neoplasm of uncertain behavior of urinary organs"	1	461	820	1281
"F32"	"M02"	"Depressive episode"	"Postinfective and reactive arthropathies"	1	45	152	197
"E64"	"O42"	"Sequelae of malnutrition and other nutritional deficiencies"	"Premature rupture of membranes"	1	0	33	33
"K92"	"N75"	"Other diseases of digestive system"	"Diseases of Bartholin's gland"	1	14	65	79
"D72"	"M17"	"Other disorders of white blood cells"	"Osteoarthritis of knee"	1	53	213	266
"E86"	"D30"	"Volume depletion"	"Benign neoplasm of urinary organs"	1	0	1749	1749
"K59"	"A69"	"Other functional intestinal disorders"	"Other spirochetal infections"	1	93	185	278
"C06"	"G56"	"Malignant neoplasm of other and unspecified parts of mouth"	"Mononeuropathies of upper limb"	1	5	82	87
"G20"	"M48"	"Parkinson's disease"	"Other spondylopathies"	1	415	679	1094
"M62"	"O14"	"Other disorders of muscle"	"Pre-eclampsia"	1	302	470	772
"M70"	"H65"	"Soft tissue disorders related to use, overuse and pressure"	"Nonsuppurative otitis media"	1	34	239	273
"D12"	"I25"	"Benign neoplasm of colon, rectum, anus and anal canal"	"Chronic ischemic heart disease"	1	3322	5804	9126
"A41"	"D07"	"Other sepsis"	"Carcinoma in situ of other and unspecified genital organs"	1	33	151	184
"N30"	"Q66"	"Cystitis"	"Congenital deformities of feet"	1	129	396	525
"F03"	"M75"	"Unspecified dementia"	"Shoulder lesions"	1	0	1090	1090
"N93"	"O26"	"Other abnormal uterine and vaginal bleeding"	"Maternal care for oth conditions predom related to pregnancy"	1	224	1102	1326
"L89"	"K35"	"Pressure ulcer"	"Acute appendicitis"	1	16	170	186
"H25"	"J38"	"Age-related cataract"	"Diseases of vocal cords and larynx, not elsewhere classified"	1	501	1170	1671
"O07"	"O04"	"Failed attempted termination of pregnancy"	"Complications following (induced) termination of pregnancy"	1	124	554	678
"I50"	"N35"	"Heart failure"	"Urethral stricture"	1	323	745	1068
"D73"	"K40"	"Diseases of spleen"	"Inguinal hernia"	1	11	51	62
"C79"	"J47"	"Secondary malignant neoplasm of other and unspecified sites"	"Bronchiectasis"	1	10	50	60
"K25"	"N60"	"Gastric ulcer"	"Benign mammary dysplasia"	1	79	232	311
"E87"	"L30"	"Other disorders of fluid, electrolyte and acid-base balance"	"Other and unspecified dermatitis"	1	378	847	1225
"H52"	"O80"	"Disorders of refraction and accommodation"	"Encounter for full-term uncomplicated delivery"	1	0	2816	2816
"N17"	"H28"	"Acute kidney failure"	"Cataract in diseases classified elsewhere"	1	0	49	49
"E86"	"J93"	"Volume depletion"	"Pneumothorax and air leak"	1	544	838	1382
"C64"	"M72"	"Malignant neoplasm of kidney, except renal pelvis"	"Fibroblastic disorders"	1	20	130	150
"N39"	"N94"	"Other disorders of urinary system"	"Pain and oth cond assoc w fem gntl org and menstrual cycle"	1	787	1599	2386
"C77"	"C61"	"Secondary and unspecified malignant neoplasm of lymph nodes"	"Malignant neoplasm of prostate"	1	392	1191	1583
"K62"	"O48"	"Other diseases of anus and rectum"	"Late pregnancy"	1	0	246	246
"M81"	"K21"	"Osteoporosis without current pathological fracture"	"Gastro-esophageal reflux disease"	1	1043	3033	4076
"J06"	"C90"	"Acute upper resp infections of multiple and unsp sites"	"Multiple myeloma and malignant plasma cell neoplasms"	1	10	115	125
"C83"	"M17"	"Non-follicular lymphoma"	"Osteoarthritis of knee"	1	62	475	537
"K57"	"M95"	"Diverticular disease of intestine"	"Oth acquired deformities of ms sys and connective tissue"	1	24	140	164
"A38"	"B34"	"Scarlet fever"	"Viral infection of unspecified site"	1	120	292	412
"J92"	"H91"	"Pleural plaque"	"Other and unspecified hearing loss"	1	150	346	496
"C53"	"O32"	"Malignant neoplasm of cervix uteri"	"Maternal care for malpresentation of fetus"	1	0	52	52
"K56"	"O04"	"Paralytic ileus and intestinal obstruction without hernia"	"Complications following (induced) termination of pregnancy"	1	0	287	287
"K13"	"M51"	"Other diseases of lip and oral mucosa"	"Thoracic, thoracolum, and lumbosacral intvrt disc disorders"	1	140	277	417
"C15"	"L08"	"Malignant neoplasm of esophagus"	"Other local infections of skin and subcutaneous tissue"	1	3	69	72
"K56"	"N70"	"Paralytic ileus and intestinal obstruction without hernia"	"Salpingitis and oophoritis"	1	59	332	391
"I82"	"M23"	"Other venous embolism and thrombosis"	"Internal derangement of knee"	1	175	653	828
"J20"	"Q90"	"Acute bronchitis"	"Down syndrome"	1	42	250	292
"J91"	"H26"	"Pleural effusion in conditions classified elsewhere"	"Other cataract"	1	83	277	360
"C79"	"D22"	"Secondary malignant neoplasm of other and unspecified sites"	"Melanocytic nevi"	1	110	267	377
"M21"	"J35"	"Other acquired deformities of limbs"	"Chronic diseases of tonsils and adenoids"	1	132	558	690
"I48"	"Q82"	"Atrial fibrillation and flutter"	"Other congenital malformations of skin"	1	51	134	185
"I82"	"E04"	"Other venous embolism and thrombosis"	"Other nontoxic goiter"	1	60	158	218
"K13"	"F10"	"Other diseases of lip and oral mucosa"	"Alcohol related disorders"	1	148	298	446
"N63"	"O48"	"Unspecified lump in breast"	"Late pregnancy"	1	4	467	471
"E55"	"D23"	"Vitamin D deficiency"	"Other benign neoplasms of skin"	1	13	147	160
"H54"	"O82"	"Blindness and low vision"	"Encounter for cesarean delivery without indication"	1	12	76	88
"C79"	"H34"	"Secondary malignant neoplasm of other and unspecified sites"	"Retinal vascular occlusions"	1	39	199	238
"K21"	"O46"	"Gastro-esophageal reflux disease"	"Antepartum hemorrhage, not elsewhere classified"	1	12	118	130
"N28"	"I34"	"Oth disorders of kidney and ureter, not elsewhere classified"	"Nonrheumatic mitral valve disorders"	1	139	244	383
"O82"	"F50"	"Encounter for cesarean delivery without indication"	"Eating disorders"	1	32	211	243
"M87"	"O80"	"Osteonecrosis"	"Encounter for full-term uncomplicated delivery"	1	0	52	52
"E83"	"G44"	"Disorders of mineral metabolism"	"Other headache syndromes"	1	20	117	137
"N83"	"H10"	"Noninflammatory disord of ovary, fallop and broad ligament"	"Conjunctivitis"	1	242	430	672
"I46"	"L89"	"Cardiac arrest"	"Pressure ulcer"	1	325	479	804
"L98"	"K40"	"Oth disorders of skin, subcu, not elsewhere classified"	"Inguinal hernia"	1	143	791	934
"I25"	"K40"	"Chronic ischemic heart disease"	"Inguinal hernia"	1	3990	7122	11112
"A41"	"D75"	"Other sepsis"	"Other and unsp diseases of blood and blood-forming organs"	1	189	456	645
"D61"	"K21"	"Oth aplastic anemias and other bone marrow failure syndromes"	"Gastro-esophageal reflux disease"	1	33	89	122
"D33"	"O42"	"Benign neoplasm of brain and oth prt central nervous system"	"Premature rupture of membranes"	1	0	30	30
"E87"	"A63"	"Other disorders of fluid, electrolyte and acid-base balance"	"Oth predominantly sexually transmitted diseases, NEC"	1	0	144	144
"K12"	"Q21"	"Stomatitis and related lesions"	"Congenital malformations of cardiac septa"	1	15	61	76
"K62"	"M65"	"Other diseases of anus and rectum"	"Synovitis and tenosynovitis"	1	655	1163	1818
"C22"	"I73"	"Malignant neoplasm of liver and intrahepatic bile ducts"	"Other peripheral vascular diseases"	1	20	170	190
"O92"	"H50"	"Oth disord of brst/lactatn assoc w pregnancy and the puerp"	"Other strabismus"	1	0	57	57
"F41"	"C21"	"Other anxiety disorders"	"Malignant neoplasm of anus and anal canal"	1	24	82	106
"C78"	"M02"	"Secondary malignant neoplasm of resp and digestive organs"	"Postinfective and reactive arthropathies"	1	0	150	150
"O43"	"O04"	"Placental disorders"	"Complications following (induced) termination of pregnancy"	1	25	148	173
"H25"	"K40"	"Age-related cataract"	"Inguinal hernia"	1	0	10899	10899
"J05"	"Q62"	"Acute obstructive laryngitis [croup] and epiglottitis"	"Congen defects of renal pelvis and congen malform of ureter"	1	52	133	185
"H90"	"N97"	"Conductive and sensorineural hearing loss"	"Female infertility"	1	78	199	277
"A49"	"O75"	"Bacterial infection of unspecified site"	"Oth complications of labor and delivery, NEC"	1	32	107	139
"J43"	"I83"	"Emphysema"	"Varicose veins of lower extremities"	1	80	221	301
"A49"	"O47"	"Bacterial infection of unspecified site"	"False labor"	1	31	155	186
"E68"	"O80"	"Sequelae of hyperalimentation"	"Encounter for full-term uncomplicated delivery"	1	0	896	896
"C78"	"M99"	"Secondary malignant neoplasm of resp and digestive organs"	"Biomechanical lesions, not elsewhere classified"	1	3	219	222
"J44"	"G50"	"Other chronic obstructive pulmonary disease"	"Disorders of trigeminal nerve"	1	138	314	452
"J90"	"M05"	"Pleural effusion, not elsewhere classified"	"Rheumatoid arthritis with rheumatoid factor"	1	84	259	343
"J96"	"K22"	"Respiratory failure, not elsewhere classified"	"Other diseases of esophagus"	1	590	1473	2063
"E27"	"K40"	"Other disorders of adrenal gland"	"Inguinal hernia"	1	23	185	208
"K64"	"O82"	"Hemorrhoids and perianal venous thrombosis"	"Encounter for cesarean delivery without indication"	1	0	1058	1058
"M23"	"J35"	"Internal derangement of knee"	"Chronic diseases of tonsils and adenoids"	1	0	3423	3423
"I20"	"D24"	"Angina pectoris"	"Benign neoplasm of breast"	1	203	801	1004
"K92"	"H52"	"Other diseases of digestive system"	"Disorders of refraction and accommodation"	1	122	309	431
"O36"	"M41"	"Maternal care for other fetal problems"	"Scoliosis"	1	0	93	93
"E68"	"O66"	"Sequelae of hyperalimentation"	"Other obstructed labor"	1	0	88	88
"J44"	"O91"	"Other chronic obstructive pulmonary disease"	"Infect of breast assoc w pregnancy, the puerp and lactation"	1	1	25	26
"I49"	"N48"	"Other cardiac arrhythmias"	"Other disorders of penis"	1	122	230	352
"O72"	"M13"	"Postpartum hemorrhage"	"Other arthritis"	1	220	450	670
"K64"	"O02"	"Hemorrhoids and perianal venous thrombosis"	"Other abnormal products of conception"	1	0	514	514
"K43"	"D39"	"Ventral hernia"	"Neoplasm of uncertain behavior of female genital organs"	1	30	148	178
"K65"	"M47"	"Peritonitis"	"Spondylosis"	1	125	283	408
"N85"	"N92"	"Other noninflammatory disorders of uterus, except cervix"	"Excessive, frequent and irregular menstruation"	1	1945	2629	4574
"M16"	"M93"	"Osteoarthritis of hip"	"Other osteochondropathies"	1	30	197	227
"I34"	"D17"	"Nonrheumatic mitral valve disorders"	"Benign lipomatous neoplasm"	1	55	208	263
"M65"	"E10"	"Synovitis and tenosynovitis"	"Type 1 diabetes mellitus"	1	626	1336	1962
"F34"	"N81"	"Persistent mood [affective] disorders"	"Female genital prolapse"	1	43	118	161
"H43"	"M20"	"Disorders of vitreous body"	"Acquired deformities of fingers and toes"	1	169	374	543
"K92"	"M20"	"Other diseases of digestive system"	"Acquired deformities of fingers and toes"	1	150	651	801
"E83"	"N83"	"Disorders of mineral metabolism"	"Noninflammatory disord of ovary, fallop and broad ligament"	1	17	219	236
"H36"	"O70"	"Retinal disorders in diseases classified elsewhere"	"Perineal laceration during delivery"	1	7	147	154
"N19"	"M65"	"Unspecified kidney failure"	"Synovitis and tenosynovitis"	1	48	346	394
"D50"	"C67"	"Iron deficiency anemia"	"Malignant neoplasm of bladder"	1	165	273	438
"B34"	"O62"	"Viral infection of unspecified site"	"Abnormalities of forces of labor"	1	319	1378	1697
"C25"	"M19"	"Malignant neoplasm of pancreas"	"Other and unspecified osteoarthritis"	1	50	405	455
"C79"	"C16"	"Secondary malignant neoplasm of other and unspecified sites"	"Malignant neoplasm of stomach"	1	299	655	954
"N32"	"O70"	"Other disorders of bladder"	"Perineal laceration during delivery"	1	20	119	139
"N85"	"O80"	"Other noninflammatory disorders of uterus, except cervix"	"Encounter for full-term uncomplicated delivery"	1	0	738	738
"K85"	"N80"	"Acute pancreatitis"	"Endometriosis"	1	25	77	102
"K56"	"I71"	"Paralytic ileus and intestinal obstruction without hernia"	"Aortic aneurysm and dissection"	1	598	861	1459
"I73"	"K40"	"Other peripheral vascular diseases"	"Inguinal hernia"	1	371	1824	2195
"J44"	"E04"	"Other chronic obstructive pulmonary disease"	"Other nontoxic goiter"	1	822	1688	2510
"I35"	"D48"	"Nonrheumatic aortic valve disorders"	"Neoplasm of uncertain behavior of other and unsp sites"	1	8	107	115
"J03"	"Q67"	"Acute tonsillitis"	"Congenital ms deformities of head, face, spine and chest"	1	118	252	370
"D64"	"G56"	"Other anemias"	"Mononeuropathies of upper limb"	1	0	3255	3255
"I49"	"O46"	"Other cardiac arrhythmias"	"Antepartum hemorrhage, not elsewhere classified"	1	4	67	71
"O42"	"B07"	"Premature rupture of membranes"	"Viral warts"	1	8	63	71
"M24"	"L20"	"Other specific joint derangements"	"Atopic dermatitis"	1	33	113	146
"O71"	"G40"	"Other obstetric trauma"	"Epilepsy and recurrent seizures"	1	73	200	273
"D12"	"K08"	"Benign neoplasm of colon, rectum, anus and anal canal"	"Other disorders of teeth and supporting structures"	1	235	442	677
"C43"	"A63"	"Malignant melanoma of skin"	"Oth predominantly sexually transmitted diseases, NEC"	1	11	75	86
"N93"	"O65"	"Other abnormal uterine and vaginal bleeding"	"Obstructed labor due to maternal pelvic abnormality"	1	0	359	359
"K55"	"H91"	"Vascular disorders of intestine"	"Other and unspecified hearing loss"	1	73	915	988
"D63"	"J44"	"Anemia in chronic diseases classified elsewhere"	"Other chronic obstructive pulmonary disease"	1	855	2550	3405
"C79"	"K11"	"Secondary malignant neoplasm of other and unspecified sites"	"Diseases of salivary glands"	1	15	151	166
"I44"	"K61"	"Atrioventricular and left bundle-branch block"	"Abscess of anal and rectal regions"	1	28	88	116
"G98"	"N47"	"Other disorders of nervous system not elsewhere classified"	"Disorders of prepuce"	1	17	94	111
"B18"	"O65"	"Chronic viral hepatitis"	"Obstructed labor due to maternal pelvic abnormality"	1	5	61	66
"M19"	"D25"	"Other and unspecified osteoarthritis"	"Leiomyoma of uterus"	1	0	1390	1390
"I70"	"H90"	"Atherosclerosis"	"Conductive and sensorineural hearing loss"	1	739	1127	1866
"M80"	"H65"	"Osteoporosis with current pathological fracture"	"Nonsuppurative otitis media"	1	4	196	200
"K63"	"M16"	"Other diseases of intestine"	"Osteoarthritis of hip"	1	100	699	799
"G56"	"N40"	"Mononeuropathies of upper limb"	"Benign prostatic hyperplasia"	1	791	1113	1904
"O64"	"M22"	"Obstructed labor due to malposition and malpresent of fetus"	"Disorder of patella"	1	91	417	508
"A49"	"N40"	"Bacterial infection of unspecified site"	"Benign prostatic hyperplasia"	1	0	2291	2291
"H65"	"J12"	"Nonsuppurative otitis media"	"Viral pneumonia, not elsewhere classified"	1	704	1298	2002
"J13"	"N92"	"Pneumonia due to Streptococcus pneumoniae"	"Excessive, frequent and irregular menstruation"	1	14	104	118
"M62"	"J36"	"Other disorders of muscle"	"Peritonsillar abscess"	1	190	343	533
"I27"	"K35"	"Other pulmonary heart diseases"	"Acute appendicitis"	1	23	80	103
"D32"	"M54"	"Benign neoplasm of meninges"	"Dorsalgia"	1	146	369	515
"N28"	"M71"	"Oth disorders of kidney and ureter, not elsewhere classified"	"Other bursopathies"	1	8	52	60
"I10"	"M92"	"Essential (primary) hypertension"	"Other juvenile osteochondrosis"	1	15	100	115
"G56"	"N76"	"Mononeuropathies of upper limb"	"Other inflammation of vagina and vulva"	1	204	394	598
"N18"	"M53"	"Chronic kidney disease (CKD)"	"Other and unspecified dorsopathies, not elsewhere classified"	1	49	274	323
"K57"	"K04"	"Diverticular disease of intestine"	"Diseases of pulp and periapical tissues"	1	269	492	761
"K08"	"I34"	"Other disorders of teeth and supporting structures"	"Nonrheumatic mitral valve disorders"	1	324	469	793
"K08"	"M22"	"Other disorders of teeth and supporting structures"	"Disorder of patella"	1	23	146	169
"J90"	"K60"	"Pleural effusion, not elsewhere classified"	"Fissure and fistula of anal and rectal regions"	1	22	141	163
"C25"	"K60"	"Malignant neoplasm of pancreas"	"Fissure and fistula of anal and rectal regions"	1	0	62	62
"D35"	"N80"	"Benign neoplasm of other and unspecified endocrine glands"	"Endometriosis"	1	4	46	50
"J18"	"N72"	"Pneumonia, unspecified organism"	"Inflammatory disease of cervix uteri"	1	0	58	58
"A41"	"H43"	"Other sepsis"	"Disorders of vitreous body"	1	163	1035	1198
"M20"	"L03"	"Acquired deformities of fingers and toes"	"Cellulitis and acute lymphangitis"	1	235	450	685
"G47"	"A63"	"Sleep disorders"	"Oth predominantly sexually transmitted diseases, NEC"	1	18	365	383
"C93"	"H25"	"Monocytic leukemia"	"Age-related cataract"	1	15	107	122
"M17"	"K40"	"Osteoarthritis of knee"	"Inguinal hernia"	1	2016	3428	5444
"I51"	"M22"	"Complications and ill-defined descriptions of heart disease"	"Disorder of patella"	1	0	82	82
"I49"	"I10"	"Other cardiac arrhythmias"	"Essential (primary) hypertension"	1	10920	13374	24294
"G96"	"I61"	"Other disorders of central nervous system"	"Nontraumatic intracerebral hemorrhage"	1	604	811	1415
"C79"	"Q61"	"Secondary malignant neoplasm of other and unspecified sites"	"Cystic kidney disease"	1	25	88	113
"H25"	"N84"	"Age-related cataract"	"Polyp of female genital tract"	1	461	1545	2006
"C61"	"I21"	"Malignant neoplasm of prostate"	"Acute myocardial infarction"	1	906	1851	2757
"L08"	"N76"	"Other local infections of skin and subcutaneous tissue"	"Other inflammation of vagina and vulva"	1	192	328	520
"J18"	"L28"	"Pneumonia, unspecified organism"	"Lichen simplex chronicus and prurigo"	1	336	516	852
"J22"	"E78"	"Unspecified acute lower respiratory infection"	"Disorders of lipoprotein metabolism and other lipidemias"	1	275	1158	1433
"E61"	"M20"	"Deficiency of other nutrient elements"	"Acquired deformities of fingers and toes"	1	2	38	40
"H81"	"K40"	"Disorders of vestibular function"	"Inguinal hernia"	1	588	898	1486
"F06"	"K80"	"Other mental disorders due to known physiological condition"	"Cholelithiasis"	1	48	288	336
"E87"	"L03"	"Other disorders of fluid, electrolyte and acid-base balance"	"Cellulitis and acute lymphangitis"	1	27	750	777
"O72"	"F44"	"Postpartum hemorrhage"	"Dissociative and conversion disorders"	1	33	153	186
"J39"	"Q25"	"Other diseases of upper respiratory tract"	"Congenital malformations of great arteries"	1	29	111	140
"B36"	"M17"	"Other superficial mycoses"	"Osteoarthritis of knee"	1	34	117	151
"E64"	"H83"	"Sequelae of malnutrition and other nutritional deficiencies"	"Other diseases of inner ear"	1	0	194	194
"I46"	"I35"	"Cardiac arrest"	"Nonrheumatic aortic valve disorders"	1	466	2011	2477
"E51"	"I20"	"Thiamine deficiency"	"Angina pectoris"	1	17	98	115
"O90"	"M23"	"Complications of the puerperium, not elsewhere classified"	"Internal derangement of knee"	1	183	307	490
"E86"	"H80"	"Volume depletion"	"Otosclerosis"	1	0	403	403
"I21"	"J32"	"Acute myocardial infarction"	"Chronic sinusitis"	1	137	307	444
"G93"	"I10"	"Other disorders of brain"	"Essential (primary) hypertension"	1	987	1520	2507
"K05"	"M72"	"Gingivitis and periodontal diseases"	"Fibroblastic disorders"	1	79	207	286
"J09"	"M75"	"Influenza due to certain identified influenza viruses"	"Shoulder lesions"	1	0	178	178
"C34"	"D27"	"Malignant neoplasm of bronchus and lung"	"Benign neoplasm of ovary"	1	0	352	352
"G96"	"M48"	"Other disorders of central nervous system"	"Other spondylopathies"	1	481	1030	1511
"C79"	"H91"	"Secondary malignant neoplasm of other and unspecified sites"	"Other and unspecified hearing loss"	1	0	3649	3649
"J94"	"M50"	"Other pleural conditions"	"Cervical disc disorders"	1	12	59	71
"L98"	"D24"	"Oth disorders of skin, subcu, not elsewhere classified"	"Benign neoplasm of breast"	1	26	186	212
"D64"	"M05"	"Other anemias"	"Rheumatoid arthritis with rheumatoid factor"	1	563	1636	2199
"D22"	"J18"	"Melanocytic nevi"	"Pneumonia, unspecified organism"	1	372	570	942
"F40"	"G40"	"Phobic anxiety disorders"	"Epilepsy and recurrent seizures"	1	24	98	122
"E86"	"G62"	"Volume depletion"	"Other and unspecified polyneuropathies"	1	731	2108	2839
"C77"	"K61"	"Secondary and unspecified malignant neoplasm of lymph nodes"	"Abscess of anal and rectal regions"	1	15	130	145
"M17"	"M95"	"Osteoarthritis of knee"	"Oth acquired deformities of ms sys and connective tissue"	1	132	255	387
"K13"	"O04"	"Other diseases of lip and oral mucosa"	"Complications following (induced) termination of pregnancy"	1	0	81	81
"G44"	"K35"	"Other headache syndromes"	"Acute appendicitis"	1	191	730	921
"N39"	"G83"	"Other disorders of urinary system"	"Other paralytic syndromes"	1	179	348	527
"J18"	"H27"	"Pneumonia, unspecified organism"	"Other disorders of lens"	1	69	885	954
"E68"	"J34"	"Sequelae of hyperalimentation"	"Other and unspecified disorders of nose and nasal sinuses"	1	10	67	77
"N94"	"L20"	"Pain and oth cond assoc w fem gntl org and menstrual cycle"	"Atopic dermatitis"	1	25	141	166
"C44"	"G44"	"Other and unspecified malignant neoplasm of skin"	"Other headache syndromes"	1	53	215	268
"J86"	"H83"	"Pyothorax"	"Other diseases of inner ear"	1	8	104	112
"M17"	"K58"	"Osteoarthritis of knee"	"Irritable bowel syndrome"	1	683	1527	2210
"K52"	"O14"	"Other and unsp noninfective gastroenteritis and colitis"	"Pre-eclampsia"	1	70	163	233
"J18"	"G35"	"Pneumonia, unspecified organism"	"Multiple sclerosis"	1	88	1377	1465
"K64"	"H72"	"Hemorrhoids and perianal venous thrombosis"	"Perforation of tympanic membrane"	1	0	81	81
"K37"	"O62"	"Unspecified appendicitis"	"Abnormalities of forces of labor"	1	45	194	239
"E66"	"H68"	"Overweight and obesity"	"Eustachian salpingitis and obstruction"	1	31	100	131
"H20"	"J35"	"Iridocyclitis"	"Chronic diseases of tonsils and adenoids"	1	4	128	132
"B02"	"K50"	"Zoster [herpes zoster]"	"Crohn's disease [regional enteritis]"	1	17	75	92
"I63"	"F10"	"Cerebral infarction"	"Alcohol related disorders"	1	1831	4209	6040
"L97"	"H33"	"Non-pressure chronic ulcer of lower limb, NEC"	"Retinal detachments and breaks"	1	47	197	244
"F32"	"I21"	"Depressive episode"	"Acute myocardial infarction"	1	1574	2418	3992
"K29"	"N92"	"Gastritis and duodenitis"	"Excessive, frequent and irregular menstruation"	1	910	1925	2835
"D30"	"O04"	"Benign neoplasm of urinary organs"	"Complications following (induced) termination of pregnancy"	1	0	31	31
"E11"	"L24"	"Type 2 diabetes mellitus"	"Irritant contact dermatitis"	1	14	115	129
"C77"	"M48"	"Secondary and unspecified malignant neoplasm of lymph nodes"	"Other spondylopathies"	1	176	395	571
"L97"	"E10"	"Non-pressure chronic ulcer of lower limb, NEC"	"Type 1 diabetes mellitus"	1	0	5415	5415
"M17"	"H94"	"Osteoarthritis of knee"	"Other disorders of ear in diseases classified elsewhere"	1	37	144	181
"K04"	"J45"	"Diseases of pulp and periapical tissues"	"Asthma"	1	277	571	848
"J47"	"N60"	"Bronchiectasis"	"Benign mammary dysplasia"	1	0	52	52
"N39"	"O21"	"Other disorders of urinary system"	"Excessive vomiting in pregnancy"	1	71	381	452
"O47"	"H50"	"False labor"	"Other strabismus"	1	24	108	132
"M81"	"N85"	"Osteoporosis without current pathological fracture"	"Other noninflammatory disorders of uterus, except cervix"	1	4	193	197
"J15"	"I10"	"Bacterial pneumonia, not elsewhere classified"	"Essential (primary) hypertension"	1	0	30464	30464
"K62"	"L50"	"Other diseases of anus and rectum"	"Urticaria"	1	224	381	605
"H25"	"M77"	"Age-related cataract"	"Other enthesopathies"	1	373	1651	2024
"M75"	"L03"	"Shoulder lesions"	"Cellulitis and acute lymphangitis"	1	281	1415	1696
"F33"	"M16"	"Major depressive disorder, recurrent"	"Osteoarthritis of hip"	1	266	1235	1501
"N17"	"M75"	"Acute kidney failure"	"Shoulder lesions"	1	71	844	915
"A41"	"Q53"	"Other sepsis"	"Undescended and ectopic testicle"	1	18	76	94
"J34"	"M92"	"Other and unspecified disorders of nose and nasal sinuses"	"Other juvenile osteochondrosis"	1	11	67	78
"N30"	"C56"	"Cystitis"	"Malignant neoplasm of ovary"	1	440	744	1184
"A49"	"L30"	"Bacterial infection of unspecified site"	"Other and unspecified dermatitis"	1	366	657	1023
"C79"	"M23"	"Secondary malignant neoplasm of other and unspecified sites"	"Internal derangement of knee"	1	0	905	905
"I95"	"M24"	"Hypotension"	"Other specific joint derangements"	1	33	90	123
"J93"	"M47"	"Pneumothorax and air leak"	"Spondylosis"	1	71	202	273
"J32"	"O20"	"Chronic sinusitis"	"Hemorrhage in early pregnancy"	1	22	236	258
"I95"	"I70"	"Hypotension"	"Atherosclerosis"	1	589	1367	1956
"J96"	"K81"	"Respiratory failure, not elsewhere classified"	"Cholecystitis"	1	421	1024	1445
"N92"	"O62"	"Excessive, frequent and irregular menstruation"	"Abnormalities of forces of labor"	1	0	7628	7628
"C44"	"G40"	"Other and unspecified malignant neoplasm of skin"	"Epilepsy and recurrent seizures"	1	324	505	829
"C53"	"O36"	"Malignant neoplasm of cervix uteri"	"Maternal care for other fetal problems"	1	1	86	87
"E87"	"C16"	"Other disorders of fluid, electrolyte and acid-base balance"	"Malignant neoplasm of stomach"	1	207	336	543
"J15"	"N03"	"Bacterial pneumonia, not elsewhere classified"	"Chronic nephritic syndrome"	1	37	204	241
"M32"	"O04"	"Systemic lupus erythematosus (SLE)"	"Complications following (induced) termination of pregnancy"	1	6	97	103
"J86"	"O80"	"Pyothorax"	"Encounter for full-term uncomplicated delivery"	1	0	84	84
"C34"	"H36"	"Malignant neoplasm of bronchus and lung"	"Retinal disorders in diseases classified elsewhere"	1	88	381	469
"N30"	"G56"	"Cystitis"	"Mononeuropathies of upper limb"	1	1609	3379	4988
"I26"	"J34"	"Pulmonary embolism"	"Other and unspecified disorders of nose and nasal sinuses"	1	13	167	180
"A63"	"G40"	"Oth predominantly sexually transmitted diseases, NEC"	"Epilepsy and recurrent seizures"	1	102	214	316
"A41"	"O10"	"Other sepsis"	"Pre-existing hypertension compl preg/chldbrth"	1	5	39	44
"J98"	"M47"	"Other respiratory disorders"	"Spondylosis"	1	135	351	486
"M50"	"G56"	"Cervical disc disorders"	"Mononeuropathies of upper limb"	1	2164	2630	4794
"I73"	"H52"	"Other peripheral vascular diseases"	"Disorders of refraction and accommodation"	1	98	277	375
"A49"	"N18"	"Bacterial infection of unspecified site"	"Chronic kidney disease (CKD)"	1	1624	3030	4654
"O28"	"M22"	"Abnormal findings on antenatal screening of mother"	"Disorder of patella"	1	5	193	198
"L89"	"K25"	"Pressure ulcer"	"Gastric ulcer"	1	321	967	1288
"E87"	"M21"	"Other disorders of fluid, electrolyte and acid-base balance"	"Other acquired deformities of limbs"	1	93	537	630
"M14"	"E16"	"Arthropathies in other diseases classified elsewhere"	"Other disorders of pancreatic internal secretion"	1	53	132	185
"E87"	"H71"	"Other disorders of fluid, electrolyte and acid-base balance"	"Cholesteatoma of middle ear"	1	0	81	81
"M76"	"J35"	"Enthesopathies, lower limb, excluding foot"	"Chronic diseases of tonsils and adenoids"	1	75	838	913
"D69"	"K29"	"Purpura and other hemorrhagic conditions"	"Gastritis and duodenitis"	1	359	576	935
"A46"	"K85"	"Erysipelas"	"Acute pancreatitis"	1	222	387	609
"I46"	"N28"	"Cardiac arrest"	"Oth disorders of kidney and ureter, not elsewhere classified"	1	150	277	427
"K85"	"D24"	"Acute pancreatitis"	"Benign neoplasm of breast"	1	35	129	164
"K56"	"M72"	"Paralytic ileus and intestinal obstruction without hernia"	"Fibroblastic disorders"	1	102	403	505
"O30"	"N98"	"Multiple gestation"	"Complications associated with artificial fertilization"	1	81	560	641
"J84"	"I10"	"Other interstitial pulmonary diseases"	"Essential (primary) hypertension"	1	1269	2549	3818
"L98"	"K85"	"Oth disorders of skin, subcu, not elsewhere classified"	"Acute pancreatitis"	1	89	184	273
"K59"	"N61"	"Other functional intestinal disorders"	"Inflammatory disorders of breast"	1	112	311	423
"K85"	"M22"	"Acute pancreatitis"	"Disorder of patella"	1	4	184	188
"K92"	"N21"	"Other diseases of digestive system"	"Calculus of lower urinary tract"	1	95	238	333
"I42"	"M70"	"Cardiomyopathy"	"Soft tissue disorders related to use, overuse and pressure"	1	120	282	402
"O20"	"F10"	"Hemorrhage in early pregnancy"	"Alcohol related disorders"	1	299	759	1058
"A46"	"L73"	"Erysipelas"	"Other follicular disorders"	1	53	125	178
"I63"	"I30"	"Cerebral infarction"	"Acute pericarditis"	1	84	210	294
"C71"	"M50"	"Malignant neoplasm of brain"	"Cervical disc disorders"	1	3	85	88
"J18"	"O21"	"Pneumonia, unspecified organism"	"Excessive vomiting in pregnancy"	1	79	323	402
"E03"	"C50"	"Other hypothyroidism"	"Malignant neoplasm of breast"	1	726	1361	2087
"M79"	"F10"	"Oth and unsp soft tissue disorders, not elsewhere classified"	"Alcohol related disorders"	1	2696	4710	7406
"K35"	"O65"	"Acute appendicitis"	"Obstructed labor due to maternal pelvic abnormality"	1	161	325	486
"M54"	"O45"	"Dorsalgia"	"Premature separation of placenta [abruptio placentae]"	1	34	219	253
"B34"	"O04"	"Viral infection of unspecified site"	"Complications following (induced) termination of pregnancy"	1	242	839	1081
"M96"	"C50"	"Intraop and postproc comp and disorders of ms sys, NEC"	"Malignant neoplasm of breast"	1	60	129	189
"L23"	"O80"	"Allergic contact dermatitis"	"Encounter for full-term uncomplicated delivery"	1	224	732	956
"M75"	"O82"	"Shoulder lesions"	"Encounter for cesarean delivery without indication"	1	0	2002	2002
"F32"	"I25"	"Depressive episode"	"Chronic ischemic heart disease"	1	3714	5264	8978
"G93"	"C50"	"Other disorders of brain"	"Malignant neoplasm of breast"	1	33	133	166
"C82"	"I88"	"Follicular lymphoma"	"Nonspecific lymphadenitis"	1	77	268	345
"G98"	"M23"	"Other disorders of nervous system not elsewhere classified"	"Internal derangement of knee"	1	158	664	822
"H52"	"G91"	"Disorders of refraction and accommodation"	"Hydrocephalus"	1	101	287	388
"K59"	"O68"	"Other functional intestinal disorders"	"Labor and delivery comp by abnlt of fetal acid-base balance"	1	507	1396	1903
"G98"	"K35"	"Other disorders of nervous system not elsewhere classified"	"Acute appendicitis"	1	11	221	232
"J06"	"H93"	"Acute upper resp infections of multiple and unsp sites"	"Other disorders of ear, not elsewhere classified"	1	37	181	218
"I48"	"J35"	"Atrial fibrillation and flutter"	"Chronic diseases of tonsils and adenoids"	1	27	296	323
"K76"	"O34"	"Other diseases of liver"	"Maternal care for abnormality of pelvic organs"	1	10	69	79
"B35"	"O80"	"Dermatophytosis"	"Encounter for full-term uncomplicated delivery"	1	22	133	155
"A41"	"M17"	"Other sepsis"	"Osteoarthritis of knee"	1	0	6185	6185
"O60"	"N97"	"Preterm labor"	"Female infertility"	1	273	1422	1695
"D30"	"N92"	"Benign neoplasm of urinary organs"	"Excessive, frequent and irregular menstruation"	1	3	236	239
"G47"	"I21"	"Sleep disorders"	"Acute myocardial infarction"	1	673	2235	2908
"L02"	"O80"	"Cutaneous abscess, furuncle and carbuncle"	"Encounter for full-term uncomplicated delivery"	1	981	3201	4182
"L30"	"N60"	"Other and unspecified dermatitis"	"Benign mammary dysplasia"	1	36	201	237
"N17"	"C61"	"Acute kidney failure"	"Malignant neoplasm of prostate"	1	375	780	1155
"M81"	"N61"	"Osteoporosis without current pathological fracture"	"Inflammatory disorders of breast"	1	20	213	233
"B95"	"A46"	"Strep as the cause of diseases classified elsewhere"	"Erysipelas"	1	169	287	456
"M85"	"G61"	"Other disorders of bone density and structure"	"Inflammatory polyneuropathy"	1	19	68	87
"K59"	"H43"	"Other functional intestinal disorders"	"Disorders of vitreous body"	1	437	1055	1492
"N20"	"H80"	"Calculus of kidney and ureter"	"Otosclerosis"	1	40	135	175
"M62"	"O20"	"Other disorders of muscle"	"Hemorrhage in early pregnancy"	1	1117	2057	3174
"K62"	"O70"	"Other diseases of anus and rectum"	"Perineal laceration during delivery"	1	130	1435	1565
"H90"	"Q90"	"Conductive and sensorineural hearing loss"	"Down syndrome"	1	50	170	220
"J15"	"M50"	"Bacterial pneumonia, not elsewhere classified"	"Cervical disc disorders"	1	17	869	886
"M85"	"N47"	"Other disorders of bone density and structure"	"Disorders of prepuce"	1	29	137	166
"N18"	"K60"	"Chronic kidney disease (CKD)"	"Fissure and fistula of anal and rectal regions"	1	48	349	397
"C20"	"O72"	"Malignant neoplasm of rectum"	"Postpartum hemorrhage"	1	0	26	26
"N90"	"O70"	"Other noninflammatory disorders of vulva and perineum"	"Perineal laceration during delivery"	1	436	1206	1642
"D43"	"M79"	"Neoplasm of uncertain behavior of brain and cnsl"	"Oth and unsp soft tissue disorders, not elsewhere classified"	1	72	151	223
"J96"	"O28"	"Respiratory failure, not elsewhere classified"	"Abnormal findings on antenatal screening of mother"	1	1	25	26
"I46"	"K58"	"Cardiac arrest"	"Irritable bowel syndrome"	1	0	207	207
"H52"	"N60"	"Disorders of refraction and accommodation"	"Benign mammary dysplasia"	1	111	283	394
"L98"	"N95"	"Oth disorders of skin, subcu, not elsewhere classified"	"Menopausal and other perimenopausal disorders"	1	137	245	382
"O62"	"K01"	"Abnormalities of forces of labor"	"Embedded and impacted teeth"	1	72	406	478
"J90"	"N03"	"Pleural effusion, not elsewhere classified"	"Chronic nephritic syndrome"	1	13	53	66
"N32"	"I20"	"Other disorders of bladder"	"Angina pectoris"	1	349	567	916
"E41"	"K25"	"Nutritional marasmus"	"Gastric ulcer"	1	34	243	277
"N71"	"O03"	"Inflammatory disease of uterus, except cervix"	"Spontaneous abortion"	1	577	1121	1698
"D72"	"M65"	"Other disorders of white blood cells"	"Synovitis and tenosynovitis"	1	20	78	98
"H20"	"O71"	"Iridocyclitis"	"Other obstetric trauma"	1	8	44	52
"M81"	"M65"	"Osteoporosis without current pathological fracture"	"Synovitis and tenosynovitis"	1	484	2050	2534
"I83"	"N91"	"Varicose veins of lower extremities"	"Absent, scanty and rare menstruation"	1	14	72	86
"G44"	"O14"	"Other headache syndromes"	"Pre-eclampsia"	1	48	212	260
"J18"	"L72"	"Pneumonia, unspecified organism"	"Follicular cysts of skin and subcutaneous tissue"	1	248	599	847
"N20"	"O32"	"Calculus of kidney and ureter"	"Maternal care for malpresentation of fetus"	1	58	239	297
"N17"	"K73"	"Acute kidney failure"	"Chronic hepatitis, not elsewhere classified"	1	17	66	83
"N19"	"I34"	"Unspecified kidney failure"	"Nonrheumatic mitral valve disorders"	1	494	737	1231
"M70"	"M24"	"Soft tissue disorders related to use, overuse and pressure"	"Other specific joint derangements"	1	617	811	1428
"K20"	"M22"	"Esophagitis"	"Disorder of patella"	1	37	186	223
"C45"	"M17"	"Mesothelioma"	"Osteoarthritis of knee"	1	0	96	96
"M79"	"A63"	"Oth and unsp soft tissue disorders, not elsewhere classified"	"Oth predominantly sexually transmitted diseases, NEC"	1	501	882	1383
"K43"	"N62"	"Ventral hernia"	"Hypertrophy of breast"	1	118	230	348
"A26"	"I50"	"Erysipeloid"	"Heart failure"	1	82	186	268
"I27"	"M76"	"Other pulmonary heart diseases"	"Enthesopathies, lower limb, excluding foot"	1	10	48	58
"H35"	"O65"	"Other retinal disorders"	"Obstructed labor due to maternal pelvic abnormality"	1	0	35	35
"I35"	"M75"	"Nonrheumatic aortic valve disorders"	"Shoulder lesions"	1	0	2985	2985
"L03"	"J35"	"Cellulitis and acute lymphangitis"	"Chronic diseases of tonsils and adenoids"	1	299	486	785
"N32"	"M17"	"Other disorders of bladder"	"Osteoarthritis of knee"	1	284	428	712
"C79"	"O04"	"Secondary malignant neoplasm of other and unspecified sites"	"Complications following (induced) termination of pregnancy"	1	0	81	81
"L89"	"H65"	"Pressure ulcer"	"Nonsuppurative otitis media"	1	0	68	68
"D51"	"J35"	"Vitamin B12 deficiency anemia"	"Chronic diseases of tonsils and adenoids"	1	3	35	38
"C77"	"C51"	"Secondary and unspecified malignant neoplasm of lymph nodes"	"Malignant neoplasm of vulva"	1	41	201	242
"M19"	"H65"	"Other and unspecified osteoarthritis"	"Nonsuppurative otitis media"	1	45	329	374
"C13"	"M54"	"Malignant neoplasm of hypopharynx"	"Dorsalgia"	1	3	88	91
"M50"	"N83"	"Cervical disc disorders"	"Noninflammatory disord of ovary, fallop and broad ligament"	1	228	592	820
"D38"	"N81"	"Neoplm of uncrt behav of mid ear & resp and intrathorac org"	"Female genital prolapse"	1	8	49	57
"G62"	"E04"	"Other and unspecified polyneuropathies"	"Other nontoxic goiter"	1	118	333	451
"I46"	"M80"	"Cardiac arrest"	"Osteoporosis with current pathological fracture"	1	143	904	1047
"C25"	"I71"	"Malignant neoplasm of pancreas"	"Aortic aneurysm and dissection"	1	79	260	339
"K43"	"O04"	"Ventral hernia"	"Complications following (induced) termination of pregnancy"	1	0	417	417
"D75"	"N20"	"Other and unsp diseases of blood and blood-forming organs"	"Calculus of kidney and ureter"	1	28	94	122
"M76"	"O00"	"Enthesopathies, lower limb, excluding foot"	"Ectopic pregnancy"	1	9	93	102
"M65"	"D48"	"Synovitis and tenosynovitis"	"Neoplasm of uncertain behavior of other and unsp sites"	1	5	107	112
"I13"	"I10"	"Hypertensive heart and chronic kidney disease"	"Essential (primary) hypertension"	1	338	1008	1346
"F33"	"M20"	"Major depressive disorder, recurrent"	"Acquired deformities of fingers and toes"	1	82	494	576
"N30"	"L23"	"Cystitis"	"Allergic contact dermatitis"	1	179	423	602
"I51"	"H25"	"Complications and ill-defined descriptions of heart disease"	"Age-related cataract"	1	811	1652	2463
"G95"	"M54"	"Other and unspecified diseases of spinal cord"	"Dorsalgia"	1	968	2185	3153
"J81"	"N81"	"Pulmonary edema"	"Female genital prolapse"	1	5	354	359
"A46"	"K21"	"Erysipelas"	"Gastro-esophageal reflux disease"	1	498	1106	1604
"K52"	"M67"	"Other and unsp noninfective gastroenteritis and colitis"	"Other disorders of synovium and tendon"	1	322	568	890
"N28"	"M22"	"Oth disorders of kidney and ureter, not elsewhere classified"	"Disorder of patella"	1	4	41	45
"I50"	"N81"	"Heart failure"	"Female genital prolapse"	1	0	3360	3360
"O75"	"J45"	"Oth complications of labor and delivery, NEC"	"Asthma"	1	346	590	936
"I74"	"N81"	"Arterial embolism and thrombosis"	"Female genital prolapse"	1	33	147	180
"D22"	"Q17"	"Melanocytic nevi"	"Other congenital malformations of ear"	1	6	112	118
"M80"	"N92"	"Osteoporosis with current pathological fracture"	"Excessive, frequent and irregular menstruation"	1	0	265	265
"C16"	"C15"	"Malignant neoplasm of stomach"	"Malignant neoplasm of esophagus"	1	1855	2380	4235
"N17"	"J44"	"Acute kidney failure"	"Other chronic obstructive pulmonary disease"	1	2060	3992	6052
"I46"	"M22"	"Cardiac arrest"	"Disorder of patella"	1	0	62	62
"D27"	"O62"	"Benign neoplasm of ovary"	"Abnormalities of forces of labor"	1	553	1444	1997
"D25"	"N97"	"Leiomyoma of uterus"	"Female infertility"	1	649	2320	2969
"C88"	"I20"	"Malig immunoproliferative dis and certain oth B-cell lymph"	"Angina pectoris"	1	17	123	140
"L97"	"E03"	"Non-pressure chronic ulcer of lower limb, NEC"	"Other hypothyroidism"	1	336	662	998
"D09"	"I21"	"Carcinoma in situ of other and unspecified sites"	"Acute myocardial infarction"	1	25	285	310
"C25"	"C20"	"Malignant neoplasm of pancreas"	"Malignant neoplasm of rectum"	1	29	136	165
"K59"	"N10"	"Other functional intestinal disorders"	"Acute pyelonephritis"	1	1434	2042	3476
"M53"	"J30"	"Other and unspecified dorsopathies, not elsewhere classified"	"Vasomotor and allergic rhinitis"	1	76	208	284
"B07"	"N04"	"Viral warts"	"Nephrotic syndrome"	1	2	57	59
"F03"	"I70"	"Unspecified dementia"	"Atherosclerosis"	1	1172	2784	3956
"D63"	"H27"	"Anemia in chronic diseases classified elsewhere"	"Other disorders of lens"	1	0	48	48
"J69"	"C54"	"Pneumonitis due to solids and liquids"	"Malignant neoplasm of corpus uteri"	1	0	43	43
"I34"	"M17"	"Nonrheumatic mitral valve disorders"	"Osteoarthritis of knee"	1	292	1357	1649
"N39"	"H72"	"Other disorders of urinary system"	"Perforation of tympanic membrane"	1	98	337	435
"I31"	"H83"	"Other diseases of pericardium"	"Other diseases of inner ear"	1	5	91	96
"E63"	"I63"	"Other nutritional deficiencies"	"Cerebral infarction"	1	174	321	495
"N49"	"L02"	"Inflammatory disorders of male genital organs, NEC"	"Cutaneous abscess, furuncle and carbuncle"	1	463	692	1155
"E21"	"H83"	"Hyperparathyroidism and other disorders of parathyroid gland"	"Other diseases of inner ear"	1	7	111	118
"H72"	"Q37"	"Perforation of tympanic membrane"	"Cleft palate with cleft lip"	1	0	68	68
"H61"	"H80"	"Other disorders of external ear"	"Otosclerosis"	1	62	157	219
"C15"	"M06"	"Malignant neoplasm of esophagus"	"Other rheumatoid arthritis"	1	11	76	87
"G95"	"M41"	"Other and unspecified diseases of spinal cord"	"Scoliosis"	1	66	151	217
"M81"	"B18"	"Osteoporosis without current pathological fracture"	"Chronic viral hepatitis"	1	33	198	231
"N30"	"M15"	"Cystitis"	"Polyosteoarthritis"	1	896	1324	2220
"I69"	"M20"	"Sequelae of cerebrovascular disease"	"Acquired deformities of fingers and toes"	1	285	1262	1547
"C25"	"N40"	"Malignant neoplasm of pancreas"	"Benign prostatic hyperplasia"	1	32	692	724
"J15"	"F79"	"Bacterial pneumonia, not elsewhere classified"	"Unspecified intellectual disabilities"	1	110	257	367
"I12"	"I10"	"Hypertensive chronic kidney disease"	"Essential (primary) hypertension"	1	1361	2870	4231
"C34"	"J03"	"Malignant neoplasm of bronchus and lung"	"Acute tonsillitis"	1	5	93	98
"N17"	"L01"	"Acute kidney failure"	"Impetigo"	1	4	35	39
"N13"	"K61"	"Obstructive and reflux uropathy"	"Abscess of anal and rectal regions"	1	71	199	270
"F43"	"L02"	"Reaction to severe stress, and adjustment disorders"	"Cutaneous abscess, furuncle and carbuncle"	1	200	474	674
"K62"	"N92"	"Other diseases of anus and rectum"	"Excessive, frequent and irregular menstruation"	1	0	2570	2570
"Q80"	"M35"	"Congenital ichthyosis"	"Other systemic involvement of connective tissue"	1	9	92	101
"M70"	"J35"	"Soft tissue disorders related to use, overuse and pressure"	"Chronic diseases of tonsils and adenoids"	1	46	636	682
"A49"	"G20"	"Bacterial infection of unspecified site"	"Parkinson's disease"	1	233	529	762
"K30"	"O75"	"Functional dyspepsia"	"Oth complications of labor and delivery, NEC"	1	116	212	328
"C67"	"C50"	"Malignant neoplasm of bladder"	"Malignant neoplasm of breast"	1	72	156	228
"E41"	"H90"	"Nutritional marasmus"	"Conductive and sensorineural hearing loss"	1	0	60	60
"C13"	"I21"	"Malignant neoplasm of hypopharynx"	"Acute myocardial infarction"	1	14	75	89
"H53"	"M23"	"Visual disturbances"	"Internal derangement of knee"	1	392	1007	1399
"M17"	"K21"	"Osteoarthritis of knee"	"Gastro-esophageal reflux disease"	1	2153	2606	4759
"J15"	"H25"	"Bacterial pneumonia, not elsewhere classified"	"Age-related cataract"	1	0	17694	17694
"K52"	"E04"	"Other and unsp noninfective gastroenteritis and colitis"	"Other nontoxic goiter"	1	232	577	809
"I81"	"F10"	"Portal vein thrombosis"	"Alcohol related disorders"	1	40	177	217
"G96"	"O24"	"Other disorders of central nervous system"	"Diabetes in pregnancy, childbirth, and the puerperium"	1	6	85	91
"I95"	"H36"	"Hypotension"	"Retinal disorders in diseases classified elsewhere"	1	63	442	505
"J03"	"H66"	"Acute tonsillitis"	"Suppurative and unspecified otitis media"	1	3022	4302	7324
"D47"	"H90"	"Oth neoplm of uncrt behav of lymphoid, hematpoetc & rel tiss"	"Conductive and sensorineural hearing loss"	1	30	196	226
"C88"	"I25"	"Malig immunoproliferative dis and certain oth B-cell lymph"	"Chronic ischemic heart disease"	1	69	163	232
"H18"	"H93"	"Other disorders of cornea"	"Other disorders of ear, not elsewhere classified"	1	72	206	278
"C18"	"N47"	"Malignant neoplasm of colon"	"Disorders of prepuce"	1	92	178	270
"J96"	"H35"	"Respiratory failure, not elsewhere classified"	"Other retinal disorders"	1	0	5195	5195
"D22"	"N92"	"Melanocytic nevi"	"Excessive, frequent and irregular menstruation"	1	343	840	1183
"M77"	"O20"	"Other enthesopathies"	"Hemorrhage in early pregnancy"	1	0	533	533
"J44"	"A15"	"Other chronic obstructive pulmonary disease"	"Respiratory tuberculosis"	1	281	425	706
"K22"	"I83"	"Other diseases of esophagus"	"Varicose veins of lower extremities"	1	174	600	774
"I95"	"K35"	"Hypotension"	"Acute appendicitis"	1	38	290	328
"M81"	"N63"	"Osteoporosis without current pathological fracture"	"Unspecified lump in breast"	1	55	1190	1245
"C77"	"O99"	"Secondary and unspecified malignant neoplasm of lymph nodes"	"Oth maternal diseases classd elsw but compl preg/chldbrth"	1	2	142	144
"G62"	"K35"	"Other and unspecified polyneuropathies"	"Acute appendicitis"	1	48	227	275
"C92"	"I10"	"Myeloid leukemia"	"Essential (primary) hypertension"	1	217	743	960
"C79"	"K74"	"Secondary malignant neoplasm of other and unspecified sites"	"Fibrosis and cirrhosis of liver"	1	33	131	164
"H43"	"O24"	"Disorders of vitreous body"	"Diabetes in pregnancy, childbirth, and the puerperium"	1	0	68	68
"A49"	"O48"	"Bacterial infection of unspecified site"	"Late pregnancy"	1	4	87	91
"H16"	"O68"	"Keratitis"	"Labor and delivery comp by abnlt of fetal acid-base balance"	1	119	269	388
"L92"	"O80"	"Granulomatous disorders of skin and subcutaneous tissue"	"Encounter for full-term uncomplicated delivery"	1	13	216	229
"M80"	"H18"	"Osteoporosis with current pathological fracture"	"Other disorders of cornea"	1	104	290	394
"C77"	"E04"	"Secondary and unspecified malignant neoplasm of lymph nodes"	"Other nontoxic goiter"	1	136	551	687
"I69"	"D12"	"Sequelae of cerebrovascular disease"	"Benign neoplasm of colon, rectum, anus and anal canal"	1	1900	2597	4497
"G95"	"M22"	"Other and unspecified diseases of spinal cord"	"Disorder of patella"	1	0	44	44
"I49"	"M79"	"Other cardiac arrhythmias"	"Oth and unsp soft tissue disorders, not elsewhere classified"	1	1359	1791	3150
"L70"	"O04"	"Acne"	"Complications following (induced) termination of pregnancy"	1	69	186	255
"N39"	"I99"	"Other disorders of urinary system"	"Other and unspecified disorders of circulatory system"	1	268	525	793
"K83"	"H91"	"Other diseases of biliary tract"	"Other and unspecified hearing loss"	1	253	1389	1642
"M96"	"M20"	"Intraop and postproc comp and disorders of ms sys, NEC"	"Acquired deformities of fingers and toes"	1	93	299	392
"C25"	"N35"	"Malignant neoplasm of pancreas"	"Urethral stricture"	1	5	44	49
"I20"	"O86"	"Angina pectoris"	"Other puerperal infections"	1	0	35	35
"I80"	"O26"	"Phlebitis and thrombophlebitis"	"Maternal care for oth conditions predom related to pregnancy"	1	86	399	485
"M23"	"N70"	"Internal derangement of knee"	"Salpingitis and oophoritis"	1	136	761	897
"G91"	"G45"	"Hydrocephalus"	"Transient cerebral ischemic attacks and related syndromes"	1	159	296	455
"E86"	"M81"	"Volume depletion"	"Osteoporosis without current pathological fracture"	1	5656	9323	14979
"C34"	"H40"	"Malignant neoplasm of bronchus and lung"	"Glaucoma"	1	85	825	910
"F17"	"H91"	"Nicotine dependence"	"Other and unspecified hearing loss"	1	537	1403	1940
"J18"	"O36"	"Pneumonia, unspecified organism"	"Maternal care for other fetal problems"	1	214	797	1011
"C80"	"K80"	"Malignant neoplasm without specification of site"	"Cholelithiasis"	1	17	328	345
"M85"	"N60"	"Other disorders of bone density and structure"	"Benign mammary dysplasia"	1	0	483	483
"N61"	"O71"	"Inflammatory disorders of breast"	"Other obstetric trauma"	1	11	155	166
"D59"	"I35"	"Acquired hemolytic anemia"	"Nonrheumatic aortic valve disorders"	1	81	216	297
"J18"	"M71"	"Pneumonia, unspecified organism"	"Other bursopathies"	1	339	1233	1572
"L02"	"N40"	"Cutaneous abscess, furuncle and carbuncle"	"Benign prostatic hyperplasia"	1	826	1060	1886
"O47"	"O04"	"False labor"	"Complications following (induced) termination of pregnancy"	1	1671	3673	5344
"K59"	"G82"	"Other functional intestinal disorders"	"Paraplegia (paraparesis) and quadriplegia (quadriparesis)"	1	503	950	1453
"A49"	"J05"	"Bacterial infection of unspecified site"	"Acute obstructive laryngitis [croup] and epiglottitis"	1	48	200	248
"I31"	"N20"	"Other diseases of pericardium"	"Calculus of kidney and ureter"	1	23	95	118
"C50"	"M22"	"Malignant neoplasm of breast"	"Disorder of patella"	1	0	209	209
"C79"	"G25"	"Secondary malignant neoplasm of other and unspecified sites"	"Other extrapyramidal and movement disorders"	1	22	74	96
"D12"	"M16"	"Benign neoplasm of colon, rectum, anus and anal canal"	"Osteoarthritis of hip"	1	1677	3227	4904
"N25"	"N20"	"Disorders resulting from impaired renal tubular function"	"Calculus of kidney and ureter"	1	21	94	115
"H92"	"G40"	"Otalgia and effusion of ear"	"Epilepsy and recurrent seizures"	1	26	95	121
"A49"	"K04"	"Bacterial infection of unspecified site"	"Diseases of pulp and periapical tissues"	1	314	767	1081
"K83"	"N20"	"Other diseases of biliary tract"	"Calculus of kidney and ureter"	1	110	269	379
"G56"	"K00"	"Mononeuropathies of upper limb"	"Disorders of tooth development and eruption"	1	14	113	127
"G96"	"N43"	"Other disorders of central nervous system"	"Hydrocele and spermatocele"	1	13	173	186
"O80"	"B65"	"Encounter for full-term uncomplicated delivery"	"Schistosomiasis [bilharziasis]"	1	10	63	73
"E25"	"M17"	"Adrenogenital disorders"	"Osteoarthritis of knee"	1	11	94	105
"N18"	"C43"	"Chronic kidney disease (CKD)"	"Malignant melanoma of skin"	1	90	307	397
"F43"	"J45"	"Reaction to severe stress, and adjustment disorders"	"Asthma"	1	359	1196	1555
"I10"	"O21"	"Essential (primary) hypertension"	"Excessive vomiting in pregnancy"	1	0	190	190
"L85"	"M16"	"Other epidermal thickening"	"Osteoarthritis of hip"	1	23	83	106
"J15"	"L72"	"Bacterial pneumonia, not elsewhere classified"	"Follicular cysts of skin and subcutaneous tissue"	1	47	298	345
"K62"	"M93"	"Other diseases of anus and rectum"	"Other osteochondropathies"	1	13	74	87
"K62"	"M67"	"Other diseases of anus and rectum"	"Other disorders of synovium and tendon"	1	432	856	1288
"D64"	"N76"	"Other anemias"	"Other inflammation of vagina and vulva"	1	110	311	421
"H26"	"D86"	"Other cataract"	"Sarcoidosis"	1	79	194	273
"E64"	"G20"	"Sequelae of malnutrition and other nutritional deficiencies"	"Parkinson's disease"	1	71	181	252
"D64"	"G50"	"Other anemias"	"Disorders of trigeminal nerve"	1	71	311	382
"I69"	"N81"	"Sequelae of cerebrovascular disease"	"Female genital prolapse"	1	0	2321	2321
"I46"	"M48"	"Cardiac arrest"	"Other spondylopathies"	1	41	831	872
"C92"	"I20"	"Myeloid leukemia"	"Angina pectoris"	1	44	403	447
"C61"	"M17"	"Malignant neoplasm of prostate"	"Osteoarthritis of knee"	1	596	2376	2972
"M19"	"O68"	"Other and unspecified osteoarthritis"	"Labor and delivery comp by abnlt of fetal acid-base balance"	1	0	341	341
"C26"	"C20"	"Malignant neoplasm of other and ill-defined digestive organs"	"Malignant neoplasm of rectum"	1	12	66	78
"G45"	"M75"	"Transient cerebral ischemic attacks and related syndromes"	"Shoulder lesions"	1	1371	2012	3383
"D64"	"G57"	"Other anemias"	"Mononeuropathies of lower limb"	1	75	421	496
"J44"	"G45"	"Other chronic obstructive pulmonary disease"	"Transient cerebral ischemic attacks and related syndromes"	1	2654	4326	6980
"A04"	"J42"	"Other bacterial intestinal infections"	"Unspecified chronic bronchitis"	1	93	419	512
"N48"	"J34"	"Other disorders of penis"	"Other and unspecified disorders of nose and nasal sinuses"	1	77	304	381
"F41"	"O36"	"Other anxiety disorders"	"Maternal care for other fetal problems"	1	131	354	485
"C64"	"H80"	"Malignant neoplasm of kidney, except renal pelvis"	"Otosclerosis"	1	0	38	38
"O92"	"M41"	"Oth disord of brst/lactatn assoc w pregnancy and the puerp"	"Scoliosis"	1	0	33	33
"E87"	"N75"	"Other disorders of fluid, electrolyte and acid-base balance"	"Diseases of Bartholin's gland"	1	0	74	74
"M94"	"O20"	"Other disorders of cartilage"	"Hemorrhage in early pregnancy"	1	10	47	57
"M46"	"O30"	"Other inflammatory spondylopathies"	"Multiple gestation"	1	1	28	29
"M90"	"I10"	"Osteopathies in diseases classified elsewhere"	"Essential (primary) hypertension"	1	71	278	349
"C78"	"I70"	"Secondary malignant neoplasm of resp and digestive organs"	"Atherosclerosis"	1	0	2047	2047
"D36"	"O62"	"Benign neoplasm of other and unspecified sites"	"Abnormalities of forces of labor"	1	17	93	110
"N44"	"B34"	"Noninflammatory disorders of testis"	"Viral infection of unspecified site"	1	26	140	166
"M15"	"I83"	"Polyosteoarthritis"	"Varicose veins of lower extremities"	1	245	560	805
"G56"	"G43"	"Mononeuropathies of upper limb"	"Migraine"	1	490	766	1256
"A46"	"H81"	"Erysipelas"	"Disorders of vestibular function"	1	256	727	983
"A09"	"H93"	"Infectious gastroenteritis and colitis, unspecified"	"Other disorders of ear, not elsewhere classified"	1	503	704	1207
"M16"	"N71"	"Osteoarthritis of hip"	"Inflammatory disease of uterus, except cervix"	1	20	87	107
"D63"	"G50"	"Anemia in chronic diseases classified elsewhere"	"Disorders of trigeminal nerve"	1	12	69	81
"I20"	"L04"	"Angina pectoris"	"Acute lymphadenitis"	1	65	152	217
"D23"	"O36"	"Other benign neoplasms of skin"	"Maternal care for other fetal problems"	1	124	270	394
"D86"	"J35"	"Sarcoidosis"	"Chronic diseases of tonsils and adenoids"	1	1	111	112
"M31"	"N92"	"Other necrotizing vasculopathies"	"Excessive, frequent and irregular menstruation"	1	0	192	192
"C61"	"M79"	"Malignant neoplasm of prostate"	"Oth and unsp soft tissue disorders, not elsewhere classified"	1	578	1168	1746
"I11"	"I22"	"Hypertensive heart disease"	"Subsequent STEMI & NSTEMI mocard infrc"	1	24	77	101
"E66"	"K50"	"Overweight and obesity"	"Crohn's disease [regional enteritis]"	1	321	518	839
"N39"	"B27"	"Other disorders of urinary system"	"Infectious mononucleosis"	1	68	149	217
"N18"	"O80"	"Chronic kidney disease (CKD)"	"Encounter for full-term uncomplicated delivery"	1	0	169	169
"L90"	"O03"	"Atrophic disorders of skin"	"Spontaneous abortion"	1	74	483	557
"E55"	"O68"	"Vitamin D deficiency"	"Labor and delivery comp by abnlt of fetal acid-base balance"	1	56	388	444
"K62"	"H50"	"Other diseases of anus and rectum"	"Other strabismus"	1	113	235	348
"I44"	"D12"	"Atrioventricular and left bundle-branch block"	"Benign neoplasm of colon, rectum, anus and anal canal"	1	570	861	1431
"N83"	"H72"	"Noninflammatory disord of ovary, fallop and broad ligament"	"Perforation of tympanic membrane"	1	32	99	131
"I35"	"K60"	"Nonrheumatic aortic valve disorders"	"Fissure and fistula of anal and rectal regions"	1	58	285	343
"N13"	"D12"	"Obstructive and reflux uropathy"	"Benign neoplasm of colon, rectum, anus and anal canal"	1	632	903	1535
"E11"	"N81"	"Type 2 diabetes mellitus"	"Female genital prolapse"	1	1604	2448	4052
"C77"	"O03"	"Secondary and unspecified malignant neoplasm of lymph nodes"	"Spontaneous abortion"	1	0	67	67
"M47"	"K61"	"Spondylosis"	"Abscess of anal and rectal regions"	1	107	314	421
"C73"	"O36"	"Malignant neoplasm of thyroid gland"	"Maternal care for other fetal problems"	1	5	38	43
"J44"	"I83"	"Other chronic obstructive pulmonary disease"	"Varicose veins of lower extremities"	1	1247	3433	4680
"D50"	"J45"	"Iron deficiency anemia"	"Asthma"	1	520	1545	2065
"K04"	"C02"	"Diseases of pulp and periapical tissues"	"Malignant neoplasm of other and unspecified parts of tongue"	1	175	295	470
"K85"	"O14"	"Acute pancreatitis"	"Pre-eclampsia"	1	14	117	131
"I20"	"O75"	"Angina pectoris"	"Oth complications of labor and delivery, NEC"	1	0	63	63
"J18"	"M77"	"Pneumonia, unspecified organism"	"Other enthesopathies"	1	568	1767	2335
"G62"	"I47"	"Other and unspecified polyneuropathies"	"Paroxysmal tachycardia"	1	214	611	825
"M54"	"N75"	"Dorsalgia"	"Diseases of Bartholin's gland"	1	215	338	553
"G56"	"B27"	"Mononeuropathies of upper limb"	"Infectious mononucleosis"	1	0	107	107
"H18"	"I83"	"Other disorders of cornea"	"Varicose veins of lower extremities"	1	99	249	348
"I21"	"J35"	"Acute myocardial infarction"	"Chronic diseases of tonsils and adenoids"	1	10	179	189
"K83"	"M62"	"Other diseases of biliary tract"	"Other disorders of muscle"	1	49	480	529
"C77"	"G56"	"Secondary and unspecified malignant neoplasm of lymph nodes"	"Mononeuropathies of upper limb"	1	73	630	703
"F03"	"G98"	"Unspecified dementia"	"Other disorders of nervous system not elsewhere classified"	1	78	161	239
"K62"	"O75"	"Other diseases of anus and rectum"	"Oth complications of labor and delivery, NEC"	1	33	209	242
"M05"	"O63"	"Rheumatoid arthritis with rheumatoid factor"	"Long labor"	1	1	54	55
"C83"	"D25"	"Non-follicular lymphoma"	"Leiomyoma of uterus"	1	0	98	98
"I48"	"M35"	"Atrial fibrillation and flutter"	"Other systemic involvement of connective tissue"	1	1816	2721	4537
"H33"	"O68"	"Retinal detachments and breaks"	"Labor and delivery comp by abnlt of fetal acid-base balance"	1	0	58	58
"J32"	"A63"	"Chronic sinusitis"	"Oth predominantly sexually transmitted diseases, NEC"	1	34	124	158
"I63"	"D16"	"Cerebral infarction"	"Benign neoplasm of bone and articular cartilage"	1	11	123	134
"N13"	"K29"	"Obstructive and reflux uropathy"	"Gastritis and duodenitis"	1	425	737	1162
"I27"	"F10"	"Other pulmonary heart diseases"	"Alcohol related disorders"	1	146	484	630
"D61"	"M16"	"Oth aplastic anemias and other bone marrow failure syndromes"	"Osteoarthritis of hip"	1	26	162	188
"E66"	"K21"	"Overweight and obesity"	"Gastro-esophageal reflux disease"	1	2540	3238	5778
"F01"	"M81"	"Vascular dementia"	"Osteoporosis without current pathological fracture"	1	482	982	1464
"C18"	"K44"	"Malignant neoplasm of colon"	"Diaphragmatic hernia"	1	396	1042	1438
"J96"	"E04"	"Respiratory failure, not elsewhere classified"	"Other nontoxic goiter"	1	113	1171	1284
"C04"	"K70"	"Malignant neoplasm of floor of mouth"	"Alcoholic liver disease"	1	17	70	87
"C77"	"M67"	"Secondary and unspecified malignant neoplasm of lymph nodes"	"Other disorders of synovium and tendon"	1	14	286	300
"K52"	"J45"	"Other and unsp noninfective gastroenteritis and colitis"	"Asthma"	1	2041	2854	4895
"N84"	"O26"	"Polyp of female genital tract"	"Maternal care for oth conditions predom related to pregnancy"	1	0	440	440
"N30"	"K20"	"Cystitis"	"Esophagitis"	1	1325	2000	3325
"M17"	"O30"	"Osteoarthritis of knee"	"Multiple gestation"	1	0	94	94
"M17"	"O47"	"Osteoarthritis of knee"	"False labor"	1	0	209	209
"K92"	"N81"	"Other diseases of digestive system"	"Female genital prolapse"	1	96	1049	1145
"O64"	"O03"	"Obstructed labor due to malposition and malpresent of fetus"	"Spontaneous abortion"	1	1650	2567	4217
"E89"	"I20"	"Postproc endocrine and metabolic comp and disorders, NEC"	"Angina pectoris"	1	187	371	558
"N81"	"M51"	"Female genital prolapse"	"Thoracic, thoracolum, and lumbosacral intvrt disc disorders"	1	1217	1576	2793
"G91"	"N63"	"Hydrocephalus"	"Unspecified lump in breast"	1	4	41	45
"O68"	"O21"	"Labor and delivery comp by abnlt of fetal acid-base balance"	"Excessive vomiting in pregnancy"	1	1999	3243	5242
"C50"	"O62"	"Malignant neoplasm of breast"	"Abnormalities of forces of labor"	1	0	602	602
"H82"	"I20"	"Vertiginous syndromes in diseases classified elsewhere"	"Angina pectoris"	1	34	200	234
"E34"	"H93"	"Other endocrine disorders"	"Other disorders of ear, not elsewhere classified"	1	23	108	131
"E20"	"O80"	"Hypoparathyroidism"	"Encounter for full-term uncomplicated delivery"	1	0	55	55
"F20"	"J30"	"Schizophrenia"	"Vasomotor and allergic rhinitis"	1	7	56	63
"M16"	"O47"	"Osteoarthritis of hip"	"False labor"	1	0	69	69
"E87"	"H93"	"Other disorders of fluid, electrolyte and acid-base balance"	"Other disorders of ear, not elsewhere classified"	1	0	1286	1286
"N18"	"M17"	"Chronic kidney disease (CKD)"	"Osteoarthritis of knee"	1	0	3434	3434
"E86"	"M19"	"Volume depletion"	"Other and unspecified osteoarthritis"	1	0	4874	4874
"D68"	"O48"	"Other coagulation defects"	"Late pregnancy"	1	32	138	170
"J18"	"J34"	"Pneumonia, unspecified organism"	"Other and unspecified disorders of nose and nasal sinuses"	1	306	1221	1527
"N30"	"Q03"	"Cystitis"	"Congenital hydrocephalus"	1	14	67	81
"E05"	"J34"	"Thyrotoxicosis [hyperthyroidism]"	"Other and unspecified disorders of nose and nasal sinuses"	1	116	218	334
"C09"	"M79"	"Malignant neoplasm of tonsil"	"Oth and unsp soft tissue disorders, not elsewhere classified"	1	16	70	86
"J44"	"C54"	"Other chronic obstructive pulmonary disease"	"Malignant neoplasm of corpus uteri"	1	134	367	501
"C78"	"O36"	"Secondary malignant neoplasm of resp and digestive organs"	"Maternal care for other fetal problems"	1	0	28	28
"M75"	"O80"	"Shoulder lesions"	"Encounter for full-term uncomplicated delivery"	1	0	4091	4091
"D50"	"H80"	"Iron deficiency anemia"	"Otosclerosis"	1	0	134	134
"C13"	"M23"	"Malignant neoplasm of hypopharynx"	"Internal derangement of knee"	1	0	40	40
"E13"	"O02"	"Other specified diabetes mellitus"	"Other abnormal products of conception"	1	2	28	30
"J22"	"K70"	"Unspecified acute lower respiratory infection"	"Alcoholic liver disease"	1	62	152	214
"N39"	"H83"	"Other disorders of urinary system"	"Other diseases of inner ear"	1	0	1407	1407
"M10"	"Q21"	"Gout"	"Congenital malformations of cardiac septa"	1	10	49	59
"M54"	"G80"	"Dorsalgia"	"Cerebral palsy"	1	46	114	160
"L57"	"M72"	"Skin changes due to chronic expsr to nonionizing radiation"	"Fibroblastic disorders"	1	43	214	257
"N39"	"N35"	"Other disorders of urinary system"	"Urethral stricture"	1	577	1032	1609
"O66"	"O21"	"Other obstructed labor"	"Excessive vomiting in pregnancy"	1	222	495	717
"I69"	"G43"	"Sequelae of cerebrovascular disease"	"Migraine"	1	396	1069	1465
"K55"	"D64"	"Vascular disorders of intestine"	"Other anemias"	1	840	1660	2500
"G95"	"H25"	"Other and unspecified diseases of spinal cord"	"Age-related cataract"	1	376	931	1307
"L98"	"I49"	"Oth disorders of skin, subcu, not elsewhere classified"	"Other cardiac arrhythmias"	1	284	485	769
"K63"	"M75"	"Other diseases of intestine"	"Shoulder lesions"	1	151	750	901
"C24"	"M79"	"Malignant neoplasm of other and unsp parts of biliary tract"	"Oth and unsp soft tissue disorders, not elsewhere classified"	1	1	109	110
"M80"	"M81"	"Osteoporosis with current pathological fracture"	"Osteoporosis without current pathological fracture"	1	8349	9629	17978
"D24"	"O48"	"Benign neoplasm of breast"	"Late pregnancy"	1	59	371	430
"J13"	"Q25"	"Pneumonia due to Streptococcus pneumoniae"	"Congenital malformations of great arteries"	1	21	92	113
"G93"	"O80"	"Other disorders of brain"	"Encounter for full-term uncomplicated delivery"	1	0	238	238
"C34"	"M11"	"Malignant neoplasm of bronchus and lung"	"Other crystal arthropathies"	1	7	57	64
"N39"	"I47"	"Other disorders of urinary system"	"Paroxysmal tachycardia"	1	1032	3427	4459
"G64"	"M23"	"Other disorders of peripheral nervous system"	"Internal derangement of knee"	1	33	118	151
"E89"	"N83"	"Postproc endocrine and metabolic comp and disorders, NEC"	"Noninflammatory disord of ovary, fallop and broad ligament"	1	51	156	207
"E04"	"O82"	"Other nontoxic goiter"	"Encounter for cesarean delivery without indication"	1	93	1335	1428
"K59"	"J05"	"Other functional intestinal disorders"	"Acute obstructive laryngitis [croup] and epiglottitis"	1	451	1168	1619
"I63"	"O02"	"Cerebral infarction"	"Other abnormal products of conception"	1	0	93	93
"D64"	"K30"	"Other anemias"	"Functional dyspepsia"	1	1241	3760	5001
"J96"	"D07"	"Respiratory failure, not elsewhere classified"	"Carcinoma in situ of other and unspecified genital organs"	1	4	119	123
"K52"	"H35"	"Other and unsp noninfective gastroenteritis and colitis"	"Other retinal disorders"	1	892	1328	2220
"O73"	"O03"	"Retained placenta and membranes, without hemorrhage"	"Spontaneous abortion"	1	344	998	1342
"K81"	"M20"	"Cholecystitis"	"Acquired deformities of fingers and toes"	1	105	215	320
"I10"	"M93"	"Essential (primary) hypertension"	"Other osteochondropathies"	1	5	307	312
"C71"	"N43"	"Malignant neoplasm of brain"	"Hydrocele and spermatocele"	1	3	69	72
"M99"	"O30"	"Biomechanical lesions, not elsewhere classified"	"Multiple gestation"	1	0	31	31
"M80"	"C85"	"Osteoporosis with current pathological fracture"	"Oth and unspecified types of non-Hodgkin lymphoma"	1	60	132	192
"C34"	"D14"	"Malignant neoplasm of bronchus and lung"	"Benign neoplasm of middle ear and respiratory system"	1	305	721	1026
"I20"	"M50"	"Angina pectoris"	"Cervical disc disorders"	1	1099	1710	2809
"G35"	"O64"	"Multiple sclerosis"	"Obstructed labor due to malposition and malpresent of fetus"	1	2	100	102
"I83"	"F10"	"Varicose veins of lower extremities"	"Alcohol related disorders"	1	878	1171	2049
"C77"	"I25"	"Secondary and unspecified malignant neoplasm of lymph nodes"	"Chronic ischemic heart disease"	1	298	1298	1596
"C92"	"J45"	"Myeloid leukemia"	"Asthma"	1	29	113	142
"I44"	"N43"	"Atrioventricular and left bundle-branch block"	"Hydrocele and spermatocele"	1	26	254	280
"G23"	"I21"	"Other degenerative diseases of basal ganglia"	"Acute myocardial infarction"	1	4	60	64
"J96"	"N84"	"Respiratory failure, not elsewhere classified"	"Polyp of female genital tract"	1	21	464	485
"M70"	"O80"	"Soft tissue disorders related to use, overuse and pressure"	"Encounter for full-term uncomplicated delivery"	1	0	1551	1551
"J69"	"C10"	"Pneumonitis due to solids and liquids"	"Malignant neoplasm of oropharynx"	1	13	76	89
"C79"	"G35"	"Secondary malignant neoplasm of other and unspecified sites"	"Multiple sclerosis"	1	6	68	74
"C18"	"G45"	"Malignant neoplasm of colon"	"Transient cerebral ischemic attacks and related syndromes"	1	457	974	1431
"I89"	"N84"	"Oth noninfective disorders of lymphatic vessels and nodes"	"Polyp of female genital tract"	1	40	124	164
"K21"	"O66"	"Gastro-esophageal reflux disease"	"Other obstructed labor"	1	8	105	113
"C44"	"N97"	"Other and unspecified malignant neoplasm of skin"	"Female infertility"	1	0	72	72
"F05"	"J44"	"Delirium due to known physiological condition"	"Other chronic obstructive pulmonary disease"	1	1120	2980	4100
"A41"	"D34"	"Other sepsis"	"Benign neoplasm of thyroid gland"	1	15	74	89
"H35"	"H81"	"Other retinal disorders"	"Disorders of vestibular function"	1	738	1279	2017
"J44"	"H11"	"Other chronic obstructive pulmonary disease"	"Other disorders of conjunctiva"	1	200	435	635
"C14"	"M51"	"Malig neoplasm of sites in the lip, oral cavity and pharynx"	"Thoracic, thoracolum, and lumbosacral intvrt disc disorders"	1	0	26	26
"A26"	"N92"	"Erysipeloid"	"Excessive, frequent and irregular menstruation"	1	0	31	31
"I26"	"M72"	"Pulmonary embolism"	"Fibroblastic disorders"	1	72	438	510
"I49"	"N60"	"Other cardiac arrhythmias"	"Benign mammary dysplasia"	1	81	376	457
"A46"	"M53"	"Erysipelas"	"Other and unspecified dorsopathies, not elsewhere classified"	1	131	231	362
"A26"	"N81"	"Erysipeloid"	"Female genital prolapse"	1	0	34	34
"J98"	"J20"	"Other respiratory disorders"	"Acute bronchitis"	1	691	1199	1890
"E87"	"H04"	"Other disorders of fluid, electrolyte and acid-base balance"	"Disorders of lacrimal system"	1	23	226	249
"I46"	"H10"	"Cardiac arrest"	"Conjunctivitis"	1	0	258	258
"F41"	"C20"	"Other anxiety disorders"	"Malignant neoplasm of rectum"	1	103	749	852
"J15"	"O42"	"Bacterial pneumonia, not elsewhere classified"	"Premature rupture of membranes"	1	23	209	232
"J84"	"I70"	"Other interstitial pulmonary diseases"	"Atherosclerosis"	1	277	471	748
"D50"	"O64"	"Iron deficiency anemia"	"Obstructed labor due to malposition and malpresent of fetus"	1	0	131	131
"J90"	"O70"	"Pleural effusion, not elsewhere classified"	"Perineal laceration during delivery"	1	1	61	62
"C71"	"E78"	"Malignant neoplasm of brain"	"Disorders of lipoprotein metabolism and other lipidemias"	1	247	517	764
"C56"	"O04"	"Malignant neoplasm of ovary"	"Complications following (induced) termination of pregnancy"	1	0	82	82
"I15"	"J35"	"Secondary hypertension"	"Chronic diseases of tonsils and adenoids"	1	27	112	139
"J05"	"J20"	"Acute obstructive laryngitis [croup] and epiglottitis"	"Acute bronchitis"	1	2409	3228	5637
"C13"	"M51"	"Malignant neoplasm of hypopharynx"	"Thoracic, thoracolum, and lumbosacral intvrt disc disorders"	1	0	42	42
"N95"	"O68"	"Menopausal and other perimenopausal disorders"	"Labor and delivery comp by abnlt of fetal acid-base balance"	1	0	67	67
"H66"	"Q22"	"Suppurative and unspecified otitis media"	"Congenital malformations of pulmonary and tricuspid valves"	1	89	177	266
"N11"	"O04"	"Chronic tubulo-interstitial nephritis"	"Complications following (induced) termination of pregnancy"	1	27	84	111
"M65"	"H10"	"Synovitis and tenosynovitis"	"Conjunctivitis"	1	416	981	1397
"I25"	"H74"	"Chronic ischemic heart disease"	"Other disorders of middle ear mastoid"	1	20	153	173
"J43"	"M65"	"Emphysema"	"Synovitis and tenosynovitis"	1	41	217	258
"H35"	"M24"	"Other retinal disorders"	"Other specific joint derangements"	1	121	241	362
"N35"	"J35"	"Urethral stricture"	"Chronic diseases of tonsils and adenoids"	1	14	62	76
"I67"	"M67"	"Other cerebrovascular diseases"	"Other disorders of synovium and tendon"	1	25	119	144
"E86"	"Q90"	"Volume depletion"	"Down syndrome"	1	24	154	178
"G47"	"K81"	"Sleep disorders"	"Cholecystitis"	1	163	335	498
"A41"	"O66"	"Other sepsis"	"Other obstructed labor"	1	6	43	49
"I61"	"H83"	"Nontraumatic intracerebral hemorrhage"	"Other diseases of inner ear"	1	1	451	452
"C56"	"N81"	"Malignant neoplasm of ovary"	"Female genital prolapse"	1	115	369	484
"K64"	"O03"	"Hemorrhoids and perianal venous thrombosis"	"Spontaneous abortion"	1	0	432	432
"I63"	"H83"	"Cerebral infarction"	"Other diseases of inner ear"	1	0	2046	2046
"J15"	"M93"	"Bacterial pneumonia, not elsewhere classified"	"Other osteochondropathies"	1	3	56	59
"K00"	"Q75"	"Disorders of tooth development and eruption"	"Other congenital malformations of skull and face bones"	1	0	44	44
"N60"	"N97"	"Benign mammary dysplasia"	"Female infertility"	1	127	595	722
"I73"	"D23"	"Other peripheral vascular diseases"	"Other benign neoplasms of skin"	1	198	537	735
"G95"	"H02"	"Other and unspecified diseases of spinal cord"	"Other disorders of eyelid"	1	35	119	154
"O92"	"O80"	"Oth disord of brst/lactatn assoc w pregnancy and the puerp"	"Encounter for full-term uncomplicated delivery"	1	7493	8840	16333
"E78"	"N40"	"Disorders of lipoprotein metabolism and other lipidemias"	"Benign prostatic hyperplasia"	1	2903	4841	7744
"C44"	"M16"	"Other and unspecified malignant neoplasm of skin"	"Osteoarthritis of hip"	1	726	2365	3091
"J96"	"H71"	"Respiratory failure, not elsewhere classified"	"Cholesteatoma of middle ear"	1	0	115	115
"E86"	"Q44"	"Volume depletion"	"Congenital malform of gallbladder, bile ducts and liver"	1	4	53	57
"G95"	"I83"	"Other and unspecified diseases of spinal cord"	"Varicose veins of lower extremities"	1	6	226	232
"K08"	"K61"	"Other disorders of teeth and supporting structures"	"Abscess of anal and rectal regions"	1	37	108	145
"C09"	"M51"	"Malignant neoplasm of tonsil"	"Thoracic, thoracolum, and lumbosacral intvrt disc disorders"	1	4	72	76
"E66"	"N63"	"Overweight and obesity"	"Unspecified lump in breast"	1	618	1012	1630
"C78"	"D24"	"Secondary malignant neoplasm of resp and digestive organs"	"Benign neoplasm of breast"	1	0	467	467
"H57"	"Q75"	"Other disorders of eye and adnexa"	"Other congenital malformations of skull and face bones"	1	23	73	96
"F03"	"M18"	"Unspecified dementia"	"Osteoarthritis of first carpometacarpal joint"	1	3	160	163
"I71"	"O62"	"Aortic aneurysm and dissection"	"Abnormalities of forces of labor"	1	0	34	34
"I15"	"N63"	"Secondary hypertension"	"Unspecified lump in breast"	1	31	109	140
"C44"	"K51"	"Other and unspecified malignant neoplasm of skin"	"Ulcerative colitis"	1	50	346	396
"H53"	"N92"	"Visual disturbances"	"Excessive, frequent and irregular menstruation"	1	101	721	822
"I21"	"M54"	"Acute myocardial infarction"	"Dorsalgia"	1	3216	4551	7767
"A41"	"M22"	"Other sepsis"	"Disorder of patella"	1	0	228	228
"J18"	"K40"	"Pneumonia, unspecified organism"	"Inguinal hernia"	1	0	14029	14029
"N19"	"E10"	"Unspecified kidney failure"	"Type 1 diabetes mellitus"	1	989	3183	4172
"J30"	"G80"	"Vasomotor and allergic rhinitis"	"Cerebral palsy"	1	11	48	59
"O72"	"H20"	"Postpartum hemorrhage"	"Iridocyclitis"	1	112	261	373
"H25"	"J33"	"Age-related cataract"	"Nasal polyp"	1	148	511	659
"L71"	"O70"	"Rosacea"	"Perineal laceration during delivery"	1	33	273	306
"M19"	"O92"	"Other and unspecified osteoarthritis"	"Oth disord of brst/lactatn assoc w pregnancy and the puerp"	1	8	46	54
"K12"	"D25"	"Stomatitis and related lesions"	"Leiomyoma of uterus"	1	27	88	115
"E64"	"K05"	"Sequelae of malnutrition and other nutritional deficiencies"	"Gingivitis and periodontal diseases"	1	203	871	1074
"K76"	"K21"	"Other diseases of liver"	"Gastro-esophageal reflux disease"	1	714	1022	1736
"K63"	"N81"	"Other diseases of intestine"	"Female genital prolapse"	1	20	350	370
"B96"	"E78"	"Oth bacterial agents as the cause of diseases classd elswhr"	"Disorders of lipoprotein metabolism and other lipidemias"	1	83	396	479
"J96"	"D03"	"Respiratory failure, not elsewhere classified"	"Melanoma in situ"	1	9	82	91
"H26"	"C54"	"Other cataract"	"Malignant neoplasm of corpus uteri"	1	96	228	324
"L97"	"N64"	"Non-pressure chronic ulcer of lower limb, NEC"	"Other disorders of breast"	1	11	52	63
"F70"	"G80"	"Mild intellectual disabilities"	"Cerebral palsy"	1	57	140	197
"A49"	"I12"	"Bacterial infection of unspecified site"	"Hypertensive chronic kidney disease"	1	38	315	353
"O99"	"N91"	"Oth maternal diseases classd elsw but compl preg/chldbrth"	"Absent, scanty and rare menstruation"	1	236	704	940
"D06"	"O71"	"Carcinoma in situ of cervix uteri"	"Other obstetric trauma"	1	65	161	226
"L29"	"K40"	"Pruritus"	"Inguinal hernia"	1	45	184	229
"J15"	"M33"	"Bacterial pneumonia, not elsewhere classified"	"Dermatopolymyositis"	1	11	75	86
"M50"	"O42"	"Cervical disc disorders"	"Premature rupture of membranes"	1	0	219	219
"C67"	"N84"	"Malignant neoplasm of bladder"	"Polyp of female genital tract"	1	18	64	82
"C25"	"J45"	"Malignant neoplasm of pancreas"	"Asthma"	1	35	372	407
"M72"	"K40"	"Fibroblastic disorders"	"Inguinal hernia"	1	704	1171	1875
"K64"	"C53"	"Hemorrhoids and perianal venous thrombosis"	"Malignant neoplasm of cervix uteri"	1	0	44	44
"N18"	"I24"	"Chronic kidney disease (CKD)"	"Other acute ischemic heart diseases"	1	249	458	707
"C45"	"H25"	"Mesothelioma"	"Age-related cataract"	1	35	162	197
"K59"	"H26"	"Other functional intestinal disorders"	"Other cataract"	1	1701	3785	5486
"M79"	"L20"	"Oth and unsp soft tissue disorders, not elsewhere classified"	"Atopic dermatitis"	1	178	759	937
"M81"	"Q85"	"Osteoporosis without current pathological fracture"	"Phakomatoses, not elsewhere classified"	1	0	33	33
"G47"	"H83"	"Sleep disorders"	"Other diseases of inner ear"	1	143	963	1106
"G62"	"H90"	"Other and unspecified polyneuropathies"	"Conductive and sensorineural hearing loss"	1	173	364	537
"D63"	"C24"	"Anemia in chronic diseases classified elsewhere"	"Malignant neoplasm of other and unsp parts of biliary tract"	1	86	215	301
"L98"	"O02"	"Oth disorders of skin, subcu, not elsewhere classified"	"Other abnormal products of conception"	1	26	166	192
"O72"	"F11"	"Postpartum hemorrhage"	"Opioid related disorders"	1	21	114	135
"I44"	"M43"	"Atrioventricular and left bundle-branch block"	"Other deforming dorsopathies"	1	38	132	170
"K60"	"O60"	"Fissure and fistula of anal and rectal regions"	"Preterm labor"	1	8	55	63
"O75"	"A09"	"Oth complications of labor and delivery, NEC"	"Infectious gastroenteritis and colitis, unspecified"	1	142	401	543
"I35"	"N63"	"Nonrheumatic aortic valve disorders"	"Unspecified lump in breast"	1	8	306	314
"J18"	"D12"	"Pneumonia, unspecified organism"	"Benign neoplasm of colon, rectum, anus and anal canal"	1	4365	7527	11892
"K63"	"K26"	"Other diseases of intestine"	"Duodenal ulcer"	1	312	533	845
"O34"	"D06"	"Maternal care for abnormality of pelvic organs"	"Carcinoma in situ of cervix uteri"	1	49	589	638
"E86"	"H11"	"Volume depletion"	"Other disorders of conjunctiva"	1	49	552	601
"O72"	"M71"	"Postpartum hemorrhage"	"Other bursopathies"	1	40	163	203
"I21"	"J38"	"Acute myocardial infarction"	"Diseases of vocal cords and larynx, not elsewhere classified"	1	284	456	740
"N19"	"E78"	"Unspecified kidney failure"	"Disorders of lipoprotein metabolism and other lipidemias"	1	984	3364	4348
"C34"	"D50"	"Malignant neoplasm of bronchus and lung"	"Iron deficiency anemia"	1	431	871	1302
"G47"	"M20"	"Sleep disorders"	"Acquired deformities of fingers and toes"	1	233	902	1135
"K80"	"C62"	"Cholelithiasis"	"Malignant neoplasm of testis"	1	5	57	62
"N19"	"J37"	"Unspecified kidney failure"	"Chronic laryngitis and laryngotracheitis"	1	5	73	78
"E83"	"O03"	"Disorders of mineral metabolism"	"Spontaneous abortion"	1	0	50	50
"K90"	"K29"	"Intestinal malabsorption"	"Gastritis and duodenitis"	1	265	471	736
"N18"	"K80"	"Chronic kidney disease (CKD)"	"Cholelithiasis"	1	0	2829	2829
"J15"	"H53"	"Bacterial pneumonia, not elsewhere classified"	"Visual disturbances"	1	297	848	1145
"G47"	"E16"	"Sleep disorders"	"Other disorders of pancreatic internal secretion"	1	115	286	401
"C45"	"E66"	"Mesothelioma"	"Overweight and obesity"	1	3	39	42
"F01"	"I48"	"Vascular dementia"	"Atrial fibrillation and flutter"	1	857	2432	3289
"E27"	"M67"	"Other disorders of adrenal gland"	"Other disorders of synovium and tendon"	1	26	91	117
"C79"	"N40"	"Secondary malignant neoplasm of other and unspecified sites"	"Benign prostatic hyperplasia"	1	0	3142	3142
"M79"	"C50"	"Oth and unsp soft tissue disorders, not elsewhere classified"	"Malignant neoplasm of breast"	1	1325	1722	3047
"A41"	"G40"	"Other sepsis"	"Epilepsy and recurrent seizures"	1	0	4342	4342
"I80"	"N63"	"Phlebitis and thrombophlebitis"	"Unspecified lump in breast"	1	224	439	663
"M85"	"N70"	"Other disorders of bone density and structure"	"Salpingitis and oophoritis"	1	0	110	110
"O20"	"N97"	"Hemorrhage in early pregnancy"	"Female infertility"	1	3656	6880	10536
"N39"	"Q42"	"Other disorders of urinary system"	"Congenital absence, atresia and stenosis of large intestine"	1	3	69	72
"I80"	"O41"	"Phlebitis and thrombophlebitis"	"Other disorders of amniotic fluid and membranes"	1	17	65	82
"F41"	"H91"	"Other anxiety disorders"	"Other and unspecified hearing loss"	1	232	1479	1711
"O48"	"O20"	"Late pregnancy"	"Hemorrhage in early pregnancy"	1	1795	3346	5141
"M13"	"H65"	"Other arthritis"	"Nonsuppurative otitis media"	1	77	292	369
"K71"	"I20"	"Toxic liver disease"	"Angina pectoris"	1	85	248	333
"M47"	"N60"	"Spondylosis"	"Benign mammary dysplasia"	1	100	598	698
"J13"	"O80"	"Pneumonia due to Streptococcus pneumoniae"	"Encounter for full-term uncomplicated delivery"	1	6	173	179
"J84"	"H33"	"Other interstitial pulmonary diseases"	"Retinal detachments and breaks"	1	12	94	106
"B34"	"Q54"	"Viral infection of unspecified site"	"Hypospadias"	1	134	371	505
"O99"	"J45"	"Oth maternal diseases classd elsw but compl preg/chldbrth"	"Asthma"	1	2153	4113	6266
"J15"	"J45"	"Bacterial pneumonia, not elsewhere classified"	"Asthma"	1	0	9599	9599
"D64"	"G40"	"Other anemias"	"Epilepsy and recurrent seizures"	1	1154	2554	3708
"D12"	"H81"	"Benign neoplasm of colon, rectum, anus and anal canal"	"Disorders of vestibular function"	1	467	1147	1614
"C83"	"C85"	"Non-follicular lymphoma"	"Oth and unspecified types of non-Hodgkin lymphoma"	1	2903	4300	7203
"M16"	"H71"	"Osteoarthritis of hip"	"Cholesteatoma of middle ear"	1	33	97	130
"N17"	"H83"	"Acute kidney failure"	"Other diseases of inner ear"	1	0	336	336
"M79"	"G40"	"Oth and unsp soft tissue disorders, not elsewhere classified"	"Epilepsy and recurrent seizures"	1	1132	2125	3257
"E27"	"M75"	"Other disorders of adrenal gland"	"Shoulder lesions"	1	72	295	367
"K72"	"N48"	"Hepatic failure, not elsewhere classified"	"Other disorders of penis"	1	8	50	58
"K30"	"O82"	"Functional dyspepsia"	"Encounter for cesarean delivery without indication"	1	422	911	1333
"K25"	"C62"	"Gastric ulcer"	"Malignant neoplasm of testis"	1	6	42	48
"I69"	"M23"	"Sequelae of cerebrovascular disease"	"Internal derangement of knee"	1	0	2500	2500
"H47"	"Q03"	"Other disorders of optic [2nd] nerve and visual pathways"	"Congenital hydrocephalus"	1	5	91	96
"J91"	"M19"	"Pleural effusion in conditions classified elsewhere"	"Other and unspecified osteoarthritis"	1	69	218	287
"I61"	"M75"	"Nontraumatic intracerebral hemorrhage"	"Shoulder lesions"	1	156	600	756
"M08"	"M13"	"Juvenile arthritis"	"Other arthritis"	1	300	484	784
"N17"	"I11"	"Acute kidney failure"	"Hypertensive heart disease"	1	400	685	1085
"J90"	"C77"	"Pleural effusion, not elsewhere classified"	"Secondary and unspecified malignant neoplasm of lymph nodes"	1	405	674	1079
"D46"	"I10"	"Myelodysplastic syndromes"	"Essential (primary) hypertension"	1	203	1085	1288
"D68"	"A63"	"Other coagulation defects"	"Oth predominantly sexually transmitted diseases, NEC"	1	21	123	144
"L57"	"C82"	"Skin changes due to chronic expsr to nonionizing radiation"	"Follicular lymphoma"	1	3	44	47
"D64"	"N21"	"Other anemias"	"Calculus of lower urinary tract"	1	145	435	580
"M23"	"M41"	"Internal derangement of knee"	"Scoliosis"	1	313	480	793
"O99"	"N30"	"Oth maternal diseases classd elsw but compl preg/chldbrth"	"Cystitis"	1	2197	4027	6224
"G57"	"O03"	"Mononeuropathies of lower limb"	"Spontaneous abortion"	1	1	138	139
"L57"	"H35"	"Skin changes due to chronic expsr to nonionizing radiation"	"Other retinal disorders"	1	227	499	726
"G95"	"O99"	"Other and unspecified diseases of spinal cord"	"Oth maternal diseases classd elsw but compl preg/chldbrth"	1	8	93	101
"M17"	"D24"	"Osteoarthritis of knee"	"Benign neoplasm of breast"	1	149	1131	1280
"G98"	"N81"	"Other disorders of nervous system not elsewhere classified"	"Female genital prolapse"	1	28	206	234
"M50"	"A63"	"Cervical disc disorders"	"Oth predominantly sexually transmitted diseases, NEC"	1	34	218	252
"F52"	"M62"	"Sexual dysfnct not due to a substance or known physiol cond"	"Other disorders of muscle"	1	140	241	381
"A49"	"A08"	"Bacterial infection of unspecified site"	"Viral and other specified intestinal infections"	1	229	570	799
"E41"	"M23"	"Nutritional marasmus"	"Internal derangement of knee"	1	0	49	49
"N97"	"A63"	"Female infertility"	"Oth predominantly sexually transmitted diseases, NEC"	1	77	988	1065
"I48"	"K58"	"Atrial fibrillation and flutter"	"Irritable bowel syndrome"	1	391	1601	1992
"O99"	"M67"	"Oth maternal diseases classd elsw but compl preg/chldbrth"	"Other disorders of synovium and tendon"	1	939	1533	2472
"M85"	"N40"	"Other disorders of bone density and structure"	"Benign prostatic hyperplasia"	1	91	748	839
"O45"	"O02"	"Premature separation of placenta [abruptio placentae]"	"Other abnormal products of conception"	1	280	569	849
"O80"	"J05"	"Encounter for full-term uncomplicated delivery"	"Acute obstructive laryngitis [croup] and epiglottitis"	1	0	82	82
"A40"	"M16"	"Streptococcal sepsis"	"Osteoarthritis of hip"	1	42	320	362
"E70"	"I21"	"Disorders of aromatic amino-acid metabolism"	"Acute myocardial infarction"	1	72	157	229
"J18"	"M22"	"Pneumonia, unspecified organism"	"Disorder of patella"	1	180	846	1026
"K27"	"C50"	"Peptic ulcer, site unspecified"	"Malignant neoplasm of breast"	1	105	196	301
"M85"	"L02"	"Other disorders of bone density and structure"	"Cutaneous abscess, furuncle and carbuncle"	1	117	671	788
"K63"	"O02"	"Other diseases of intestine"	"Other abnormal products of conception"	1	5	47	52
"H26"	"O36"	"Other cataract"	"Maternal care for other fetal problems"	1	0	37	37
"N39"	"M32"	"Other disorders of urinary system"	"Systemic lupus erythematosus (SLE)"	1	40	208	248
"J42"	"H83"	"Unspecified chronic bronchitis"	"Other diseases of inner ear"	1	260	534	794
"I44"	"O62"	"Atrioventricular and left bundle-branch block"	"Abnormalities of forces of labor"	1	3	65	68
"M05"	"O42"	"Rheumatoid arthritis with rheumatoid factor"	"Premature rupture of membranes"	1	7	103	110
"K41"	"O62"	"Femoral hernia"	"Abnormalities of forces of labor"	1	5	118	123
"J96"	"K92"	"Respiratory failure, not elsewhere classified"	"Other diseases of digestive system"	1	2556	3925	6481
"D64"	"O64"	"Other anemias"	"Obstructed labor due to malposition and malpresent of fetus"	1	0	142	142
"J34"	"O03"	"Other and unspecified disorders of nose and nasal sinuses"	"Spontaneous abortion"	1	99	239	338
"D62"	"G44"	"Acute posthemorrhagic anemia"	"Other headache syndromes"	1	34	92	126
"M70"	"H83"	"Soft tissue disorders related to use, overuse and pressure"	"Other diseases of inner ear"	1	233	532	765
"O34"	"J30"	"Maternal care for abnormality of pelvic organs"	"Vasomotor and allergic rhinitis"	1	73	227	300
"M80"	"K42"	"Osteoporosis with current pathological fracture"	"Umbilical hernia"	1	62	243	305
"K74"	"O04"	"Fibrosis and cirrhosis of liver"	"Complications following (induced) termination of pregnancy"	1	0	35	35
"O89"	"O21"	"Complications of anesthesia during the puerperium"	"Excessive vomiting in pregnancy"	1	15	72	87
"I60"	"O80"	"Nontraumatic subarachnoid hemorrhage"	"Encounter for full-term uncomplicated delivery"	1	0	275	275
"K64"	"H43"	"Hemorrhoids and perianal venous thrombosis"	"Disorders of vitreous body"	1	26	307	333
"E55"	"O71"	"Vitamin D deficiency"	"Other obstetric trauma"	1	3	105	108
"C92"	"K80"	"Myeloid leukemia"	"Cholelithiasis"	1	38	166	204
"C77"	"N84"	"Secondary and unspecified malignant neoplasm of lymph nodes"	"Polyp of female genital tract"	1	51	222	273
"K59"	"K04"	"Other functional intestinal disorders"	"Diseases of pulp and periapical tissues"	1	541	1425	1966
"D23"	"J30"	"Other benign neoplasms of skin"	"Vasomotor and allergic rhinitis"	1	138	248	386
"C50"	"M20"	"Malignant neoplasm of breast"	"Acquired deformities of fingers and toes"	1	586	878	1464
"N81"	"L20"	"Female genital prolapse"	"Atopic dermatitis"	1	11	68	79
"I42"	"O03"	"Cardiomyopathy"	"Spontaneous abortion"	1	0	35	35
"D25"	"O64"	"Leiomyoma of uterus"	"Obstructed labor due to malposition and malpresent of fetus"	1	0	278	278
"M70"	"J36"	"Soft tissue disorders related to use, overuse and pressure"	"Peritonsillar abscess"	1	33	171	204
"M31"	"N60"	"Other necrotizing vasculopathies"	"Benign mammary dysplasia"	1	3	81	84
"C54"	"I83"	"Malignant neoplasm of corpus uteri"	"Varicose veins of lower extremities"	1	117	236	353
"H25"	"B25"	"Age-related cataract"	"Cytomegaloviral disease"	1	37	121	158
"K43"	"G43"	"Ventral hernia"	"Migraine"	1	119	234	353
"E86"	"I85"	"Volume depletion"	"Esophageal varices"	1	335	739	1074
"I15"	"O68"	"Secondary hypertension"	"Labor and delivery comp by abnlt of fetal acid-base balance"	1	25	165	190
"D64"	"M65"	"Other anemias"	"Synovitis and tenosynovitis"	1	177	1606	1783
"I10"	"O36"	"Essential (primary) hypertension"	"Maternal care for other fetal problems"	1	67	1033	1100
"H54"	"M17"	"Blindness and low vision"	"Osteoarthritis of knee"	1	123	578	701
"O26"	"O00"	"Maternal care for oth conditions predom related to pregnancy"	"Ectopic pregnancy"	1	632	1264	1896
"E03"	"D34"	"Other hypothyroidism"	"Benign neoplasm of thyroid gland"	1	28	249	277
"D11"	"O04"	"Benign neoplasm of major salivary glands"	"Complications following (induced) termination of pregnancy"	1	2	137	139
"F52"	"O70"	"Sexual dysfnct not due to a substance or known physiol cond"	"Perineal laceration during delivery"	1	129	229	358
"M13"	"F10"	"Other arthritis"	"Alcohol related disorders"	1	319	558	877
"M67"	"O03"	"Other disorders of synovium and tendon"	"Spontaneous abortion"	1	177	837	1014
"E87"	"M94"	"Other disorders of fluid, electrolyte and acid-base balance"	"Other disorders of cartilage"	1	1	33	34
"O34"	"J45"	"Maternal care for abnormality of pelvic organs"	"Asthma"	1	319	683	1002
"E65"	"O42"	"Localized adiposity"	"Premature rupture of membranes"	1	30	380	410
"N92"	"O87"	"Excessive, frequent and irregular menstruation"	"Venous complications and hemorrhoids in the puerperium"	1	0	226	226
"J47"	"K26"	"Bronchiectasis"	"Duodenal ulcer"	1	12	57	69
"F14"	"K35"	"Cocaine related disorders"	"Acute appendicitis"	1	3	65	68
"G95"	"D17"	"Other and unspecified diseases of spinal cord"	"Benign lipomatous neoplasm"	1	13	152	165
"M16"	"E04"	"Osteoarthritis of hip"	"Other nontoxic goiter"	1	496	856	1352
"J06"	"Q90"	"Acute upper resp infections of multiple and unsp sites"	"Down syndrome"	1	3	129	132
"C25"	"K11"	"Malignant neoplasm of pancreas"	"Diseases of salivary glands"	1	0	48	48
"M86"	"N81"	"Osteomyelitis"	"Female genital prolapse"	1	25	76	101
"G20"	"M16"	"Parkinson's disease"	"Osteoarthritis of hip"	1	188	965	1153
"N80"	"O80"	"Endometriosis"	"Encounter for full-term uncomplicated delivery"	1	592	1515	2107
"B37"	"M20"	"Candidiasis"	"Acquired deformities of fingers and toes"	1	62	253	315
"I20"	"N88"	"Angina pectoris"	"Other noninflammatory disorders of cervix uteri"	1	10	72	82
"I15"	"O70"	"Secondary hypertension"	"Perineal laceration during delivery"	1	22	183	205
"E10"	"N20"	"Type 1 diabetes mellitus"	"Calculus of kidney and ureter"	1	619	903	1522
"K05"	"C91"	"Gingivitis and periodontal diseases"	"Lymphoid leukemia"	1	62	141	203
"F05"	"N84"	"Delirium due to known physiological condition"	"Polyp of female genital tract"	1	0	98	98
"N18"	"G56"	"Chronic kidney disease (CKD)"	"Mononeuropathies of upper limb"	1	191	1439	1630
"J81"	"I20"	"Pulmonary edema"	"Angina pectoris"	1	1006	3102	4108
"L98"	"J32"	"Oth disorders of skin, subcu, not elsewhere classified"	"Chronic sinusitis"	1	34	144	178
"B18"	"O03"	"Chronic viral hepatitis"	"Spontaneous abortion"	1	30	183	213
"H65"	"Q32"	"Nonsuppurative otitis media"	"Congenital malformations of trachea and bronchus"	1	39	100	139
"L30"	"K60"	"Other and unspecified dermatitis"	"Fissure and fistula of anal and rectal regions"	1	212	433	645
"F33"	"M79"	"Major depressive disorder, recurrent"	"Oth and unsp soft tissue disorders, not elsewhere classified"	1	742	2020	2762
"K30"	"M62"	"Functional dyspepsia"	"Other disorders of muscle"	1	2099	3429	5528
"G30"	"M47"	"Alzheimer's disease"	"Spondylosis"	1	0	319	319
"O30"	"O00"	"Multiple gestation"	"Ectopic pregnancy"	1	201	779	980
"I63"	"Q18"	"Cerebral infarction"	"Other congenital malformations of face and neck"	1	10	67	77
"J44"	"N95"	"Other chronic obstructive pulmonary disease"	"Menopausal and other perimenopausal disorders"	1	800	1721	2521
"M51"	"O03"	"Thoracic, thoracolum, and lumbosacral intvrt disc disorders"	"Spontaneous abortion"	1	0	1326	1326
"M87"	"C61"	"Osteonecrosis"	"Malignant neoplasm of prostate"	1	31	95	126
"E13"	"E10"	"Other specified diabetes mellitus"	"Type 1 diabetes mellitus"	1	611	2482	3093
"I44"	"M54"	"Atrioventricular and left bundle-branch block"	"Dorsalgia"	1	558	1197	1755
"N99"	"O48"	"Intraop and postproc comp and disorders of GU sys, NEC"	"Late pregnancy"	1	24	127	151
"D50"	"O32"	"Iron deficiency anemia"	"Maternal care for malpresentation of fetus"	1	0	204	204
"N18"	"O20"	"Chronic kidney disease (CKD)"	"Hemorrhage in early pregnancy"	1	0	73	73
"E64"	"C56"	"Sequelae of malnutrition and other nutritional deficiencies"	"Malignant neoplasm of ovary"	1	15	83	98
"G82"	"G71"	"Paraplegia (paraparesis) and quadriplegia (quadriparesis)"	"Primary disorders of muscles"	1	5	120	125
"M20"	"I83"	"Acquired deformities of fingers and toes"	"Varicose veins of lower extremities"	1	948	1504	2452
"J44"	"J37"	"Other chronic obstructive pulmonary disease"	"Chronic laryngitis and laryngotracheitis"	1	234	834	1068
"E55"	"M20"	"Vitamin D deficiency"	"Acquired deformities of fingers and toes"	1	14	234	248
"E83"	"D24"	"Disorders of mineral metabolism"	"Benign neoplasm of breast"	1	0	107	107
"N45"	"L05"	"Orchitis and epididymitis"	"Pilonidal cyst and sinus"	1	49	120	169
"I78"	"F10"	"Diseases of capillaries"	"Alcohol related disorders"	1	87	186	273
"E06"	"O02"	"Thyroiditis"	"Other abnormal products of conception"	1	39	454	493
"F43"	"O34"	"Reaction to severe stress, and adjustment disorders"	"Maternal care for abnormality of pelvic organs"	1	94	283	377
"H33"	"D24"	"Retinal detachments and breaks"	"Benign neoplasm of breast"	1	20	124	144
"J18"	"H34"	"Pneumonia, unspecified organism"	"Retinal vascular occlusions"	1	644	1674	2318
"I15"	"O02"	"Secondary hypertension"	"Other abnormal products of conception"	1	8	89	97
"B34"	"O75"	"Viral infection of unspecified site"	"Oth complications of labor and delivery, NEC"	1	125	228	353
"J05"	"J00"	"Acute obstructive laryngitis [croup] and epiglottitis"	"Acute nasopharyngitis [common cold]"	1	1576	2174	3750
"M19"	"N87"	"Other and unspecified osteoarthritis"	"Dysplasia of cervix uteri"	1	0	378	378
"M79"	"Q54"	"Oth and unsp soft tissue disorders, not elsewhere classified"	"Hypospadias"	1	64	226	290
"F17"	"N92"	"Nicotine dependence"	"Excessive, frequent and irregular menstruation"	1	1051	2323	3374
"B37"	"I70"	"Candidiasis"	"Atherosclerosis"	1	415	805	1220
"C43"	"N87"	"Malignant melanoma of skin"	"Dysplasia of cervix uteri"	1	19	132	151
"C71"	"O80"	"Malignant neoplasm of brain"	"Encounter for full-term uncomplicated delivery"	1	0	89	89
"D63"	"M75"	"Anemia in chronic diseases classified elsewhere"	"Shoulder lesions"	1	44	726	770
"J95"	"H25"	"Intraop and postproc comp and disorders of resp sys, NEC"	"Age-related cataract"	1	197	604	801
"K74"	"M62"	"Fibrosis and cirrhosis of liver"	"Other disorders of muscle"	1	24	322	346
"G96"	"G40"	"Other disorders of central nervous system"	"Epilepsy and recurrent seizures"	1	1875	2890	4765
"I74"	"H83"	"Arterial embolism and thrombosis"	"Other diseases of inner ear"	1	18	150	168
"A41"	"O26"	"Other sepsis"	"Maternal care for oth conditions predom related to pregnancy"	1	13	190	203
"C22"	"K29"	"Malignant neoplasm of liver and intrahepatic bile ducts"	"Gastritis and duodenitis"	1	28	442	470
"Q65"	"A63"	"Congenital deformities of hip"	"Oth predominantly sexually transmitted diseases, NEC"	1	12	50	62
"M16"	"M24"	"Osteoarthritis of hip"	"Other specific joint derangements"	1	861	1136	1997
"O14"	"J35"	"Pre-eclampsia"	"Chronic diseases of tonsils and adenoids"	1	41	523	564
"A41"	"H18"	"Other sepsis"	"Other disorders of cornea"	1	145	482	627
"J32"	"E84"	"Chronic sinusitis"	"Cystic fibrosis"	1	0	43	43
"I26"	"J45"	"Pulmonary embolism"	"Asthma"	1	761	1561	2322
"A09"	"M62"	"Infectious gastroenteritis and colitis, unspecified"	"Other disorders of muscle"	1	1647	2411	4058
"M07"	"O64"	"Enteropathic arthropathies"	"Obstructed labor due to malposition and malpresent of fetus"	1	0	54	54
"I69"	"O71"	"Sequelae of cerebrovascular disease"	"Other obstetric trauma"	1	0	28	28
"C78"	"D23"	"Secondary malignant neoplasm of resp and digestive organs"	"Other benign neoplasms of skin"	1	17	752	769
"O91"	"O82"	"Infect of breast assoc w pregnancy, the puerp and lactation"	"Encounter for cesarean delivery without indication"	1	0	4144	4144
"H57"	"N43"	"Other disorders of eye and adnexa"	"Hydrocele and spermatocele"	1	15	106	121
"G97"	"O32"	"Intraop and postproc comp and disorders of nervous sys, NEC"	"Maternal care for malpresentation of fetus"	1	3	34	37
"H92"	"O70"	"Otalgia and effusion of ear"	"Perineal laceration during delivery"	1	39	113	152
"N18"	"K85"	"Chronic kidney disease (CKD)"	"Acute pancreatitis"	1	318	640	958
"J90"	"M23"	"Pleural effusion, not elsewhere classified"	"Internal derangement of knee"	1	17	532	549
"I61"	"H25"	"Nontraumatic intracerebral hemorrhage"	"Age-related cataract"	1	1008	3464	4472
"K59"	"D07"	"Other functional intestinal disorders"	"Carcinoma in situ of other and unspecified genital organs"	1	53	227	280
"L50"	"J00"	"Urticaria"	"Acute nasopharyngitis [common cold]"	1	214	671	885
"M96"	"M17"	"Intraop and postproc comp and disorders of ms sys, NEC"	"Osteoarthritis of knee"	1	202	355	557
"J43"	"N43"	"Emphysema"	"Hydrocele and spermatocele"	1	28	116	144
"J81"	"H36"	"Pulmonary edema"	"Retinal disorders in diseases classified elsewhere"	1	88	369	457
"K92"	"J38"	"Other diseases of digestive system"	"Diseases of vocal cords and larynx, not elsewhere classified"	1	123	313	436
"C15"	"D17"	"Malignant neoplasm of esophagus"	"Benign lipomatous neoplasm"	1	1	91	92
"M19"	"H72"	"Other and unspecified osteoarthritis"	"Perforation of tympanic membrane"	1	37	173	210
"B07"	"N19"	"Viral warts"	"Unspecified kidney failure"	1	32	170	202
"K72"	"N94"	"Hepatic failure, not elsewhere classified"	"Pain and oth cond assoc w fem gntl org and menstrual cycle"	1	2	32	34
"E87"	"Q66"	"Other disorders of fluid, electrolyte and acid-base balance"	"Congenital deformities of feet"	1	20	91	111
"C78"	"H02"	"Secondary malignant neoplasm of resp and digestive organs"	"Other disorders of eyelid"	1	67	758	825
"N18"	"D31"	"Chronic kidney disease (CKD)"	"Benign neoplasm of eye and adnexa"	1	12	65	77
"C15"	"I35"	"Malignant neoplasm of esophagus"	"Nonrheumatic aortic valve disorders"	1	87	176	263
"I87"	"O32"	"Other disorders of veins"	"Maternal care for malpresentation of fetus"	1	0	28	28
"G31"	"G96"	"Oth degenerative diseases of nervous system, NEC"	"Other disorders of central nervous system"	1	189	338	527
"I48"	"H25"	"Atrial fibrillation and flutter"	"Age-related cataract"	1	0	41557	41557
"N61"	"N83"	"Inflammatory disorders of breast"	"Noninflammatory disord of ovary, fallop and broad ligament"	1	93	179	272
"C65"	"N40"	"Malignant neoplasm of renal pelvis"	"Benign prostatic hyperplasia"	1	69	164	233
"O47"	"L20"	"False labor"	"Atopic dermatitis"	1	26	162	188
"K57"	"K05"	"Diverticular disease of intestine"	"Gingivitis and periodontal diseases"	1	276	495	771
"C78"	"N39"	"Secondary malignant neoplasm of resp and digestive organs"	"Other disorders of urinary system"	1	1266	2174	3440
"K91"	"N81"	"Intraop and postproc comp and disorders of dgstv sys, NEC"	"Female genital prolapse"	1	31	181	212
"J35"	"L20"	"Chronic diseases of tonsils and adenoids"	"Atopic dermatitis"	1	541	752	1293
"D84"	"K52"	"Other immunodeficiencies"	"Other and unsp noninfective gastroenteritis and colitis"	1	46	112	158
"C78"	"H44"	"Secondary malignant neoplasm of resp and digestive organs"	"Disorders of globe"	1	15	140	155
"C79"	"G57"	"Secondary malignant neoplasm of other and unspecified sites"	"Mononeuropathies of lower limb"	1	14	164	178
"I26"	"M67"	"Pulmonary embolism"	"Other disorders of synovium and tendon"	1	67	325	392
"C15"	"M70"	"Malignant neoplasm of esophagus"	"Soft tissue disorders related to use, overuse and pressure"	1	0	101	101
"M25"	"O66"	"Other joint disorder, not elsewhere classified"	"Other obstructed labor"	1	14	208	222
"M70"	"O20"	"Soft tissue disorders related to use, overuse and pressure"	"Hemorrhage in early pregnancy"	1	36	334	370
"I13"	"E10"	"Hypertensive heart and chronic kidney disease"	"Type 1 diabetes mellitus"	1	100	196	296
"E86"	"D50"	"Volume depletion"	"Iron deficiency anemia"	1	3314	4140	7454
"M47"	"O42"	"Spondylosis"	"Premature rupture of membranes"	1	0	139	139
"G47"	"D16"	"Sleep disorders"	"Benign neoplasm of bone and articular cartilage"	1	21	189	210
"J09"	"E78"	"Influenza due to certain identified influenza viruses"	"Disorders of lipoprotein metabolism and other lipidemias"	1	22	347	369
"N28"	"H93"	"Oth disorders of kidney and ureter, not elsewhere classified"	"Other disorders of ear, not elsewhere classified"	1	5	234	239
"G43"	"N87"	"Migraine"	"Dysplasia of cervix uteri"	1	224	443	667
"N89"	"N87"	"Other noninflammatory disorders of vagina"	"Dysplasia of cervix uteri"	1	206	401	607
"K59"	"C10"	"Other functional intestinal disorders"	"Malignant neoplasm of oropharynx"	1	119	359	478
"I27"	"K57"	"Other pulmonary heart diseases"	"Diverticular disease of intestine"	1	294	535	829
"M79"	"O42"	"Oth and unsp soft tissue disorders, not elsewhere classified"	"Premature rupture of membranes"	1	513	839	1352
"J91"	"C20"	"Pleural effusion in conditions classified elsewhere"	"Malignant neoplasm of rectum"	1	33	201	234
"N84"	"O82"	"Polyp of female genital tract"	"Encounter for cesarean delivery without indication"	1	39	864	903
"C15"	"K35"	"Malignant neoplasm of esophagus"	"Acute appendicitis"	1	0	50	50
"G30"	"N95"	"Alzheimer's disease"	"Menopausal and other perimenopausal disorders"	1	1	182	183
"I95"	"J33"	"Hypotension"	"Nasal polyp"	1	3	49	52
"I31"	"M79"	"Other diseases of pericardium"	"Oth and unsp soft tissue disorders, not elsewhere classified"	1	95	200	295
"H30"	"O04"	"Chorioretinal inflammation"	"Complications following (induced) termination of pregnancy"	1	4	45	49
"E87"	"C44"	"Other disorders of fluid, electrolyte and acid-base balance"	"Other and unspecified malignant neoplasm of skin"	1	664	1714	2378
"O69"	"O20"	"Labor and delivery complicated by umbilical cord comp"	"Hemorrhage in early pregnancy"	1	119	270	389
"M13"	"O82"	"Other arthritis"	"Encounter for cesarean delivery without indication"	1	66	350	416
"F43"	"O91"	"Reaction to severe stress, and adjustment disorders"	"Infect of breast assoc w pregnancy, the puerp and lactation"	1	22	71	93
"M70"	"O64"	"Soft tissue disorders related to use, overuse and pressure"	"Obstructed labor due to malposition and malpresent of fetus"	1	8	172	180
"M51"	"O13"	"Thoracic, thoracolum, and lumbosacral intvrt disc disorders"	"Gestational hypertension without significant proteinuria"	1	30	212	242
"H35"	"O71"	"Other retinal disorders"	"Other obstetric trauma"	1	0	44	44
"C16"	"M23"	"Malignant neoplasm of stomach"	"Internal derangement of knee"	1	0	243	243
"D64"	"J34"	"Other anemias"	"Other and unspecified disorders of nose and nasal sinuses"	1	34	396	430
"E04"	"O99"	"Other nontoxic goiter"	"Oth maternal diseases classd elsw but compl preg/chldbrth"	1	581	1340	1921
"I69"	"J38"	"Sequelae of cerebrovascular disease"	"Diseases of vocal cords and larynx, not elsewhere classified"	1	210	564	774
"I69"	"I60"	"Sequelae of cerebrovascular disease"	"Nontraumatic subarachnoid hemorrhage"	1	1796	3128	4924
"M53"	"O70"	"Other and unspecified dorsopathies, not elsewhere classified"	"Perineal laceration during delivery"	1	156	1052	1208
"K60"	"H66"	"Fissure and fistula of anal and rectal regions"	"Suppurative and unspecified otitis media"	1	72	167	239
"C77"	"M18"	"Secondary and unspecified malignant neoplasm of lymph nodes"	"Osteoarthritis of first carpometacarpal joint"	1	29	94	123
"K92"	"D16"	"Other diseases of digestive system"	"Benign neoplasm of bone and articular cartilage"	1	23	90	113
"I47"	"F10"	"Paroxysmal tachycardia"	"Alcohol related disorders"	1	1046	1333	2379
"I89"	"K05"	"Oth noninfective disorders of lymphatic vessels and nodes"	"Gingivitis and periodontal diseases"	1	85	166	251
"I49"	"J36"	"Other cardiac arrhythmias"	"Peritonsillar abscess"	1	17	88	105
"K63"	"H43"	"Other diseases of intestine"	"Disorders of vitreous body"	1	47	117	164
"E86"	"M66"	"Volume depletion"	"Spontaneous rupture of synovium and tendon"	1	36	227	263
"M80"	"M06"	"Osteoporosis with current pathological fracture"	"Other rheumatoid arthritis"	1	333	1379	1712
"C71"	"D24"	"Malignant neoplasm of brain"	"Benign neoplasm of breast"	1	0	53	53
"J15"	"N50"	"Bacterial pneumonia, not elsewhere classified"	"Other and unspecified disorders of male genital organs"	1	101	285	386
"O43"	"O03"	"Placental disorders"	"Spontaneous abortion"	1	69	213	282
"N47"	"Q25"	"Disorders of prepuce"	"Congenital malformations of great arteries"	1	3	78	81
"K92"	"M17"	"Other diseases of digestive system"	"Osteoarthritis of knee"	1	0	3462	3462
"M35"	"D24"	"Other systemic involvement of connective tissue"	"Benign neoplasm of breast"	1	131	263	394
"H16"	"D33"	"Keratitis"	"Benign neoplasm of brain and oth prt central nervous system"	1	19	89	108
"M84"	"O80"	"Disorder of continuity of bone"	"Encounter for full-term uncomplicated delivery"	1	7	119	126
"M53"	"O02"	"Other and unspecified dorsopathies, not elsewhere classified"	"Other abnormal products of conception"	1	40	348	388
"N73"	"O65"	"Other female pelvic inflammatory diseases"	"Obstructed labor due to maternal pelvic abnormality"	1	31	111	142
"D25"	"O91"	"Leiomyoma of uterus"	"Infect of breast assoc w pregnancy, the puerp and lactation"	1	1	58	59
"N08"	"F10"	"Glomerular disorders in diseases classified elsewhere"	"Alcohol related disorders"	1	1	38	39
"N39"	"K85"	"Other disorders of urinary system"	"Acute pancreatitis"	1	563	1031	1594
"E86"	"M05"	"Volume depletion"	"Rheumatoid arthritis with rheumatoid factor"	1	138	1509	1647
"L97"	"D14"	"Non-pressure chronic ulcer of lower limb, NEC"	"Benign neoplasm of middle ear and respiratory system"	1	7	93	100
"K72"	"M62"	"Hepatic failure, not elsewhere classified"	"Other disorders of muscle"	1	21	336	357
"F05"	"I48"	"Delirium due to known physiological condition"	"Atrial fibrillation and flutter"	1	1838	4709	6547
"J15"	"N80"	"Bacterial pneumonia, not elsewhere classified"	"Endometriosis"	1	10	161	171
"N18"	"I42"	"Chronic kidney disease (CKD)"	"Cardiomyopathy"	1	698	1639	2337
"M67"	"H72"	"Other disorders of synovium and tendon"	"Perforation of tympanic membrane"	1	64	153	217
"C77"	"O62"	"Secondary and unspecified malignant neoplasm of lymph nodes"	"Abnormalities of forces of labor"	1	0	159	159
"A41"	"H44"	"Other sepsis"	"Disorders of globe"	1	57	268	325
"I10"	"B27"	"Essential (primary) hypertension"	"Infectious mononucleosis"	1	11	123	134
"C78"	"N80"	"Secondary malignant neoplasm of resp and digestive organs"	"Endometriosis"	1	0	82	82
"D22"	"C43"	"Melanocytic nevi"	"Malignant melanoma of skin"	1	0	5874	5874
"I45"	"F10"	"Other conduction disorders"	"Alcohol related disorders"	1	238	389	627
"C85"	"K40"	"Oth and unspecified types of non-Hodgkin lymphoma"	"Inguinal hernia"	1	115	322	437
"A46"	"L03"	"Erysipelas"	"Cellulitis and acute lymphangitis"	1	1002	1515	2517
"E87"	"M72"	"Other disorders of fluid, electrolyte and acid-base balance"	"Fibroblastic disorders"	1	55	1003	1058
"I42"	"H66"	"Cardiomyopathy"	"Suppurative and unspecified otitis media"	1	14	72	86
"N18"	"A88"	"Chronic kidney disease (CKD)"	"Oth viral infections of central nervous system, NEC"	1	0	44	44
"I63"	"M66"	"Cerebral infarction"	"Spontaneous rupture of synovium and tendon"	1	67	159	226
"F33"	"N75"	"Major depressive disorder, recurrent"	"Diseases of Bartholin's gland"	1	7	70	77
"I35"	"N75"	"Nonrheumatic aortic valve disorders"	"Diseases of Bartholin's gland"	1	0	28	28
"M07"	"O02"	"Enteropathic arthropathies"	"Other abnormal products of conception"	1	0	116	116
"N17"	"M23"	"Acute kidney failure"	"Internal derangement of knee"	1	0	611	611
"K31"	"D17"	"Other diseases of stomach and duodenum"	"Benign lipomatous neoplasm"	1	26	77	103
"N18"	"D12"	"Chronic kidney disease (CKD)"	"Benign neoplasm of colon, rectum, anus and anal canal"	1	877	2437	3314
"C79"	"N63"	"Secondary malignant neoplasm of other and unspecified sites"	"Unspecified lump in breast"	1	0	1160	1160
"O34"	"O04"	"Maternal care for abnormality of pelvic organs"	"Complications following (induced) termination of pregnancy"	1	0	3074	3074
"L90"	"K35"	"Atrophic disorders of skin"	"Acute appendicitis"	1	136	745	881
"K59"	"Q53"	"Other functional intestinal disorders"	"Undescended and ectopic testicle"	1	281	625	906
"I51"	"M75"	"Complications and ill-defined descriptions of heart disease"	"Shoulder lesions"	1	199	612	811
"I61"	"N20"	"Nontraumatic intracerebral hemorrhage"	"Calculus of kidney and ureter"	1	63	363	426
"J15"	"H50"	"Bacterial pneumonia, not elsewhere classified"	"Other strabismus"	1	93	422	515
"K75"	"H91"	"Other inflammatory liver diseases"	"Other and unspecified hearing loss"	1	72	172	244
"D27"	"Q17"	"Benign neoplasm of ovary"	"Other congenital malformations of ear"	1	2	32	34
"M25"	"N20"	"Other joint disorder, not elsewhere classified"	"Calculus of kidney and ureter"	1	448	660	1108
"N19"	"C53"	"Unspecified kidney failure"	"Malignant neoplasm of cervix uteri"	1	44	159	203
"A48"	"K40"	"Other bacterial diseases, not elsewhere classified"	"Inguinal hernia"	1	25	78	103
"J69"	"K59"	"Pneumonitis due to solids and liquids"	"Other functional intestinal disorders"	1	442	1330	1772
"D22"	"L02"	"Melanocytic nevi"	"Cutaneous abscess, furuncle and carbuncle"	1	118	332	450
"C15"	"M16"	"Malignant neoplasm of esophagus"	"Osteoarthritis of hip"	1	4	371	375
"E78"	"N46"	"Disorders of lipoprotein metabolism and other lipidemias"	"Male infertility"	1	9	286	295
"J15"	"O70"	"Bacterial pneumonia, not elsewhere classified"	"Perineal laceration during delivery"	1	56	768	824
"M67"	"O26"	"Other disorders of synovium and tendon"	"Maternal care for oth conditions predom related to pregnancy"	1	339	634	973
"B37"	"C61"	"Candidiasis"	"Malignant neoplasm of prostate"	1	142	346	488
"G95"	"G43"	"Other and unspecified diseases of spinal cord"	"Migraine"	1	13	80	93
"G30"	"I95"	"Alzheimer's disease"	"Hypotension"	1	178	370	548
"M16"	"J45"	"Osteoarthritis of hip"	"Asthma"	1	1336	1639	2975
"K76"	"H91"	"Other diseases of liver"	"Other and unspecified hearing loss"	1	423	790	1213
"M51"	"O46"	"Thoracic, thoracolum, and lumbosacral intvrt disc disorders"	"Antepartum hemorrhage, not elsewhere classified"	1	3	328	331
"I95"	"J32"	"Hypotension"	"Chronic sinusitis"	1	14	87	101
"L97"	"I20"	"Non-pressure chronic ulcer of lower limb, NEC"	"Angina pectoris"	1	0	2987	2987
"K59"	"N97"	"Other functional intestinal disorders"	"Female infertility"	1	289	1040	1329
"D63"	"D62"	"Anemia in chronic diseases classified elsewhere"	"Acute posthemorrhagic anemia"	1	514	696	1210
"K72"	"F32"	"Hepatic failure, not elsewhere classified"	"Depressive episode"	1	179	353	532
"I72"	"O04"	"Other aneurysm"	"Complications following (induced) termination of pregnancy"	1	0	28	28
"H25"	"O62"	"Age-related cataract"	"Abnormalities of forces of labor"	1	0	89	89
"M75"	"J37"	"Shoulder lesions"	"Chronic laryngitis and laryngotracheitis"	1	117	313	430
"E83"	"G45"	"Disorders of mineral metabolism"	"Transient cerebral ischemic attacks and related syndromes"	1	77	464	541
"D36"	"O04"	"Benign neoplasm of other and unspecified sites"	"Complications following (induced) termination of pregnancy"	1	3	74	77
"C25"	"A08"	"Malignant neoplasm of pancreas"	"Viral and other specified intestinal infections"	1	6	54	60
"G44"	"I60"	"Other headache syndromes"	"Nontraumatic subarachnoid hemorrhage"	1	320	559	879
"N62"	"H10"	"Hypertrophy of breast"	"Conjunctivitis"	1	138	338	476
"I48"	"Q20"	"Atrial fibrillation and flutter"	"Congenital malformations of cardiac chambers and connections"	1	13	58	71
"K40"	"O04"	"Inguinal hernia"	"Complications following (induced) termination of pregnancy"	1	114	313	427
"H53"	"Q53"	"Visual disturbances"	"Undescended and ectopic testicle"	1	10	107	117
"J86"	"M23"	"Pyothorax"	"Internal derangement of knee"	1	46	144	190
"K80"	"O60"	"Cholelithiasis"	"Preterm labor"	1	43	440	483
"K04"	"K35"	"Diseases of pulp and periapical tissues"	"Acute appendicitis"	1	76	189	265
"K70"	"F11"	"Alcoholic liver disease"	"Opioid related disorders"	1	104	224	328
"J84"	"N40"	"Other interstitial pulmonary diseases"	"Benign prostatic hyperplasia"	1	212	654	866
"M13"	"O80"	"Other arthritis"	"Encounter for full-term uncomplicated delivery"	1	21	1122	1143
"H26"	"H40"	"Other cataract"	"Glaucoma"	1	2888	4473	7361
"N46"	"C62"	"Male infertility"	"Malignant neoplasm of testis"	1	163	435	598
"J44"	"L04"	"Other chronic obstructive pulmonary disease"	"Acute lymphadenitis"	1	33	159	192
"C77"	"J03"	"Secondary and unspecified malignant neoplasm of lymph nodes"	"Acute tonsillitis"	1	7	66	73
"G62"	"A69"	"Other and unspecified polyneuropathies"	"Other spirochetal infections"	1	62	132	194
"H02"	"O36"	"Other disorders of eyelid"	"Maternal care for other fetal problems"	1	17	143	160
"N76"	"O62"	"Other inflammation of vagina and vulva"	"Abnormalities of forces of labor"	1	565	1053	1618
"F41"	"C61"	"Other anxiety disorders"	"Malignant neoplasm of prostate"	1	90	997	1087
"N60"	"O91"	"Benign mammary dysplasia"	"Infect of breast assoc w pregnancy, the puerp and lactation"	1	82	179	261
"C18"	"N95"	"Malignant neoplasm of colon"	"Menopausal and other perimenopausal disorders"	1	166	524	690
"M76"	"O02"	"Enthesopathies, lower limb, excluding foot"	"Other abnormal products of conception"	1	100	233	333
"D52"	"G40"	"Folate deficiency anemia"	"Epilepsy and recurrent seizures"	1	22	81	103
"K60"	"J30"	"Fissure and fistula of anal and rectal regions"	"Vasomotor and allergic rhinitis"	1	97	204	301
"E87"	"N06"	"Other disorders of fluid, electrolyte and acid-base balance"	"Isolated proteinuria with specified morphological lesion"	1	31	101	132
"I83"	"O00"	"Varicose veins of lower extremities"	"Ectopic pregnancy"	1	0	306	306
"E11"	"D48"	"Type 2 diabetes mellitus"	"Neoplasm of uncertain behavior of other and unsp sites"	1	124	224	348
"K59"	"D86"	"Other functional intestinal disorders"	"Sarcoidosis"	1	121	275	396
"J09"	"K80"	"Influenza due to certain identified influenza viruses"	"Cholelithiasis"	1	0	170	170
"N31"	"O03"	"Neuromuscular dysfunction of bladder, NEC"	"Spontaneous abortion"	1	4	64	68
"K21"	"O42"	"Gastro-esophageal reflux disease"	"Premature rupture of membranes"	1	52	332	384
"M81"	"D23"	"Osteoporosis without current pathological fracture"	"Other benign neoplasms of skin"	1	319	980	1299
"J18"	"B91"	"Pneumonia, unspecified organism"	"Sequelae of poliomyelitis"	1	110	289	399
"H47"	"G80"	"Other disorders of optic [2nd] nerve and visual pathways"	"Cerebral palsy"	1	71	354	425
"H49"	"D32"	"Paralytic strabismus"	"Benign neoplasm of meninges"	1	88	170	258
"B37"	"I83"	"Candidiasis"	"Varicose veins of lower extremities"	1	175	524	699
"K43"	"O63"	"Ventral hernia"	"Long labor"	1	0	127	127
"O45"	"A63"	"Premature separation of placenta [abruptio placentae]"	"Oth predominantly sexually transmitted diseases, NEC"	1	12	69	81
"O82"	"Q17"	"Encounter for cesarean delivery without indication"	"Other congenital malformations of ear"	1	0	141	141
"L89"	"G62"	"Pressure ulcer"	"Other and unspecified polyneuropathies"	1	165	567	732
"I61"	"K58"	"Nontraumatic intracerebral hemorrhage"	"Irritable bowel syndrome"	1	23	213	236
"K72"	"C20"	"Hepatic failure, not elsewhere classified"	"Malignant neoplasm of rectum"	1	29	101	130
"G44"	"L03"	"Other headache syndromes"	"Cellulitis and acute lymphangitis"	1	82	280	362
"H71"	"J05"	"Cholesteatoma of middle ear"	"Acute obstructive laryngitis [croup] and epiglottitis"	1	0	48	48
"K59"	"Q76"	"Other functional intestinal disorders"	"Congenital malformations of spine and bony thorax"	1	17	125	142
"Q61"	"H93"	"Cystic kidney disease"	"Other disorders of ear, not elsewhere classified"	1	29	150	179
"K22"	"O68"	"Other diseases of esophagus"	"Labor and delivery comp by abnlt of fetal acid-base balance"	1	22	85	107
"E03"	"H81"	"Other hypothyroidism"	"Disorders of vestibular function"	1	612	804	1416
"C79"	"M41"	"Secondary malignant neoplasm of other and unspecified sites"	"Scoliosis"	1	10	97	107
"N99"	"O42"	"Intraop and postproc comp and disorders of GU sys, NEC"	"Premature rupture of membranes"	1	37	146	183
"O33"	"O68"	"Maternal care for disproportion"	"Labor and delivery comp by abnlt of fetal acid-base balance"	1	243	465	708
"N61"	"M62"	"Inflammatory disorders of breast"	"Other disorders of muscle"	1	111	288	399
"J44"	"L72"	"Other chronic obstructive pulmonary disease"	"Follicular cysts of skin and subcutaneous tissue"	1	145	399	544
"M81"	"D39"	"Osteoporosis without current pathological fracture"	"Neoplasm of uncertain behavior of female genital organs"	1	1	115	116
"I08"	"I34"	"Multiple valve diseases"	"Nonrheumatic mitral valve disorders"	1	116	404	520
"K29"	"O00"	"Gastritis and duodenitis"	"Ectopic pregnancy"	1	55	184	239
"K02"	"J03"	"Dental caries"	"Acute tonsillitis"	1	129	272	401
"I89"	"N80"	"Oth noninfective disorders of lymphatic vessels and nodes"	"Endometriosis"	1	3	51	54
"C16"	"M65"	"Malignant neoplasm of stomach"	"Synovitis and tenosynovitis"	1	3	152	155
"G30"	"C20"	"Alzheimer's disease"	"Malignant neoplasm of rectum"	1	9	127	136
"M75"	"J36"	"Shoulder lesions"	"Peritonsillar abscess"	1	65	537	602
"E61"	"K56"	"Deficiency of other nutrient elements"	"Paralytic ileus and intestinal obstruction without hernia"	1	65	138	203
"N39"	"O40"	"Other disorders of urinary system"	"Polyhydramnios"	1	30	92	122
"L40"	"O68"	"Psoriasis"	"Labor and delivery comp by abnlt of fetal acid-base balance"	1	71	264	335
"M25"	"M23"	"Other joint disorder, not elsewhere classified"	"Internal derangement of knee"	1	4331	6157	10488
"H01"	"M16"	"Other inflammation of eyelid"	"Osteoarthritis of hip"	1	68	181	249
"N20"	"J34"	"Calculus of kidney and ureter"	"Other and unspecified disorders of nose and nasal sinuses"	1	261	581	842
"E11"	"D17"	"Type 2 diabetes mellitus"	"Benign lipomatous neoplasm"	1	740	1396	2136
"K74"	"M23"	"Fibrosis and cirrhosis of liver"	"Internal derangement of knee"	1	12	298	310
"F06"	"G45"	"Other mental disorders due to known physiological condition"	"Transient cerebral ischemic attacks and related syndromes"	1	112	476	588
"C16"	"M75"	"Malignant neoplasm of stomach"	"Shoulder lesions"	1	13	327	340
"D05"	"O62"	"Carcinoma in situ of breast"	"Abnormalities of forces of labor"	1	0	60	60
"E89"	"O75"	"Postproc endocrine and metabolic comp and disorders, NEC"	"Oth complications of labor and delivery, NEC"	1	7	56	63
"D64"	"H26"	"Other anemias"	"Other cataract"	1	0	5996	5996
"O72"	"N63"	"Postpartum hemorrhage"	"Unspecified lump in breast"	1	1066	1924	2990
"O23"	"L20"	"Infections of genitourinary tract in pregnancy"	"Atopic dermatitis"	1	12	132	144
"K52"	"K25"	"Other and unsp noninfective gastroenteritis and colitis"	"Gastric ulcer"	1	995	1747	2742
"C77"	"K35"	"Secondary and unspecified malignant neoplasm of lymph nodes"	"Acute appendicitis"	1	12	232	244
"B37"	"M17"	"Candidiasis"	"Osteoarthritis of knee"	1	178	908	1086
"J06"	"O02"	"Acute upper resp infections of multiple and unsp sites"	"Other abnormal products of conception"	1	7	299	306
"M16"	"Q54"	"Osteoarthritis of hip"	"Hypospadias"	1	10	83	93
"L30"	"M16"	"Other and unspecified dermatitis"	"Osteoarthritis of hip"	1	382	676	1058
"M47"	"O75"	"Spondylosis"	"Oth complications of labor and delivery, NEC"	1	0	66	66
"J15"	"C85"	"Bacterial pneumonia, not elsewhere classified"	"Oth and unspecified types of non-Hodgkin lymphoma"	1	233	737	970
"K59"	"M32"	"Other functional intestinal disorders"	"Systemic lupus erythematosus (SLE)"	1	37	152	189
"J37"	"N92"	"Chronic laryngitis and laryngotracheitis"	"Excessive, frequent and irregular menstruation"	1	55	148	203
"J01"	"O02"	"Acute sinusitis"	"Other abnormal products of conception"	1	59	349	408
"O68"	"Q52"	"Labor and delivery comp by abnlt of fetal acid-base balance"	"Other congenital malformations of female genitalia"	1	5	59	64
"K59"	"C01"	"Other functional intestinal disorders"	"Malignant neoplasm of base of tongue"	1	41	123	164
"H18"	"H33"	"Other disorders of cornea"	"Retinal detachments and breaks"	1	164	417	581
"O70"	"H66"	"Perineal laceration during delivery"	"Suppurative and unspecified otitis media"	1	72	384	456
"H43"	"H10"	"Disorders of vitreous body"	"Conjunctivitis"	1	226	422	648
"D14"	"K35"	"Benign neoplasm of middle ear and respiratory system"	"Acute appendicitis"	1	51	123	174
"D34"	"O70"	"Benign neoplasm of thyroid gland"	"Perineal laceration during delivery"	1	8	214	222
"J96"	"Q05"	"Respiratory failure, not elsewhere classified"	"Spina bifida"	1	4	36	40
"J18"	"C73"	"Pneumonia, unspecified organism"	"Malignant neoplasm of thyroid gland"	1	101	264	365
"D17"	"H65"	"Benign lipomatous neoplasm"	"Nonsuppurative otitis media"	1	55	198	253
"I27"	"N92"	"Other pulmonary heart diseases"	"Excessive, frequent and irregular menstruation"	1	7	157	164
"M79"	"O02"	"Oth and unsp soft tissue disorders, not elsewhere classified"	"Other abnormal products of conception"	1	487	1495	1982
"D63"	"N43"	"Anemia in chronic diseases classified elsewhere"	"Hydrocele and spermatocele"	1	6	213	219
"E78"	"N81"	"Disorders of lipoprotein metabolism and other lipidemias"	"Female genital prolapse"	1	1479	3419	4898
"E50"	"H91"	"Vitamin A deficiency"	"Other and unspecified hearing loss"	1	23	235	258
"O68"	"M08"	"Labor and delivery comp by abnlt of fetal acid-base balance"	"Juvenile arthritis"	1	0	39	39
"K42"	"M65"	"Umbilical hernia"	"Synovitis and tenosynovitis"	1	293	488	781
"H18"	"O99"	"Other disorders of cornea"	"Oth maternal diseases classd elsw but compl preg/chldbrth"	1	41	171	212
"O42"	"O03"	"Premature rupture of membranes"	"Spontaneous abortion"	1	2456	4923	7379
"I21"	"N94"	"Acute myocardial infarction"	"Pain and oth cond assoc w fem gntl org and menstrual cycle"	1	5	179	184
"N30"	"J05"	"Cystitis"	"Acute obstructive laryngitis [croup] and epiglottitis"	1	32	579	611
"N81"	"O82"	"Female genital prolapse"	"Encounter for cesarean delivery without indication"	1	229	895	1124
"K80"	"D06"	"Cholelithiasis"	"Carcinoma in situ of cervix uteri"	1	23	297	320
"F06"	"I21"	"Other mental disorders due to known physiological condition"	"Acute myocardial infarction"	1	108	404	512
"M80"	"M45"	"Osteoporosis with current pathological fracture"	"Ankylosing spondylitis"	1	20	74	94
"I48"	"M93"	"Atrial fibrillation and flutter"	"Other osteochondropathies"	1	0	101	101
"I73"	"N62"	"Other peripheral vascular diseases"	"Hypertrophy of breast"	1	113	268	381
"L97"	"D30"	"Non-pressure chronic ulcer of lower limb, NEC"	"Benign neoplasm of urinary organs"	1	38	237	275
"N18"	"M47"	"Chronic kidney disease (CKD)"	"Spondylosis"	1	107	1152	1259
"A41"	"E51"	"Other sepsis"	"Thiamine deficiency"	1	75	163	238
"O99"	"K29"	"Oth maternal diseases classd elsw but compl preg/chldbrth"	"Gastritis and duodenitis"	1	676	1044	1720
"M81"	"H81"	"Osteoporosis without current pathological fracture"	"Disorders of vestibular function"	1	974	2100	3074
"F01"	"N81"	"Vascular dementia"	"Female genital prolapse"	1	0	278	278
"A46"	"O34"	"Erysipelas"	"Maternal care for abnormality of pelvic organs"	1	22	75	97
"J43"	"N80"	"Emphysema"	"Endometriosis"	1	2	35	37
"O36"	"E10"	"Maternal care for other fetal problems"	"Type 1 diabetes mellitus"	1	69	319	388
"D64"	"A88"	"Other anemias"	"Oth viral infections of central nervous system, NEC"	1	0	126	126
"C93"	"H91"	"Monocytic leukemia"	"Other and unspecified hearing loss"	1	6	78	84
"J15"	"A46"	"Bacterial pneumonia, not elsewhere classified"	"Erysipelas"	1	1812	3305	5117
"Q95"	"O03"	"Balanced rearrangements and structural markers, NEC"	"Spontaneous abortion"	1	5	40	45
"I46"	"K44"	"Cardiac arrest"	"Diaphragmatic hernia"	1	1	766	767
"E25"	"H25"	"Adrenogenital disorders"	"Age-related cataract"	1	88	219	307
"K57"	"I21"	"Diverticular disease of intestine"	"Acute myocardial infarction"	1	2391	3473	5864
"J22"	"C61"	"Unspecified acute lower respiratory infection"	"Malignant neoplasm of prostate"	1	105	245	350
"J15"	"G80"	"Bacterial pneumonia, not elsewhere classified"	"Cerebral palsy"	1	107	358	465
"C71"	"K35"	"Malignant neoplasm of brain"	"Acute appendicitis"	1	5	68	73
"N11"	"E11"	"Chronic tubulo-interstitial nephritis"	"Type 2 diabetes mellitus"	1	119	323	442
"G45"	"O02"	"Transient cerebral ischemic attacks and related syndromes"	"Other abnormal products of conception"	1	0	142	142
"M23"	"L05"	"Internal derangement of knee"	"Pilonidal cyst and sinus"	1	376	700	1076
"E68"	"E11"	"Sequelae of hyperalimentation"	"Type 2 diabetes mellitus"	1	106	637	743
"M85"	"K21"	"Other disorders of bone density and structure"	"Gastro-esophageal reflux disease"	1	337	1553	1890
"O80"	"L70"	"Encounter for full-term uncomplicated delivery"	"Acne"	1	202	318	520
"L30"	"D27"	"Other and unspecified dermatitis"	"Benign neoplasm of ovary"	1	34	178	212
"K31"	"G56"	"Other diseases of stomach and duodenum"	"Mononeuropathies of upper limb"	1	57	204	261
"I73"	"H93"	"Other peripheral vascular diseases"	"Other disorders of ear, not elsewhere classified"	1	203	980	1183
"E29"	"M23"	"Testicular dysfunction"	"Internal derangement of knee"	1	31	145	176
"E55"	"M22"	"Vitamin D deficiency"	"Disorder of patella"	1	0	111	111
"E78"	"N94"	"Disorders of lipoprotein metabolism and other lipidemias"	"Pain and oth cond assoc w fem gntl org and menstrual cycle"	1	8	744	752
"G63"	"O80"	"Polyneuropathy in diseases classified elsewhere"	"Encounter for full-term uncomplicated delivery"	1	0	28	28
"F05"	"C43"	"Delirium due to known physiological condition"	"Malignant melanoma of skin"	1	13	259	272
"J45"	"J20"	"Asthma"	"Acute bronchitis"	1	10825	15980	26805
"O02"	"K35"	"Other abnormal products of conception"	"Acute appendicitis"	1	327	767	1094
"I24"	"N81"	"Other acute ischemic heart diseases"	"Female genital prolapse"	1	50	140	190
"D64"	"H50"	"Other anemias"	"Other strabismus"	1	75	362	437
"E63"	"I21"	"Other nutritional deficiencies"	"Acute myocardial infarction"	1	46	119	165
"D47"	"M67"	"Oth neoplm of uncrt behav of lymphoid, hematpoetc & rel tiss"	"Other disorders of synovium and tendon"	1	5	117	122
"D50"	"J38"	"Iron deficiency anemia"	"Diseases of vocal cords and larynx, not elsewhere classified"	1	49	204	253
"H18"	"N97"	"Other disorders of cornea"	"Female infertility"	1	3	78	81
"G95"	"I70"	"Other and unspecified diseases of spinal cord"	"Atherosclerosis"	1	106	273	379
"N19"	"M41"	"Unspecified kidney failure"	"Scoliosis"	1	20	69	89
"F43"	"M89"	"Reaction to severe stress, and adjustment disorders"	"Other disorders of bone"	1	53	122	175
"J18"	"D27"	"Pneumonia, unspecified organism"	"Benign neoplasm of ovary"	1	210	1328	1538
"I35"	"H25"	"Nonrheumatic aortic valve disorders"	"Age-related cataract"	1	0	13796	13796
"J93"	"J45"	"Pneumothorax and air leak"	"Asthma"	1	345	688	1033
"D64"	"O28"	"Other anemias"	"Abnormal findings on antenatal screening of mother"	1	14	68	82
"O48"	"O02"	"Late pregnancy"	"Other abnormal products of conception"	1	2018	2944	4962
"N12"	"B34"	"Tubulo-interstitial nephritis, not spcf as acute or chronic"	"Viral infection of unspecified site"	1	205	363	568
"E55"	"I21"	"Vitamin D deficiency"	"Acute myocardial infarction"	1	168	798	966
"I44"	"K51"	"Atrioventricular and left bundle-branch block"	"Ulcerative colitis"	1	48	133	181
"N39"	"C20"	"Other disorders of urinary system"	"Malignant neoplasm of rectum"	1	449	1514	1963
"I50"	"K57"	"Heart failure"	"Diverticular disease of intestine"	1	4254	5708	9962
"I25"	"M02"	"Chronic ischemic heart disease"	"Postinfective and reactive arthropathies"	1	266	404	670
"M22"	"Q53"	"Disorder of patella"	"Undescended and ectopic testicle"	1	0	98	98
"A41"	"I26"	"Other sepsis"	"Pulmonary embolism"	1	2147	2680	4827
"E64"	"K21"	"Sequelae of malnutrition and other nutritional deficiencies"	"Gastro-esophageal reflux disease"	1	193	646	839
"M90"	"K40"	"Osteopathies in diseases classified elsewhere"	"Inguinal hernia"	1	2	58	60
"J95"	"N81"	"Intraop and postproc comp and disorders of resp sys, NEC"	"Female genital prolapse"	1	1	71	72
"M47"	"K80"	"Spondylosis"	"Cholelithiasis"	1	1213	1720	2933
"I20"	"J35"	"Angina pectoris"	"Chronic diseases of tonsils and adenoids"	1	67	413	480
"D14"	"N87"	"Benign neoplasm of middle ear and respiratory system"	"Dysplasia of cervix uteri"	1	10	56	66
"A49"	"N19"	"Bacterial infection of unspecified site"	"Unspecified kidney failure"	1	923	1597	2520
"K76"	"M65"	"Other diseases of liver"	"Synovitis and tenosynovitis"	1	132	353	485
"K72"	"E78"	"Hepatic failure, not elsewhere classified"	"Disorders of lipoprotein metabolism and other lipidemias"	1	85	520	605
"I33"	"M65"	"Acute and subacute endocarditis"	"Synovitis and tenosynovitis"	1	18	83	101
"I78"	"K40"	"Diseases of capillaries"	"Inguinal hernia"	1	97	185	282
"Q61"	"M72"	"Cystic kidney disease"	"Fibroblastic disorders"	1	17	75	92
"K62"	"O63"	"Other diseases of anus and rectum"	"Long labor"	1	14	232	246
"I46"	"G50"	"Cardiac arrest"	"Disorders of trigeminal nerve"	1	4	44	48
"L57"	"C54"	"Skin changes due to chronic expsr to nonionizing radiation"	"Malignant neoplasm of corpus uteri"	1	7	43	50
"E83"	"H93"	"Disorders of mineral metabolism"	"Other disorders of ear, not elsewhere classified"	1	11	279	290
"C78"	"C64"	"Secondary malignant neoplasm of resp and digestive organs"	"Malignant neoplasm of kidney, except renal pelvis"	1	1193	2311	3504
"N08"	"H35"	"Glomerular disorders in diseases classified elsewhere"	"Other retinal disorders"	1	49	122	171
"O08"	"J36"	"Complications following ectopic and molar pregnancy"	"Peritonsillar abscess"	1	13	123	136
"N30"	"L72"	"Cystitis"	"Follicular cysts of skin and subcutaneous tissue"	1	194	349	543
"M85"	"M35"	"Other disorders of bone density and structure"	"Other systemic involvement of connective tissue"	1	1034	1892	2926
"J96"	"N31"	"Respiratory failure, not elsewhere classified"	"Neuromuscular dysfunction of bladder, NEC"	1	125	634	759
"Q65"	"O68"	"Congenital deformities of hip"	"Labor and delivery comp by abnlt of fetal acid-base balance"	1	28	138	166
"C79"	"C13"	"Secondary malignant neoplasm of other and unspecified sites"	"Malignant neoplasm of hypopharynx"	1	31	113	144
"G96"	"D24"	"Other disorders of central nervous system"	"Benign neoplasm of breast"	1	0	189	189
"N98"	"J35"	"Complications associated with artificial fertilization"	"Chronic diseases of tonsils and adenoids"	1	0	40	40
"K25"	"H93"	"Gastric ulcer"	"Other disorders of ear, not elsewhere classified"	1	438	843	1281
"C25"	"H40"	"Malignant neoplasm of pancreas"	"Glaucoma"	1	6	211	217
"J84"	"I21"	"Other interstitial pulmonary diseases"	"Acute myocardial infarction"	1	431	711	1142
"N17"	"D05"	"Acute kidney failure"	"Carcinoma in situ of breast"	1	0	30	30
"N19"	"H91"	"Unspecified kidney failure"	"Other and unspecified hearing loss"	1	0	3379	3379
"O90"	"A09"	"Complications of the puerperium, not elsewhere classified"	"Infectious gastroenteritis and colitis, unspecified"	1	86	252	338
"M75"	"D17"	"Shoulder lesions"	"Benign lipomatous neoplasm"	1	1589	2054	3643
"N12"	"O68"	"Tubulo-interstitial nephritis, not spcf as acute or chronic"	"Labor and delivery comp by abnlt of fetal acid-base balance"	1	58	131	189
"A46"	"N92"	"Erysipelas"	"Excessive, frequent and irregular menstruation"	1	24	782	806
"K62"	"K01"	"Other diseases of anus and rectum"	"Embedded and impacted teeth"	1	52	165	217
"M54"	"O36"	"Dorsalgia"	"Maternal care for other fetal problems"	1	632	1385	2017
"M47"	"O24"	"Spondylosis"	"Diabetes in pregnancy, childbirth, and the puerperium"	1	0	76	76
"K74"	"M47"	"Fibrosis and cirrhosis of liver"	"Spondylosis"	1	49	200	249
"Q23"	"J45"	"Congenital malformations of aortic and mitral valves"	"Asthma"	1	74	177	251
"M75"	"O10"	"Shoulder lesions"	"Pre-existing hypertension compl preg/chldbrth"	1	5	111	116
"C15"	"M71"	"Malignant neoplasm of esophagus"	"Other bursopathies"	1	0	37	37
"D64"	"M16"	"Other anemias"	"Osteoarthritis of hip"	1	0	7972	7972
"L29"	"K60"	"Pruritus"	"Fissure and fistula of anal and rectal regions"	1	216	343	559
"G47"	"N70"	"Sleep disorders"	"Salpingitis and oophoritis"	1	0	117	117
"D63"	"N94"	"Anemia in chronic diseases classified elsewhere"	"Pain and oth cond assoc w fem gntl org and menstrual cycle"	1	0	53	53
"K59"	"E84"	"Other functional intestinal disorders"	"Cystic fibrosis"	1	16	105	121
"C18"	"H33"	"Malignant neoplasm of colon"	"Retinal detachments and breaks"	1	67	283	350
"K72"	"K35"	"Hepatic failure, not elsewhere classified"	"Acute appendicitis"	1	9	73	82
"C73"	"O04"	"Malignant neoplasm of thyroid gland"	"Complications following (induced) termination of pregnancy"	1	0	67	67
"K43"	"K57"	"Ventral hernia"	"Diverticular disease of intestine"	1	1745	2904	4649
"K05"	"C81"	"Gingivitis and periodontal diseases"	"Hodgkin lymphoma"	1	43	184	227
"I70"	"I20"	"Atherosclerosis"	"Angina pectoris"	1	0	14775	14775
"C18"	"N92"	"Malignant neoplasm of colon"	"Excessive, frequent and irregular menstruation"	1	0	408	408
"K59"	"H50"	"Other functional intestinal disorders"	"Other strabismus"	1	444	796	1240
"C44"	"I10"	"Other and unspecified malignant neoplasm of skin"	"Essential (primary) hypertension"	1	6118	8589	14707
"M80"	"M65"	"Osteoporosis with current pathological fracture"	"Synovitis and tenosynovitis"	1	36	741	777
"I15"	"O72"	"Secondary hypertension"	"Postpartum hemorrhage"	1	149	255	404
"N30"	"H34"	"Cystitis"	"Retinal vascular occlusions"	1	476	1062	1538
"D64"	"H93"	"Other anemias"	"Other disorders of ear, not elsewhere classified"	1	0	2204	2204
"M76"	"L02"	"Enthesopathies, lower limb, excluding foot"	"Cutaneous abscess, furuncle and carbuncle"	1	351	501	852
"I21"	"O68"	"Acute myocardial infarction"	"Labor and delivery comp by abnlt of fetal acid-base balance"	1	0	72	72
"E83"	"K81"	"Disorders of mineral metabolism"	"Cholecystitis"	1	47	141	188
"E04"	"D25"	"Other nontoxic goiter"	"Leiomyoma of uterus"	1	665	1236	1901
"N30"	"D10"	"Cystitis"	"Benign neoplasm of mouth and pharynx"	1	270	407	677
"C44"	"H53"	"Other and unspecified malignant neoplasm of skin"	"Visual disturbances"	1	209	333	542
"J94"	"K57"	"Other pleural conditions"	"Diverticular disease of intestine"	1	136	290	426
"N19"	"K25"	"Unspecified kidney failure"	"Gastric ulcer"	1	783	1427	2210
"I10"	"J03"	"Essential (primary) hypertension"	"Acute tonsillitis"	1	409	1049	1458
"I42"	"M75"	"Cardiomyopathy"	"Shoulder lesions"	1	276	600	876
"D27"	"O03"	"Benign neoplasm of ovary"	"Spontaneous abortion"	1	305	799	1104
"K60"	"O26"	"Fissure and fistula of anal and rectal regions"	"Maternal care for oth conditions predom related to pregnancy"	1	143	411	554
"H53"	"M65"	"Visual disturbances"	"Synovitis and tenosynovitis"	1	193	476	669
"C22"	"H90"	"Malignant neoplasm of liver and intrahepatic bile ducts"	"Conductive and sensorineural hearing loss"	1	1	119	120
"L50"	"J35"	"Urticaria"	"Chronic diseases of tonsils and adenoids"	1	303	679	982
"N30"	"N92"	"Cystitis"	"Excessive, frequent and irregular menstruation"	1	1863	4053	5916
"M62"	"O26"	"Other disorders of muscle"	"Maternal care for oth conditions predom related to pregnancy"	1	1368	1832	3200
"M35"	"O03"	"Other systemic involvement of connective tissue"	"Spontaneous abortion"	1	100	273	373
"D22"	"N03"	"Melanocytic nevi"	"Chronic nephritic syndrome"	1	1	52	53
"M50"	"O91"	"Cervical disc disorders"	"Infect of breast assoc w pregnancy, the puerp and lactation"	1	0	55	55
"D33"	"J35"	"Benign neoplasm of brain and oth prt central nervous system"	"Chronic diseases of tonsils and adenoids"	1	12	77	89
"G60"	"G62"	"Hereditary and idiopathic neuropathy"	"Other and unspecified polyneuropathies"	1	336	583	919
"M75"	"K80"	"Shoulder lesions"	"Cholelithiasis"	1	2417	4092	6509
"D13"	"N40"	"Benign neoplasm of and ill-defined parts of digestive system"	"Benign prostatic hyperplasia"	1	105	264	369
"J94"	"K40"	"Other pleural conditions"	"Inguinal hernia"	1	75	371	446
"E16"	"C54"	"Other disorders of pancreatic internal secretion"	"Malignant neoplasm of corpus uteri"	1	10	50	60
"J43"	"D30"	"Emphysema"	"Benign neoplasm of urinary organs"	1	74	153	227
"I73"	"G35"	"Other peripheral vascular diseases"	"Multiple sclerosis"	1	23	77	100
"A04"	"K70"	"Other bacterial intestinal infections"	"Alcoholic liver disease"	1	277	590	867
"C77"	"N92"	"Secondary and unspecified malignant neoplasm of lymph nodes"	"Excessive, frequent and irregular menstruation"	1	0	552	552
"K02"	"M51"	"Dental caries"	"Thoracic, thoracolum, and lumbosacral intvrt disc disorders"	1	113	385	498
"M17"	"O41"	"Osteoarthritis of knee"	"Other disorders of amniotic fluid and membranes"	1	0	57	57
"L57"	"H93"	"Skin changes due to chronic expsr to nonionizing radiation"	"Other disorders of ear, not elsewhere classified"	1	45	332	377
"C91"	"M50"	"Lymphoid leukemia"	"Cervical disc disorders"	1	6	62	68
"I25"	"M72"	"Chronic ischemic heart disease"	"Fibroblastic disorders"	1	954	1761	2715
"K70"	"M17"	"Alcoholic liver disease"	"Osteoarthritis of knee"	1	304	604	908
"H47"	"O62"	"Other disorders of optic [2nd] nerve and visual pathways"	"Abnormalities of forces of labor"	1	9	112	121
"E20"	"O70"	"Hypoparathyroidism"	"Perineal laceration during delivery"	1	4	36	40
"F03"	"C54"	"Unspecified dementia"	"Malignant neoplasm of corpus uteri"	1	13	257	270
"C77"	"M35"	"Secondary and unspecified malignant neoplasm of lymph nodes"	"Other systemic involvement of connective tissue"	1	61	214	275
"G47"	"H81"	"Sleep disorders"	"Disorders of vestibular function"	1	270	840	1110
"I69"	"Q18"	"Sequelae of cerebrovascular disease"	"Other congenital malformations of face and neck"	1	5	76	81
"E78"	"L02"	"Disorders of lipoprotein metabolism and other lipidemias"	"Cutaneous abscess, furuncle and carbuncle"	1	1322	2835	4157
"O75"	"H66"	"Oth complications of labor and delivery, NEC"	"Suppurative and unspecified otitis media"	1	14	70	84
"E88"	"M17"	"Other and unspecified metabolic disorders"	"Osteoarthritis of knee"	1	183	310	493
"C22"	"C44"	"Malignant neoplasm of liver and intrahepatic bile ducts"	"Other and unspecified malignant neoplasm of skin"	1	18	174	192
"M79"	"D25"	"Oth and unsp soft tissue disorders, not elsewhere classified"	"Leiomyoma of uterus"	1	1021	2367	3388
"I27"	"E05"	"Other pulmonary heart diseases"	"Thyrotoxicosis [hyperthyroidism]"	1	146	388	534
"J84"	"O70"	"Other interstitial pulmonary diseases"	"Perineal laceration during delivery"	1	0	63	63
"D24"	"K35"	"Benign neoplasm of breast"	"Acute appendicitis"	1	174	335	509
"D50"	"H71"	"Iron deficiency anemia"	"Cholesteatoma of middle ear"	1	7	52	59
"I25"	"O08"	"Chronic ischemic heart disease"	"Complications following ectopic and molar pregnancy"	1	0	33	33
"M51"	"O68"	"Thoracic, thoracolum, and lumbosacral intvrt disc disorders"	"Labor and delivery comp by abnlt of fetal acid-base balance"	1	0	1954	1954
"F01"	"I47"	"Vascular dementia"	"Paroxysmal tachycardia"	1	42	350	392
"I48"	"N46"	"Atrial fibrillation and flutter"	"Male infertility"	1	6	174	180
"I72"	"H93"	"Other aneurysm"	"Other disorders of ear, not elsewhere classified"	1	15	159	174
"G45"	"I20"	"Transient cerebral ischemic attacks and related syndromes"	"Angina pectoris"	1	3299	5787	9086
"C22"	"I69"	"Malignant neoplasm of liver and intrahepatic bile ducts"	"Sequelae of cerebrovascular disease"	1	54	238	292
"C15"	"M20"	"Malignant neoplasm of esophagus"	"Acquired deformities of fingers and toes"	1	0	89	89
"M46"	"O42"	"Other inflammatory spondylopathies"	"Premature rupture of membranes"	1	7	99	106
"H02"	"N40"	"Other disorders of eyelid"	"Benign prostatic hyperplasia"	1	432	1260	1692
"C79"	"O64"	"Secondary malignant neoplasm of other and unspecified sites"	"Obstructed labor due to malposition and malpresent of fetus"	1	0	25	25
"J44"	"Q66"	"Other chronic obstructive pulmonary disease"	"Congenital deformities of feet"	1	73	153	226
"H33"	"D27"	"Retinal detachments and breaks"	"Benign neoplasm of ovary"	1	28	93	121
"J45"	"Q37"	"Asthma"	"Cleft palate with cleft lip"	1	36	158	194
"J69"	"M51"	"Pneumonitis due to solids and liquids"	"Thoracic, thoracolum, and lumbosacral intvrt disc disorders"	1	0	286	286
"E05"	"K00"	"Thyrotoxicosis [hyperthyroidism]"	"Disorders of tooth development and eruption"	1	2	43	45
"I25"	"M62"	"Chronic ischemic heart disease"	"Other disorders of muscle"	1	3081	5503	8584
"A41"	"O30"	"Other sepsis"	"Multiple gestation"	1	1	54	55
"M54"	"K40"	"Dorsalgia"	"Inguinal hernia"	1	2808	3576	6384
"D63"	"H52"	"Anemia in chronic diseases classified elsewhere"	"Disorders of refraction and accommodation"	1	15	101	116
"J15"	"K30"	"Bacterial pneumonia, not elsewhere classified"	"Functional dyspepsia"	1	0	2995	2995
"I10"	"M70"	"Essential (primary) hypertension"	"Soft tissue disorders related to use, overuse and pressure"	1	3078	3968	7046
"G43"	"O80"	"Migraine"	"Encounter for full-term uncomplicated delivery"	1	0	4438	4438
"A41"	"Q05"	"Other sepsis"	"Spina bifida"	1	0	43	43
"H91"	"Q96"	"Other and unspecified hearing loss"	"Turner's syndrome"	1	14	63	77
"I10"	"O44"	"Essential (primary) hypertension"	"Placenta previa"	1	0	63	63
"F03"	"K20"	"Unspecified dementia"	"Esophagitis"	1	257	857	1114
"I69"	"N92"	"Sequelae of cerebrovascular disease"	"Excessive, frequent and irregular menstruation"	1	0	1033	1033
"J98"	"M71"	"Other respiratory disorders"	"Other bursopathies"	1	22	85	107
"I95"	"I15"	"Hypotension"	"Secondary hypertension"	1	235	429	664
"E89"	"E06"	"Postproc endocrine and metabolic comp and disorders, NEC"	"Thyroiditis"	1	74	167	241
"J15"	"D45"	"Bacterial pneumonia, not elsewhere classified"	"Polycythemia vera"	1	30	189	219
"I83"	"O28"	"Varicose veins of lower extremities"	"Abnormal findings on antenatal screening of mother"	1	16	217	233
"E83"	"O20"	"Disorders of mineral metabolism"	"Hemorrhage in early pregnancy"	1	0	47	47
"M21"	"J20"	"Other acquired deformities of limbs"	"Acute bronchitis"	1	55	467	522
"E89"	"D61"	"Postproc endocrine and metabolic comp and disorders, NEC"	"Oth aplastic anemias and other bone marrow failure syndromes"	1	9	70	79
"K80"	"N80"	"Cholelithiasis"	"Endometriosis"	1	287	682	969
"J96"	"O48"	"Respiratory failure, not elsewhere classified"	"Late pregnancy"	1	0	28	28
"I82"	"N60"	"Other venous embolism and thrombosis"	"Benign mammary dysplasia"	1	1	97	98
"K63"	"E78"	"Other diseases of intestine"	"Disorders of lipoprotein metabolism and other lipidemias"	1	398	1338	1736
"G40"	"Q90"	"Epilepsy and recurrent seizures"	"Down syndrome"	1	162	300	462
"N20"	"O86"	"Calculus of kidney and ureter"	"Other puerperal infections"	1	37	104	141
"C56"	"D24"	"Malignant neoplasm of ovary"	"Benign neoplasm of breast"	1	34	129	163
"E66"	"H72"	"Overweight and obesity"	"Perforation of tympanic membrane"	1	76	427	503
"H18"	"J35"	"Other disorders of cornea"	"Chronic diseases of tonsils and adenoids"	1	0	101	101
"O34"	"O12"	"Maternal care for abnormality of pelvic organs"	"Gestational edema and proteinuria without hypertension"	1	353	535	888
"M05"	"O26"	"Rheumatoid arthritis with rheumatoid factor"	"Maternal care for oth conditions predom related to pregnancy"	1	2	129	131
"M85"	"M13"	"Other disorders of bone density and structure"	"Other arthritis"	1	333	840	1173
"O72"	"E86"	"Postpartum hemorrhage"	"Volume depletion"	1	184	546	730
"O65"	"B27"	"Obstructed labor due to maternal pelvic abnormality"	"Infectious mononucleosis"	1	0	39	39
"I27"	"M77"	"Other pulmonary heart diseases"	"Other enthesopathies"	1	9	64	73
"O10"	"O04"	"Pre-existing hypertension compl preg/chldbrth"	"Complications following (induced) termination of pregnancy"	1	101	383	484
"G95"	"H66"	"Other and unspecified diseases of spinal cord"	"Suppurative and unspecified otitis media"	1	0	50	50
"I80"	"H66"	"Phlebitis and thrombophlebitis"	"Suppurative and unspecified otitis media"	1	47	240	287
"K57"	"K40"	"Diverticular disease of intestine"	"Inguinal hernia"	1	0	5559	5559
"N50"	"N40"	"Other and unspecified disorders of male genital organs"	"Benign prostatic hyperplasia"	1	477	743	1220
"H26"	"K20"	"Other cataract"	"Esophagitis"	1	307	474	781
"G25"	"J45"	"Other extrapyramidal and movement disorders"	"Asthma"	1	100	330	430
"K58"	"D24"	"Irritable bowel syndrome"	"Benign neoplasm of breast"	1	237	428	665
"C77"	"I70"	"Secondary and unspecified malignant neoplasm of lymph nodes"	"Atherosclerosis"	1	117	634	751
"G44"	"O42"	"Other headache syndromes"	"Premature rupture of membranes"	1	124	375	499
"K63"	"E05"	"Other diseases of intestine"	"Thyrotoxicosis [hyperthyroidism]"	1	90	268	358
"A09"	"J00"	"Infectious gastroenteritis and colitis, unspecified"	"Acute nasopharyngitis [common cold]"	1	2220	3327	5547
"L89"	"L02"	"Pressure ulcer"	"Cutaneous abscess, furuncle and carbuncle"	1	447	1148	1595
"O72"	"N11"	"Postpartum hemorrhage"	"Chronic tubulo-interstitial nephritis"	1	11	136	147
"F01"	"G62"	"Vascular dementia"	"Other and unspecified polyneuropathies"	1	62	247	309
"M16"	"K60"	"Osteoarthritis of hip"	"Fissure and fistula of anal and rectal regions"	1	200	446	646
"I51"	"M72"	"Complications and ill-defined descriptions of heart disease"	"Fibroblastic disorders"	1	41	186	227
"K85"	"O20"	"Acute pancreatitis"	"Hemorrhage in early pregnancy"	1	28	214	242
"C25"	"C44"	"Malignant neoplasm of pancreas"	"Other and unspecified malignant neoplasm of skin"	1	21	295	316
"N30"	"M72"	"Cystitis"	"Fibroblastic disorders"	1	410	1518	1928
"E83"	"O68"	"Disorders of mineral metabolism"	"Labor and delivery comp by abnlt of fetal acid-base balance"	1	0	71	71
"I26"	"N40"	"Pulmonary embolism"	"Benign prostatic hyperplasia"	1	370	1633	2003
"H18"	"H91"	"Other disorders of cornea"	"Other and unspecified hearing loss"	1	490	992	1482
"E68"	"M17"	"Sequelae of hyperalimentation"	"Osteoarthritis of knee"	1	212	403	615
"B02"	"M31"	"Zoster [herpes zoster]"	"Other necrotizing vasculopathies"	1	71	163	234
"B36"	"M51"	"Other superficial mycoses"	"Thoracic, thoracolum, and lumbosacral intvrt disc disorders"	1	31	116	147
"N13"	"O04"	"Obstructive and reflux uropathy"	"Complications following (induced) termination of pregnancy"	1	68	426	494
"O34"	"O13"	"Maternal care for abnormality of pelvic organs"	"Gestational hypertension without significant proteinuria"	1	622	939	1561
"J90"	"M47"	"Pleural effusion, not elsewhere classified"	"Spondylosis"	1	51	408	459
"L90"	"O80"	"Atrophic disorders of skin"	"Encounter for full-term uncomplicated delivery"	1	286	1949	2235
"H54"	"E10"	"Blindness and low vision"	"Type 1 diabetes mellitus"	1	177	559	736
"H93"	"O32"	"Other disorders of ear, not elsewhere classified"	"Maternal care for malpresentation of fetus"	1	10	95	105
"O71"	"M41"	"Other obstetric trauma"	"Scoliosis"	1	8	68	76
"A63"	"M92"	"Oth predominantly sexually transmitted diseases, NEC"	"Other juvenile osteochondrosis"	1	0	34	34
"G62"	"K51"	"Other and unspecified polyneuropathies"	"Ulcerative colitis"	1	50	212	262
"C48"	"N92"	"Malignant neoplasm of retroperitoneum and peritoneum"	"Excessive, frequent and irregular menstruation"	1	0	39	39
"A46"	"D48"	"Erysipelas"	"Neoplasm of uncertain behavior of other and unsp sites"	1	29	105	134
"J86"	"G56"	"Pyothorax"	"Mononeuropathies of upper limb"	1	48	123	171
"M51"	"O12"	"Thoracic, thoracolum, and lumbosacral intvrt disc disorders"	"Gestational edema and proteinuria without hypertension"	1	5	126	131
"C71"	"J42"	"Malignant neoplasm of brain"	"Unspecified chronic bronchitis"	1	17	91	108
"I46"	"E16"	"Cardiac arrest"	"Other disorders of pancreatic internal secretion"	1	55	663	718
"A49"	"K41"	"Bacterial infection of unspecified site"	"Femoral hernia"	1	3	93	96
"A41"	"C71"	"Other sepsis"	"Malignant neoplasm of brain"	1	256	494	750
"F60"	"O62"	"Specific personality disorders"	"Abnormalities of forces of labor"	1	46	167	213
"I72"	"L02"	"Other aneurysm"	"Cutaneous abscess, furuncle and carbuncle"	1	114	217	331
"F44"	"O04"	"Dissociative and conversion disorders"	"Complications following (induced) termination of pregnancy"	1	18	127	145
"K62"	"G45"	"Other diseases of anus and rectum"	"Transient cerebral ischemic attacks and related syndromes"	1	1165	1953	3118
"M16"	"H93"	"Osteoarthritis of hip"	"Other disorders of ear, not elsewhere classified"	1	831	1664	2495
"M51"	"Q53"	"Thoracic, thoracolum, and lumbosacral intvrt disc disorders"	"Undescended and ectopic testicle"	1	0	88	88
"K25"	"F10"	"Gastric ulcer"	"Alcohol related disorders"	1	2521	3698	6219
"E87"	"G62"	"Other disorders of fluid, electrolyte and acid-base balance"	"Other and unspecified polyneuropathies"	1	684	1445	2129
"J96"	"G80"	"Respiratory failure, not elsewhere classified"	"Cerebral palsy"	1	148	396	544
"C77"	"M53"	"Secondary and unspecified malignant neoplasm of lymph nodes"	"Other and unspecified dorsopathies, not elsewhere classified"	1	33	167	200
"H25"	"N85"	"Age-related cataract"	"Other noninflammatory disorders of uterus, except cervix"	1	64	351	415
"K25"	"O03"	"Gastric ulcer"	"Spontaneous abortion"	1	4	162	166
"M43"	"H80"	"Other deforming dorsopathies"	"Otosclerosis"	1	7	45	52
"C21"	"M17"	"Malignant neoplasm of anus and anal canal"	"Osteoarthritis of knee"	1	22	81	103
"I50"	"O26"	"Heart failure"	"Maternal care for oth conditions predom related to pregnancy"	1	0	38	38
"N17"	"D17"	"Acute kidney failure"	"Benign lipomatous neoplasm"	1	8	240	248
"N88"	"D06"	"Other noninflammatory disorders of cervix uteri"	"Carcinoma in situ of cervix uteri"	1	28	311	339
"G35"	"O42"	"Multiple sclerosis"	"Premature rupture of membranes"	1	20	126	146
"C61"	"M51"	"Malignant neoplasm of prostate"	"Thoracic, thoracolum, and lumbosacral intvrt disc disorders"	1	168	1466	1634
"C82"	"D25"	"Follicular lymphoma"	"Leiomyoma of uterus"	1	6	46	52
"C24"	"M51"	"Malignant neoplasm of other and unsp parts of biliary tract"	"Thoracic, thoracolum, and lumbosacral intvrt disc disorders"	1	0	110	110
"D22"	"H90"	"Melanocytic nevi"	"Conductive and sensorineural hearing loss"	1	81	167	248
"I26"	"G35"	"Pulmonary embolism"	"Multiple sclerosis"	1	4	83	87
"M48"	"N63"	"Other spondylopathies"	"Unspecified lump in breast"	1	86	528	614
"I49"	"D17"	"Other cardiac arrhythmias"	"Benign lipomatous neoplasm"	1	226	482	708
"F41"	"H81"	"Other anxiety disorders"	"Disorders of vestibular function"	1	254	744	998
"N99"	"D25"	"Intraop and postproc comp and disorders of GU sys, NEC"	"Leiomyoma of uterus"	1	113	862	975
"E64"	"K29"	"Sequelae of malnutrition and other nutritional deficiencies"	"Gastritis and duodenitis"	1	249	751	1000
"J22"	"M54"	"Unspecified acute lower respiratory infection"	"Dorsalgia"	1	122	779	901
"L82"	"O80"	"Seborrheic keratosis"	"Encounter for full-term uncomplicated delivery"	1	0	193	193
"H54"	"H26"	"Blindness and low vision"	"Other cataract"	1	397	740	1137
"C61"	"H61"	"Malignant neoplasm of prostate"	"Other disorders of external ear"	1	52	151	203
"L04"	"J05"	"Acute lymphadenitis"	"Acute obstructive laryngitis [croup] and epiglottitis"	1	65	163	228
"B94"	"A87"	"Sequelae of other and unsp infectious and parasitic diseases"	"Viral meningitis"	1	11	68	79
"C79"	"N97"	"Secondary malignant neoplasm of other and unspecified sites"	"Female infertility"	1	0	87	87
"M81"	"O14"	"Osteoporosis without current pathological fracture"	"Pre-eclampsia"	1	0	38	38
"M51"	"H65"	"Thoracic, thoracolum, and lumbosacral intvrt disc disorders"	"Nonsuppurative otitis media"	1	182	345	527
"H43"	"E04"	"Disorders of vitreous body"	"Other nontoxic goiter"	1	125	292	417
"C54"	"N71"	"Malignant neoplasm of corpus uteri"	"Inflammatory disease of uterus, except cervix"	1	55	129	184
"K46"	"M51"	"Unspecified abdominal hernia"	"Thoracic, thoracolum, and lumbosacral intvrt disc disorders"	1	34	139	173
"I95"	"H91"	"Hypotension"	"Other and unspecified hearing loss"	1	0	3092	3092
"N95"	"M20"	"Menopausal and other perimenopausal disorders"	"Acquired deformities of fingers and toes"	1	577	775	1352
"J18"	"E10"	"Pneumonia, unspecified organism"	"Type 1 diabetes mellitus"	1	6388	10511	16899
"N13"	"D17"	"Obstructive and reflux uropathy"	"Benign lipomatous neoplasm"	1	91	211	302
"M86"	"L08"	"Osteomyelitis"	"Other local infections of skin and subcutaneous tissue"	1	320	478	798
"E64"	"C50"	"Sequelae of malnutrition and other nutritional deficiencies"	"Malignant neoplasm of breast"	1	15	243	258
"K64"	"G47"	"Hemorrhoids and perianal venous thrombosis"	"Sleep disorders"	1	430	883	1313
"C15"	"M47"	"Malignant neoplasm of esophagus"	"Spondylosis"	1	6	170	176
"K60"	"O46"	"Fissure and fistula of anal and rectal regions"	"Antepartum hemorrhage, not elsewhere classified"	1	28	107	135
"D63"	"C51"	"Anemia in chronic diseases classified elsewhere"	"Malignant neoplasm of vulva"	1	11	67	78
"K59"	"Q82"	"Other functional intestinal disorders"	"Other congenital malformations of skin"	1	116	266	382
"J10"	"D12"	"Influenza due to other identified influenza virus"	"Benign neoplasm of colon, rectum, anus and anal canal"	1	32	163	195
"O62"	"N97"	"Abnormalities of forces of labor"	"Female infertility"	1	0	27743	27743
"K05"	"K80"	"Gingivitis and periodontal diseases"	"Cholelithiasis"	1	246	379	625
"J18"	"G71"	"Pneumonia, unspecified organism"	"Primary disorders of muscles"	1	153	325	478
"G90"	"I25"	"Disorders of autonomic nervous system"	"Chronic ischemic heart disease"	1	271	416	687
"C92"	"E05"	"Myeloid leukemia"	"Thyrotoxicosis [hyperthyroidism]"	1	14	72	86
"I20"	"O26"	"Angina pectoris"	"Maternal care for oth conditions predom related to pregnancy"	1	0	223	223
"G98"	"M76"	"Other disorders of nervous system not elsewhere classified"	"Enthesopathies, lower limb, excluding foot"	1	31	116	147
"M81"	"M67"	"Osteoporosis without current pathological fracture"	"Other disorders of synovium and tendon"	1	242	1090	1332
"C83"	"D27"	"Non-follicular lymphoma"	"Benign neoplasm of ovary"	1	7	66	73
"C79"	"M22"	"Secondary malignant neoplasm of other and unspecified sites"	"Disorder of patella"	1	0	66	66
"I34"	"N92"	"Nonrheumatic mitral valve disorders"	"Excessive, frequent and irregular menstruation"	1	12	297	309
"N39"	"O92"	"Other disorders of urinary system"	"Oth disord of brst/lactatn assoc w pregnancy and the puerp"	1	97	260	357
"G35"	"O71"	"Multiple sclerosis"	"Other obstetric trauma"	1	7	120	127
"J96"	"C91"	"Respiratory failure, not elsewhere classified"	"Lymphoid leukemia"	1	132	634	766
"C92"	"M79"	"Myeloid leukemia"	"Oth and unsp soft tissue disorders, not elsewhere classified"	1	67	203	270
"J96"	"H54"	"Respiratory failure, not elsewhere classified"	"Blindness and low vision"	1	359	612	971
"D22"	"M75"	"Melanocytic nevi"	"Shoulder lesions"	1	610	857	1467
"K59"	"N63"	"Other functional intestinal disorders"	"Unspecified lump in breast"	1	253	1287	1540
"M71"	"M62"	"Other bursopathies"	"Other disorders of muscle"	1	264	554	818
"D22"	"I25"	"Melanocytic nevi"	"Chronic ischemic heart disease"	1	194	318	512
"O32"	"N96"	"Maternal care for malpresentation of fetus"	"Recurrent pregnancy loss"	1	136	279	415
"I71"	"H93"	"Aortic aneurysm and dissection"	"Other disorders of ear, not elsewhere classified"	1	25	751	776
"L08"	"E11"	"Other local infections of skin and subcutaneous tissue"	"Type 2 diabetes mellitus"	1	1239	1911	3150
"I71"	"M20"	"Aortic aneurysm and dissection"	"Acquired deformities of fingers and toes"	1	26	395	421
"M31"	"N95"	"Other necrotizing vasculopathies"	"Menopausal and other perimenopausal disorders"	1	65	173	238
"C10"	"Q18"	"Malignant neoplasm of oropharynx"	"Other congenital malformations of face and neck"	1	17	67	84
"H53"	"O68"	"Visual disturbances"	"Labor and delivery comp by abnlt of fetal acid-base balance"	1	55	337	392
"J18"	"D16"	"Pneumonia, unspecified organism"	"Benign neoplasm of bone and articular cartilage"	1	126	396	522
"I38"	"E11"	"Endocarditis, valve unspecified"	"Type 2 diabetes mellitus"	1	111	364	475
"I69"	"I65"	"Sequelae of cerebrovascular disease"	"Occls and stenosis of precerb art, not rslt in cereb infrc"	1	1239	3718	4957
"K50"	"J45"	"Crohn's disease [regional enteritis]"	"Asthma"	1	268	455	723
"J96"	"J37"	"Respiratory failure, not elsewhere classified"	"Chronic laryngitis and laryngotracheitis"	1	0	428	428
"E21"	"K61"	"Hyperparathyroidism and other disorders of parathyroid gland"	"Abscess of anal and rectal regions"	1	7	43	50
"J44"	"N50"	"Other chronic obstructive pulmonary disease"	"Other and unspecified disorders of male genital organs"	1	213	357	570
"C79"	"K41"	"Secondary malignant neoplasm of other and unspecified sites"	"Femoral hernia"	1	6	68	74
"N30"	"D14"	"Cystitis"	"Benign neoplasm of middle ear and respiratory system"	1	221	540	761
"E10"	"K40"	"Type 1 diabetes mellitus"	"Inguinal hernia"	1	663	1316	1979
"C79"	"N80"	"Secondary malignant neoplasm of other and unspecified sites"	"Endometriosis"	1	0	59	59
"M80"	"M18"	"Osteoporosis with current pathological fracture"	"Osteoarthritis of first carpometacarpal joint"	1	78	291	369
"D73"	"I20"	"Diseases of spleen"	"Angina pectoris"	1	17	85	102
"L08"	"E10"	"Other local infections of skin and subcutaneous tissue"	"Type 1 diabetes mellitus"	1	543	1433	1976
"N39"	"D18"	"Other disorders of urinary system"	"Hemangioma and lymphangioma, any site"	1	171	296	467
"F41"	"M77"	"Other anxiety disorders"	"Other enthesopathies"	1	83	303	386
"C77"	"O75"	"Secondary and unspecified malignant neoplasm of lymph nodes"	"Oth complications of labor and delivery, NEC"	1	0	28	28
"C78"	"I71"	"Secondary malignant neoplasm of resp and digestive organs"	"Aortic aneurysm and dissection"	1	259	803	1062
"H18"	"K40"	"Other disorders of cornea"	"Inguinal hernia"	1	81	300	381
"K60"	"O47"	"Fissure and fistula of anal and rectal regions"	"False labor"	1	113	260	373
"M25"	"Q54"	"Other joint disorder, not elsewhere classified"	"Hypospadias"	1	12	74	86
"F31"	"M51"	"Bipolar disorder"	"Thoracic, thoracolum, and lumbosacral intvrt disc disorders"	1	64	193	257
"M85"	"H43"	"Other disorders of bone density and structure"	"Disorders of vitreous body"	1	236	453	689
"C34"	"K52"	"Malignant neoplasm of bronchus and lung"	"Other and unsp noninfective gastroenteritis and colitis"	1	475	699	1174
"C34"	"K30"	"Malignant neoplasm of bronchus and lung"	"Functional dyspepsia"	1	0	1706	1706
"K05"	"K70"	"Gingivitis and periodontal diseases"	"Alcoholic liver disease"	1	149	315	464
"A49"	"K92"	"Bacterial infection of unspecified site"	"Other diseases of digestive system"	1	1057	1648	2705
"C64"	"M65"	"Malignant neoplasm of kidney, except renal pelvis"	"Synovitis and tenosynovitis"	1	28	158	186
"N18"	"Q54"	"Chronic kidney disease (CKD)"	"Hypospadias"	1	0	53	53
"G47"	"D05"	"Sleep disorders"	"Carcinoma in situ of breast"	1	13	71	84
"N93"	"H66"	"Other abnormal uterine and vaginal bleeding"	"Suppurative and unspecified otitis media"	1	3	57	60
"E04"	"L20"	"Other nontoxic goiter"	"Atopic dermatitis"	1	21	72	93
"A41"	"F32"	"Other sepsis"	"Depressive episode"	1	2175	4116	6291
"C61"	"J33"	"Malignant neoplasm of prostate"	"Nasal polyp"	1	24	180	204
"N39"	"O70"	"Other disorders of urinary system"	"Perineal laceration during delivery"	1	0	4305	4305
"C20"	"K44"	"Malignant neoplasm of rectum"	"Diaphragmatic hernia"	1	121	276	397
"M24"	"O65"	"Other specific joint derangements"	"Obstructed labor due to maternal pelvic abnormality"	1	11	100	111
"G90"	"M16"	"Disorders of autonomic nervous system"	"Osteoarthritis of hip"	1	72	154	226
"B02"	"O03"	"Zoster [herpes zoster]"	"Spontaneous abortion"	1	0	37	37
"G98"	"G43"	"Other disorders of nervous system not elsewhere classified"	"Migraine"	1	115	310	425
"J18"	"K29"	"Pneumonia, unspecified organism"	"Gastritis and duodenitis"	1	0	15882	15882
"D59"	"C91"	"Acquired hemolytic anemia"	"Lymphoid leukemia"	1	83	253	336
"K22"	"O82"	"Other diseases of esophagus"	"Encounter for cesarean delivery without indication"	1	16	99	115
"J18"	"L23"	"Pneumonia, unspecified organism"	"Allergic contact dermatitis"	1	151	655	806
"K56"	"N94"	"Paralytic ileus and intestinal obstruction without hernia"	"Pain and oth cond assoc w fem gntl org and menstrual cycle"	1	57	301	358
"J22"	"M23"	"Unspecified acute lower respiratory infection"	"Internal derangement of knee"	1	10	335	345
"J10"	"M75"	"Influenza due to other identified influenza virus"	"Shoulder lesions"	1	12	191	203
"M85"	"N05"	"Other disorders of bone density and structure"	"Unspecified nephritic syndrome"	1	7	45	52
"M90"	"C61"	"Osteopathies in diseases classified elsewhere"	"Malignant neoplasm of prostate"	1	60	292	352
"N30"	"D30"	"Cystitis"	"Benign neoplasm of urinary organs"	1	1143	3509	4652
"I63"	"I25"	"Cerebral infarction"	"Chronic ischemic heart disease"	1	8363	10198	18561
"D63"	"N13"	"Anemia in chronic diseases classified elsewhere"	"Obstructive and reflux uropathy"	1	865	1582	2447
"J09"	"I15"	"Influenza due to certain identified influenza viruses"	"Secondary hypertension"	1	2	65	67
"M66"	"F10"	"Spontaneous rupture of synovium and tendon"	"Alcohol related disorders"	1	64	139	203
"I10"	"N44"	"Essential (primary) hypertension"	"Noninflammatory disorders of testis"	1	5	83	88
"J95"	"J38"	"Intraop and postproc comp and disorders of resp sys, NEC"	"Diseases of vocal cords and larynx, not elsewhere classified"	1	131	335	466
"E05"	"D06"	"Thyrotoxicosis [hyperthyroidism]"	"Carcinoma in situ of cervix uteri"	1	4	107	111
"K01"	"Q53"	"Embedded and impacted teeth"	"Undescended and ectopic testicle"	1	0	67	67
"G93"	"N87"	"Other disorders of brain"	"Dysplasia of cervix uteri"	1	7	59	66
"N18"	"E15"	"Chronic kidney disease (CKD)"	"Nondiabetic hypoglycemic coma"	1	91	213	304
"L89"	"A46"	"Pressure ulcer"	"Erysipelas"	1	695	1586	2281
"E11"	"K01"	"Type 2 diabetes mellitus"	"Embedded and impacted teeth"	1	93	188	281
"C43"	"O70"	"Malignant melanoma of skin"	"Perineal laceration during delivery"	1	51	488	539
"E06"	"K80"	"Thyroiditis"	"Cholelithiasis"	1	150	257	407
"F32"	"D30"	"Depressive episode"	"Benign neoplasm of urinary organs"	1	104	434	538
"L70"	"K50"	"Acne"	"Crohn's disease [regional enteritis]"	1	42	124	166
"O70"	"M42"	"Perineal laceration during delivery"	"Spinal osteochondrosis"	1	16	92	108
"J18"	"O86"	"Pneumonia, unspecified organism"	"Other puerperal infections"	1	72	229	301
"L97"	"D45"	"Non-pressure chronic ulcer of lower limb, NEC"	"Polycythemia vera"	1	36	106	142
"M18"	"H93"	"Osteoarthritis of first carpometacarpal joint"	"Other disorders of ear, not elsewhere classified"	1	129	281	410
"A54"	"O04"	"Gonococcal infection"	"Complications following (induced) termination of pregnancy"	1	36	305	341
"I89"	"O48"	"Oth noninfective disorders of lymphatic vessels and nodes"	"Late pregnancy"	1	0	42	42
"D12"	"M24"	"Benign neoplasm of colon, rectum, anus and anal canal"	"Other specific joint derangements"	1	75	489	564
"I49"	"M54"	"Other cardiac arrhythmias"	"Dorsalgia"	1	1429	2445	3874
"E64"	"D24"	"Sequelae of malnutrition and other nutritional deficiencies"	"Benign neoplasm of breast"	1	0	53	53
"O42"	"H50"	"Premature rupture of membranes"	"Other strabismus"	1	21	99	120
"I61"	"K80"	"Nontraumatic intracerebral hemorrhage"	"Cholelithiasis"	1	187	656	843
"G47"	"H00"	"Sleep disorders"	"Hordeolum and chalazion"	1	24	175	199
"E21"	"H25"	"Hyperparathyroidism and other disorders of parathyroid gland"	"Age-related cataract"	1	663	1219	1882
"E41"	"N81"	"Nutritional marasmus"	"Female genital prolapse"	1	0	59	59
"E26"	"I10"	"Hyperaldosteronism"	"Essential (primary) hypertension"	1	162	484	646
"I50"	"N70"	"Heart failure"	"Salpingitis and oophoritis"	1	0	78	78
"O24"	"J36"	"Diabetes in pregnancy, childbirth, and the puerperium"	"Peritonsillar abscess"	1	9	77	86
"A46"	"O90"	"Erysipelas"	"Complications of the puerperium, not elsewhere classified"	1	7	43	50
"C79"	"J42"	"Secondary malignant neoplasm of other and unspecified sites"	"Unspecified chronic bronchitis"	1	90	643	733
"M80"	"J33"	"Osteoporosis with current pathological fracture"	"Nasal polyp"	1	1	75	76
"E13"	"G44"	"Other specified diabetes mellitus"	"Other headache syndromes"	1	16	62	78
"D32"	"M51"	"Benign neoplasm of meninges"	"Thoracic, thoracolum, and lumbosacral intvrt disc disorders"	1	65	299	364
"C77"	"I20"	"Secondary and unspecified malignant neoplasm of lymph nodes"	"Angina pectoris"	1	76	1355	1431
"D50"	"M76"	"Iron deficiency anemia"	"Enthesopathies, lower limb, excluding foot"	1	77	225	302
"K60"	"N97"	"Fissure and fistula of anal and rectal regions"	"Female infertility"	1	153	386	539
"M79"	"K35"	"Oth and unsp soft tissue disorders, not elsewhere classified"	"Acute appendicitis"	1	1242	2658	3900
"N13"	"H10"	"Obstructive and reflux uropathy"	"Conjunctivitis"	1	53	268	321
"K73"	"O04"	"Chronic hepatitis, not elsewhere classified"	"Complications following (induced) termination of pregnancy"	1	0	53	53
"J32"	"O42"	"Chronic sinusitis"	"Premature rupture of membranes"	1	54	175	229
"Q99"	"J35"	"Other chromosome abnormalities, not elsewhere classified"	"Chronic diseases of tonsils and adenoids"	1	33	89	122
"L57"	"K40"	"Skin changes due to chronic expsr to nonionizing radiation"	"Inguinal hernia"	1	61	641	702
"K11"	"N92"	"Diseases of salivary glands"	"Excessive, frequent and irregular menstruation"	1	105	302	407
"M66"	"O68"	"Spontaneous rupture of synovium and tendon"	"Labor and delivery comp by abnlt of fetal acid-base balance"	1	0	38	38
"I35"	"K80"	"Nonrheumatic aortic valve disorders"	"Cholelithiasis"	1	490	2133	2623
"N17"	"O82"	"Acute kidney failure"	"Encounter for cesarean delivery without indication"	1	13	81	94
"O90"	"J30"	"Complications of the puerperium, not elsewhere classified"	"Vasomotor and allergic rhinitis"	1	65	137	202
"C34"	"O99"	"Malignant neoplasm of bronchus and lung"	"Oth maternal diseases classd elsw but compl preg/chldbrth"	1	0	33	33
"C45"	"H35"	"Mesothelioma"	"Other retinal disorders"	1	9	48	57
"D38"	"H91"	"Neoplm of uncrt behav of mid ear & resp and intrathorac org"	"Other and unspecified hearing loss"	1	63	321	384
"M85"	"M33"	"Other disorders of bone density and structure"	"Dermatopolymyositis"	1	37	124	161
"A49"	"C56"	"Bacterial infection of unspecified site"	"Malignant neoplasm of ovary"	1	68	376	444
"N31"	"O75"	"Neuromuscular dysfunction of bladder, NEC"	"Oth complications of labor and delivery, NEC"	1	3	32	35
"G31"	"I21"	"Oth degenerative diseases of nervous system, NEC"	"Acute myocardial infarction"	1	91	312	403
"C79"	"L97"	"Secondary malignant neoplasm of other and unspecified sites"	"Non-pressure chronic ulcer of lower limb, NEC"	1	103	208	311
"C61"	"M19"	"Malignant neoplasm of prostate"	"Other and unspecified osteoarthritis"	1	405	820	1225
"H25"	"D14"	"Age-related cataract"	"Benign neoplasm of middle ear and respiratory system"	1	395	922	1317
"L30"	"I47"	"Other and unspecified dermatitis"	"Paroxysmal tachycardia"	1	189	381	570
"F03"	"I95"	"Unspecified dementia"	"Hypotension"	1	1066	1460	2526
"G62"	"L40"	"Other and unspecified polyneuropathies"	"Psoriasis"	1	118	246	364
"F52"	"O04"	"Sexual dysfnct not due to a substance or known physiol cond"	"Complications following (induced) termination of pregnancy"	1	5	156	161
"J44"	"O65"	"Other chronic obstructive pulmonary disease"	"Obstructed labor due to maternal pelvic abnormality"	1	0	38	38
"E03"	"I47"	"Other hypothyroidism"	"Paroxysmal tachycardia"	1	690	1602	2292
"O48"	"J35"	"Late pregnancy"	"Chronic diseases of tonsils and adenoids"	1	133	505	638
"B59"	"C91"	"Pneumocystosis"	"Lymphoid leukemia"	1	12	163	175
"A04"	"D25"	"Other bacterial intestinal infections"	"Leiomyoma of uterus"	1	12	125	137
"N18"	"M76"	"Chronic kidney disease (CKD)"	"Enthesopathies, lower limb, excluding foot"	1	52	313	365
"I48"	"L60"	"Atrial fibrillation and flutter"	"Nail disorders"	1	217	356	573
"I70"	"M31"	"Atherosclerosis"	"Other necrotizing vasculopathies"	1	379	556	935
"K56"	"J44"	"Paralytic ileus and intestinal obstruction without hernia"	"Other chronic obstructive pulmonary disease"	1	2806	3830	6636
"O80"	"K00"	"Encounter for full-term uncomplicated delivery"	"Disorders of tooth development and eruption"	1	127	731	858
"C73"	"Q18"	"Malignant neoplasm of thyroid gland"	"Other congenital malformations of face and neck"	1	20	102	122
"I46"	"C34"	"Cardiac arrest"	"Malignant neoplasm of bronchus and lung"	1	321	1035	1356
"K70"	"D23"	"Alcoholic liver disease"	"Other benign neoplasms of skin"	1	59	139	198
"I71"	"J34"	"Aortic aneurysm and dissection"	"Other and unspecified disorders of nose and nasal sinuses"	1	0	152	152
"M41"	"Q65"	"Scoliosis"	"Congenital deformities of hip"	1	72	189	261
"F41"	"G95"	"Other anxiety disorders"	"Other and unspecified diseases of spinal cord"	1	145	1042	1187
"C16"	"G45"	"Malignant neoplasm of stomach"	"Transient cerebral ischemic attacks and related syndromes"	1	49	308	357
"J47"	"N97"	"Bronchiectasis"	"Female infertility"	1	0	37	37
"C78"	"N75"	"Secondary malignant neoplasm of resp and digestive organs"	"Diseases of Bartholin's gland"	1	0	48	48
"O73"	"O20"	"Retained placenta and membranes, without hemorrhage"	"Hemorrhage in early pregnancy"	1	422	1688	2110
"E78"	"A69"	"Disorders of lipoprotein metabolism and other lipidemias"	"Other spirochetal infections"	1	84	205	289
"A49"	"L98"	"Bacterial infection of unspecified site"	"Oth disorders of skin, subcu, not elsewhere classified"	1	648	854	1502
"F17"	"A15"	"Nicotine dependence"	"Respiratory tuberculosis"	1	35	96	131
"H35"	"N46"	"Other retinal disorders"	"Male infertility"	1	25	88	113
"G20"	"I83"	"Parkinson's disease"	"Varicose veins of lower extremities"	1	39	348	387
"O90"	"O30"	"Complications of the puerperium, not elsewhere classified"	"Multiple gestation"	1	316	1093	1409
"D09"	"M50"	"Carcinoma in situ of other and unspecified sites"	"Cervical disc disorders"	1	0	53	53
"A49"	"J35"	"Bacterial infection of unspecified site"	"Chronic diseases of tonsils and adenoids"	1	104	392	496
"J32"	"Q53"	"Chronic sinusitis"	"Undescended and ectopic testicle"	1	0	26	26
"C10"	"M20"	"Malignant neoplasm of oropharynx"	"Acquired deformities of fingers and toes"	1	1	29	30
"K52"	"K40"	"Other and unsp noninfective gastroenteritis and colitis"	"Inguinal hernia"	1	434	1528	1962
"A40"	"C85"	"Streptococcal sepsis"	"Oth and unspecified types of non-Hodgkin lymphoma"	1	33	102	135
"D64"	"G82"	"Other anemias"	"Paraplegia (paraparesis) and quadriplegia (quadriparesis)"	1	174	334	508
"E68"	"O71"	"Sequelae of hyperalimentation"	"Other obstetric trauma"	1	0	156	156
"E13"	"H83"	"Other specified diabetes mellitus"	"Other diseases of inner ear"	1	0	64	64
"K74"	"H83"	"Fibrosis and cirrhosis of liver"	"Other diseases of inner ear"	1	5	150	155
"K30"	"J35"	"Functional dyspepsia"	"Chronic diseases of tonsils and adenoids"	1	189	942	1131
"M80"	"N83"	"Osteoporosis with current pathological fracture"	"Noninflammatory disord of ovary, fallop and broad ligament"	1	56	340	396
"D47"	"K60"	"Oth neoplm of uncrt behav of lymphoid, hematpoetc & rel tiss"	"Fissure and fistula of anal and rectal regions"	1	8	61	69
"E89"	"C30"	"Postproc endocrine and metabolic comp and disorders, NEC"	"Malignant neoplasm of nasal cavity and middle ear"	1	2	37	39
"C88"	"E78"	"Malig immunoproliferative dis and certain oth B-cell lymph"	"Disorders of lipoprotein metabolism and other lipidemias"	1	25	110	135
"A49"	"I87"	"Bacterial infection of unspecified site"	"Other disorders of veins"	1	156	285	441
"C34"	"C54"	"Malignant neoplasm of bronchus and lung"	"Malignant neoplasm of corpus uteri"	1	17	249	266
"G95"	"M10"	"Other and unspecified diseases of spinal cord"	"Gout"	1	44	132	176
"A26"	"K40"	"Erysipeloid"	"Inguinal hernia"	1	0	79	79
"E83"	"K52"	"Disorders of mineral metabolism"	"Other and unsp noninfective gastroenteritis and colitis"	1	414	604	1018
"I34"	"M76"	"Nonrheumatic mitral valve disorders"	"Enthesopathies, lower limb, excluding foot"	1	34	110	144
"K08"	"N60"	"Other disorders of teeth and supporting structures"	"Benign mammary dysplasia"	1	20	90	110
"K86"	"O04"	"Other diseases of pancreas"	"Complications following (induced) termination of pregnancy"	1	0	67	67
"K64"	"O36"	"Hemorrhoids and perianal venous thrombosis"	"Maternal care for other fetal problems"	1	0	494	494
"I89"	"A09"	"Oth noninfective disorders of lymphatic vessels and nodes"	"Infectious gastroenteritis and colitis, unspecified"	1	96	205	301
"K55"	"K29"	"Vascular disorders of intestine"	"Gastritis and duodenitis"	1	292	996	1288
"C78"	"L60"	"Secondary malignant neoplasm of resp and digestive organs"	"Nail disorders"	1	21	126	147
"C34"	"A69"	"Malignant neoplasm of bronchus and lung"	"Other spirochetal infections"	1	0	78	78
"E27"	"K29"	"Other disorders of adrenal gland"	"Gastritis and duodenitis"	1	93	303	396
"C20"	"M47"	"Malignant neoplasm of rectum"	"Spondylosis"	1	99	197	296
"H26"	"O62"	"Other cataract"	"Abnormalities of forces of labor"	1	0	135	135
"K55"	"H25"	"Vascular disorders of intestine"	"Age-related cataract"	1	351	1404	1755
"J91"	"H81"	"Pleural effusion in conditions classified elsewhere"	"Disorders of vestibular function"	1	13	156	169
"I50"	"O99"	"Heart failure"	"Oth maternal diseases classd elsw but compl preg/chldbrth"	1	19	184	203
"A41"	"J18"	"Other sepsis"	"Pneumonia, unspecified organism"	1	23556	25629	49185
"E65"	"O62"	"Localized adiposity"	"Abnormalities of forces of labor"	1	0	1154	1154
"E64"	"C73"	"Sequelae of malnutrition and other nutritional deficiencies"	"Malignant neoplasm of thyroid gland"	1	6	51	57
"F03"	"G90"	"Unspecified dementia"	"Disorders of autonomic nervous system"	1	63	217	280
"O46"	"G40"	"Antepartum hemorrhage, not elsewhere classified"	"Epilepsy and recurrent seizures"	1	37	105	142
"I21"	"H90"	"Acute myocardial infarction"	"Conductive and sensorineural hearing loss"	1	1144	1976	3120
"F10"	"Q53"	"Alcohol related disorders"	"Undescended and ectopic testicle"	1	0	112	112
"K91"	"O04"	"Intraop and postproc comp and disorders of dgstv sys, NEC"	"Complications following (induced) termination of pregnancy"	1	0	107	107
"E86"	"K80"	"Volume depletion"	"Cholelithiasis"	1	0	7061	7061
"K83"	"J45"	"Other diseases of biliary tract"	"Asthma"	1	184	459	643
"G51"	"N87"	"Facial nerve disorders"	"Dysplasia of cervix uteri"	1	24	77	101
"J94"	"M65"	"Other pleural conditions"	"Synovitis and tenosynovitis"	1	18	99	117
"M48"	"J35"	"Other spondylopathies"	"Chronic diseases of tonsils and adenoids"	1	6	231	237
"A41"	"O63"	"Other sepsis"	"Long labor"	1	8	74	82
"K91"	"H91"	"Intraop and postproc comp and disorders of dgstv sys, NEC"	"Other and unspecified hearing loss"	1	226	530	756
"I44"	"D30"	"Atrioventricular and left bundle-branch block"	"Benign neoplasm of urinary organs"	1	90	322	412
"K59"	"G83"	"Other functional intestinal disorders"	"Other paralytic syndromes"	1	176	300	476
"F41"	"O48"	"Other anxiety disorders"	"Late pregnancy"	1	2	177	179
"O70"	"O47"	"Perineal laceration during delivery"	"False labor"	1	8903	14146	23049
"D46"	"H25"	"Myelodysplastic syndromes"	"Age-related cataract"	1	190	786	976
"H43"	"H91"	"Disorders of vitreous body"	"Other and unspecified hearing loss"	1	1009	1293	2302
"K65"	"I83"	"Peritonitis"	"Varicose veins of lower extremities"	1	119	361	480
"J18"	"D05"	"Pneumonia, unspecified organism"	"Carcinoma in situ of breast"	1	118	283	401
"E85"	"E78"	"Amyloidosis"	"Disorders of lipoprotein metabolism and other lipidemias"	1	23	84	107
"A46"	"I65"	"Erysipelas"	"Occls and stenosis of precerb art, not rslt in cereb infrc"	1	93	235	328
"M81"	"H65"	"Osteoporosis without current pathological fracture"	"Nonsuppurative otitis media"	1	24	446	470
"C79"	"I48"	"Secondary malignant neoplasm of other and unspecified sites"	"Atrial fibrillation and flutter"	1	1108	2911	4019
"O72"	"O08"	"Postpartum hemorrhage"	"Complications following ectopic and molar pregnancy"	1	2325	4860	7185
"I73"	"N63"	"Other peripheral vascular diseases"	"Unspecified lump in breast"	1	47	283	330
"E86"	"M48"	"Volume depletion"	"Other spondylopathies"	1	0	5324	5324
"I08"	"K05"	"Multiple valve diseases"	"Gingivitis and periodontal diseases"	1	40	235	275
"M41"	"Q05"	"Scoliosis"	"Spina bifida"	1	10	77	87
"J44"	"D39"	"Other chronic obstructive pulmonary disease"	"Neoplasm of uncertain behavior of female genital organs"	1	33	108	141
"D64"	"N90"	"Other anemias"	"Other noninflammatory disorders of vulva and perineum"	1	58	147	205
"K08"	"O65"	"Other disorders of teeth and supporting structures"	"Obstructed labor due to maternal pelvic abnormality"	1	1	38	39
"E72"	"I63"	"Other disorders of amino-acid metabolism"	"Cerebral infarction"	1	65	177	242
"D86"	"O02"	"Sarcoidosis"	"Other abnormal products of conception"	1	18	74	92
"N13"	"N87"	"Obstructive and reflux uropathy"	"Dysplasia of cervix uteri"	1	58	168	226
"K83"	"C53"	"Other diseases of biliary tract"	"Malignant neoplasm of cervix uteri"	1	4	43	47
"D63"	"C02"	"Anemia in chronic diseases classified elsewhere"	"Malignant neoplasm of other and unspecified parts of tongue"	1	20	73	93
"M13"	"O20"	"Other arthritis"	"Hemorrhage in early pregnancy"	1	5	236	241
"G47"	"N21"	"Sleep disorders"	"Calculus of lower urinary tract"	1	48	156	204
"G62"	"O99"	"Other and unspecified polyneuropathies"	"Oth maternal diseases classd elsw but compl preg/chldbrth"	1	10	155	165
"J96"	"M51"	"Respiratory failure, not elsewhere classified"	"Thoracic, thoracolum, and lumbosacral intvrt disc disorders"	1	0	2801	2801
"F03"	"E66"	"Unspecified dementia"	"Overweight and obesity"	1	199	1061	1260
"M75"	"M54"	"Shoulder lesions"	"Dorsalgia"	1	7577	11431	19008
"E13"	"O80"	"Other specified diabetes mellitus"	"Encounter for full-term uncomplicated delivery"	1	0	69	69
"I11"	"I47"	"Hypertensive heart disease"	"Paroxysmal tachycardia"	1	490	885	1375
"K72"	"I70"	"Hepatic failure, not elsewhere classified"	"Atherosclerosis"	1	122	342	464
"J96"	"C04"	"Respiratory failure, not elsewhere classified"	"Malignant neoplasm of floor of mouth"	1	56	133	189
"I69"	"H72"	"Sequelae of cerebrovascular disease"	"Perforation of tympanic membrane"	1	33	157	190
"M25"	"M02"	"Other joint disorder, not elsewhere classified"	"Postinfective and reactive arthropathies"	1	1045	1294	2339
"O92"	"L05"	"Oth disord of brst/lactatn assoc w pregnancy and the puerp"	"Pilonidal cyst and sinus"	1	3	104	107
"D33"	"M22"	"Benign neoplasm of brain and oth prt central nervous system"	"Disorder of patella"	1	5	37	42
"J03"	"Q41"	"Acute tonsillitis"	"Congenital absence, atresia and stenosis of small intestine"	1	2	38	40
"N48"	"M23"	"Other disorders of penis"	"Internal derangement of knee"	1	336	775	1111
"M71"	"N92"	"Other bursopathies"	"Excessive, frequent and irregular menstruation"	1	93	479	572
"I61"	"D27"	"Nontraumatic intracerebral hemorrhage"	"Benign neoplasm of ovary"	1	9	123	132
"J96"	"D06"	"Respiratory failure, not elsewhere classified"	"Carcinoma in situ of cervix uteri"	1	0	48	48
"A41"	"J32"	"Other sepsis"	"Chronic sinusitis"	1	54	436	490
"O21"	"K00"	"Excessive vomiting in pregnancy"	"Disorders of tooth development and eruption"	1	0	57	57
"D35"	"O64"	"Benign neoplasm of other and unspecified endocrine glands"	"Obstructed labor due to malposition and malpresent of fetus"	1	0	25	25
"I49"	"E04"	"Other cardiac arrhythmias"	"Other nontoxic goiter"	1	303	643	946
"N18"	"H90"	"Chronic kidney disease (CKD)"	"Conductive and sensorineural hearing loss"	1	93	1190	1283
"I63"	"M19"	"Cerebral infarction"	"Other and unspecified osteoarthritis"	1	1337	2115	3452
"E68"	"O02"	"Sequelae of hyperalimentation"	"Other abnormal products of conception"	1	0	246	246
"N89"	"J35"	"Other noninflammatory disorders of vagina"	"Chronic diseases of tonsils and adenoids"	1	31	105	136
"C85"	"K42"	"Oth and unspecified types of non-Hodgkin lymphoma"	"Umbilical hernia"	1	26	76	102
"J06"	"M25"	"Acute upper resp infections of multiple and unsp sites"	"Other joint disorder, not elsewhere classified"	1	162	278	440
"N50"	"F10"	"Other and unspecified disorders of male genital organs"	"Alcohol related disorders"	1	192	439	631
"H68"	"Q21"	"Eustachian salpingitis and obstruction"	"Congenital malformations of cardiac septa"	1	6	70	76
"A56"	"M41"	"Other sexually transmitted chlamydial diseases"	"Scoliosis"	1	0	28	28
"C34"	"M17"	"Malignant neoplasm of bronchus and lung"	"Osteoarthritis of knee"	1	0	2501	2501
"C78"	"M41"	"Secondary malignant neoplasm of resp and digestive organs"	"Scoliosis"	1	6	140	146
"O36"	"O04"	"Maternal care for other fetal problems"	"Complications following (induced) termination of pregnancy"	1	1515	3907	5422
"O34"	"O30"	"Maternal care for abnormality of pelvic organs"	"Multiple gestation"	1	1325	2513	3838
"M47"	"O91"	"Spondylosis"	"Infect of breast assoc w pregnancy, the puerp and lactation"	1	0	38	38
"C44"	"K26"	"Other and unspecified malignant neoplasm of skin"	"Duodenal ulcer"	1	285	568	853
"J06"	"M72"	"Acute upper resp infections of multiple and unsp sites"	"Fibroblastic disorders"	1	30	154	184
"C79"	"M17"	"Secondary malignant neoplasm of other and unspecified sites"	"Osteoarthritis of knee"	1	0	1683	1683
"K57"	"O02"	"Diverticular disease of intestine"	"Other abnormal products of conception"	1	0	97	97
"O30"	"J35"	"Multiple gestation"	"Chronic diseases of tonsils and adenoids"	1	20	286	306
"O72"	"G51"	"Postpartum hemorrhage"	"Facial nerve disorders"	1	214	412	626
"I31"	"M51"	"Other diseases of pericardium"	"Thoracic, thoracolum, and lumbosacral intvrt disc disorders"	1	31	140	171
"I34"	"N43"	"Nonrheumatic mitral valve disorders"	"Hydrocele and spermatocele"	1	50	152	202
"H54"	"H10"	"Blindness and low vision"	"Conjunctivitis"	1	88	227	315
"E78"	"K44"	"Disorders of lipoprotein metabolism and other lipidemias"	"Diaphragmatic hernia"	1	1843	3105	4948
"D64"	"M93"	"Other anemias"	"Other osteochondropathies"	1	0	54	54
"I48"	"O42"	"Atrial fibrillation and flutter"	"Premature rupture of membranes"	1	0	77	77
"D23"	"J35"	"Other benign neoplasms of skin"	"Chronic diseases of tonsils and adenoids"	1	158	428	586
"C79"	"D12"	"Secondary malignant neoplasm of other and unspecified sites"	"Benign neoplasm of colon, rectum, anus and anal canal"	1	243	1798	2041
"D22"	"E66"	"Melanocytic nevi"	"Overweight and obesity"	1	568	841	1409
"N17"	"K26"	"Acute kidney failure"	"Duodenal ulcer"	1	521	1011	1532
"E29"	"N44"	"Testicular dysfunction"	"Noninflammatory disorders of testis"	1	7	72	79
"C49"	"D12"	"Malignant neoplasm of other connective and soft tissue"	"Benign neoplasm of colon, rectum, anus and anal canal"	1	84	168	252
"C77"	"J30"	"Secondary and unspecified malignant neoplasm of lymph nodes"	"Vasomotor and allergic rhinitis"	1	1	91	92
"H25"	"N20"	"Age-related cataract"	"Calculus of kidney and ureter"	1	888	2777	3665
"K43"	"H65"	"Ventral hernia"	"Nonsuppurative otitis media"	1	53	141	194
"N63"	"O80"	"Unspecified lump in breast"	"Encounter for full-term uncomplicated delivery"	1	0	5208	5208
"A41"	"Q42"	"Other sepsis"	"Congenital absence, atresia and stenosis of large intestine"	1	5	42	47
"K02"	"I10"	"Dental caries"	"Essential (primary) hypertension"	1	1030	1693	2723
"G44"	"D06"	"Other headache syndromes"	"Carcinoma in situ of cervix uteri"	1	0	79	79
"K64"	"J15"	"Hemorrhoids and perianal venous thrombosis"	"Bacterial pneumonia, not elsewhere classified"	1	241	630	871
"K55"	"D25"	"Vascular disorders of intestine"	"Leiomyoma of uterus"	1	1	68	69
"F01"	"G46"	"Vascular dementia"	"Vascular syndromes of brain in cerebrovascular diseases"	1	13	56	69
"O82"	"J30"	"Encounter for cesarean delivery without indication"	"Vasomotor and allergic rhinitis"	1	444	640	1084
"C78"	"J30"	"Secondary malignant neoplasm of resp and digestive organs"	"Vasomotor and allergic rhinitis"	1	0	100	100
"D63"	"K57"	"Anemia in chronic diseases classified elsewhere"	"Diverticular disease of intestine"	1	375	1439	1814
"F06"	"I10"	"Other mental disorders due to known physiological condition"	"Essential (primary) hypertension"	1	792	2272	3064
"H16"	"O03"	"Keratitis"	"Spontaneous abortion"	1	38	200	238
"I50"	"M50"	"Heart failure"	"Cervical disc disorders"	1	122	1244	1366
"I73"	"H25"	"Other peripheral vascular diseases"	"Age-related cataract"	1	3924	5341	9265
"E13"	"L50"	"Other specified diabetes mellitus"	"Urticaria"	1	6	48	54
"F17"	"H40"	"Nicotine dependence"	"Glaucoma"	1	98	183	281
"N19"	"I21"	"Unspecified kidney failure"	"Acute myocardial infarction"	1	1817	3707	5524
"N30"	"E78"	"Cystitis"	"Disorders of lipoprotein metabolism and other lipidemias"	1	7664	10784	18448
"E55"	"I99"	"Vitamin D deficiency"	"Other and unspecified disorders of circulatory system"	1	22	105	127
"C78"	"Q61"	"Secondary malignant neoplasm of resp and digestive organs"	"Cystic kidney disease"	1	24	131	155
"I10"	"Q85"	"Essential (primary) hypertension"	"Phakomatoses, not elsewhere classified"	1	33	131	164
"E05"	"D25"	"Thyrotoxicosis [hyperthyroidism]"	"Leiomyoma of uterus"	1	403	833	1236
"K62"	"N43"	"Other diseases of anus and rectum"	"Hydrocele and spermatocele"	1	174	455	629
"M45"	"O02"	"Ankylosing spondylitis"	"Other abnormal products of conception"	1	8	45	53
"E78"	"I83"	"Disorders of lipoprotein metabolism and other lipidemias"	"Varicose veins of lower extremities"	1	0	4566	4566
"M17"	"N75"	"Osteoarthritis of knee"	"Diseases of Bartholin's gland"	1	17	171	188
"L68"	"O04"	"Hypertrichosis"	"Complications following (induced) termination of pregnancy"	1	225	408	633
"O99"	"N80"	"Oth maternal diseases classd elsw but compl preg/chldbrth"	"Endometriosis"	1	1094	1881	2975
"I08"	"H91"	"Multiple valve diseases"	"Other and unspecified hearing loss"	1	42	117	159
"F03"	"A08"	"Unspecified dementia"	"Viral and other specified intestinal infections"	1	349	621	970
"I63"	"D25"	"Cerebral infarction"	"Leiomyoma of uterus"	1	0	627	627
"B99"	"H91"	"Other and unspecified infectious diseases"	"Other and unspecified hearing loss"	1	40	187	227
"I26"	"M05"	"Pulmonary embolism"	"Rheumatoid arthritis with rheumatoid factor"	1	178	419	597
"F17"	"Q17"	"Nicotine dependence"	"Other congenital malformations of ear"	1	0	48	48
"J96"	"N94"	"Respiratory failure, not elsewhere classified"	"Pain and oth cond assoc w fem gntl org and menstrual cycle"	1	0	180	180
"D09"	"C44"	"Carcinoma in situ of other and unspecified sites"	"Other and unspecified malignant neoplasm of skin"	1	53	151	204
"I78"	"N92"	"Diseases of capillaries"	"Excessive, frequent and irregular menstruation"	1	111	372	483
"H35"	"H93"	"Other retinal disorders"	"Other disorders of ear, not elsewhere classified"	1	427	1864	2291
"O99"	"J36"	"Oth maternal diseases classd elsw but compl preg/chldbrth"	"Peritonsillar abscess"	1	71	604	675
"J22"	"O03"	"Unspecified acute lower respiratory infection"	"Spontaneous abortion"	1	0	43	43
"I48"	"H50"	"Atrial fibrillation and flutter"	"Other strabismus"	1	177	469	646
"I25"	"I83"	"Chronic ischemic heart disease"	"Varicose veins of lower extremities"	1	2165	3925	6090
"G47"	"I86"	"Sleep disorders"	"Varicose veins of other sites"	1	23	102	125
"N92"	"O00"	"Excessive, frequent and irregular menstruation"	"Ectopic pregnancy"	1	0	1212	1212
"C90"	"K21"	"Multiple myeloma and malignant plasma cell neoplasms"	"Gastro-esophageal reflux disease"	1	26	118	144
"K05"	"N87"	"Gingivitis and periodontal diseases"	"Dysplasia of cervix uteri"	1	24	93	117
"J18"	"C09"	"Pneumonia, unspecified organism"	"Malignant neoplasm of tonsil"	1	153	471	624
"M10"	"I20"	"Gout"	"Angina pectoris"	1	0	4964	4964
"K43"	"O47"	"Ventral hernia"	"False labor"	1	1	270	271
"K56"	"H25"	"Paralytic ileus and intestinal obstruction without hernia"	"Age-related cataract"	1	2021	4278	6299
"O73"	"O30"	"Retained placenta and membranes, without hemorrhage"	"Multiple gestation"	1	157	304	461
"M51"	"D27"	"Thoracic, thoracolum, and lumbosacral intvrt disc disorders"	"Benign neoplasm of ovary"	1	436	708	1144
"J15"	"M76"	"Bacterial pneumonia, not elsewhere classified"	"Enthesopathies, lower limb, excluding foot"	1	94	511	605
"C22"	"M43"	"Malignant neoplasm of liver and intrahepatic bile ducts"	"Other deforming dorsopathies"	1	0	29	29
"J84"	"M05"	"Other interstitial pulmonary diseases"	"Rheumatoid arthritis with rheumatoid factor"	1	244	499	743
"E78"	"H91"	"Disorders of lipoprotein metabolism and other lipidemias"	"Other and unspecified hearing loss"	1	5154	8945	14099
"A49"	"N83"	"Bacterial infection of unspecified site"	"Noninflammatory disord of ovary, fallop and broad ligament"	1	125	497	622
"D13"	"O70"	"Benign neoplasm of and ill-defined parts of digestive system"	"Perineal laceration during delivery"	1	1	170	171
"Q87"	"Q21"	"Oth congenital malform syndromes affecting multiple systems"	"Congenital malformations of cardiac septa"	1	172	285	457
"E86"	"H18"	"Volume depletion"	"Other disorders of cornea"	1	164	752	916
"I67"	"O80"	"Other cerebrovascular diseases"	"Encounter for full-term uncomplicated delivery"	1	0	134	134
"K08"	"N03"	"Other disorders of teeth and supporting structures"	"Chronic nephritic syndrome"	1	8	58	66
"N81"	"N60"	"Female genital prolapse"	"Benign mammary dysplasia"	1	190	805	995
"J90"	"J32"	"Pleural effusion, not elsewhere classified"	"Chronic sinusitis"	1	9	87	96
"G45"	"M17"	"Transient cerebral ischemic attacks and related syndromes"	"Osteoarthritis of knee"	1	1649	3084	4733
"J84"	"M51"	"Other interstitial pulmonary diseases"	"Thoracic, thoracolum, and lumbosacral intvrt disc disorders"	1	60	546	606
"N75"	"O80"	"Diseases of Bartholin's gland"	"Encounter for full-term uncomplicated delivery"	1	375	1480	1855
"J15"	"G45"	"Bacterial pneumonia, not elsewhere classified"	"Transient cerebral ischemic attacks and related syndromes"	1	0	4309	4309
"D12"	"H02"	"Benign neoplasm of colon, rectum, anus and anal canal"	"Other disorders of eyelid"	1	919	1285	2204
"Q61"	"I25"	"Cystic kidney disease"	"Chronic ischemic heart disease"	1	255	481	736
"O26"	"N96"	"Maternal care for oth conditions predom related to pregnancy"	"Recurrent pregnancy loss"	1	450	1407	1857
"F32"	"O36"	"Depressive episode"	"Maternal care for other fetal problems"	1	138	297	435
"D04"	"M17"	"Carcinoma in situ of skin"	"Osteoarthritis of knee"	1	31	177	208
"K05"	"N97"	"Gingivitis and periodontal diseases"	"Female infertility"	1	18	80	98
"K59"	"H53"	"Other functional intestinal disorders"	"Visual disturbances"	1	817	1144	1961
"C25"	"I49"	"Malignant neoplasm of pancreas"	"Other cardiac arrhythmias"	1	33	262	295
"F17"	"M00"	"Nicotine dependence"	"Pyogenic arthritis"	1	28	83	111
"N19"	"G51"	"Unspecified kidney failure"	"Facial nerve disorders"	1	25	88	113
"M48"	"H00"	"Other spondylopathies"	"Hordeolum and chalazion"	1	13	92	105
"J15"	"B02"	"Bacterial pneumonia, not elsewhere classified"	"Zoster [herpes zoster]"	1	380	690	1070
"A49"	"C90"	"Bacterial infection of unspecified site"	"Multiple myeloma and malignant plasma cell neoplasms"	1	127	586	713
"C15"	"H18"	"Malignant neoplasm of esophagus"	"Other disorders of cornea"	1	3	34	37
"E55"	"K40"	"Vitamin D deficiency"	"Inguinal hernia"	1	0	484	484
"K64"	"M17"	"Hemorrhoids and perianal venous thrombosis"	"Osteoarthritis of knee"	1	0	2408	2408
"M50"	"N87"	"Cervical disc disorders"	"Dysplasia of cervix uteri"	1	28	410	438
"L71"	"O02"	"Rosacea"	"Other abnormal products of conception"	1	10	102	112
"A49"	"C20"	"Bacterial infection of unspecified site"	"Malignant neoplasm of rectum"	1	137	710	847
"C79"	"C30"	"Secondary malignant neoplasm of other and unspecified sites"	"Malignant neoplasm of nasal cavity and middle ear"	1	23	78	101
"I26"	"O62"	"Pulmonary embolism"	"Abnormalities of forces of labor"	1	17	353	370
"L89"	"F20"	"Pressure ulcer"	"Schizophrenia"	1	84	196	280
"K66"	"N83"	"Other disorders of peritoneum"	"Noninflammatory disord of ovary, fallop and broad ligament"	1	469	754	1223
"D43"	"M65"	"Neoplasm of uncertain behavior of brain and cnsl"	"Synovitis and tenosynovitis"	1	11	80	91
"C22"	"J34"	"Malignant neoplasm of liver and intrahepatic bile ducts"	"Other and unspecified disorders of nose and nasal sinuses"	1	0	28	28
"F03"	"D50"	"Unspecified dementia"	"Iron deficiency anemia"	1	1292	1675	2967
"G96"	"O68"	"Other disorders of central nervous system"	"Labor and delivery comp by abnlt of fetal acid-base balance"	1	0	404	404
"C76"	"G45"	"Malignant neoplasm of other and ill-defined sites"	"Transient cerebral ischemic attacks and related syndromes"	1	34	117	151
"K62"	"G56"	"Other diseases of anus and rectum"	"Mononeuropathies of upper limb"	1	980	1711	2691
"I68"	"I10"	"Cerebrovascular disorders in diseases classified elsewhere"	"Essential (primary) hypertension"	1	83	188	271
"N30"	"K58"	"Cystitis"	"Irritable bowel syndrome"	1	1164	2183	3347
"H50"	"Q05"	"Other strabismus"	"Spina bifida"	1	4	63	67
"Q51"	"J35"	"Congenital malformations of uterus and cervix"	"Chronic diseases of tonsils and adenoids"	1	0	58	58
"K83"	"M17"	"Other diseases of biliary tract"	"Osteoarthritis of knee"	1	169	805	974
"J95"	"N43"	"Intraop and postproc comp and disorders of resp sys, NEC"	"Hydrocele and spermatocele"	1	0	38	38
"N19"	"H52"	"Unspecified kidney failure"	"Disorders of refraction and accommodation"	1	45	118	163
"I38"	"I35"	"Endocarditis, valve unspecified"	"Nonrheumatic aortic valve disorders"	1	488	879	1367
"M47"	"O34"	"Spondylosis"	"Maternal care for abnormality of pelvic organs"	1	0	152	152
"N63"	"H66"	"Unspecified lump in breast"	"Suppurative and unspecified otitis media"	1	21	143	164
"F32"	"O30"	"Depressive episode"	"Multiple gestation"	1	16	73	89
"C44"	"H50"	"Other and unspecified malignant neoplasm of skin"	"Other strabismus"	1	32	143	175
"E66"	"H66"	"Overweight and obesity"	"Suppurative and unspecified otitis media"	1	0	932	932
"I46"	"M34"	"Cardiac arrest"	"Systemic sclerosis [scleroderma]"	1	3	40	43
"L90"	"O70"	"Atrophic disorders of skin"	"Perineal laceration during delivery"	1	516	991	1507
"A41"	"Q61"	"Other sepsis"	"Cystic kidney disease"	1	249	575	824
"A41"	"D59"	"Other sepsis"	"Acquired hemolytic anemia"	1	266	451	717
"E05"	"N60"	"Thyrotoxicosis [hyperthyroidism]"	"Benign mammary dysplasia"	1	187	442	629
"I69"	"N64"	"Sequelae of cerebrovascular disease"	"Other disorders of breast"	1	72	188	260
"H36"	"N63"	"Retinal disorders in diseases classified elsewhere"	"Unspecified lump in breast"	1	57	127	184
"M90"	"C34"	"Osteopathies in diseases classified elsewhere"	"Malignant neoplasm of bronchus and lung"	1	126	248	374
"L59"	"C50"	"Oth disorders of skin, subcu related to radiation"	"Malignant neoplasm of breast"	1	16	711	727
"G20"	"K60"	"Parkinson's disease"	"Fissure and fistula of anal and rectal regions"	1	1	65	66
"I26"	"M24"	"Pulmonary embolism"	"Other specific joint derangements"	1	70	183	253
"G91"	"M20"	"Hydrocephalus"	"Acquired deformities of fingers and toes"	1	28	88	116
"F03"	"N62"	"Unspecified dementia"	"Hypertrophy of breast"	1	0	152	152
"I63"	"C50"	"Cerebral infarction"	"Malignant neoplasm of breast"	1	421	1561	1982
"A41"	"N35"	"Other sepsis"	"Urethral stricture"	1	254	814	1068
"E28"	"J36"	"Ovarian dysfunction"	"Peritonsillar abscess"	1	8	69	77
"K43"	"C53"	"Ventral hernia"	"Malignant neoplasm of cervix uteri"	1	32	162	194
"M79"	"H27"	"Oth and unsp soft tissue disorders, not elsewhere classified"	"Other disorders of lens"	1	57	181	238
"I85"	"D24"	"Esophageal varices"	"Benign neoplasm of breast"	1	4	38	42
"D50"	"M75"	"Iron deficiency anemia"	"Shoulder lesions"	1	473	1202	1675
"H40"	"D17"	"Glaucoma"	"Benign lipomatous neoplasm"	1	116	233	349
"D12"	"O34"	"Benign neoplasm of colon, rectum, anus and anal canal"	"Maternal care for abnormality of pelvic organs"	1	0	89	89
"M25"	"O65"	"Other joint disorder, not elsewhere classified"	"Obstructed labor due to maternal pelvic abnormality"	1	0	333	333
"A04"	"N83"	"Other bacterial intestinal infections"	"Noninflammatory disord of ovary, fallop and broad ligament"	1	78	203	281
"C45"	"I21"	"Mesothelioma"	"Acute myocardial infarction"	1	14	70	84
"E34"	"E10"	"Other endocrine disorders"	"Type 1 diabetes mellitus"	1	110	434	544
"K02"	"H83"	"Dental caries"	"Other diseases of inner ear"	1	18	142	160
"B95"	"O68"	"Strep as the cause of diseases classified elsewhere"	"Labor and delivery comp by abnlt of fetal acid-base balance"	1	41	134	175
"J90"	"I83"	"Pleural effusion, not elsewhere classified"	"Varicose veins of lower extremities"	1	41	563	604
"C25"	"I34"	"Malignant neoplasm of pancreas"	"Nonrheumatic mitral valve disorders"	1	15	116	131
"C34"	"J32"	"Malignant neoplasm of bronchus and lung"	"Chronic sinusitis"	1	10	221	231
"J15"	"K42"	"Bacterial pneumonia, not elsewhere classified"	"Umbilical hernia"	1	162	847	1009
"M72"	"O04"	"Fibroblastic disorders"	"Complications following (induced) termination of pregnancy"	1	0	301	301
"I95"	"K40"	"Hypotension"	"Inguinal hernia"	1	20	1065	1085
"I73"	"L02"	"Other peripheral vascular diseases"	"Cutaneous abscess, furuncle and carbuncle"	1	487	1117	1604
"N18"	"G37"	"Chronic kidney disease (CKD)"	"Other demyelinating diseases of central nervous system"	1	2	32	34
"E89"	"J38"	"Postproc endocrine and metabolic comp and disorders, NEC"	"Diseases of vocal cords and larynx, not elsewhere classified"	1	72	183	255
"C80"	"C32"	"Malignant neoplasm without specification of site"	"Malignant neoplasm of larynx"	1	24	74	98
"M25"	"L05"	"Other joint disorder, not elsewhere classified"	"Pilonidal cyst and sinus"	1	55	234	289
"K21"	"I20"	"Gastro-esophageal reflux disease"	"Angina pectoris"	1	3828	5384	9212
"F17"	"H20"	"Nicotine dependence"	"Iridocyclitis"	1	27	133	160
"I50"	"L43"	"Heart failure"	"Lichen planus"	1	50	194	244
"J22"	"M20"	"Unspecified acute lower respiratory infection"	"Acquired deformities of fingers and toes"	1	2	191	193
"K56"	"O30"	"Paralytic ileus and intestinal obstruction without hernia"	"Multiple gestation"	1	22	109	131
"G44"	"O36"	"Other headache syndromes"	"Maternal care for other fetal problems"	1	143	398	541
"A09"	"Q90"	"Infectious gastroenteritis and colitis, unspecified"	"Down syndrome"	1	37	195	232
"K04"	"M54"	"Diseases of pulp and periapical tissues"	"Dorsalgia"	1	622	1041	1663
"K51"	"O03"	"Ulcerative colitis"	"Spontaneous abortion"	1	109	284	393
"I63"	"O26"	"Cerebral infarction"	"Maternal care for oth conditions predom related to pregnancy"	1	0	89	89
"K63"	"K44"	"Other diseases of intestine"	"Diaphragmatic hernia"	1	210	601	811
"K92"	"M65"	"Other diseases of digestive system"	"Synovitis and tenosynovitis"	1	191	758	949
"E86"	"H71"	"Volume depletion"	"Cholesteatoma of middle ear"	1	1	139	140
"M76"	"H72"	"Enthesopathies, lower limb, excluding foot"	"Perforation of tympanic membrane"	1	38	112	150
"C16"	"K40"	"Malignant neoplasm of stomach"	"Inguinal hernia"	1	19	494	513
"C61"	"J42"	"Malignant neoplasm of prostate"	"Unspecified chronic bronchitis"	1	249	459	708
"A49"	"I83"	"Bacterial infection of unspecified site"	"Varicose veins of lower extremities"	1	118	1344	1462
"K59"	"O21"	"Other functional intestinal disorders"	"Excessive vomiting in pregnancy"	1	295	503	798
"J10"	"C85"	"Influenza due to other identified influenza virus"	"Oth and unspecified types of non-Hodgkin lymphoma"	1	5	53	58
"C34"	"D51"	"Malignant neoplasm of bronchus and lung"	"Vitamin B12 deficiency anemia"	1	39	200	239
"I10"	"O32"	"Essential (primary) hypertension"	"Maternal care for malpresentation of fetus"	1	0	438	438
"K30"	"M08"	"Functional dyspepsia"	"Juvenile arthritis"	1	6	46	52
"O99"	"M92"	"Oth maternal diseases classd elsw but compl preg/chldbrth"	"Other juvenile osteochondrosis"	1	0	84	84
"E87"	"N10"	"Other disorders of fluid, electrolyte and acid-base balance"	"Acute pyelonephritis"	1	649	854	1503
"M75"	"K20"	"Shoulder lesions"	"Esophagitis"	1	495	736	1231
"F32"	"C54"	"Depressive episode"	"Malignant neoplasm of corpus uteri"	1	68	226	294
"C20"	"I47"	"Malignant neoplasm of rectum"	"Paroxysmal tachycardia"	1	174	285	459
"I49"	"K26"	"Other cardiac arrhythmias"	"Duodenal ulcer"	1	443	647	1090
"K31"	"D25"	"Other diseases of stomach and duodenum"	"Leiomyoma of uterus"	1	4	77	81
"C25"	"M21"	"Malignant neoplasm of pancreas"	"Other acquired deformities of limbs"	1	0	59	59
"F41"	"O41"	"Other anxiety disorders"	"Other disorders of amniotic fluid and membranes"	1	5	58	63
"H15"	"O70"	"Disorders of sclera"	"Perineal laceration during delivery"	1	11	63	74
"K65"	"J30"	"Peritonitis"	"Vasomotor and allergic rhinitis"	1	16	63	79
"M99"	"M23"	"Biomechanical lesions, not elsewhere classified"	"Internal derangement of knee"	1	257	1002	1259
"D17"	"K51"	"Benign lipomatous neoplasm"	"Ulcerative colitis"	1	124	220	344
"F20"	"H90"	"Schizophrenia"	"Conductive and sensorineural hearing loss"	1	23	78	101
"D69"	"M75"	"Purpura and other hemorrhagic conditions"	"Shoulder lesions"	1	232	388	620
"E83"	"O36"	"Disorders of mineral metabolism"	"Maternal care for other fetal problems"	1	7	50	57
"I49"	"O75"	"Other cardiac arrhythmias"	"Oth complications of labor and delivery, NEC"	1	19	125	144
"H44"	"O99"	"Disorders of globe"	"Oth maternal diseases classd elsw but compl preg/chldbrth"	1	68	197	265
"I88"	"Q53"	"Nonspecific lymphadenitis"	"Undescended and ectopic testicle"	1	15	63	78
"F41"	"I69"	"Other anxiety disorders"	"Sequelae of cerebrovascular disease"	1	785	1004	1789
"L97"	"N43"	"Non-pressure chronic ulcer of lower limb, NEC"	"Hydrocele and spermatocele"	1	16	148	164
"D64"	"K42"	"Other anemias"	"Umbilical hernia"	1	293	957	1250
"K62"	"O03"	"Other diseases of anus and rectum"	"Spontaneous abortion"	1	0	460	460
"I33"	"N92"	"Acute and subacute endocarditis"	"Excessive, frequent and irregular menstruation"	1	8	54	62
"E87"	"G44"	"Other disorders of fluid, electrolyte and acid-base balance"	"Other headache syndromes"	1	116	544	660
"J22"	"H81"	"Unspecified acute lower respiratory infection"	"Disorders of vestibular function"	1	15	185	200
"I44"	"M77"	"Atrioventricular and left bundle-branch block"	"Other enthesopathies"	1	28	145	173
"M21"	"O20"	"Other acquired deformities of limbs"	"Hemorrhage in early pregnancy"	1	42	161	203
"O26"	"H65"	"Maternal care for oth conditions predom related to pregnancy"	"Nonsuppurative otitis media"	1	24	139	163
"L02"	"J05"	"Cutaneous abscess, furuncle and carbuncle"	"Acute obstructive laryngitis [croup] and epiglottitis"	1	30	309	339
"I80"	"K21"	"Phlebitis and thrombophlebitis"	"Gastro-esophageal reflux disease"	1	801	1171	1972
"F32"	"M54"	"Depressive episode"	"Dorsalgia"	1	2634	4748	7382
"O69"	"O30"	"Labor and delivery complicated by umbilical cord comp"	"Multiple gestation"	1	130	361	491
"K59"	"A08"	"Other functional intestinal disorders"	"Viral and other specified intestinal infections"	1	1105	2177	3282
"I44"	"F10"	"Atrioventricular and left bundle-branch block"	"Alcohol related disorders"	1	237	678	915
"K25"	"K40"	"Gastric ulcer"	"Inguinal hernia"	1	875	1639	2514
"O91"	"A60"	"Infect of breast assoc w pregnancy, the puerp and lactation"	"Anogenital herpesviral [herpes simplex] infections"	1	5	62	67
"F17"	"D24"	"Nicotine dependence"	"Benign neoplasm of breast"	1	37	380	417
"H52"	"O32"	"Disorders of refraction and accommodation"	"Maternal care for malpresentation of fetus"	1	77	253	330
"G50"	"O75"	"Disorders of trigeminal nerve"	"Oth complications of labor and delivery, NEC"	1	0	29	29
"G47"	"I65"	"Sleep disorders"	"Occls and stenosis of precerb art, not rslt in cereb infrc"	1	91	262	353
"K04"	"O71"	"Diseases of pulp and periapical tissues"	"Other obstetric trauma"	1	5	68	73
"O91"	"J45"	"Infect of breast assoc w pregnancy, the puerp and lactation"	"Asthma"	1	83	256	339
"F43"	"J30"	"Reaction to severe stress, and adjustment disorders"	"Vasomotor and allergic rhinitis"	1	97	286	383
"E87"	"M77"	"Other disorders of fluid, electrolyte and acid-base balance"	"Other enthesopathies"	1	6	502	508
"I89"	"O32"	"Oth noninfective disorders of lymphatic vessels and nodes"	"Maternal care for malpresentation of fetus"	1	0	26	26
"M81"	"O71"	"Osteoporosis without current pathological fracture"	"Other obstetric trauma"	1	0	48	48
"D72"	"I20"	"Other disorders of white blood cells"	"Angina pectoris"	1	70	302	372
"J91"	"E66"	"Pleural effusion in conditions classified elsewhere"	"Overweight and obesity"	1	71	312	383
"J06"	"O42"	"Acute upper resp infections of multiple and unsp sites"	"Premature rupture of membranes"	1	24	209	233
"M96"	"N87"	"Intraop and postproc comp and disorders of ms sys, NEC"	"Dysplasia of cervix uteri"	1	8	51	59
"L30"	"K35"	"Other and unspecified dermatitis"	"Acute appendicitis"	1	82	368	450
"J95"	"N20"	"Intraop and postproc comp and disorders of resp sys, NEC"	"Calculus of kidney and ureter"	1	18	92	110
"M85"	"O14"	"Other disorders of bone density and structure"	"Pre-eclampsia"	1	0	39	39
"K64"	"K52"	"Hemorrhoids and perianal venous thrombosis"	"Other and unsp noninfective gastroenteritis and colitis"	1	287	839	1126
"J96"	"J20"	"Respiratory failure, not elsewhere classified"	"Acute bronchitis"	1	2168	3443	5611
"K40"	"H10"	"Inguinal hernia"	"Conjunctivitis"	1	573	1027	1600
"G31"	"K35"	"Oth degenerative diseases of nervous system, NEC"	"Acute appendicitis"	1	6	42	48
"F32"	"O03"	"Depressive episode"	"Spontaneous abortion"	1	28	472	500
"A04"	"D62"	"Other bacterial intestinal infections"	"Acute posthemorrhagic anemia"	1	257	412	669
"I48"	"J32"	"Atrial fibrillation and flutter"	"Chronic sinusitis"	1	166	595	761
"I80"	"N60"	"Phlebitis and thrombophlebitis"	"Benign mammary dysplasia"	1	107	376	483
"J70"	"H91"	"Respiratory conditions due to other external agents"	"Other and unspecified hearing loss"	1	23	97	120
"L97"	"G43"	"Non-pressure chronic ulcer of lower limb, NEC"	"Migraine"	1	4	74	78
"M21"	"D27"	"Other acquired deformities of limbs"	"Benign neoplasm of ovary"	1	54	140	194
"E04"	"F10"	"Other nontoxic goiter"	"Alcohol related disorders"	1	195	343	538
"N48"	"C20"	"Other disorders of penis"	"Malignant neoplasm of rectum"	1	155	551	706
"H54"	"J44"	"Blindness and low vision"	"Other chronic obstructive pulmonary disease"	1	570	771	1341
"N83"	"O82"	"Noninflammatory disord of ovary, fallop and broad ligament"	"Encounter for cesarean delivery without indication"	1	1150	1815	2965
"K64"	"O04"	"Hemorrhoids and perianal venous thrombosis"	"Complications following (induced) termination of pregnancy"	1	0	609	609
"Q61"	"H90"	"Cystic kidney disease"	"Conductive and sensorineural hearing loss"	1	54	121	175
"I24"	"K40"	"Other acute ischemic heart diseases"	"Inguinal hernia"	1	158	325	483
"F41"	"O03"	"Other anxiety disorders"	"Spontaneous abortion"	1	4	533	537
"F33"	"O70"	"Major depressive disorder, recurrent"	"Perineal laceration during delivery"	1	367	710	1077
"K22"	"N63"	"Other diseases of esophagus"	"Unspecified lump in breast"	1	32	137	169
"N20"	"B27"	"Calculus of kidney and ureter"	"Infectious mononucleosis"	1	8	126	134
"N18"	"E11"	"Chronic kidney disease (CKD)"	"Type 2 diabetes mellitus"	1	0	13700	13700
"N19"	"K80"	"Unspecified kidney failure"	"Cholelithiasis"	1	385	1176	1561
"J00"	"Q25"	"Acute nasopharyngitis [common cold]"	"Congenital malformations of great arteries"	1	197	578	775
"A49"	"G62"	"Bacterial infection of unspecified site"	"Other and unspecified polyneuropathies"	1	302	856	1158
"C79"	"A88"	"Secondary malignant neoplasm of other and unspecified sites"	"Oth viral infections of central nervous system, NEC"	1	0	47	47
"O70"	"A39"	"Perineal laceration during delivery"	"Meningococcal infection"	1	0	26	26
"O72"	"B07"	"Postpartum hemorrhage"	"Viral warts"	1	0	215	215
"J18"	"D39"	"Pneumonia, unspecified organism"	"Neoplasm of uncertain behavior of female genital organs"	1	48	234	282
"M20"	"H10"	"Acquired deformities of fingers and toes"	"Conjunctivitis"	1	197	554	751
"A49"	"E03"	"Bacterial infection of unspecified site"	"Other hypothyroidism"	1	497	1133	1630
"D30"	"H93"	"Benign neoplasm of urinary organs"	"Other disorders of ear, not elsewhere classified"	1	168	302	470
"C22"	"M50"	"Malignant neoplasm of liver and intrahepatic bile ducts"	"Cervical disc disorders"	1	0	45	45
"K56"	"C16"	"Paralytic ileus and intestinal obstruction without hernia"	"Malignant neoplasm of stomach"	1	271	573	844
"F03"	"H71"	"Unspecified dementia"	"Cholesteatoma of middle ear"	1	0	45	45
"F05"	"J32"	"Delirium due to known physiological condition"	"Chronic sinusitis"	1	0	58	58
"I10"	"M32"	"Essential (primary) hypertension"	"Systemic lupus erythematosus (SLE)"	1	147	362	509
"K76"	"J05"	"Other diseases of liver"	"Acute obstructive laryngitis [croup] and epiglottitis"	1	0	30	30
"M84"	"J45"	"Disorder of continuity of bone"	"Asthma"	1	99	222	321
"K92"	"E03"	"Other diseases of digestive system"	"Other hypothyroidism"	1	855	1129	1984
"C44"	"N03"	"Other and unspecified malignant neoplasm of skin"	"Chronic nephritic syndrome"	1	5	121	126
"M80"	"I48"	"Osteoporosis with current pathological fracture"	"Atrial fibrillation and flutter"	1	3768	4590	8358
"C92"	"C82"	"Myeloid leukemia"	"Follicular lymphoma"	1	20	71	91
"N13"	"C19"	"Obstructive and reflux uropathy"	"Malignant neoplasm of rectosigmoid junction"	1	37	107	144
"N80"	"N70"	"Endometriosis"	"Salpingitis and oophoritis"	1	818	1075	1893
"M18"	"M17"	"Osteoarthritis of first carpometacarpal joint"	"Osteoarthritis of knee"	1	871	1251	2122
"J09"	"O68"	"Influenza due to certain identified influenza viruses"	"Labor and delivery comp by abnlt of fetal acid-base balance"	1	4	75	79
"C61"	"H43"	"Malignant neoplasm of prostate"	"Disorders of vitreous body"	1	159	358	517
"J86"	"M47"	"Pyothorax"	"Spondylosis"	1	51	115	166
"C10"	"I20"	"Malignant neoplasm of oropharynx"	"Angina pectoris"	1	3	122	125
"H54"	"O04"	"Blindness and low vision"	"Complications following (induced) termination of pregnancy"	1	0	97	97
"M81"	"L27"	"Osteoporosis without current pathological fracture"	"Dermatitis due to substances taken internally"	1	97	204	301
"C34"	"M50"	"Malignant neoplasm of bronchus and lung"	"Cervical disc disorders"	1	0	684	684
"F06"	"M51"	"Other mental disorders due to known physiological condition"	"Thoracic, thoracolum, and lumbosacral intvrt disc disorders"	1	11	330	341
"H36"	"M54"	"Retinal disorders in diseases classified elsewhere"	"Dorsalgia"	1	472	830	1302
"C83"	"M77"	"Non-follicular lymphoma"	"Other enthesopathies"	1	10	73	83
"H49"	"K40"	"Paralytic strabismus"	"Inguinal hernia"	1	66	161	227
"I46"	"M17"	"Cardiac arrest"	"Osteoarthritis of knee"	1	0	1372	1372
"E68"	"N87"	"Sequelae of hyperalimentation"	"Dysplasia of cervix uteri"	1	47	150	197
"E23"	"M70"	"Hypofunction and other disorders of the pituitary gland"	"Soft tissue disorders related to use, overuse and pressure"	1	26	76	102
"F03"	"K40"	"Unspecified dementia"	"Inguinal hernia"	1	0	2788	2788
"D46"	"N43"	"Myelodysplastic syndromes"	"Hydrocele and spermatocele"	1	3	47	50
"G44"	"N87"	"Other headache syndromes"	"Dysplasia of cervix uteri"	1	132	351	483
"I83"	"O24"	"Varicose veins of lower extremities"	"Diabetes in pregnancy, childbirth, and the puerperium"	1	21	332	353
"E11"	"J30"	"Type 2 diabetes mellitus"	"Vasomotor and allergic rhinitis"	1	83	459	542
"E64"	"K58"	"Sequelae of malnutrition and other nutritional deficiencies"	"Irritable bowel syndrome"	1	111	293	404
"G30"	"D12"	"Alzheimer's disease"	"Benign neoplasm of colon, rectum, anus and anal canal"	1	2	628	630
"G47"	"H65"	"Sleep disorders"	"Nonsuppurative otitis media"	1	647	1045	1692
"C77"	"C15"	"Secondary and unspecified malignant neoplasm of lymph nodes"	"Malignant neoplasm of esophagus"	1	318	619	937
"C80"	"A09"	"Malignant neoplasm without specification of site"	"Infectious gastroenteritis and colitis, unspecified"	1	45	128	173
"O08"	"O03"	"Complications following ectopic and molar pregnancy"	"Spontaneous abortion"	1	1724	3778	5502
"M48"	"I83"	"Other spondylopathies"	"Varicose veins of lower extremities"	1	434	1838	2272
"E87"	"I85"	"Other disorders of fluid, electrolyte and acid-base balance"	"Esophageal varices"	1	421	619	1040
"H26"	"A69"	"Other cataract"	"Other spirochetal infections"	1	13	71	84
"I95"	"C67"	"Hypotension"	"Malignant neoplasm of bladder"	1	64	198	262
"F41"	"D17"	"Other anxiety disorders"	"Benign lipomatous neoplasm"	1	61	365	426
"I44"	"J30"	"Atrioventricular and left bundle-branch block"	"Vasomotor and allergic rhinitis"	1	6	56	62
"J06"	"J42"	"Acute upper resp infections of multiple and unsp sites"	"Unspecified chronic bronchitis"	1	40	115	155
"I20"	"N73"	"Angina pectoris"	"Other female pelvic inflammatory diseases"	1	2	124	126
"K64"	"O34"	"Hemorrhoids and perianal venous thrombosis"	"Maternal care for abnormality of pelvic organs"	1	0	362	362
"K80"	"O90"	"Cholelithiasis"	"Complications of the puerperium, not elsewhere classified"	1	222	510	732
"I20"	"O91"	"Angina pectoris"	"Infect of breast assoc w pregnancy, the puerp and lactation"	1	0	26	26
"I10"	"O99"	"Essential (primary) hypertension"	"Oth maternal diseases classd elsw but compl preg/chldbrth"	1	0	2945	2945
"G63"	"H36"	"Polyneuropathy in diseases classified elsewhere"	"Retinal disorders in diseases classified elsewhere"	1	248	442	690
"N28"	"K25"	"Oth disorders of kidney and ureter, not elsewhere classified"	"Gastric ulcer"	1	198	484	682
"E04"	"K35"	"Other nontoxic goiter"	"Acute appendicitis"	1	180	445	625
"D72"	"M22"	"Other disorders of white blood cells"	"Disorder of patella"	1	0	34	34
"K72"	"N81"	"Hepatic failure, not elsewhere classified"	"Female genital prolapse"	1	10	97	107
"I35"	"H57"	"Nonrheumatic aortic valve disorders"	"Other disorders of eye and adnexa"	1	145	252	397
"N11"	"N20"	"Chronic tubulo-interstitial nephritis"	"Calculus of kidney and ureter"	1	179	316	495
"G35"	"M22"	"Multiple sclerosis"	"Disorder of patella"	1	7	157	164
"L82"	"K80"	"Seborrheic keratosis"	"Cholelithiasis"	1	51	263	314
"M53"	"O34"	"Other and unspecified dorsopathies, not elsewhere classified"	"Maternal care for abnormality of pelvic organs"	1	79	199	278
"G56"	"N47"	"Mononeuropathies of upper limb"	"Disorders of prepuce"	1	207	331	538
"K76"	"J32"	"Other diseases of liver"	"Chronic sinusitis"	1	44	117	161
"J18"	"Q25"	"Pneumonia, unspecified organism"	"Congenital malformations of great arteries"	1	357	1024	1381
"J44"	"M16"	"Other chronic obstructive pulmonary disease"	"Osteoarthritis of hip"	1	0	8463	8463
"C22"	"C61"	"Malignant neoplasm of liver and intrahepatic bile ducts"	"Malignant neoplasm of prostate"	1	22	134	156
"I65"	"D24"	"Occls and stenosis of precerb art, not rslt in cereb infrc"	"Benign neoplasm of breast"	1	7	47	54
"E13"	"I25"	"Other specified diabetes mellitus"	"Chronic ischemic heart disease"	1	310	808	1118
"A49"	"I21"	"Bacterial infection of unspecified site"	"Acute myocardial infarction"	1	0	3365	3365
"M99"	"O99"	"Biomechanical lesions, not elsewhere classified"	"Oth maternal diseases classd elsw but compl preg/chldbrth"	1	53	275	328
"O15"	"N97"	"Eclampsia"	"Female infertility"	1	12	60	72
"F01"	"M19"	"Vascular dementia"	"Other and unspecified osteoarthritis"	1	57	326	383
"G47"	"N35"	"Sleep disorders"	"Urethral stricture"	1	73	246	319
"E86"	"N84"	"Volume depletion"	"Polyp of female genital tract"	1	33	627	660
"N48"	"K40"	"Other disorders of penis"	"Inguinal hernia"	1	467	1005	1472
"H53"	"M16"	"Visual disturbances"	"Osteoarthritis of hip"	1	380	578	958
"M81"	"O75"	"Osteoporosis without current pathological fracture"	"Oth complications of labor and delivery, NEC"	1	0	47	47
"E86"	"N97"	"Volume depletion"	"Female infertility"	1	42	215	257
"O62"	"O21"	"Abnormalities of forces of labor"	"Excessive vomiting in pregnancy"	1	3172	4394	7566
"H36"	"M67"	"Retinal disorders in diseases classified elsewhere"	"Other disorders of synovium and tendon"	1	114	205	319
"I67"	"O99"	"Other cerebrovascular diseases"	"Oth maternal diseases classd elsw but compl preg/chldbrth"	1	41	109	150
"C20"	"I83"	"Malignant neoplasm of rectum"	"Varicose veins of lower extremities"	1	84	435	519
"M48"	"M31"	"Other spondylopathies"	"Other necrotizing vasculopathies"	1	260	418	678
"N13"	"M54"	"Obstructive and reflux uropathy"	"Dorsalgia"	1	883	1317	2200
"K64"	"M65"	"Hemorrhoids and perianal venous thrombosis"	"Synovitis and tenosynovitis"	1	0	1271	1271
"C44"	"M75"	"Other and unspecified malignant neoplasm of skin"	"Shoulder lesions"	1	632	1913	2545
"F17"	"M76"	"Nicotine dependence"	"Enthesopathies, lower limb, excluding foot"	1	113	295	408
"I10"	"O63"	"Essential (primary) hypertension"	"Long labor"	1	0	234	234
"F60"	"F32"	"Specific personality disorders"	"Depressive episode"	1	353	558	911
"E61"	"K29"	"Deficiency of other nutrient elements"	"Gastritis and duodenitis"	1	38	148	186
"E55"	"K30"	"Vitamin D deficiency"	"Functional dyspepsia"	1	159	588	747
"K63"	"O26"	"Other diseases of intestine"	"Maternal care for oth conditions predom related to pregnancy"	1	4	98	102
"D30"	"O70"	"Benign neoplasm of urinary organs"	"Perineal laceration during delivery"	1	0	30	30
"K02"	"Q53"	"Dental caries"	"Undescended and ectopic testicle"	1	32	129	161
"I33"	"N20"	"Acute and subacute endocarditis"	"Calculus of kidney and ureter"	1	33	96	129
"F11"	"O04"	"Opioid related disorders"	"Complications following (induced) termination of pregnancy"	1	70	214	284
"A41"	"I61"	"Other sepsis"	"Nontraumatic intracerebral hemorrhage"	1	995	1468	2463
"J38"	"O48"	"Diseases of vocal cords and larynx, not elsewhere classified"	"Late pregnancy"	1	14	67	81
"I73"	"F10"	"Other peripheral vascular diseases"	"Alcohol related disorders"	1	534	1953	2487
"D75"	"I10"	"Other and unsp diseases of blood and blood-forming organs"	"Essential (primary) hypertension"	1	787	1218	2005
"I42"	"N87"	"Cardiomyopathy"	"Dysplasia of cervix uteri"	1	5	45	50
"F03"	"H27"	"Unspecified dementia"	"Other disorders of lens"	1	0	224	224
"N95"	"O42"	"Menopausal and other perimenopausal disorders"	"Premature rupture of membranes"	1	0	31	31
"O90"	"O47"	"Complications of the puerperium, not elsewhere classified"	"False labor"	1	698	2031	2729
"N82"	"C54"	"Fistulae involving female genital tract"	"Malignant neoplasm of corpus uteri"	1	45	155	200
"C78"	"F20"	"Secondary malignant neoplasm of resp and digestive organs"	"Schizophrenia"	1	52	136	188
"I73"	"H10"	"Other peripheral vascular diseases"	"Conjunctivitis"	1	12	469	481
"I63"	"C54"	"Cerebral infarction"	"Malignant neoplasm of corpus uteri"	1	66	287	353
"C16"	"K25"	"Malignant neoplasm of stomach"	"Gastric ulcer"	1	552	1644	2196
"L97"	"I69"	"Non-pressure chronic ulcer of lower limb, NEC"	"Sequelae of cerebrovascular disease"	1	1325	1822	3147
"F84"	"Q85"	"Pervasive developmental disorders"	"Phakomatoses, not elsewhere classified"	1	4	39	43
"J44"	"M47"	"Other chronic obstructive pulmonary disease"	"Spondylosis"	1	1552	3358	4910
"A41"	"I50"	"Other sepsis"	"Heart failure"	1	0	21827	21827
"D46"	"I65"	"Myelodysplastic syndromes"	"Occls and stenosis of precerb art, not rslt in cereb infrc"	1	3	31	34
"C20"	"M75"	"Malignant neoplasm of rectum"	"Shoulder lesions"	1	131	470	601
"Q65"	"O65"	"Congenital deformities of hip"	"Obstructed labor due to maternal pelvic abnormality"	1	0	29	29
"F33"	"H83"	"Major depressive disorder, recurrent"	"Other diseases of inner ear"	1	0	219	219
"D63"	"O99"	"Anemia in chronic diseases classified elsewhere"	"Oth maternal diseases classd elsw but compl preg/chldbrth"	1	2	48	50
"I72"	"M72"	"Other aneurysm"	"Fibroblastic disorders"	1	25	88	113
"J84"	"O99"	"Other interstitial pulmonary diseases"	"Oth maternal diseases classd elsw but compl preg/chldbrth"	1	5	54	59
"N80"	"J36"	"Endometriosis"	"Peritonsillar abscess"	1	12	88	100
"C49"	"C17"	"Malignant neoplasm of other connective and soft tissue"	"Malignant neoplasm of small intestine"	1	49	115	164
"M31"	"K40"	"Other necrotizing vasculopathies"	"Inguinal hernia"	1	138	309	447
"O72"	"N12"	"Postpartum hemorrhage"	"Tubulo-interstitial nephritis, not spcf as acute or chronic"	1	173	321	494
"E41"	"I25"	"Nutritional marasmus"	"Chronic ischemic heart disease"	1	35	385	420
"J91"	"I25"	"Pleural effusion in conditions classified elsewhere"	"Chronic ischemic heart disease"	1	496	1578	2074
"B95"	"N20"	"Strep as the cause of diseases classified elsewhere"	"Calculus of kidney and ureter"	1	13	73	86
"C17"	"J44"	"Malignant neoplasm of small intestine"	"Other chronic obstructive pulmonary disease"	1	51	128	179
"E61"	"C15"	"Deficiency of other nutrient elements"	"Malignant neoplasm of esophagus"	1	10	53	63
"H91"	"E04"	"Other and unspecified hearing loss"	"Other nontoxic goiter"	1	1162	1542	2704
"D64"	"H04"	"Other anemias"	"Disorders of lacrimal system"	1	76	337	413
"K56"	"K62"	"Paralytic ileus and intestinal obstruction without hernia"	"Other diseases of anus and rectum"	1	1415	2205	3620
"I21"	"M65"	"Acute myocardial infarction"	"Synovitis and tenosynovitis"	1	640	1293	1933
"G03"	"O80"	"Meningitis due to other and unspecified causes"	"Encounter for full-term uncomplicated delivery"	1	26	178	204
"O47"	"M41"	"False labor"	"Scoliosis"	1	1	96	97
"D47"	"H91"	"Oth neoplm of uncrt behav of lymphoid, hematpoetc & rel tiss"	"Other and unspecified hearing loss"	1	129	874	1003
"K02"	"Q21"	"Dental caries"	"Congenital malformations of cardiac septa"	1	31	231	262
"M25"	"G80"	"Other joint disorder, not elsewhere classified"	"Cerebral palsy"	1	11	58	69
"F41"	"I48"	"Other anxiety disorders"	"Atrial fibrillation and flutter"	1	971	2107	3078
"G47"	"N45"	"Sleep disorders"	"Orchitis and epididymitis"	1	129	492	621
"M54"	"D39"	"Dorsalgia"	"Neoplasm of uncertain behavior of female genital organs"	1	53	149	202
"I89"	"I25"	"Oth noninfective disorders of lymphatic vessels and nodes"	"Chronic ischemic heart disease"	1	225	411	636
"M85"	"O20"	"Other disorders of bone density and structure"	"Hemorrhage in early pregnancy"	1	0	96	96
"F84"	"H91"	"Pervasive developmental disorders"	"Other and unspecified hearing loss"	1	45	110	155
"H25"	"C43"	"Age-related cataract"	"Malignant melanoma of skin"	1	743	989	1732
"C24"	"M17"	"Malignant neoplasm of other and unsp parts of biliary tract"	"Osteoarthritis of knee"	1	0	181	181
"J15"	"N87"	"Bacterial pneumonia, not elsewhere classified"	"Dysplasia of cervix uteri"	1	0	247	247
"B96"	"M22"	"Oth bacterial agents as the cause of diseases classd elswhr"	"Disorder of patella"	1	0	25	25
"K30"	"F10"	"Functional dyspepsia"	"Alcohol related disorders"	1	1457	2241	3698
"I46"	"M25"	"Cardiac arrest"	"Other joint disorder, not elsewhere classified"	1	12	340	352
"J84"	"M50"	"Other interstitial pulmonary diseases"	"Cervical disc disorders"	1	23	171	194
"D13"	"O82"	"Benign neoplasm of and ill-defined parts of digestive system"	"Encounter for cesarean delivery without indication"	1	0	96	96
"C79"	"K51"	"Secondary malignant neoplasm of other and unspecified sites"	"Ulcerative colitis"	1	24	246	270
"H91"	"O00"	"Other and unspecified hearing loss"	"Ectopic pregnancy"	1	0	87	87
"E35"	"I20"	"Disorders of endocrine glands in diseases classd elswhr"	"Angina pectoris"	1	28	156	184
"C78"	"J44"	"Secondary malignant neoplasm of resp and digestive organs"	"Other chronic obstructive pulmonary disease"	1	0	6286	6286
"K29"	"O82"	"Gastritis and duodenitis"	"Encounter for cesarean delivery without indication"	1	404	603	1007
"M87"	"J35"	"Osteonecrosis"	"Chronic diseases of tonsils and adenoids"	1	1	29	30
"I27"	"M34"	"Other pulmonary heart diseases"	"Systemic sclerosis [scleroderma]"	1	40	126	166
"A41"	"O80"	"Other sepsis"	"Encounter for full-term uncomplicated delivery"	1	0	776	776
"C77"	"M43"	"Secondary and unspecified malignant neoplasm of lymph nodes"	"Other deforming dorsopathies"	1	23	132	155
"D09"	"D17"	"Carcinoma in situ of other and unspecified sites"	"Benign lipomatous neoplasm"	1	0	57	57
"L97"	"H53"	"Non-pressure chronic ulcer of lower limb, NEC"	"Visual disturbances"	1	87	217	304
"I74"	"H90"	"Arterial embolism and thrombosis"	"Conductive and sensorineural hearing loss"	1	77	200	277
"E65"	"O70"	"Localized adiposity"	"Perineal laceration during delivery"	1	38	1009	1047
"B34"	"Q62"	"Viral infection of unspecified site"	"Congen defects of renal pelvis and congen malform of ureter"	1	291	607	898
"I81"	"K80"	"Portal vein thrombosis"	"Cholelithiasis"	1	74	154	228
"J18"	"O23"	"Pneumonia, unspecified organism"	"Infections of genitourinary tract in pregnancy"	1	170	546	716
"M46"	"H20"	"Other inflammatory spondylopathies"	"Iridocyclitis"	1	52	274	326
"K72"	"M16"	"Hepatic failure, not elsewhere classified"	"Osteoarthritis of hip"	1	48	277	325
"C83"	"D48"	"Non-follicular lymphoma"	"Neoplasm of uncertain behavior of other and unsp sites"	1	36	132	168
"N18"	"N92"	"Chronic kidney disease (CKD)"	"Excessive, frequent and irregular menstruation"	1	0	467	467
"D68"	"O45"	"Other coagulation defects"	"Premature separation of placenta [abruptio placentae]"	1	24	173	197
"J81"	"M85"	"Pulmonary edema"	"Other disorders of bone density and structure"	1	45	138	183
"C64"	"N95"	"Malignant neoplasm of kidney, except renal pelvis"	"Menopausal and other perimenopausal disorders"	1	28	122	150
"O82"	"N91"	"Encounter for cesarean delivery without indication"	"Absent, scanty and rare menstruation"	1	212	379	591
"I69"	"H71"	"Sequelae of cerebrovascular disease"	"Cholesteatoma of middle ear"	1	5	126	131
"I42"	"G56"	"Cardiomyopathy"	"Mononeuropathies of upper limb"	1	135	451	586
"N50"	"L03"	"Other and unspecified disorders of male genital organs"	"Cellulitis and acute lymphangitis"	1	34	195	229
"H52"	"B27"	"Disorders of refraction and accommodation"	"Infectious mononucleosis"	1	27	85	112
"L97"	"I25"	"Non-pressure chronic ulcer of lower limb, NEC"	"Chronic ischemic heart disease"	1	1653	4081	5734
"I97"	"O80"	"Intraop and postproc comp and disorders of circ sys, NEC"	"Encounter for full-term uncomplicated delivery"	1	0	47	47
"G44"	"G40"	"Other headache syndromes"	"Epilepsy and recurrent seizures"	1	416	736	1152
"H90"	"L20"	"Conductive and sensorineural hearing loss"	"Atopic dermatitis"	1	49	125	174
"K63"	"C44"	"Other diseases of intestine"	"Other and unspecified malignant neoplasm of skin"	1	161	306	467
"I89"	"C60"	"Oth noninfective disorders of lymphatic vessels and nodes"	"Malignant neoplasm of penis"	1	6	56	62
"A41"	"D50"	"Other sepsis"	"Iron deficiency anemia"	1	1913	3261	5174
"K56"	"K01"	"Paralytic ileus and intestinal obstruction without hernia"	"Embedded and impacted teeth"	1	24	76	100
"C93"	"K80"	"Monocytic leukemia"	"Cholelithiasis"	1	2	27	29
"K80"	"L20"	"Cholelithiasis"	"Atopic dermatitis"	1	32	175	207
"K52"	"N60"	"Other and unsp noninfective gastroenteritis and colitis"	"Benign mammary dysplasia"	1	83	359	442
"L98"	"O36"	"Oth disorders of skin, subcu, not elsewhere classified"	"Maternal care for other fetal problems"	1	24	134	158
"I15"	"O64"	"Secondary hypertension"	"Obstructed labor due to malposition and malpresent of fetus"	1	2	45	47
"G60"	"O80"	"Hereditary and idiopathic neuropathy"	"Encounter for full-term uncomplicated delivery"	1	2	56	58
"K61"	"O03"	"Abscess of anal and rectal regions"	"Spontaneous abortion"	1	58	215	273
"J10"	"M51"	"Influenza due to other identified influenza virus"	"Thoracic, thoracolum, and lumbosacral intvrt disc disorders"	1	0	171	171
"C77"	"O34"	"Secondary and unspecified malignant neoplasm of lymph nodes"	"Maternal care for abnormality of pelvic organs"	1	0	37	37
"H34"	"C50"	"Retinal vascular occlusions"	"Malignant neoplasm of breast"	1	78	212	290
"J90"	"N40"	"Pleural effusion, not elsewhere classified"	"Benign prostatic hyperplasia"	1	117	1166	1283
"F03"	"D25"	"Unspecified dementia"	"Leiomyoma of uterus"	1	0	146	146
"F41"	"D43"	"Other anxiety disorders"	"Neoplasm of uncertain behavior of brain and cnsl"	1	53	267	320
"C49"	"I10"	"Malignant neoplasm of other connective and soft tissue"	"Essential (primary) hypertension"	1	305	522	827
"E13"	"I48"	"Other specified diabetes mellitus"	"Atrial fibrillation and flutter"	1	385	588	973
"M13"	"O62"	"Other arthritis"	"Abnormalities of forces of labor"	1	43	579	622
"I51"	"A46"	"Complications and ill-defined descriptions of heart disease"	"Erysipelas"	1	283	444	727
"D27"	"O70"	"Benign neoplasm of ovary"	"Perineal laceration during delivery"	1	766	1047	1813
"F41"	"H36"	"Other anxiety disorders"	"Retinal disorders in diseases classified elsewhere"	1	62	175	237
"G47"	"M70"	"Sleep disorders"	"Soft tissue disorders related to use, overuse and pressure"	1	316	1217	1533
"C77"	"O02"	"Secondary and unspecified malignant neoplasm of lymph nodes"	"Other abnormal products of conception"	1	0	60	60
"K83"	"N60"	"Other diseases of biliary tract"	"Benign mammary dysplasia"	1	15	87	102
"D63"	"E78"	"Anemia in chronic diseases classified elsewhere"	"Disorders of lipoprotein metabolism and other lipidemias"	1	0	2248	2248
"N39"	"K51"	"Other disorders of urinary system"	"Ulcerative colitis"	1	291	1143	1434
"E86"	"F48"	"Volume depletion"	"Other nonpsychotic mental disorders"	1	44	192	236
"D47"	"H25"	"Oth neoplm of uncrt behav of lymphoid, hematpoetc & rel tiss"	"Age-related cataract"	1	450	1218	1668
"O40"	"O24"	"Polyhydramnios"	"Diabetes in pregnancy, childbirth, and the puerperium"	1	528	776	1304
"F17"	"H90"	"Nicotine dependence"	"Conductive and sensorineural hearing loss"	1	107	376	483
"N18"	"J37"	"Chronic kidney disease (CKD)"	"Chronic laryngitis and laryngotracheitis"	1	0	130	130
"I11"	"I21"	"Hypertensive heart disease"	"Acute myocardial infarction"	1	1670	2751	4421
"F17"	"H83"	"Nicotine dependence"	"Other diseases of inner ear"	1	1	308	309
"C20"	"H90"	"Malignant neoplasm of rectum"	"Conductive and sensorineural hearing loss"	1	149	276	425
"A41"	"I80"	"Other sepsis"	"Phlebitis and thrombophlebitis"	1	0	5979	5979
"J01"	"N87"	"Acute sinusitis"	"Dysplasia of cervix uteri"	1	38	122	160
"H25"	"G57"	"Age-related cataract"	"Mononeuropathies of lower limb"	1	247	764	1011
"N18"	"N84"	"Chronic kidney disease (CKD)"	"Polyp of female genital tract"	1	37	235	272
"D75"	"M16"	"Other and unsp diseases of blood and blood-forming organs"	"Osteoarthritis of hip"	1	94	200	294
"E86"	"I99"	"Volume depletion"	"Other and unspecified disorders of circulatory system"	1	266	704	970
"J35"	"A39"	"Chronic diseases of tonsils and adenoids"	"Meningococcal infection"	1	20	71	91
"K05"	"E11"	"Gingivitis and periodontal diseases"	"Type 2 diabetes mellitus"	1	728	1090	1818
"G96"	"I70"	"Other disorders of central nervous system"	"Atherosclerosis"	1	225	811	1036
"D69"	"N60"	"Purpura and other hemorrhagic conditions"	"Benign mammary dysplasia"	1	23	99	122
"M19"	"M16"	"Other and unspecified osteoarthritis"	"Osteoarthritis of hip"	1	2797	4536	7333
"G06"	"M23"	"Intracranial and intraspinal abscess and granuloma"	"Internal derangement of knee"	1	14	55	69
"E13"	"O70"	"Other specified diabetes mellitus"	"Perineal laceration during delivery"	1	0	38	38
"J95"	"K01"	"Intraop and postproc comp and disorders of resp sys, NEC"	"Embedded and impacted teeth"	1	9	55	64
"J94"	"H25"	"Other pleural conditions"	"Age-related cataract"	1	302	910	1212
"C71"	"M05"	"Malignant neoplasm of brain"	"Rheumatoid arthritis with rheumatoid factor"	1	4	40	44
"L97"	"D25"	"Non-pressure chronic ulcer of lower limb, NEC"	"Leiomyoma of uterus"	1	1	105	106
"C78"	"D32"	"Secondary malignant neoplasm of resp and digestive organs"	"Benign neoplasm of meninges"	1	27	117	144
"F10"	"H80"	"Alcohol related disorders"	"Otosclerosis"	1	51	123	174
"I51"	"N97"	"Complications and ill-defined descriptions of heart disease"	"Female infertility"	1	1	86	87
"B07"	"E10"	"Viral warts"	"Type 1 diabetes mellitus"	1	54	124	178
"D80"	"J45"	"Immunodeficiency with predominantly antibody defects"	"Asthma"	1	135	301	436
"C77"	"H20"	"Secondary and unspecified malignant neoplasm of lymph nodes"	"Iridocyclitis"	1	10	63	73
"J15"	"C77"	"Bacterial pneumonia, not elsewhere classified"	"Secondary and unspecified malignant neoplasm of lymph nodes"	1	668	1020	1688
"J43"	"D27"	"Emphysema"	"Benign neoplasm of ovary"	1	19	88	107
"E55"	"H83"	"Vitamin D deficiency"	"Other diseases of inner ear"	1	0	87	87
"M86"	"M51"	"Osteomyelitis"	"Thoracic, thoracolum, and lumbosacral intvrt disc disorders"	1	83	251	334
"K83"	"N43"	"Other diseases of biliary tract"	"Hydrocele and spermatocele"	1	8	113	121
"C78"	"A63"	"Secondary malignant neoplasm of resp and digestive organs"	"Oth predominantly sexually transmitted diseases, NEC"	1	0	86	86
"C61"	"K60"	"Malignant neoplasm of prostate"	"Fissure and fistula of anal and rectal regions"	1	60	255	315
"E86"	"B35"	"Volume depletion"	"Dermatophytosis"	1	100	187	287
"C49"	"K58"	"Malignant neoplasm of other connective and soft tissue"	"Irritable bowel syndrome"	1	2	35	37
"J18"	"I63"	"Pneumonia, unspecified organism"	"Cerebral infarction"	1	12122	15824	27946
"I87"	"J34"	"Other disorders of veins"	"Other and unspecified disorders of nose and nasal sinuses"	1	9	63	72
"O22"	"O20"	"Venous complications and hemorrhoids in pregnancy"	"Hemorrhage in early pregnancy"	1	68	292	360
"E41"	"C32"	"Nutritional marasmus"	"Malignant neoplasm of larynx"	1	4	56	60
"D69"	"C90"	"Purpura and other hemorrhagic conditions"	"Multiple myeloma and malignant plasma cell neoplasms"	1	76	182	258
"M81"	"M05"	"Osteoporosis without current pathological fracture"	"Rheumatoid arthritis with rheumatoid factor"	1	993	2603	3596
"M20"	"G80"	"Acquired deformities of fingers and toes"	"Cerebral palsy"	1	31	127	158
"A09"	"I83"	"Infectious gastroenteritis and colitis, unspecified"	"Varicose veins of lower extremities"	1	716	1040	1756
"J18"	"N63"	"Pneumonia, unspecified organism"	"Unspecified lump in breast"	1	447	1937	2384
"G93"	"O48"	"Other disorders of brain"	"Late pregnancy"	1	0	38	38
"B95"	"H36"	"Strep as the cause of diseases classified elsewhere"	"Retinal disorders in diseases classified elsewhere"	1	15	57	72
"K44"	"O30"	"Diaphragmatic hernia"	"Multiple gestation"	1	4	79	83
"D63"	"D27"	"Anemia in chronic diseases classified elsewhere"	"Benign neoplasm of ovary"	1	10	187	197
"K56"	"M77"	"Paralytic ileus and intestinal obstruction without hernia"	"Other enthesopathies"	1	81	294	375
"D21"	"L02"	"Other benign neoplasms of connective and other soft tissue"	"Cutaneous abscess, furuncle and carbuncle"	1	160	266	426
"D35"	"O71"	"Benign neoplasm of other and unspecified endocrine glands"	"Other obstetric trauma"	1	0	25	25
"I63"	"G43"	"Cerebral infarction"	"Migraine"	1	507	887	1394
"N94"	"O70"	"Pain and oth cond assoc w fem gntl org and menstrual cycle"	"Perineal laceration during delivery"	1	1783	3564	5347
"M48"	"H27"	"Other spondylopathies"	"Other disorders of lens"	1	23	89	112
"C79"	"K73"	"Secondary malignant neoplasm of other and unspecified sites"	"Chronic hepatitis, not elsewhere classified"	1	1	27	28
"C79"	"I63"	"Secondary malignant neoplasm of other and unspecified sites"	"Cerebral infarction"	1	424	1363	1787
"N17"	"I70"	"Acute kidney failure"	"Atherosclerosis"	1	862	2066	2928
"G25"	"O70"	"Other extrapyramidal and movement disorders"	"Perineal laceration during delivery"	1	3	45	48
"C16"	"M10"	"Malignant neoplasm of stomach"	"Gout"	1	29	103	132
"J84"	"N97"	"Other interstitial pulmonary diseases"	"Female infertility"	1	1	46	47
"M13"	"O42"	"Other arthritis"	"Premature rupture of membranes"	1	45	148	193
"G62"	"N81"	"Other and unspecified polyneuropathies"	"Female genital prolapse"	1	98	451	549
"J10"	"O82"	"Influenza due to other identified influenza virus"	"Encounter for cesarean delivery without indication"	1	5	76	81
"O80"	"A39"	"Encounter for full-term uncomplicated delivery"	"Meningococcal infection"	1	0	52	52
"M35"	"I83"	"Other systemic involvement of connective tissue"	"Varicose veins of lower extremities"	1	457	710	1167
"K76"	"L50"	"Other diseases of liver"	"Urticaria"	1	53	150	203
"C43"	"O48"	"Malignant melanoma of skin"	"Late pregnancy"	1	0	96	96
"F03"	"M54"	"Unspecified dementia"	"Dorsalgia"	1	0	4876	4876
"K56"	"D37"	"Paralytic ileus and intestinal obstruction without hernia"	"Neoplasm of uncrt behavior of oral cavity and dgstv organs"	1	224	344	568
"I61"	"L05"	"Nontraumatic intracerebral hemorrhage"	"Pilonidal cyst and sinus"	1	0	29	29
"E86"	"L28"	"Volume depletion"	"Lichen simplex chronicus and prurigo"	1	99	351	450
"C79"	"M25"	"Secondary malignant neoplasm of other and unspecified sites"	"Other joint disorder, not elsewhere classified"	1	40	459	499
"J36"	"Q53"	"Peritonsillar abscess"	"Undescended and ectopic testicle"	1	0	59	59
"G62"	"N03"	"Other and unspecified polyneuropathies"	"Chronic nephritic syndrome"	1	21	72	93
"E55"	"A63"	"Vitamin D deficiency"	"Oth predominantly sexually transmitted diseases, NEC"	1	0	55	55
"K63"	"A08"	"Other diseases of intestine"	"Viral and other specified intestinal infections"	1	77	170	247
"C78"	"L30"	"Secondary malignant neoplasm of resp and digestive organs"	"Other and unspecified dermatitis"	1	64	318	382
"L98"	"N97"	"Oth disorders of skin, subcu, not elsewhere classified"	"Female infertility"	1	43	210	253
"B37"	"D27"	"Candidiasis"	"Benign neoplasm of ovary"	1	56	166	222
"C77"	"N94"	"Secondary and unspecified malignant neoplasm of lymph nodes"	"Pain and oth cond assoc w fem gntl org and menstrual cycle"	1	0	125	125
"G62"	"M62"	"Other and unspecified polyneuropathies"	"Other disorders of muscle"	1	233	1236	1469
"G96"	"G57"	"Other disorders of central nervous system"	"Mononeuropathies of lower limb"	1	91	213	304
"K85"	"H91"	"Acute pancreatitis"	"Other and unspecified hearing loss"	1	682	1079	1761
"G20"	"I10"	"Parkinson's disease"	"Essential (primary) hypertension"	1	1856	3076	4932
"K85"	"J30"	"Acute pancreatitis"	"Vasomotor and allergic rhinitis"	1	23	102	125
"H36"	"M50"	"Retinal disorders in diseases classified elsewhere"	"Cervical disc disorders"	1	88	198	286
"K76"	"M54"	"Other diseases of liver"	"Dorsalgia"	1	547	1306	1853
"C67"	"H80"	"Malignant neoplasm of bladder"	"Otosclerosis"	1	2	48	50
"M19"	"M76"	"Other and unspecified osteoarthritis"	"Enthesopathies, lower limb, excluding foot"	1	819	1352	2171
"K86"	"K30"	"Other diseases of pancreas"	"Functional dyspepsia"	1	374	784	1158
"K52"	"D06"	"Other and unsp noninfective gastroenteritis and colitis"	"Carcinoma in situ of cervix uteri"	1	0	91	91
"A41"	"L28"	"Other sepsis"	"Lichen simplex chronicus and prurigo"	1	103	328	431
"M76"	"M62"	"Enthesopathies, lower limb, excluding foot"	"Other disorders of muscle"	1	1055	1556	2611
"K59"	"O47"	"Other functional intestinal disorders"	"False labor"	1	412	701	1113
"K50"	"J35"	"Crohn's disease [regional enteritis]"	"Chronic diseases of tonsils and adenoids"	1	10	315	325
"H53"	"M72"	"Visual disturbances"	"Fibroblastic disorders"	1	126	228	354
"C34"	"M43"	"Malignant neoplasm of bronchus and lung"	"Other deforming dorsopathies"	1	0	408	408
"E87"	"I35"	"Other disorders of fluid, electrolyte and acid-base balance"	"Nonrheumatic aortic valve disorders"	1	2029	2746	4775
"C18"	"K26"	"Malignant neoplasm of colon"	"Duodenal ulcer"	1	436	669	1105
"F33"	"H26"	"Major depressive disorder, recurrent"	"Other cataract"	1	207	746	953
"H53"	"D43"	"Visual disturbances"	"Neoplasm of uncertain behavior of brain and cnsl"	1	164	361	525
"A49"	"M95"	"Bacterial infection of unspecified site"	"Oth acquired deformities of ms sys and connective tissue"	1	22	118	140
"I83"	"O32"	"Varicose veins of lower extremities"	"Maternal care for malpresentation of fetus"	1	0	810	810
"G44"	"O63"	"Other headache syndromes"	"Long labor"	1	42	223	265
"I26"	"E10"	"Pulmonary embolism"	"Type 1 diabetes mellitus"	1	639	1012	1651
"H91"	"N83"	"Other and unspecified hearing loss"	"Noninflammatory disord of ovary, fallop and broad ligament"	1	468	754	1222
"D50"	"H93"	"Iron deficiency anemia"	"Other disorders of ear, not elsewhere classified"	1	49	668	717
"A09"	"Q20"	"Infectious gastroenteritis and colitis, unspecified"	"Congenital malformations of cardiac chambers and connections"	1	35	144	179
"J81"	"N63"	"Pulmonary edema"	"Unspecified lump in breast"	1	10	91	101
"O46"	"B27"	"Antepartum hemorrhage, not elsewhere classified"	"Infectious mononucleosis"	1	0	37	37
"K92"	"C67"	"Other diseases of digestive system"	"Malignant neoplasm of bladder"	1	197	487	684
"N18"	"H04"	"Chronic kidney disease (CKD)"	"Disorders of lacrimal system"	1	28	157	185
"E86"	"D16"	"Volume depletion"	"Benign neoplasm of bone and articular cartilage"	1	15	155	170
"O35"	"L05"	"Maternal care for known or suspected fetal abnlt and damage"	"Pilonidal cyst and sinus"	1	0	38	38
"E03"	"M23"	"Other hypothyroidism"	"Internal derangement of knee"	1	628	1908	2536
"M46"	"J36"	"Other inflammatory spondylopathies"	"Peritonsillar abscess"	1	0	30	30
"C44"	"O82"	"Other and unspecified malignant neoplasm of skin"	"Encounter for cesarean delivery without indication"	1	0	163	163
"L08"	"M51"	"Other local infections of skin and subcutaneous tissue"	"Thoracic, thoracolum, and lumbosacral intvrt disc disorders"	1	621	1151	1772
"H02"	"N63"	"Other disorders of eyelid"	"Unspecified lump in breast"	1	115	310	425
"E87"	"J36"	"Other disorders of fluid, electrolyte and acid-base balance"	"Peritonsillar abscess"	1	0	106	106
"J15"	"C61"	"Bacterial pneumonia, not elsewhere classified"	"Malignant neoplasm of prostate"	1	707	2262	2969
"N62"	"H72"	"Hypertrophy of breast"	"Perforation of tympanic membrane"	1	24	79	103
"I63"	"H80"	"Cerebral infarction"	"Otosclerosis"	1	0	311	311
"M18"	"K80"	"Osteoarthritis of first carpometacarpal joint"	"Cholelithiasis"	1	180	558	738
"K28"	"M16"	"Gastrojejunal ulcer"	"Osteoarthritis of hip"	1	31	134	165
"I83"	"O22"	"Varicose veins of lower extremities"	"Venous complications and hemorrhoids in pregnancy"	1	74	257	331
"E87"	"M65"	"Other disorders of fluid, electrolyte and acid-base balance"	"Synovitis and tenosynovitis"	1	16	1025	1041
"K59"	"L02"	"Other functional intestinal disorders"	"Cutaneous abscess, furuncle and carbuncle"	1	1203	3147	4350
"E06"	"M23"	"Thyroiditis"	"Internal derangement of knee"	1	195	371	566
"J96"	"O21"	"Respiratory failure, not elsewhere classified"	"Excessive vomiting in pregnancy"	1	0	38	38
"I97"	"I35"	"Intraop and postproc comp and disorders of circ sys, NEC"	"Nonrheumatic aortic valve disorders"	1	179	451	630
"K62"	"H81"	"Other diseases of anus and rectum"	"Disorders of vestibular function"	1	585	1092	1677
"G31"	"D17"	"Oth degenerative diseases of nervous system, NEC"	"Benign lipomatous neoplasm"	1	7	62	69
"E10"	"M22"	"Type 1 diabetes mellitus"	"Disorder of patella"	1	97	251	348
"M81"	"K13"	"Osteoporosis without current pathological fracture"	"Other diseases of lip and oral mucosa"	1	88	329	417
"J32"	"O70"	"Chronic sinusitis"	"Perineal laceration during delivery"	1	149	618	767
"J96"	"N97"	"Respiratory failure, not elsewhere classified"	"Female infertility"	1	0	155	155
"I61"	"M76"	"Nontraumatic intracerebral hemorrhage"	"Enthesopathies, lower limb, excluding foot"	1	26	111	137
"O42"	"K00"	"Premature rupture of membranes"	"Disorders of tooth development and eruption"	1	0	120	120
"N17"	"M35"	"Acute kidney failure"	"Other systemic involvement of connective tissue"	1	115	478	593
"J70"	"C34"	"Respiratory conditions due to other external agents"	"Malignant neoplasm of bronchus and lung"	1	62	227	289
"M21"	"O62"	"Other acquired deformities of limbs"	"Abnormalities of forces of labor"	1	93	439	532
"H57"	"H26"	"Other disorders of eye and adnexa"	"Other cataract"	1	452	657	1109
"K76"	"O20"	"Other diseases of liver"	"Hemorrhage in early pregnancy"	1	0	145	145
"C80"	"K04"	"Malignant neoplasm without specification of site"	"Diseases of pulp and periapical tissues"	1	67	206	273
"C64"	"E66"	"Malignant neoplasm of kidney, except renal pelvis"	"Overweight and obesity"	1	128	370	498
"I82"	"H91"	"Other venous embolism and thrombosis"	"Other and unspecified hearing loss"	1	164	748	912
"I33"	"O80"	"Acute and subacute endocarditis"	"Encounter for full-term uncomplicated delivery"	1	0	31	31
"I25"	"G43"	"Chronic ischemic heart disease"	"Migraine"	1	234	822	1056
"A49"	"I99"	"Bacterial infection of unspecified site"	"Other and unspecified disorders of circulatory system"	1	74	216	290
"I10"	"L03"	"Essential (primary) hypertension"	"Cellulitis and acute lymphangitis"	1	812	2833	3645
"L90"	"M22"	"Atrophic disorders of skin"	"Disorder of patella"	1	96	486	582
"O72"	"Q78"	"Postpartum hemorrhage"	"Other osteochondrodysplasias"	1	0	68	68
"K56"	"O32"	"Paralytic ileus and intestinal obstruction without hernia"	"Maternal care for malpresentation of fetus"	1	13	121	134
"J13"	"J44"	"Pneumonia due to Streptococcus pneumoniae"	"Other chronic obstructive pulmonary disease"	1	1499	1826	3325
"K59"	"G56"	"Other functional intestinal disorders"	"Mononeuropathies of upper limb"	1	0	5140	5140
"E16"	"C50"	"Other disorders of pancreatic internal secretion"	"Malignant neoplasm of breast"	1	85	231	316
"C65"	"H83"	"Malignant neoplasm of renal pelvis"	"Other diseases of inner ear"	1	8	44	52
"D84"	"B34"	"Other immunodeficiencies"	"Viral infection of unspecified site"	1	137	436	573
"C78"	"C13"	"Secondary malignant neoplasm of resp and digestive organs"	"Malignant neoplasm of hypopharynx"	1	55	211	266
"C90"	"K30"	"Multiple myeloma and malignant plasma cell neoplasms"	"Functional dyspepsia"	1	34	142	176
"J43"	"M77"	"Emphysema"	"Other enthesopathies"	1	13	95	108
"B08"	"Q25"	"Oth viral infect with skin and mucous membrane lesions, NEC"	"Congenital malformations of great arteries"	1	11	52	63
"F41"	"C13"	"Other anxiety disorders"	"Malignant neoplasm of hypopharynx"	1	29	108	137
"M67"	"K01"	"Other disorders of synovium and tendon"	"Embedded and impacted teeth"	1	69	154	223
"G35"	"L05"	"Multiple sclerosis"	"Pilonidal cyst and sinus"	1	8	63	71
"N39"	"N97"	"Other disorders of urinary system"	"Female infertility"	1	31	963	994
"E53"	"C50"	"Deficiency of other B group vitamins"	"Malignant neoplasm of breast"	1	23	132	155
"E66"	"K40"	"Overweight and obesity"	"Inguinal hernia"	1	1564	2701	4265
"L89"	"M65"	"Pressure ulcer"	"Synovitis and tenosynovitis"	1	7	202	209
"B02"	"J35"	"Zoster [herpes zoster]"	"Chronic diseases of tonsils and adenoids"	1	13	88	101
"L89"	"I21"	"Pressure ulcer"	"Acute myocardial infarction"	1	408	1313	1721
"G47"	"J42"	"Sleep disorders"	"Unspecified chronic bronchitis"	1	136	489	625
"B07"	"Q53"	"Viral warts"	"Undescended and ectopic testicle"	1	1	30	31
"K20"	"N92"	"Esophagitis"	"Excessive, frequent and irregular menstruation"	1	136	484	620
"I95"	"J03"	"Hypotension"	"Acute tonsillitis"	1	31	86	117
"I25"	"N88"	"Chronic ischemic heart disease"	"Other noninflammatory disorders of cervix uteri"	1	3	52	55
"G30"	"J38"	"Alzheimer's disease"	"Diseases of vocal cords and larynx, not elsewhere classified"	1	0	55	55
"H36"	"L02"	"Retinal disorders in diseases classified elsewhere"	"Cutaneous abscess, furuncle and carbuncle"	1	585	1159	1744
"N30"	"K70"	"Cystitis"	"Alcoholic liver disease"	1	1104	1613	2717
"G47"	"C13"	"Sleep disorders"	"Malignant neoplasm of hypopharynx"	1	32	133	165
"K52"	"I21"	"Other and unsp noninfective gastroenteritis and colitis"	"Acute myocardial infarction"	1	971	2276	3247
"L94"	"M34"	"Other localized connective tissue disorders"	"Systemic sclerosis [scleroderma]"	1	103	212	315
"I15"	"I10"	"Secondary hypertension"	"Essential (primary) hypertension"	1	3740	7547	11287
"C80"	"M35"	"Malignant neoplasm without specification of site"	"Other systemic involvement of connective tissue"	1	22	93	115
"H53"	"N95"	"Visual disturbances"	"Menopausal and other perimenopausal disorders"	1	131	246	377
"I10"	"O13"	"Essential (primary) hypertension"	"Gestational hypertension without significant proteinuria"	1	286	1642	1928
"N19"	"G56"	"Unspecified kidney failure"	"Mononeuropathies of upper limb"	1	145	486	631
"C77"	"M25"	"Secondary and unspecified malignant neoplasm of lymph nodes"	"Other joint disorder, not elsewhere classified"	1	69	230	299
"M19"	"Q17"	"Other and unspecified osteoarthritis"	"Other congenital malformations of ear"	1	0	31	31
"M17"	"H72"	"Osteoarthritis of knee"	"Perforation of tympanic membrane"	1	124	236	360
"H33"	"N87"	"Retinal detachments and breaks"	"Dysplasia of cervix uteri"	1	0	63	63
"K04"	"O62"	"Diseases of pulp and periapical tissues"	"Abnormalities of forces of labor"	1	18	373	391
"N84"	"O34"	"Polyp of female genital tract"	"Maternal care for abnormality of pelvic organs"	1	108	276	384
"D64"	"I99"	"Other anemias"	"Other and unspecified disorders of circulatory system"	1	294	510	804
"D68"	"I06"	"Other coagulation defects"	"Rheumatic aortic valve diseases"	1	7	40	47
"K76"	"M23"	"Other diseases of liver"	"Internal derangement of knee"	1	255	797	1052
"E78"	"B18"	"Disorders of lipoprotein metabolism and other lipidemias"	"Chronic viral hepatitis"	1	68	158	226
"M81"	"J33"	"Osteoporosis without current pathological fracture"	"Nasal polyp"	1	20	218	238
"M16"	"O02"	"Osteoarthritis of hip"	"Other abnormal products of conception"	1	0	116	116
"E78"	"H27"	"Disorders of lipoprotein metabolism and other lipidemias"	"Other disorders of lens"	1	54	182	236
"B37"	"G35"	"Candidiasis"	"Multiple sclerosis"	1	1	85	86
"I11"	"E05"	"Hypertensive heart disease"	"Thyrotoxicosis [hyperthyroidism]"	1	247	455	702
"F17"	"O36"	"Nicotine dependence"	"Maternal care for other fetal problems"	1	172	546	718
"K92"	"C43"	"Other diseases of digestive system"	"Malignant melanoma of skin"	1	108	260	368
"J06"	"O66"	"Acute upper resp infections of multiple and unsp sites"	"Other obstructed labor"	1	4	53	57
"C03"	"I10"	"Malignant neoplasm of gum"	"Essential (primary) hypertension"	1	49	117	166
"K62"	"I10"	"Other diseases of anus and rectum"	"Essential (primary) hypertension"	1	9512	10974	20486
"K80"	"K35"	"Cholelithiasis"	"Acute appendicitis"	1	882	1964	2846
"J06"	"I15"	"Acute upper resp infections of multiple and unsp sites"	"Secondary hypertension"	1	44	116	160
"C77"	"D12"	"Secondary and unspecified malignant neoplasm of lymph nodes"	"Benign neoplasm of colon, rectum, anus and anal canal"	1	490	899	1389
"C18"	"J20"	"Malignant neoplasm of colon"	"Acute bronchitis"	1	89	212	301
"H53"	"J36"	"Visual disturbances"	"Peritonsillar abscess"	1	14	59	73
"K72"	"M20"	"Hepatic failure, not elsewhere classified"	"Acquired deformities of fingers and toes"	1	19	88	107
"I44"	"M65"	"Atrioventricular and left bundle-branch block"	"Synovitis and tenosynovitis"	1	67	403	470
"K90"	"O62"	"Intestinal malabsorption"	"Abnormalities of forces of labor"	1	17	251	268
"L98"	"O23"	"Oth disorders of skin, subcu, not elsewhere classified"	"Infections of genitourinary tract in pregnancy"	1	30	86	116
"D22"	"J35"	"Melanocytic nevi"	"Chronic diseases of tonsils and adenoids"	1	4	506	510
"D22"	"M79"	"Melanocytic nevi"	"Oth and unsp soft tissue disorders, not elsewhere classified"	1	508	959	1467
"N19"	"E15"	"Unspecified kidney failure"	"Nondiabetic hypoglycemic coma"	1	58	141	199
"J90"	"H81"	"Pleural effusion, not elsewhere classified"	"Disorders of vestibular function"	1	39	335	374
"I73"	"M65"	"Other peripheral vascular diseases"	"Synovitis and tenosynovitis"	1	277	996	1273
"D86"	"M22"	"Sarcoidosis"	"Disorder of patella"	1	11	92	103
"C18"	"N87"	"Malignant neoplasm of colon"	"Dysplasia of cervix uteri"	1	0	100	100
"A41"	"Q04"	"Other sepsis"	"Other congenital malformations of brain"	1	10	49	59
"A41"	"G51"	"Other sepsis"	"Facial nerve disorders"	1	88	395	483
"B18"	"J35"	"Chronic viral hepatitis"	"Chronic diseases of tonsils and adenoids"	1	7	59	66
"K65"	"O26"	"Peritonitis"	"Maternal care for oth conditions predom related to pregnancy"	1	19	92	111
"M75"	"O40"	"Shoulder lesions"	"Polyhydramnios"	1	1	78	79
"M76"	"O71"	"Enthesopathies, lower limb, excluding foot"	"Other obstetric trauma"	1	32	156	188
"C06"	"K21"	"Malignant neoplasm of other and unspecified parts of mouth"	"Gastro-esophageal reflux disease"	1	29	97	126
"E04"	"L03"	"Other nontoxic goiter"	"Cellulitis and acute lymphangitis"	1	87	219	306
"C78"	"N31"	"Secondary malignant neoplasm of resp and digestive organs"	"Neuromuscular dysfunction of bladder, NEC"	1	36	250	286
"J44"	"D48"	"Other chronic obstructive pulmonary disease"	"Neoplasm of uncertain behavior of other and unsp sites"	1	97	309	406
"E66"	"B07"	"Overweight and obesity"	"Viral warts"	1	25	201	226
"N84"	"O71"	"Polyp of female genital tract"	"Other obstetric trauma"	1	0	318	318
"J81"	"N39"	"Pulmonary edema"	"Other disorders of urinary system"	1	1199	1618	2817
"M65"	"O03"	"Synovitis and tenosynovitis"	"Spontaneous abortion"	1	213	770	983
"J15"	"G71"	"Bacterial pneumonia, not elsewhere classified"	"Primary disorders of muscles"	1	35	154	189
"C44"	"E11"	"Other and unspecified malignant neoplasm of skin"	"Type 2 diabetes mellitus"	1	1416	2334	3750
"A41"	"G82"	"Other sepsis"	"Paraplegia (paraparesis) and quadriplegia (quadriparesis)"	1	463	936	1399
"K59"	"I69"	"Other functional intestinal disorders"	"Sequelae of cerebrovascular disease"	1	5615	6180	11795
"D63"	"I71"	"Anemia in chronic diseases classified elsewhere"	"Aortic aneurysm and dissection"	1	190	490	680
"J38"	"Q25"	"Diseases of vocal cords and larynx, not elsewhere classified"	"Congenital malformations of great arteries"	1	22	72	94
"D35"	"M76"	"Benign neoplasm of other and unspecified endocrine glands"	"Enthesopathies, lower limb, excluding foot"	1	21	76	97
"D64"	"C43"	"Other anemias"	"Malignant melanoma of skin"	1	231	877	1108
"I26"	"N99"	"Pulmonary embolism"	"Intraop and postproc comp and disorders of GU sys, NEC"	1	62	166	228
"K66"	"O65"	"Other disorders of peritoneum"	"Obstructed labor due to maternal pelvic abnormality"	1	1	39	40
"C90"	"H35"	"Multiple myeloma and malignant plasma cell neoplasms"	"Other retinal disorders"	1	96	209	305
"L08"	"H66"	"Other local infections of skin and subcutaneous tissue"	"Suppurative and unspecified otitis media"	1	190	851	1041
"A46"	"O70"	"Erysipelas"	"Perineal laceration during delivery"	1	47	403	450
"D50"	"K21"	"Iron deficiency anemia"	"Gastro-esophageal reflux disease"	1	943	1735	2678
"J18"	"K50"	"Pneumonia, unspecified organism"	"Crohn's disease [regional enteritis]"	1	520	1138	1658
"O42"	"N96"	"Premature rupture of membranes"	"Recurrent pregnancy loss"	1	211	370	581
"M19"	"O30"	"Other and unspecified osteoarthritis"	"Multiple gestation"	1	0	52	52
"O36"	"K00"	"Maternal care for other fetal problems"	"Disorders of tooth development and eruption"	1	0	137	137
"H53"	"N60"	"Visual disturbances"	"Benign mammary dysplasia"	1	13	205	218
"D68"	"O02"	"Other coagulation defects"	"Other abnormal products of conception"	1	189	714	903
"K21"	"O23"	"Gastro-esophageal reflux disease"	"Infections of genitourinary tract in pregnancy"	1	68	248	316
"J31"	"N92"	"Chronic rhinitis, nasopharyngitis and pharyngitis"	"Excessive, frequent and irregular menstruation"	1	74	174	248
"J96"	"J43"	"Respiratory failure, not elsewhere classified"	"Emphysema"	1	2080	3503	5583
"D23"	"N97"	"Other benign neoplasms of skin"	"Female infertility"	1	131	350	481
"N39"	"B34"	"Other disorders of urinary system"	"Viral infection of unspecified site"	1	1145	1681	2826
"L05"	"K00"	"Pilonidal cyst and sinus"	"Disorders of tooth development and eruption"	1	16	92	108
"C18"	"J38"	"Malignant neoplasm of colon"	"Diseases of vocal cords and larynx, not elsewhere classified"	1	72	155	227
"J69"	"C67"	"Pneumonitis due to solids and liquids"	"Malignant neoplasm of bladder"	1	8	94	102
"N39"	"C61"	"Other disorders of urinary system"	"Malignant neoplasm of prostate"	1	1418	4008	5426
"J47"	"N43"	"Bronchiectasis"	"Hydrocele and spermatocele"	1	0	44	44
"E55"	"N60"	"Vitamin D deficiency"	"Benign mammary dysplasia"	1	5	89	94
"E16"	"N81"	"Other disorders of pancreatic internal secretion"	"Female genital prolapse"	1	45	226	271
"I44"	"N92"	"Atrioventricular and left bundle-branch block"	"Excessive, frequent and irregular menstruation"	1	0	214	214
"M23"	"O48"	"Internal derangement of knee"	"Late pregnancy"	1	143	810	953
"J09"	"Q61"	"Influenza due to certain identified influenza viruses"	"Cystic kidney disease"	1	1	27	28
"M85"	"H10"	"Other disorders of bone density and structure"	"Conjunctivitis"	1	0	459	459
"H90"	"O70"	"Conductive and sensorineural hearing loss"	"Perineal laceration during delivery"	1	279	443	722
"Q61"	"M65"	"Cystic kidney disease"	"Synovitis and tenosynovitis"	1	44	161	205
"M85"	"D33"	"Other disorders of bone density and structure"	"Benign neoplasm of brain and oth prt central nervous system"	1	17	95	112
"M25"	"O71"	"Other joint disorder, not elsewhere classified"	"Other obstetric trauma"	1	10	456	466
"K61"	"M22"	"Abscess of anal and rectal regions"	"Disorder of patella"	1	32	233	265
"N28"	"D50"	"Oth disorders of kidney and ureter, not elsewhere classified"	"Iron deficiency anemia"	1	282	461	743
"C79"	"K45"	"Secondary malignant neoplasm of other and unspecified sites"	"Other abdominal hernia"	1	11	70	81
"J90"	"M65"	"Pleural effusion, not elsewhere classified"	"Synovitis and tenosynovitis"	1	19	305	324
"K76"	"O64"	"Other diseases of liver"	"Obstructed labor due to malposition and malpresent of fetus"	1	0	45	45
"F48"	"O80"	"Other nonpsychotic mental disorders"	"Encounter for full-term uncomplicated delivery"	1	22	94	116
"I87"	"O80"	"Other disorders of veins"	"Encounter for full-term uncomplicated delivery"	1	0	233	233
"J69"	"D62"	"Pneumonitis due to solids and liquids"	"Acute posthemorrhagic anemia"	1	126	257	383
"A46"	"J34"	"Erysipelas"	"Other and unspecified disorders of nose and nasal sinuses"	1	71	347	418
"M19"	"A63"	"Other and unspecified osteoarthritis"	"Oth predominantly sexually transmitted diseases, NEC"	1	9	240	249
"O92"	"M24"	"Oth disord of brst/lactatn assoc w pregnancy and the puerp"	"Other specific joint derangements"	1	25	80	105
"B95"	"M67"	"Strep as the cause of diseases classified elsewhere"	"Other disorders of synovium and tendon"	1	11	55	66
"K44"	"O46"	"Diaphragmatic hernia"	"Antepartum hemorrhage, not elsewhere classified"	1	1	81	82
"N17"	"M05"	"Acute kidney failure"	"Rheumatoid arthritis with rheumatoid factor"	1	48	321	369
"I70"	"O82"	"Atherosclerosis"	"Encounter for cesarean delivery without indication"	1	0	63	63
"F05"	"C49"	"Delirium due to known physiological condition"	"Malignant neoplasm of other connective and soft tissue"	1	16	67	83
"K30"	"J30"	"Functional dyspepsia"	"Vasomotor and allergic rhinitis"	1	321	504	825
"I26"	"M77"	"Pulmonary embolism"	"Other enthesopathies"	1	82	368	450
"G95"	"J45"	"Other and unspecified diseases of spinal cord"	"Asthma"	1	45	300	345
"G93"	"N97"	"Other disorders of brain"	"Female infertility"	1	7	64	71
"K59"	"O71"	"Other functional intestinal disorders"	"Other obstetric trauma"	1	76	481	557
"G44"	"O02"	"Other headache syndromes"	"Other abnormal products of conception"	1	119	588	707
"N39"	"G56"	"Other disorders of urinary system"	"Mononeuropathies of upper limb"	1	1289	3662	4951
"K92"	"H35"	"Other diseases of digestive system"	"Other retinal disorders"	1	822	2247	3069
"B35"	"O62"	"Dermatophytosis"	"Abnormalities of forces of labor"	1	15	83	98
"L72"	"O82"	"Follicular cysts of skin and subcutaneous tissue"	"Encounter for cesarean delivery without indication"	1	15	227	242
"E86"	"N43"	"Volume depletion"	"Hydrocele and spermatocele"	1	56	813	869
"J18"	"N84"	"Pneumonia, unspecified organism"	"Polyp of female genital tract"	1	357	1147	1504
"N94"	"O41"	"Pain and oth cond assoc w fem gntl org and menstrual cycle"	"Other disorders of amniotic fluid and membranes"	1	81	162	243
"O75"	"O45"	"Oth complications of labor and delivery, NEC"	"Premature separation of placenta [abruptio placentae]"	1	272	442	714
"G47"	"O48"	"Sleep disorders"	"Late pregnancy"	1	0	88	88
"E88"	"O70"	"Other and unspecified metabolic disorders"	"Perineal laceration during delivery"	1	33	152	185
"C34"	"L02"	"Malignant neoplasm of bronchus and lung"	"Cutaneous abscess, furuncle and carbuncle"	1	49	1202	1251
"K02"	"C11"	"Dental caries"	"Malignant neoplasm of nasopharynx"	1	38	106	144
"H16"	"O62"	"Keratitis"	"Abnormalities of forces of labor"	1	116	467	583
"N19"	"O82"	"Unspecified kidney failure"	"Encounter for cesarean delivery without indication"	1	15	67	82
"G62"	"H65"	"Other and unspecified polyneuropathies"	"Nonsuppurative otitis media"	1	22	109	131
"K86"	"O70"	"Other diseases of pancreas"	"Perineal laceration during delivery"	1	5	71	76
"C20"	"M76"	"Malignant neoplasm of rectum"	"Enthesopathies, lower limb, excluding foot"	1	20	74	94
"C77"	"J45"	"Secondary and unspecified malignant neoplasm of lymph nodes"	"Asthma"	1	103	574	677
"K63"	"H26"	"Other diseases of intestine"	"Other cataract"	1	160	397	557
"M17"	"N93"	"Osteoarthritis of knee"	"Other abnormal uterine and vaginal bleeding"	1	101	312	413
"J95"	"H91"	"Intraop and postproc comp and disorders of resp sys, NEC"	"Other and unspecified hearing loss"	1	41	389	430
"D62"	"I63"	"Acute posthemorrhagic anemia"	"Cerebral infarction"	1	698	1250	1948
"I71"	"M67"	"Aortic aneurysm and dissection"	"Other disorders of synovium and tendon"	1	17	275	292
"I61"	"I50"	"Nontraumatic intracerebral hemorrhage"	"Heart failure"	1	1308	1600	2908
"K05"	"O68"	"Gingivitis and periodontal diseases"	"Labor and delivery comp by abnlt of fetal acid-base balance"	1	20	91	111
"K52"	"C61"	"Other and unsp noninfective gastroenteritis and colitis"	"Malignant neoplasm of prostate"	1	364	708	1072
"I63"	"H33"	"Cerebral infarction"	"Retinal detachments and breaks"	1	166	724	890
"I95"	"I99"	"Hypotension"	"Other and unspecified disorders of circulatory system"	1	106	204	310
"M77"	"O65"	"Other enthesopathies"	"Obstructed labor due to maternal pelvic abnormality"	1	0	171	171
"F32"	"O48"	"Depressive episode"	"Late pregnancy"	1	9	161	170
"A41"	"C61"	"Other sepsis"	"Malignant neoplasm of prostate"	1	1730	4474	6204
"C64"	"E78"	"Malignant neoplasm of kidney, except renal pelvis"	"Disorders of lipoprotein metabolism and other lipidemias"	1	232	618	850
"I10"	"O34"	"Essential (primary) hypertension"	"Maternal care for abnormality of pelvic organs"	1	19	508	527
"C06"	"M16"	"Malignant neoplasm of other and unspecified parts of mouth"	"Osteoarthritis of hip"	1	27	90	117
"I77"	"N03"	"Other disorders of arteries and arterioles"	"Chronic nephritic syndrome"	1	11	67	78
"D22"	"O04"	"Melanocytic nevi"	"Complications following (induced) termination of pregnancy"	1	31	845	876
"I89"	"O62"	"Oth noninfective disorders of lymphatic vessels and nodes"	"Abnormalities of forces of labor"	1	0	163	163
"D14"	"D25"	"Benign neoplasm of middle ear and respiratory system"	"Leiomyoma of uterus"	1	25	138	163
"M80"	"D05"	"Osteoporosis with current pathological fracture"	"Carcinoma in situ of breast"	1	9	77	86
"G31"	"G40"	"Oth degenerative diseases of nervous system, NEC"	"Epilepsy and recurrent seizures"	1	395	631	1026
"F41"	"M21"	"Other anxiety disorders"	"Other acquired deformities of limbs"	1	50	193	243
"D47"	"H93"	"Oth neoplm of uncrt behav of lymphoid, hematpoetc & rel tiss"	"Other disorders of ear, not elsewhere classified"	1	5	231	236
"K58"	"A09"	"Irritable bowel syndrome"	"Infectious gastroenteritis and colitis, unspecified"	1	1293	1972	3265
"O75"	"F50"	"Oth complications of labor and delivery, NEC"	"Eating disorders"	1	9	53	62
"C79"	"J93"	"Secondary malignant neoplasm of other and unspecified sites"	"Pneumothorax and air leak"	1	313	579	892
"J09"	"K05"	"Influenza due to certain identified influenza viruses"	"Gingivitis and periodontal diseases"	1	11	81	92
"B37"	"J44"	"Candidiasis"	"Other chronic obstructive pulmonary disease"	1	1533	2898	4431
"E78"	"K80"	"Disorders of lipoprotein metabolism and other lipidemias"	"Cholelithiasis"	1	2740	5279	8019
"K59"	"C78"	"Other functional intestinal disorders"	"Secondary malignant neoplasm of resp and digestive organs"	1	4819	6335	11154
"I46"	"C67"	"Cardiac arrest"	"Malignant neoplasm of bladder"	1	26	309	335
"C15"	"H52"	"Malignant neoplasm of esophagus"	"Disorders of refraction and accommodation"	1	2	42	44
"G81"	"I20"	"Hemiplegia and hemiparesis"	"Angina pectoris"	1	54	180	234
"B00"	"J00"	"Herpesviral [herpes simplex] infections"	"Acute nasopharyngitis [common cold]"	1	52	187	239
"D09"	"K26"	"Carcinoma in situ of other and unspecified sites"	"Duodenal ulcer"	1	9	55	64
"D35"	"M17"	"Benign neoplasm of other and unspecified endocrine glands"	"Osteoarthritis of knee"	1	152	371	523
"K52"	"M75"	"Other and unsp noninfective gastroenteritis and colitis"	"Shoulder lesions"	1	1108	1753	2861
"M07"	"O99"	"Enteropathic arthropathies"	"Oth maternal diseases classd elsw but compl preg/chldbrth"	1	65	420	485
"O87"	"O26"	"Venous complications and hemorrhoids in the puerperium"	"Maternal care for oth conditions predom related to pregnancy"	1	332	616	948
"I46"	"D22"	"Cardiac arrest"	"Melanocytic nevi"	1	12	71	83
"M79"	"H50"	"Oth and unsp soft tissue disorders, not elsewhere classified"	"Other strabismus"	1	347	801	1148
"M75"	"N63"	"Shoulder lesions"	"Unspecified lump in breast"	1	478	1100	1578
"C43"	"D27"	"Malignant melanoma of skin"	"Benign neoplasm of ovary"	1	41	110	151
"O91"	"O30"	"Infect of breast assoc w pregnancy, the puerp and lactation"	"Multiple gestation"	1	174	704	878
"J47"	"M35"	"Bronchiectasis"	"Other systemic involvement of connective tissue"	1	53	146	199
"L29"	"M17"	"Pruritus"	"Osteoarthritis of knee"	1	115	255	370
"G47"	"M51"	"Sleep disorders"	"Thoracic, thoracolum, and lumbosacral intvrt disc disorders"	1	0	3905	3905
"M90"	"M17"	"Osteopathies in diseases classified elsewhere"	"Osteoarthritis of knee"	1	15	95	110
"G30"	"C54"	"Alzheimer's disease"	"Malignant neoplasm of corpus uteri"	1	0	71	71
"K92"	"L03"	"Other diseases of digestive system"	"Cellulitis and acute lymphangitis"	1	150	639	789
"C10"	"M79"	"Malignant neoplasm of oropharynx"	"Oth and unsp soft tissue disorders, not elsewhere classified"	1	9	104	113
"H91"	"H27"	"Other and unspecified hearing loss"	"Other disorders of lens"	1	378	941	1319
"B59"	"M31"	"Pneumocystosis"	"Other necrotizing vasculopathies"	1	12	74	86
"M46"	"M62"	"Other inflammatory spondylopathies"	"Other disorders of muscle"	1	180	542	722
"B37"	"I48"	"Candidiasis"	"Atrial fibrillation and flutter"	1	1659	2062	3721
"A41"	"M54"	"Other sepsis"	"Dorsalgia"	1	0	8833	8833
"G24"	"O70"	"Dystonia"	"Perineal laceration during delivery"	1	17	77	94
"M23"	"Q17"	"Internal derangement of knee"	"Other congenital malformations of ear"	1	19	453	472
"I35"	"M22"	"Nonrheumatic aortic valve disorders"	"Disorder of patella"	1	0	129	129
"I73"	"M05"	"Other peripheral vascular diseases"	"Rheumatoid arthritis with rheumatoid factor"	1	190	333	523
"C85"	"N92"	"Oth and unspecified types of non-Hodgkin lymphoma"	"Excessive, frequent and irregular menstruation"	1	2	120	122
"J18"	"L04"	"Pneumonia, unspecified organism"	"Acute lymphadenitis"	1	199	392	591
"E78"	"O64"	"Disorders of lipoprotein metabolism and other lipidemias"	"Obstructed labor due to malposition and malpresent of fetus"	1	0	64	64
"M99"	"N43"	"Biomechanical lesions, not elsewhere classified"	"Hydrocele and spermatocele"	1	24	76	100
"N20"	"G35"	"Calculus of kidney and ureter"	"Multiple sclerosis"	1	37	162	199
"E78"	"M22"	"Disorders of lipoprotein metabolism and other lipidemias"	"Disorder of patella"	1	0	782	782
"E16"	"H35"	"Other disorders of pancreatic internal secretion"	"Other retinal disorders"	1	586	850	1436
"O72"	"L23"	"Postpartum hemorrhage"	"Allergic contact dermatitis"	1	116	491	607
"O91"	"O23"	"Infect of breast assoc w pregnancy, the puerp and lactation"	"Infections of genitourinary tract in pregnancy"	1	301	801	1102
"A49"	"N13"	"Bacterial infection of unspecified site"	"Obstructive and reflux uropathy"	1	583	924	1507
"D34"	"N97"	"Benign neoplasm of thyroid gland"	"Female infertility"	1	4	51	55
"M51"	"O36"	"Thoracic, thoracolum, and lumbosacral intvrt disc disorders"	"Maternal care for other fetal problems"	1	50	823	873
"K56"	"D25"	"Paralytic ileus and intestinal obstruction without hernia"	"Leiomyoma of uterus"	1	95	976	1071
"N19"	"C54"	"Unspecified kidney failure"	"Malignant neoplasm of corpus uteri"	1	11	120	131
"C54"	"N95"	"Malignant neoplasm of corpus uteri"	"Menopausal and other perimenopausal disorders"	1	0	4874	4874
"K62"	"O66"	"Other diseases of anus and rectum"	"Other obstructed labor"	1	11	102	113
"N63"	"O42"	"Unspecified lump in breast"	"Premature rupture of membranes"	1	200	618	818
"O72"	"F19"	"Postpartum hemorrhage"	"Other psychoactive substance related disorders"	1	9	94	103
"E83"	"N62"	"Disorders of mineral metabolism"	"Hypertrophy of breast"	1	9	104	113
"G82"	"I20"	"Paraplegia (paraparesis) and quadriplegia (quadriparesis)"	"Angina pectoris"	1	85	245	330
"K59"	"G00"	"Other functional intestinal disorders"	"Bacterial meningitis, not elsewhere classified"	1	78	209	287
"O36"	"K35"	"Maternal care for other fetal problems"	"Acute appendicitis"	1	201	710	911
"C18"	"M22"	"Malignant neoplasm of colon"	"Disorder of patella"	1	0	77	77
"K91"	"H83"	"Intraop and postproc comp and disorders of dgstv sys, NEC"	"Other diseases of inner ear"	1	13	118	131
"C22"	"H91"	"Malignant neoplasm of liver and intrahepatic bile ducts"	"Other and unspecified hearing loss"	1	17	622	639
"N18"	"K26"	"Chronic kidney disease (CKD)"	"Duodenal ulcer"	1	706	1789	2495
"K65"	"C56"	"Peritonitis"	"Malignant neoplasm of ovary"	1	129	240	369
"J91"	"N60"	"Pleural effusion in conditions classified elsewhere"	"Benign mammary dysplasia"	1	0	55	55
"D64"	"J31"	"Other anemias"	"Chronic rhinitis, nasopharyngitis and pharyngitis"	1	26	111	137
"C34"	"E11"	"Malignant neoplasm of bronchus and lung"	"Type 2 diabetes mellitus"	1	1257	3828	5085
"E66"	"L68"	"Overweight and obesity"	"Hypertrichosis"	1	623	1034	1657
"H46"	"O48"	"Optic neuritis"	"Late pregnancy"	1	1	30	31
"N50"	"D40"	"Other and unspecified disorders of male genital organs"	"Neoplasm of uncertain behavior of male genital organs"	1	16	62	78
"C56"	"K44"	"Malignant neoplasm of ovary"	"Diaphragmatic hernia"	1	87	190	277
"N16"	"I25"	"Renal tubulo-interstitial disord in diseases classd elswhr"	"Chronic ischemic heart disease"	1	79	179	258
"D30"	"K40"	"Benign neoplasm of urinary organs"	"Inguinal hernia"	1	474	683	1157
"K92"	"M77"	"Other diseases of digestive system"	"Other enthesopathies"	1	120	297	417
"H34"	"N92"	"Retinal vascular occlusions"	"Excessive, frequent and irregular menstruation"	1	0	130	130
"M51"	"O10"	"Thoracic, thoracolum, and lumbosacral intvrt disc disorders"	"Pre-existing hypertension compl preg/chldbrth"	1	16	100	116
"K29"	"H80"	"Gastritis and duodenitis"	"Otosclerosis"	1	69	242	311
"D61"	"M23"	"Oth aplastic anemias and other bone marrow failure syndromes"	"Internal derangement of knee"	1	10	79	89
"O22"	"O02"	"Venous complications and hemorrhoids in pregnancy"	"Other abnormal products of conception"	1	66	258	324
"E03"	"H83"	"Other hypothyroidism"	"Other diseases of inner ear"	1	8	315	323
"L08"	"K40"	"Other local infections of skin and subcutaneous tissue"	"Inguinal hernia"	1	486	1219	1705
"B33"	"O80"	"Other viral diseases, not elsewhere classified"	"Encounter for full-term uncomplicated delivery"	1	3	32	35
"M24"	"F10"	"Other specific joint derangements"	"Alcohol related disorders"	1	397	711	1108
"K63"	"I21"	"Other diseases of intestine"	"Acute myocardial infarction"	1	267	883	1150
"K65"	"Q61"	"Peritonitis"	"Cystic kidney disease"	1	58	212	270
"E89"	"C73"	"Postproc endocrine and metabolic comp and disorders, NEC"	"Malignant neoplasm of thyroid gland"	1	43	1145	1188
"D64"	"N84"	"Other anemias"	"Polyp of female genital tract"	1	286	546	832
"I72"	"H90"	"Other aneurysm"	"Conductive and sensorineural hearing loss"	1	49	141	190
"N81"	"L05"	"Female genital prolapse"	"Pilonidal cyst and sinus"	1	6	37	43
"F03"	"N84"	"Unspecified dementia"	"Polyp of female genital tract"	1	1	197	198
"M76"	"O80"	"Enthesopathies, lower limb, excluding foot"	"Encounter for full-term uncomplicated delivery"	1	181	1393	1574
"G35"	"N87"	"Multiple sclerosis"	"Dysplasia of cervix uteri"	1	48	131	179
"J22"	"D25"	"Unspecified acute lower respiratory infection"	"Leiomyoma of uterus"	1	0	69	69
"M10"	"M23"	"Gout"	"Internal derangement of knee"	1	498	1420	1918
"N90"	"O32"	"Other noninflammatory disorders of vulva and perineum"	"Maternal care for malpresentation of fetus"	1	38	99	137
"D63"	"H72"	"Anemia in chronic diseases classified elsewhere"	"Perforation of tympanic membrane"	1	3	55	58
"E86"	"O42"	"Volume depletion"	"Premature rupture of membranes"	1	47	123	170
"D12"	"C50"	"Benign neoplasm of colon, rectum, anus and anal canal"	"Malignant neoplasm of breast"	1	481	1655	2136
"O34"	"M41"	"Maternal care for abnormality of pelvic organs"	"Scoliosis"	1	0	68	68
"E68"	"O68"	"Sequelae of hyperalimentation"	"Labor and delivery comp by abnlt of fetal acid-base balance"	1	0	397	397
"H91"	"Q90"	"Other and unspecified hearing loss"	"Down syndrome"	1	62	170	232
"K05"	"M34"	"Gingivitis and periodontal diseases"	"Systemic sclerosis [scleroderma]"	1	8	45	53
"M72"	"K30"	"Fibroblastic disorders"	"Functional dyspepsia"	1	386	579	965
"L98"	"M76"	"Oth disorders of skin, subcu, not elsewhere classified"	"Enthesopathies, lower limb, excluding foot"	1	100	216	316
"C92"	"D45"	"Myeloid leukemia"	"Polycythemia vera"	1	10	88	98
"L30"	"G56"	"Other and unspecified dermatitis"	"Mononeuropathies of upper limb"	1	356	570	926
"H53"	"D32"	"Visual disturbances"	"Benign neoplasm of meninges"	1	183	379	562
"L89"	"D50"	"Pressure ulcer"	"Iron deficiency anemia"	1	328	638	966
"Q18"	"O04"	"Other congenital malformations of face and neck"	"Complications following (induced) termination of pregnancy"	1	96	249	345
"I80"	"O20"	"Phlebitis and thrombophlebitis"	"Hemorrhage in early pregnancy"	1	23	480	503
"H52"	"O47"	"Disorders of refraction and accommodation"	"False labor"	1	124	257	381
"E21"	"N84"	"Hyperparathyroidism and other disorders of parathyroid gland"	"Polyp of female genital tract"	1	34	173	207
"D70"	"C34"	"Neutropenia"	"Malignant neoplasm of bronchus and lung"	1	115	659	774
"C20"	"O99"	"Malignant neoplasm of rectum"	"Oth maternal diseases classd elsw but compl preg/chldbrth"	1	0	26	26
"C34"	"K70"	"Malignant neoplasm of bronchus and lung"	"Alcoholic liver disease"	1	78	578	656
"I20"	"M23"	"Angina pectoris"	"Internal derangement of knee"	1	2791	4367	7158
"J15"	"O64"	"Bacterial pneumonia, not elsewhere classified"	"Obstructed labor due to malposition and malpresent of fetus"	1	0	135	135
"D10"	"O80"	"Benign neoplasm of mouth and pharynx"	"Encounter for full-term uncomplicated delivery"	1	0	407	407
"D13"	"K30"	"Benign neoplasm of and ill-defined parts of digestive system"	"Functional dyspepsia"	1	309	616	925
"K45"	"E65"	"Other abdominal hernia"	"Localized adiposity"	1	98	223	321
"I61"	"O68"	"Nontraumatic intracerebral hemorrhage"	"Labor and delivery comp by abnlt of fetal acid-base balance"	1	0	50	50
"E86"	"Q39"	"Volume depletion"	"Congenital malformations of esophagus"	1	22	75	97
"A41"	"O00"	"Other sepsis"	"Ectopic pregnancy"	1	1	61	62
"A41"	"N02"	"Other sepsis"	"Recurrent and persistent hematuria"	1	99	275	374
"M96"	"D25"	"Intraop and postproc comp and disorders of ms sys, NEC"	"Leiomyoma of uterus"	1	9	92	101
"C67"	"M17"	"Malignant neoplasm of bladder"	"Osteoarthritis of knee"	1	153	535	688
"D46"	"D75"	"Myelodysplastic syndromes"	"Other and unsp diseases of blood and blood-forming organs"	1	82	181	263
"G20"	"I20"	"Parkinson's disease"	"Angina pectoris"	1	199	1420	1619
"N30"	"M62"	"Cystitis"	"Other disorders of muscle"	1	0	9471	9471
"G56"	"O04"	"Mononeuropathies of upper limb"	"Complications following (induced) termination of pregnancy"	1	0	2214	2214
"N39"	"F29"	"Other disorders of urinary system"	"Unsp psychosis not due to a substance or known physiol cond"	1	39	103	142
"M80"	"K44"	"Osteoporosis with current pathological fracture"	"Diaphragmatic hernia"	1	503	1586	2089
"C77"	"K81"	"Secondary and unspecified malignant neoplasm of lymph nodes"	"Cholecystitis"	1	35	106	141
"A09"	"N03"	"Infectious gastroenteritis and colitis, unspecified"	"Chronic nephritic syndrome"	1	93	276	369
"K91"	"N43"	"Intraop and postproc comp and disorders of dgstv sys, NEC"	"Hydrocele and spermatocele"	1	21	71	92
"E87"	"E15"	"Other disorders of fluid, electrolyte and acid-base balance"	"Nondiabetic hypoglycemic coma"	1	88	203	291
"I10"	"M22"	"Essential (primary) hypertension"	"Disorder of patella"	1	0	1586	1586
"O91"	"O80"	"Infect of breast assoc w pregnancy, the puerp and lactation"	"Encounter for full-term uncomplicated delivery"	1	0	12128	12128
"N46"	"Q67"	"Male infertility"	"Congenital ms deformities of head, face, spine and chest"	1	0	26	26
"D68"	"N40"	"Other coagulation defects"	"Benign prostatic hyperplasia"	1	115	410	525
"J16"	"O80"	"Pneumonia due to oth infectious organisms, NEC"	"Encounter for full-term uncomplicated delivery"	1	18	74	92
"K56"	"O36"	"Paralytic ileus and intestinal obstruction without hernia"	"Maternal care for other fetal problems"	1	50	176	226
"I49"	"O02"	"Other cardiac arrhythmias"	"Other abnormal products of conception"	1	19	251	270
"I35"	"K85"	"Nonrheumatic aortic valve disorders"	"Acute pancreatitis"	1	198	377	575
"D38"	"I25"	"Neoplm of uncrt behav of mid ear & resp and intrathorac org"	"Chronic ischemic heart disease"	1	208	355	563
"J22"	"L05"	"Unspecified acute lower respiratory infection"	"Pilonidal cyst and sinus"	1	0	25	25
"L97"	"C43"	"Non-pressure chronic ulcer of lower limb, NEC"	"Malignant melanoma of skin"	1	53	167	220
"G54"	"I70"	"Nerve root and plexus disorders"	"Atherosclerosis"	1	151	293	444
"C79"	"K57"	"Secondary malignant neoplasm of other and unspecified sites"	"Diverticular disease of intestine"	1	240	1494	1734
"A49"	"M32"	"Bacterial infection of unspecified site"	"Systemic lupus erythematosus (SLE)"	1	14	77	91
"M99"	"O42"	"Biomechanical lesions, not elsewhere classified"	"Premature rupture of membranes"	1	0	92	92
"N62"	"O80"	"Hypertrophy of breast"	"Encounter for full-term uncomplicated delivery"	1	1193	1487	2680
"C91"	"I20"	"Lymphoid leukemia"	"Angina pectoris"	1	158	471	629
"I87"	"O22"	"Other disorders of veins"	"Venous complications and hemorrhoids in pregnancy"	1	12	54	66
"A41"	"D16"	"Other sepsis"	"Benign neoplasm of bone and articular cartilage"	1	10	180	190
"J96"	"D16"	"Respiratory failure, not elsewhere classified"	"Benign neoplasm of bone and articular cartilage"	1	2	137	139
"E34"	"E11"	"Other endocrine disorders"	"Type 2 diabetes mellitus"	1	324	722	1046
"Q80"	"G80"	"Congenital ichthyosis"	"Cerebral palsy"	1	12	72	84
"D64"	"N64"	"Other anemias"	"Other disorders of breast"	1	158	322	480
"J98"	"C32"	"Other respiratory disorders"	"Malignant neoplasm of larynx"	1	31	123	154
"C77"	"O64"	"Secondary and unspecified malignant neoplasm of lymph nodes"	"Obstructed labor due to malposition and malpresent of fetus"	1	0	26	26
"C04"	"C06"	"Malignant neoplasm of floor of mouth"	"Malignant neoplasm of other and unspecified parts of mouth"	1	557	782	1339
"M24"	"N44"	"Other specific joint derangements"	"Noninflammatory disorders of testis"	1	11	53	64
"O41"	"M22"	"Other disorders of amniotic fluid and membranes"	"Disorder of patella"	1	13	179	192
"I63"	"O75"	"Cerebral infarction"	"Oth complications of labor and delivery, NEC"	1	0	38	38
"K60"	"K51"	"Fissure and fistula of anal and rectal regions"	"Ulcerative colitis"	1	344	733	1077
"K62"	"M43"	"Other diseases of anus and rectum"	"Other deforming dorsopathies"	1	252	422	674
"E66"	"J45"	"Overweight and obesity"	"Asthma"	1	5187	7445	12632
"I10"	"J33"	"Essential (primary) hypertension"	"Nasal polyp"	1	528	837	1365
"M21"	"H83"	"Other acquired deformities of limbs"	"Other diseases of inner ear"	1	83	189	272
"J14"	"I20"	"Pneumonia due to Hemophilus influenzae"	"Angina pectoris"	1	37	336	373
"N19"	"N43"	"Unspecified kidney failure"	"Hydrocele and spermatocele"	1	53	202	255
"N18"	"I48"	"Chronic kidney disease (CKD)"	"Atrial fibrillation and flutter"	1	0	15501	15501
"D64"	"N43"	"Other anemias"	"Hydrocele and spermatocele"	1	64	819	883
"C78"	"N48"	"Secondary malignant neoplasm of resp and digestive organs"	"Other disorders of penis"	1	32	253	285
"O86"	"O21"	"Other puerperal infections"	"Excessive vomiting in pregnancy"	1	182	526	708
"H60"	"O71"	"Otitis externa"	"Other obstetric trauma"	1	23	80	103
"J32"	"N97"	"Chronic sinusitis"	"Female infertility"	1	32	186	218
"E89"	"D34"	"Postproc endocrine and metabolic comp and disorders, NEC"	"Benign neoplasm of thyroid gland"	1	14	235	249
"M76"	"J03"	"Enthesopathies, lower limb, excluding foot"	"Acute tonsillitis"	1	213	375	588
"D12"	"J03"	"Benign neoplasm of colon, rectum, anus and anal canal"	"Acute tonsillitis"	1	28	288	316
"E87"	"K85"	"Other disorders of fluid, electrolyte and acid-base balance"	"Acute pancreatitis"	1	481	1171	1652
"I50"	"O36"	"Heart failure"	"Maternal care for other fetal problems"	1	0	59	59
"C24"	"M20"	"Malignant neoplasm of other and unsp parts of biliary tract"	"Acquired deformities of fingers and toes"	1	0	48	48
"M72"	"H52"	"Fibroblastic disorders"	"Disorders of refraction and accommodation"	1	144	254	398
"I26"	"M17"	"Pulmonary embolism"	"Osteoarthritis of knee"	1	0	3035	3035
"J44"	"O04"	"Other chronic obstructive pulmonary disease"	"Complications following (induced) termination of pregnancy"	1	0	292	292
"M79"	"I20"	"Oth and unsp soft tissue disorders, not elsewhere classified"	"Angina pectoris"	1	4482	7134	11616
"M19"	"N85"	"Other and unspecified osteoarthritis"	"Other noninflammatory disorders of uterus, except cervix"	1	9	155	164
"N64"	"O64"	"Other disorders of breast"	"Obstructed labor due to malposition and malpresent of fetus"	1	108	467	575
"D12"	"H65"	"Benign neoplasm of colon, rectum, anus and anal canal"	"Nonsuppurative otitis media"	1	36	404	440
"I69"	"A63"	"Sequelae of cerebrovascular disease"	"Oth predominantly sexually transmitted diseases, NEC"	1	6	131	137
"C49"	"K40"	"Malignant neoplasm of other connective and soft tissue"	"Inguinal hernia"	1	37	153	190
"J38"	"O26"	"Diseases of vocal cords and larynx, not elsewhere classified"	"Maternal care for oth conditions predom related to pregnancy"	1	37	102	139
"E86"	"M41"	"Volume depletion"	"Scoliosis"	1	261	523	784
"M80"	"M20"	"Osteoporosis with current pathological fracture"	"Acquired deformities of fingers and toes"	1	45	984	1029
"A46"	"L23"	"Erysipelas"	"Allergic contact dermatitis"	1	136	260	396
"K61"	"O04"	"Abscess of anal and rectal regions"	"Complications following (induced) termination of pregnancy"	1	51	573	624
"D75"	"M65"	"Other and unsp diseases of blood and blood-forming organs"	"Synovitis and tenosynovitis"	1	37	112	149
"K22"	"K85"	"Other diseases of esophagus"	"Acute pancreatitis"	1	220	343	563
"I15"	"O26"	"Secondary hypertension"	"Maternal care for oth conditions predom related to pregnancy"	1	7	85	92
"I51"	"I49"	"Complications and ill-defined descriptions of heart disease"	"Other cardiac arrhythmias"	1	681	910	1591
"I50"	"H11"	"Heart failure"	"Other disorders of conjunctiva"	1	187	527	714
"A04"	"M35"	"Other bacterial intestinal infections"	"Other systemic involvement of connective tissue"	1	90	507	597
"H93"	"O99"	"Other disorders of ear, not elsewhere classified"	"Oth maternal diseases classd elsw but compl preg/chldbrth"	1	155	378	533
"E64"	"A63"	"Sequelae of malnutrition and other nutritional deficiencies"	"Oth predominantly sexually transmitted diseases, NEC"	1	1	36	37
"C15"	"K60"	"Malignant neoplasm of esophagus"	"Fissure and fistula of anal and rectal regions"	1	0	45	45
"I25"	"M76"	"Chronic ischemic heart disease"	"Enthesopathies, lower limb, excluding foot"	1	408	713	1121
"M08"	"H66"	"Juvenile arthritis"	"Suppurative and unspecified otitis media"	1	21	111	132
"I82"	"N43"	"Other venous embolism and thrombosis"	"Hydrocele and spermatocele"	1	19	72	91
"H26"	"H36"	"Other cataract"	"Retinal disorders in diseases classified elsewhere"	1	948	2181	3129
"D43"	"K21"	"Neoplasm of uncertain behavior of brain and cnsl"	"Gastro-esophageal reflux disease"	1	11	77	88
"O13"	"K35"	"Gestational hypertension without significant proteinuria"	"Acute appendicitis"	1	28	153	181
"N30"	"D27"	"Cystitis"	"Benign neoplasm of ovary"	1	763	1555	2318
"G57"	"O32"	"Mononeuropathies of lower limb"	"Maternal care for malpresentation of fetus"	1	5	59	64
"I27"	"M75"	"Other pulmonary heart diseases"	"Shoulder lesions"	1	76	327	403
"F33"	"M42"	"Major depressive disorder, recurrent"	"Spinal osteochondrosis"	1	9	67	76
"E86"	"M21"	"Volume depletion"	"Other acquired deformities of limbs"	1	190	771	961
"G40"	"J20"	"Epilepsy and recurrent seizures"	"Acute bronchitis"	1	552	771	1323
"G82"	"G80"	"Paraplegia (paraparesis) and quadriplegia (quadriparesis)"	"Cerebral palsy"	1	525	840	1365
"L68"	"O80"	"Hypertrichosis"	"Encounter for full-term uncomplicated delivery"	1	546	890	1436
"E05"	"M23"	"Thyrotoxicosis [hyperthyroidism]"	"Internal derangement of knee"	1	823	1214	2037
"K59"	"G80"	"Other functional intestinal disorders"	"Cerebral palsy"	1	295	476	771
"M79"	"K01"	"Oth and unsp soft tissue disorders, not elsewhere classified"	"Embedded and impacted teeth"	1	218	404	622
"E03"	"L02"	"Other hypothyroidism"	"Cutaneous abscess, furuncle and carbuncle"	1	357	810	1167
"M76"	"N92"	"Enthesopathies, lower limb, excluding foot"	"Excessive, frequent and irregular menstruation"	1	378	1264	1642
"O85"	"O21"	"Puerperal sepsis"	"Excessive vomiting in pregnancy"	1	112	321	433
"E66"	"O08"	"Overweight and obesity"	"Complications following ectopic and molar pregnancy"	1	946	1389	2335
"K83"	"K61"	"Other diseases of biliary tract"	"Abscess of anal and rectal regions"	1	30	88	118
"J15"	"O28"	"Bacterial pneumonia, not elsewhere classified"	"Abnormal findings on antenatal screening of mother"	1	10	61	71
"H34"	"H93"	"Retinal vascular occlusions"	"Other disorders of ear, not elsewhere classified"	1	60	305	365
"O72"	"J34"	"Postpartum hemorrhage"	"Other and unspecified disorders of nose and nasal sinuses"	1	209	910	1119
"E68"	"N60"	"Sequelae of hyperalimentation"	"Benign mammary dysplasia"	1	27	86	113
"N31"	"O80"	"Neuromuscular dysfunction of bladder, NEC"	"Encounter for full-term uncomplicated delivery"	1	1	226	227
"C10"	"E78"	"Malignant neoplasm of oropharynx"	"Disorders of lipoprotein metabolism and other lipidemias"	1	36	134	170
"O90"	"O32"	"Complications of the puerperium, not elsewhere classified"	"Maternal care for malpresentation of fetus"	1	588	1878	2466
"G47"	"A09"	"Sleep disorders"	"Infectious gastroenteritis and colitis, unspecified"	1	388	1647	2035
"N19"	"H10"	"Unspecified kidney failure"	"Conjunctivitis"	1	30	251	281
"I87"	"K35"	"Other disorders of veins"	"Acute appendicitis"	1	10	73	83
"E13"	"N81"	"Other specified diabetes mellitus"	"Female genital prolapse"	1	11	82	93
"G44"	"O03"	"Other headache syndromes"	"Spontaneous abortion"	1	41	624	665
"M49"	"I10"	"Spondylopathies in diseases classified elsewhere"	"Essential (primary) hypertension"	1	90	204	294
"J22"	"D17"	"Unspecified acute lower respiratory infection"	"Benign lipomatous neoplasm"	1	1	111	112
"K58"	"N62"	"Irritable bowel syndrome"	"Hypertrophy of breast"	1	163	307	470
"M21"	"O82"	"Other acquired deformities of limbs"	"Encounter for cesarean delivery without indication"	1	112	234	346
"I31"	"M17"	"Other diseases of pericardium"	"Osteoarthritis of knee"	1	51	239	290
"A41"	"K31"	"Other sepsis"	"Other diseases of stomach and duodenum"	1	423	615	1038
"G95"	"N95"	"Other and unspecified diseases of spinal cord"	"Menopausal and other perimenopausal disorders"	1	24	130	154
"H90"	"D25"	"Conductive and sensorineural hearing loss"	"Leiomyoma of uterus"	1	106	561	667
"A41"	"M66"	"Other sepsis"	"Spontaneous rupture of synovium and tendon"	1	40	225	265
"M16"	"D16"	"Osteoarthritis of hip"	"Benign neoplasm of bone and articular cartilage"	1	166	293	459
"M18"	"D27"	"Osteoarthritis of first carpometacarpal joint"	"Benign neoplasm of ovary"	1	14	147	161
"K26"	"O80"	"Duodenal ulcer"	"Encounter for full-term uncomplicated delivery"	1	35	306	341
"C65"	"M51"	"Malignant neoplasm of renal pelvis"	"Thoracic, thoracolum, and lumbosacral intvrt disc disorders"	1	11	76	87
"N30"	"G51"	"Cystitis"	"Facial nerve disorders"	1	305	505	810
"I21"	"I83"	"Acute myocardial infarction"	"Varicose veins of lower extremities"	1	922	2142	3064
"J98"	"K61"	"Other respiratory disorders"	"Abscess of anal and rectal regions"	1	29	98	127
"D64"	"D31"	"Other anemias"	"Benign neoplasm of eye and adnexa"	1	49	136	185
"C78"	"M00"	"Secondary malignant neoplasm of resp and digestive organs"	"Pyogenic arthritis"	1	6	114	120
"E86"	"C32"	"Volume depletion"	"Malignant neoplasm of larynx"	1	103	545	648
"J10"	"A41"	"Influenza due to other identified influenza virus"	"Other sepsis"	1	290	465	755
"G43"	"O20"	"Migraine"	"Hemorrhage in early pregnancy"	1	152	1079	1231
"L90"	"K29"	"Atrophic disorders of skin"	"Gastritis and duodenitis"	1	243	474	717
"G12"	"M20"	"Spinal muscular atrophy and related syndromes"	"Acquired deformities of fingers and toes"	1	2	50	52
"M21"	"Q89"	"Other acquired deformities of limbs"	"Other congenital malformations, not elsewhere classified"	1	16	71	87
"D43"	"O70"	"Neoplasm of uncertain behavior of brain and cnsl"	"Perineal laceration during delivery"	1	0	52	52
"J38"	"D25"	"Diseases of vocal cords and larynx, not elsewhere classified"	"Leiomyoma of uterus"	1	94	254	348
"D71"	"C56"	"Functional disorders of polymorphonuclear neutrophils"	"Malignant neoplasm of ovary"	1	6	47	53
"N28"	"C44"	"Oth disorders of kidney and ureter, not elsewhere classified"	"Other and unspecified malignant neoplasm of skin"	1	171	313	484
"N47"	"G80"	"Disorders of prepuce"	"Cerebral palsy"	1	32	99	131
"M80"	"M07"	"Osteoporosis with current pathological fracture"	"Enteropathic arthropathies"	1	39	171	210
"L89"	"G43"	"Pressure ulcer"	"Migraine"	1	2	61	63
"K44"	"L03"	"Diaphragmatic hernia"	"Cellulitis and acute lymphangitis"	1	171	399	570
"I50"	"M43"	"Heart failure"	"Other deforming dorsopathies"	1	203	883	1086
"K25"	"J30"	"Gastric ulcer"	"Vasomotor and allergic rhinitis"	1	51	124	175
"F43"	"O20"	"Reaction to severe stress, and adjustment disorders"	"Hemorrhage in early pregnancy"	1	15	575	590
"C90"	"M77"	"Multiple myeloma and malignant plasma cell neoplasms"	"Other enthesopathies"	1	4	48	52
"C15"	"M81"	"Malignant neoplasm of esophagus"	"Osteoporosis without current pathological fracture"	1	99	190	289
"C49"	"D37"	"Malignant neoplasm of other connective and soft tissue"	"Neoplasm of uncrt behavior of oral cavity and dgstv organs"	1	29	83	112
"N35"	"J05"	"Urethral stricture"	"Acute obstructive laryngitis [croup] and epiglottitis"	1	1	28	29
"E11"	"K35"	"Type 2 diabetes mellitus"	"Acute appendicitis"	1	449	1344	1793
"N17"	"L08"	"Acute kidney failure"	"Other local infections of skin and subcutaneous tissue"	1	243	493	736
"C79"	"M13"	"Secondary malignant neoplasm of other and unspecified sites"	"Other arthritis"	1	49	279	328
"J06"	"M22"	"Acute upper resp infections of multiple and unsp sites"	"Disorder of patella"	1	16	242	258
"B02"	"C81"	"Zoster [herpes zoster]"	"Hodgkin lymphoma"	1	36	135	171
"C88"	"M51"	"Malig immunoproliferative dis and certain oth B-cell lymph"	"Thoracic, thoracolum, and lumbosacral intvrt disc disorders"	1	1	73	74
"D05"	"N92"	"Carcinoma in situ of breast"	"Excessive, frequent and irregular menstruation"	1	4	298	302
"I50"	"F52"	"Heart failure"	"Sexual dysfnct not due to a substance or known physiol cond"	1	2	32	34
"K30"	"K35"	"Functional dyspepsia"	"Acute appendicitis"	1	514	979	1493
"C22"	"M48"	"Malignant neoplasm of liver and intrahepatic bile ducts"	"Other spondylopathies"	1	12	202	214
"I20"	"O99"	"Angina pectoris"	"Oth maternal diseases classd elsw but compl preg/chldbrth"	1	0	452	452
"M80"	"I20"	"Osteoporosis with current pathological fracture"	"Angina pectoris"	1	0	4079	4079
"F33"	"M75"	"Major depressive disorder, recurrent"	"Shoulder lesions"	1	400	1116	1516
"O75"	"N96"	"Oth complications of labor and delivery, NEC"	"Recurrent pregnancy loss"	1	112	229	341
"N17"	"O03"	"Acute kidney failure"	"Spontaneous abortion"	1	0	25	25
"H43"	"M76"	"Disorders of vitreous body"	"Enthesopathies, lower limb, excluding foot"	1	97	183	280
"J22"	"M77"	"Unspecified acute lower respiratory infection"	"Other enthesopathies"	1	16	84	100
"I69"	"J03"	"Sequelae of cerebrovascular disease"	"Acute tonsillitis"	1	45	210	255
"F33"	"M54"	"Major depressive disorder, recurrent"	"Dorsalgia"	1	973	2942	3915
"E89"	"O63"	"Postproc endocrine and metabolic comp and disorders, NEC"	"Long labor"	1	3	54	57
"L89"	"C20"	"Pressure ulcer"	"Malignant neoplasm of rectum"	1	61	212	273
"A49"	"H40"	"Bacterial infection of unspecified site"	"Glaucoma"	1	53	641	694
"K05"	"K61"	"Gingivitis and periodontal diseases"	"Abscess of anal and rectal regions"	1	37	144	181
"J96"	"F60"	"Respiratory failure, not elsewhere classified"	"Specific personality disorders"	1	99	227	326
"M16"	"K58"	"Osteoarthritis of hip"	"Irritable bowel syndrome"	1	361	925	1286
"F17"	"F99"	"Nicotine dependence"	"Mental disorder, not otherwise specified"	1	32	181	213
"M80"	"D10"	"Osteoporosis with current pathological fracture"	"Benign neoplasm of mouth and pharynx"	1	44	144	188
"J91"	"I69"	"Pleural effusion in conditions classified elsewhere"	"Sequelae of cerebrovascular disease"	1	255	437	692
"M19"	"J35"	"Other and unspecified osteoarthritis"	"Chronic diseases of tonsils and adenoids"	1	0	490	490
"F41"	"K00"	"Other anxiety disorders"	"Disorders of tooth development and eruption"	1	3	54	57
"N19"	"L50"	"Unspecified kidney failure"	"Urticaria"	1	45	130	175
"A04"	"M10"	"Other bacterial intestinal infections"	"Gout"	1	247	590	837
"I62"	"M23"	"Other and unspecified nontraumatic intracranial hemorrhage"	"Internal derangement of knee"	1	12	75	87
"J84"	"M79"	"Other interstitial pulmonary diseases"	"Oth and unsp soft tissue disorders, not elsewhere classified"	1	210	633	843
"N90"	"K35"	"Other noninflammatory disorders of vulva and perineum"	"Acute appendicitis"	1	46	112	158
"I10"	"N83"	"Essential (primary) hypertension"	"Noninflammatory disord of ovary, fallop and broad ligament"	1	2693	3327	6020
"L60"	"J35"	"Nail disorders"	"Chronic diseases of tonsils and adenoids"	1	83	442	525
"C26"	"C18"	"Malignant neoplasm of other and ill-defined digestive organs"	"Malignant neoplasm of colon"	1	59	159	218
"J95"	"C50"	"Intraop and postproc comp and disorders of resp sys, NEC"	"Malignant neoplasm of breast"	1	5	144	149
"C64"	"I83"	"Malignant neoplasm of kidney, except renal pelvis"	"Varicose veins of lower extremities"	1	16	239	255
"N15"	"M51"	"Other renal tubulo-interstitial diseases"	"Thoracic, thoracolum, and lumbosacral intvrt disc disorders"	1	18	84	102
"M75"	"F10"	"Shoulder lesions"	"Alcohol related disorders"	1	1008	2984	3992
"E78"	"I88"	"Disorders of lipoprotein metabolism and other lipidemias"	"Nonspecific lymphadenitis"	1	69	207	276
"G63"	"D17"	"Polyneuropathy in diseases classified elsewhere"	"Benign lipomatous neoplasm"	1	16	61	77
"L91"	"Q17"	"Hypertrophic disorders of skin"	"Other congenital malformations of ear"	1	17	216	233
"C78"	"N73"	"Secondary malignant neoplasm of resp and digestive organs"	"Other female pelvic inflammatory diseases"	1	4	64	68
"L89"	"J37"	"Pressure ulcer"	"Chronic laryngitis and laryngotracheitis"	1	0	33	33
"C64"	"K30"	"Malignant neoplasm of kidney, except renal pelvis"	"Functional dyspepsia"	1	47	245	292
"M25"	"D23"	"Other joint disorder, not elsewhere classified"	"Other benign neoplasms of skin"	1	381	550	931
"C25"	"G40"	"Malignant neoplasm of pancreas"	"Epilepsy and recurrent seizures"	1	19	120	139
"C64"	"H40"	"Malignant neoplasm of kidney, except renal pelvis"	"Glaucoma"	1	38	108	146
"M14"	"I10"	"Arthropathies in other diseases classified elsewhere"	"Essential (primary) hypertension"	1	281	538	819
"I50"	"J34"	"Heart failure"	"Other and unspecified disorders of nose and nasal sinuses"	1	44	495	539
"K76"	"K61"	"Other diseases of liver"	"Abscess of anal and rectal regions"	1	31	159	190
"F41"	"D05"	"Other anxiety disorders"	"Carcinoma in situ of breast"	1	19	72	91
"D84"	"O82"	"Other immunodeficiencies"	"Encounter for cesarean delivery without indication"	1	1	59	60
"N30"	"E10"	"Cystitis"	"Type 1 diabetes mellitus"	1	4235	7008	11243
"M81"	"L68"	"Osteoporosis without current pathological fracture"	"Hypertrichosis"	1	2	116	118
"K57"	"H43"	"Diverticular disease of intestine"	"Disorders of vitreous body"	1	459	783	1242
"E66"	"O65"	"Overweight and obesity"	"Obstructed labor due to maternal pelvic abnormality"	1	697	2212	2909
"I31"	"Q21"	"Other diseases of pericardium"	"Congenital malformations of cardiac septa"	1	41	105	146
"O72"	"G43"	"Postpartum hemorrhage"	"Migraine"	1	1024	2382	3406
"H02"	"O32"	"Other disorders of eyelid"	"Maternal care for malpresentation of fetus"	1	2	94	96
"J22"	"K35"	"Unspecified acute lower respiratory infection"	"Acute appendicitis"	1	6	105	111
"J13"	"M51"	"Pneumonia due to Streptococcus pneumoniae"	"Thoracic, thoracolum, and lumbosacral intvrt disc disorders"	1	50	249	299
"D47"	"O68"	"Oth neoplm of uncrt behav of lymphoid, hematpoetc & rel tiss"	"Labor and delivery comp by abnlt of fetal acid-base balance"	1	0	25	25
"I69"	"G51"	"Sequelae of cerebrovascular disease"	"Facial nerve disorders"	1	344	727	1071
"H35"	"O70"	"Other retinal disorders"	"Perineal laceration during delivery"	1	19	249	268
"N25"	"I12"	"Disorders resulting from impaired renal tubular function"	"Hypertensive chronic kidney disease"	1	102	213	315
"N17"	"H02"	"Acute kidney failure"	"Other disorders of eyelid"	1	75	375	450
"C18"	"C20"	"Malignant neoplasm of colon"	"Malignant neoplasm of rectum"	1	2697	4156	6853
"N13"	"E04"	"Obstructive and reflux uropathy"	"Other nontoxic goiter"	1	133	253	386
"M65"	"J35"	"Synovitis and tenosynovitis"	"Chronic diseases of tonsils and adenoids"	1	238	1054	1292
"C92"	"D51"	"Myeloid leukemia"	"Vitamin B12 deficiency anemia"	1	24	77	101
"K81"	"O36"	"Cholecystitis"	"Maternal care for other fetal problems"	1	34	140	174
"D50"	"H40"	"Iron deficiency anemia"	"Glaucoma"	1	152	620	772
"K05"	"N03"	"Gingivitis and periodontal diseases"	"Chronic nephritic syndrome"	1	30	164	194
"E86"	"M50"	"Volume depletion"	"Cervical disc disorders"	1	0	896	896
"K58"	"M41"	"Irritable bowel syndrome"	"Scoliosis"	1	93	182	275
"D09"	"M79"	"Carcinoma in situ of other and unspecified sites"	"Oth and unsp soft tissue disorders, not elsewhere classified"	1	9	211	220
"I97"	"E11"	"Intraop and postproc comp and disorders of circ sys, NEC"	"Type 2 diabetes mellitus"	1	136	396	532
"N92"	"N96"	"Excessive, frequent and irregular menstruation"	"Recurrent pregnancy loss"	1	56	285	341
"N80"	"O65"	"Endometriosis"	"Obstructed labor due to maternal pelvic abnormality"	1	22	214	236
"D24"	"O42"	"Benign neoplasm of breast"	"Premature rupture of membranes"	1	233	410	643
"J16"	"I20"	"Pneumonia due to oth infectious organisms, NEC"	"Angina pectoris"	1	60	226	286
"I95"	"I50"	"Hypotension"	"Heart failure"	1	2367	4629	6996
"E16"	"K80"	"Other disorders of pancreatic internal secretion"	"Cholelithiasis"	1	229	615	844
"L89"	"J18"	"Pressure ulcer"	"Pneumonia, unspecified organism"	1	3370	4397	7767
"I35"	"H26"	"Nonrheumatic aortic valve disorders"	"Other cataract"	1	1014	2476	3490
"K04"	"K50"	"Diseases of pulp and periapical tissues"	"Crohn's disease [regional enteritis]"	1	21	73	94
"F10"	"M08"	"Alcohol related disorders"	"Juvenile arthritis"	1	5	54	59
"L89"	"N81"	"Pressure ulcer"	"Female genital prolapse"	1	0	319	319
"M86"	"A46"	"Osteomyelitis"	"Erysipelas"	1	413	600	1013
"J90"	"N80"	"Pleural effusion, not elsewhere classified"	"Endometriosis"	1	1	39	40
"H57"	"N92"	"Other disorders of eye and adnexa"	"Excessive, frequent and irregular menstruation"	1	35	545	580
"J81"	"I12"	"Pulmonary edema"	"Hypertensive chronic kidney disease"	1	177	307	484
"M90"	"I21"	"Osteopathies in diseases classified elsewhere"	"Acute myocardial infarction"	1	11	55	66
"O04"	"H66"	"Complications following (induced) termination of pregnancy"	"Suppurative and unspecified otitis media"	1	138	355	493
"K25"	"J35"	"Gastric ulcer"	"Chronic diseases of tonsils and adenoids"	1	25	194	219
"K44"	"O82"	"Diaphragmatic hernia"	"Encounter for cesarean delivery without indication"	1	65	513	578
"E41"	"E66"	"Nutritional marasmus"	"Overweight and obesity"	1	0	52	52
"N64"	"K80"	"Other disorders of breast"	"Cholelithiasis"	1	443	663	1106
"O85"	"K35"	"Puerperal sepsis"	"Acute appendicitis"	1	39	112	151
"K28"	"C50"	"Gastrojejunal ulcer"	"Malignant neoplasm of breast"	1	13	53	66
"E05"	"H65"	"Thyrotoxicosis [hyperthyroidism]"	"Nonsuppurative otitis media"	1	49	160	209
"H90"	"M22"	"Conductive and sensorineural hearing loss"	"Disorder of patella"	1	90	301	391
"M06"	"M51"	"Other rheumatoid arthritis"	"Thoracic, thoracolum, and lumbosacral intvrt disc disorders"	1	565	831	1396
"N13"	"O02"	"Obstructive and reflux uropathy"	"Other abnormal products of conception"	1	82	220	302
"H35"	"K61"	"Other retinal disorders"	"Abscess of anal and rectal regions"	1	64	221	285
"M48"	"O36"	"Other spondylopathies"	"Maternal care for other fetal problems"	1	0	68	68
"E61"	"E66"	"Deficiency of other nutrient elements"	"Overweight and obesity"	1	30	198	228
"C65"	"H25"	"Malignant neoplasm of renal pelvis"	"Age-related cataract"	1	119	211	330
"G56"	"N60"	"Mononeuropathies of upper limb"	"Benign mammary dysplasia"	1	251	825	1076
"J44"	"K35"	"Other chronic obstructive pulmonary disease"	"Acute appendicitis"	1	617	1238	1855
"M70"	"E04"	"Soft tissue disorders related to use, overuse and pressure"	"Other nontoxic goiter"	1	274	497	771
"G95"	"I25"	"Other and unspecified diseases of spinal cord"	"Chronic ischemic heart disease"	1	176	726	902
"D12"	"M25"	"Benign neoplasm of colon, rectum, anus and anal canal"	"Other joint disorder, not elsewhere classified"	1	620	1315	1935
"D50"	"N48"	"Iron deficiency anemia"	"Other disorders of penis"	1	27	152	179
"L30"	"K50"	"Other and unspecified dermatitis"	"Crohn's disease [regional enteritis]"	1	83	304	387
"I69"	"D30"	"Sequelae of cerebrovascular disease"	"Benign neoplasm of urinary organs"	1	282	967	1249
"K81"	"O63"	"Cholecystitis"	"Long labor"	1	5	77	82
"E86"	"H52"	"Volume depletion"	"Disorders of refraction and accommodation"	1	300	712	1012
"J18"	"L40"	"Pneumonia, unspecified organism"	"Psoriasis"	1	751	1710	2461
"A49"	"O02"	"Bacterial infection of unspecified site"	"Other abnormal products of conception"	1	34	197	231
"I63"	"A63"	"Cerebral infarction"	"Oth predominantly sexually transmitted diseases, NEC"	1	5	127	132
"C78"	"N88"	"Secondary malignant neoplasm of resp and digestive organs"	"Other noninflammatory disorders of cervix uteri"	1	0	29	29
"A41"	"O65"	"Other sepsis"	"Obstructed labor due to maternal pelvic abnormality"	1	0	60	60
"M19"	"H80"	"Other and unspecified osteoarthritis"	"Otosclerosis"	1	5	239	244
"H33"	"O04"	"Retinal detachments and breaks"	"Complications following (induced) termination of pregnancy"	1	0	100	100
"K04"	"Q21"	"Diseases of pulp and periapical tissues"	"Congenital malformations of cardiac septa"	1	17	61	78
"L30"	"H93"	"Other and unspecified dermatitis"	"Other disorders of ear, not elsewhere classified"	1	165	319	484
"K81"	"O75"	"Cholecystitis"	"Oth complications of labor and delivery, NEC"	1	15	91	106
"D62"	"C50"	"Acute posthemorrhagic anemia"	"Malignant neoplasm of breast"	1	90	331	421
"D64"	"H36"	"Other anemias"	"Retinal disorders in diseases classified elsewhere"	1	592	1990	2582
"M23"	"D39"	"Internal derangement of knee"	"Neoplasm of uncertain behavior of female genital organs"	1	23	74	97
"L97"	"H66"	"Non-pressure chronic ulcer of lower limb, NEC"	"Suppurative and unspecified otitis media"	1	3	113	116
"C78"	"M51"	"Secondary malignant neoplasm of resp and digestive organs"	"Thoracic, thoracolum, and lumbosacral intvrt disc disorders"	1	0	1688	1688
"O72"	"M65"	"Postpartum hemorrhage"	"Synovitis and tenosynovitis"	1	528	2292	2820
"H53"	"N47"	"Visual disturbances"	"Disorders of prepuce"	1	95	185	280
"O72"	"L73"	"Postpartum hemorrhage"	"Other follicular disorders"	1	134	414	548
"M17"	"H27"	"Osteoarthritis of knee"	"Other disorders of lens"	1	110	202	312
"D32"	"G45"	"Benign neoplasm of meninges"	"Transient cerebral ischemic attacks and related syndromes"	1	204	335	539
"I61"	"J35"	"Nontraumatic intracerebral hemorrhage"	"Chronic diseases of tonsils and adenoids"	1	8	61	69
"J86"	"L02"	"Pyothorax"	"Cutaneous abscess, furuncle and carbuncle"	1	142	245	387
"K92"	"M67"	"Other diseases of digestive system"	"Other disorders of synovium and tendon"	1	158	417	575
"B59"	"I25"	"Pneumocystosis"	"Chronic ischemic heart disease"	1	12	62	74
"C78"	"J18"	"Secondary malignant neoplasm of resp and digestive organs"	"Pneumonia, unspecified organism"	1	4453	5326	9779
"C44"	"M76"	"Other and unspecified malignant neoplasm of skin"	"Enthesopathies, lower limb, excluding foot"	1	87	312	399
"C80"	"C67"	"Malignant neoplasm without specification of site"	"Malignant neoplasm of bladder"	1	45	134	179
"E64"	"H10"	"Sequelae of malnutrition and other nutritional deficiencies"	"Conjunctivitis"	1	41	120	161
"K04"	"K61"	"Diseases of pulp and periapical tissues"	"Abscess of anal and rectal regions"	1	58	160	218
"M99"	"A63"	"Biomechanical lesions, not elsewhere classified"	"Oth predominantly sexually transmitted diseases, NEC"	1	11	63	74
"C79"	"I20"	"Secondary malignant neoplasm of other and unspecified sites"	"Angina pectoris"	1	0	2723	2723
"H26"	"J03"	"Other cataract"	"Acute tonsillitis"	1	54	126	180
"G57"	"N60"	"Mononeuropathies of lower limb"	"Benign mammary dysplasia"	1	44	136	180
"M81"	"D35"	"Osteoporosis without current pathological fracture"	"Benign neoplasm of other and unspecified endocrine glands"	1	247	396	643
"C80"	"H43"	"Malignant neoplasm without specification of site"	"Disorders of vitreous body"	1	2	50	52
"J36"	"Q17"	"Peritonsillar abscess"	"Other congenital malformations of ear"	1	1	66	67
"J09"	"C91"	"Influenza due to certain identified influenza viruses"	"Lymphoid leukemia"	1	0	76	76
"J43"	"J45"	"Emphysema"	"Asthma"	1	1661	2052	3713
"K80"	"O66"	"Cholelithiasis"	"Other obstructed labor"	1	98	785	883
"M07"	"O72"	"Enteropathic arthropathies"	"Postpartum hemorrhage"	1	136	247	383
"I87"	"O02"	"Other disorders of veins"	"Other abnormal products of conception"	1	2	31	33
"M41"	"G80"	"Scoliosis"	"Cerebral palsy"	1	34	436	470
"J91"	"M21"	"Pleural effusion in conditions classified elsewhere"	"Other acquired deformities of limbs"	1	10	59	69
"H57"	"O75"	"Other disorders of eye and adnexa"	"Oth complications of labor and delivery, NEC"	1	15	96	111
"F06"	"N94"	"Other mental disorders due to known physiological condition"	"Pain and oth cond assoc w fem gntl org and menstrual cycle"	1	0	34	34
"C71"	"N84"	"Malignant neoplasm of brain"	"Polyp of female genital tract"	1	4	72	76
"E86"	"I80"	"Volume depletion"	"Phlebitis and thrombophlebitis"	1	0	6005	6005
"I12"	"K40"	"Hypertensive chronic kidney disease"	"Inguinal hernia"	1	75	171	246
"D63"	"H93"	"Anemia in chronic diseases classified elsewhere"	"Other disorders of ear, not elsewhere classified"	1	0	449	449
"I42"	"K21"	"Cardiomyopathy"	"Gastro-esophageal reflux disease"	1	192	438	630
"C78"	"M70"	"Secondary malignant neoplasm of resp and digestive organs"	"Soft tissue disorders related to use, overuse and pressure"	1	0	687	687
"N13"	"F10"	"Obstructive and reflux uropathy"	"Alcohol related disorders"	1	162	576	738
"A41"	"N32"	"Other sepsis"	"Other disorders of bladder"	1	492	769	1261
"E86"	"G82"	"Volume depletion"	"Paraplegia (paraparesis) and quadriplegia (quadriparesis)"	1	280	505	785
"B37"	"H25"	"Candidiasis"	"Age-related cataract"	1	883	2287	3170
"N18"	"I22"	"Chronic kidney disease (CKD)"	"Subsequent STEMI & NSTEMI mocard infrc"	1	34	147	181
"F03"	"N31"	"Unspecified dementia"	"Neuromuscular dysfunction of bladder, NEC"	1	90	403	493
"K65"	"M16"	"Peritonitis"	"Osteoarthritis of hip"	1	189	575	764
"K65"	"K50"	"Peritonitis"	"Crohn's disease [regional enteritis]"	1	254	528	782
"I61"	"J33"	"Nontraumatic intracerebral hemorrhage"	"Nasal polyp"	1	12	56	68
"K80"	"M93"	"Cholelithiasis"	"Other osteochondropathies"	1	21	137	158
"K05"	"O48"	"Gingivitis and periodontal diseases"	"Late pregnancy"	1	0	33	33
"M47"	"O99"	"Spondylosis"	"Oth maternal diseases classd elsw but compl preg/chldbrth"	1	0	576	576
"E83"	"K05"	"Disorders of mineral metabolism"	"Gingivitis and periodontal diseases"	1	118	256	374
"N61"	"O82"	"Inflammatory disorders of breast"	"Encounter for cesarean delivery without indication"	1	46	505	551
"N30"	"I25"	"Cystitis"	"Chronic ischemic heart disease"	1	0	28256	28256
"M05"	"H83"	"Rheumatoid arthritis with rheumatoid factor"	"Other diseases of inner ear"	1	66	186	252
"D75"	"M17"	"Other and unsp diseases of blood and blood-forming organs"	"Osteoarthritis of knee"	1	114	288	402
"A04"	"C91"	"Other bacterial intestinal infections"	"Lymphoid leukemia"	1	54	245	299
"K65"	"H90"	"Peritonitis"	"Conductive and sensorineural hearing loss"	1	99	226	325
"C79"	"M47"	"Secondary malignant neoplasm of other and unspecified sites"	"Spondylosis"	1	61	830	891
"E85"	"M17"	"Amyloidosis"	"Osteoarthritis of knee"	1	7	69	76
"L97"	"G62"	"Non-pressure chronic ulcer of lower limb, NEC"	"Other and unspecified polyneuropathies"	1	313	744	1057
"K04"	"I21"	"Diseases of pulp and periapical tissues"	"Acute myocardial infarction"	1	492	680	1172
"K66"	"K35"	"Other disorders of peritoneum"	"Acute appendicitis"	1	83	281	364
"C79"	"D24"	"Secondary malignant neoplasm of other and unspecified sites"	"Benign neoplasm of breast"	1	0	418	418
"J18"	"Q41"	"Pneumonia, unspecified organism"	"Congenital absence, atresia and stenosis of small intestine"	1	10	79	89
"F33"	"O42"	"Major depressive disorder, recurrent"	"Premature rupture of membranes"	1	110	273	383
"C61"	"L72"	"Malignant neoplasm of prostate"	"Follicular cysts of skin and subcutaneous tissue"	1	16	129	145
"N39"	"O00"	"Other disorders of urinary system"	"Ectopic pregnancy"	1	0	325	325
"D86"	"F10"	"Sarcoidosis"	"Alcohol related disorders"	1	51	142	193
"M00"	"H91"	"Pyogenic arthritis"	"Other and unspecified hearing loss"	1	170	434	604
"I67"	"O71"	"Other cerebrovascular diseases"	"Other obstetric trauma"	1	0	25	25
"C44"	"C54"	"Other and unspecified malignant neoplasm of skin"	"Malignant neoplasm of corpus uteri"	1	48	162	210
"M65"	"O14"	"Synovitis and tenosynovitis"	"Pre-eclampsia"	1	141	263	404
"K80"	"M51"	"Cholelithiasis"	"Thoracic, thoracolum, and lumbosacral intvrt disc disorders"	1	2430	3198	5628
"D62"	"H33"	"Acute posthemorrhagic anemia"	"Retinal detachments and breaks"	1	15	141	156
"M93"	"J35"	"Other osteochondropathies"	"Chronic diseases of tonsils and adenoids"	1	26	105	131
"I33"	"M16"	"Acute and subacute endocarditis"	"Osteoarthritis of hip"	1	41	240	281
"L98"	"O71"	"Oth disorders of skin, subcu, not elsewhere classified"	"Other obstetric trauma"	1	7	105	112
"K66"	"N71"	"Other disorders of peritoneum"	"Inflammatory disease of uterus, except cervix"	1	26	106	132
"F41"	"D72"	"Other anxiety disorders"	"Other disorders of white blood cells"	1	55	134	189
"J96"	"F10"	"Respiratory failure, not elsewhere classified"	"Alcohol related disorders"	1	0	9114	9114
"J69"	"D30"	"Pneumonitis due to solids and liquids"	"Benign neoplasm of urinary organs"	1	0	98	98
"A49"	"M48"	"Bacterial infection of unspecified site"	"Other spondylopathies"	1	347	1637	1984
"J38"	"O04"	"Diseases of vocal cords and larynx, not elsewhere classified"	"Complications following (induced) termination of pregnancy"	1	34	391	425
"N50"	"Q53"	"Other and unspecified disorders of male genital organs"	"Undescended and ectopic testicle"	1	224	712	936
"L68"	"J35"	"Hypertrichosis"	"Chronic diseases of tonsils and adenoids"	1	38	206	244
"H43"	"K40"	"Disorders of vitreous body"	"Inguinal hernia"	1	259	667	926
"D72"	"O04"	"Other disorders of white blood cells"	"Complications following (induced) termination of pregnancy"	1	0	72	72
"F17"	"J45"	"Nicotine dependence"	"Asthma"	1	1183	2201	3384
"F23"	"O04"	"Brief psychotic disorder"	"Complications following (induced) termination of pregnancy"	1	20	77	97
"M17"	"Q82"	"Osteoarthritis of knee"	"Other congenital malformations of skin"	1	53	142	195
"E66"	"F98"	"Overweight and obesity"	"Oth behav/emotn disord w onset usly occur in chldhd and adol"	1	145	261	406
"I45"	"I20"	"Other conduction disorders"	"Angina pectoris"	1	1049	2390	3439
"H80"	"O04"	"Otosclerosis"	"Complications following (induced) termination of pregnancy"	1	16	191	207
"H66"	"Q89"	"Suppurative and unspecified otitis media"	"Other congenital malformations, not elsewhere classified"	1	66	171	237
"C16"	"N47"	"Malignant neoplasm of stomach"	"Disorders of prepuce"	1	15	61	76
"C25"	"M54"	"Malignant neoplasm of pancreas"	"Dorsalgia"	1	44	779	823
"N30"	"M19"	"Cystitis"	"Other and unspecified osteoarthritis"	1	3061	3591	6652
"M35"	"O20"	"Other systemic involvement of connective tissue"	"Hemorrhage in early pregnancy"	1	109	279	388
"C79"	"D48"	"Secondary malignant neoplasm of other and unspecified sites"	"Neoplasm of uncertain behavior of other and unsp sites"	1	249	539	788
"K55"	"N81"	"Vascular disorders of intestine"	"Female genital prolapse"	1	4	198	202
"G47"	"N89"	"Sleep disorders"	"Other noninflammatory disorders of vagina"	1	18	83	101
"K92"	"D11"	"Other diseases of digestive system"	"Benign neoplasm of major salivary glands"	1	41	143	184
"A49"	"I63"	"Bacterial infection of unspecified site"	"Cerebral infarction"	1	1008	2945	3953
"M62"	"K35"	"Other disorders of muscle"	"Acute appendicitis"	1	1072	1655	2727
"M79"	"O85"	"Oth and unsp soft tissue disorders, not elsewhere classified"	"Puerperal sepsis"	1	62	152	214
"Q53"	"H66"	"Undescended and ectopic testicle"	"Suppurative and unspecified otitis media"	1	314	625	939
"K52"	"I10"	"Other and unsp noninfective gastroenteritis and colitis"	"Essential (primary) hypertension"	1	4735	9049	13784
"N92"	"Q18"	"Excessive, frequent and irregular menstruation"	"Other congenital malformations of face and neck"	1	67	155	222
"M23"	"N60"	"Internal derangement of knee"	"Benign mammary dysplasia"	1	582	1285	1867
"K28"	"E66"	"Gastrojejunal ulcer"	"Overweight and obesity"	1	177	316	493
"M76"	"J45"	"Enthesopathies, lower limb, excluding foot"	"Asthma"	1	488	1189	1677
"K83"	"K50"	"Other diseases of biliary tract"	"Crohn's disease [regional enteritis]"	1	77	159	236
"E64"	"C32"	"Sequelae of malnutrition and other nutritional deficiencies"	"Malignant neoplasm of larynx"	1	61	435	496
"K22"	"J34"	"Other diseases of esophagus"	"Other and unspecified disorders of nose and nasal sinuses"	1	52	201	253
"N50"	"J35"	"Other and unspecified disorders of male genital organs"	"Chronic diseases of tonsils and adenoids"	1	24	343	367
"H66"	"Q25"	"Suppurative and unspecified otitis media"	"Congenital malformations of great arteries"	1	158	603	761
"D86"	"O04"	"Sarcoidosis"	"Complications following (induced) termination of pregnancy"	1	6	175	181
"O34"	"M62"	"Maternal care for abnormality of pelvic organs"	"Other disorders of muscle"	1	487	781	1268
"M72"	"N92"	"Fibroblastic disorders"	"Excessive, frequent and irregular menstruation"	1	96	1000	1096
"C16"	"D17"	"Malignant neoplasm of stomach"	"Benign lipomatous neoplasm"	1	1	102	103
"N17"	"H25"	"Acute kidney failure"	"Age-related cataract"	1	0	4705	4705
"Q50"	"N83"	"Congen malform of ovaries, fallopian tubes & broad ligaments"	"Noninflammatory disord of ovary, fallop and broad ligament"	1	334	551	885
"I26"	"O65"	"Pulmonary embolism"	"Obstructed labor due to maternal pelvic abnormality"	1	0	54	54
"F34"	"F10"	"Persistent mood [affective] disorders"	"Alcohol related disorders"	1	224	545	769
"N32"	"G37"	"Other disorders of bladder"	"Other demyelinating diseases of central nervous system"	1	4	33	37
"E53"	"M54"	"Deficiency of other B group vitamins"	"Dorsalgia"	1	212	581	793
"O99"	"J05"	"Oth maternal diseases classd elsw but compl preg/chldbrth"	"Acute obstructive laryngitis [croup] and epiglottitis"	1	0	49	49
"J15"	"H43"	"Bacterial pneumonia, not elsewhere classified"	"Disorders of vitreous body"	1	133	788	921
"J14"	"E78"	"Pneumonia due to Hemophilus influenzae"	"Disorders of lipoprotein metabolism and other lipidemias"	1	116	225	341
"O63"	"O47"	"Long labor"	"False labor"	1	1141	1732	2873
"E55"	"O99"	"Vitamin D deficiency"	"Oth maternal diseases classd elsw but compl preg/chldbrth"	1	460	984	1444
"G82"	"G35"	"Paraplegia (paraparesis) and quadriplegia (quadriparesis)"	"Multiple sclerosis"	1	18	157	175
"J43"	"F10"	"Emphysema"	"Alcohol related disorders"	1	255	582	837
"F41"	"O75"	"Other anxiety disorders"	"Oth complications of labor and delivery, NEC"	1	68	144	212
"N12"	"O02"	"Tubulo-interstitial nephritis, not spcf as acute or chronic"	"Other abnormal products of conception"	1	41	109	150
"F17"	"F43"	"Nicotine dependence"	"Reaction to severe stress, and adjustment disorders"	1	310	483	793
"M81"	"I47"	"Osteoporosis without current pathological fracture"	"Paroxysmal tachycardia"	1	673	2095	2768
"G30"	"I73"	"Alzheimer's disease"	"Other peripheral vascular diseases"	1	12	343	355
"K80"	"L03"	"Cholelithiasis"	"Cellulitis and acute lymphangitis"	1	275	656	931
"H43"	"N92"	"Disorders of vitreous body"	"Excessive, frequent and irregular menstruation"	1	0	454	454
"K43"	"C20"	"Ventral hernia"	"Malignant neoplasm of rectum"	1	0	2802	2802
"C78"	"K61"	"Secondary malignant neoplasm of resp and digestive organs"	"Abscess of anal and rectal regions"	1	78	353	431
"J18"	"C43"	"Pneumonia, unspecified organism"	"Malignant melanoma of skin"	1	578	1361	1939
"F17"	"G56"	"Nicotine dependence"	"Mononeuropathies of upper limb"	1	468	1239	1707
"C78"	"C06"	"Secondary malignant neoplasm of resp and digestive organs"	"Malignant neoplasm of other and unspecified parts of mouth"	1	46	243	289
"K62"	"I80"	"Other diseases of anus and rectum"	"Phlebitis and thrombophlebitis"	1	1083	1440	2523
"M48"	"O75"	"Other spondylopathies"	"Oth complications of labor and delivery, NEC"	1	0	29	29
"M19"	"O21"	"Other and unspecified osteoarthritis"	"Excessive vomiting in pregnancy"	1	0	73	73
"M53"	"J34"	"Other and unspecified dorsopathies, not elsewhere classified"	"Other and unspecified disorders of nose and nasal sinuses"	1	99	227	326
"J86"	"F10"	"Pyothorax"	"Alcohol related disorders"	1	269	709	978
"A41"	"H36"	"Other sepsis"	"Retinal disorders in diseases classified elsewhere"	1	337	1796	2133
"C34"	"K25"	"Malignant neoplasm of bronchus and lung"	"Gastric ulcer"	1	385	1754	2139
"N28"	"L40"	"Oth disorders of kidney and ureter, not elsewhere classified"	"Psoriasis"	1	39	119	158
"K25"	"O99"	"Gastric ulcer"	"Oth maternal diseases classd elsw but compl preg/chldbrth"	1	114	244	358
"J80"	"M75"	"Acute respiratory distress syndrome"	"Shoulder lesions"	1	2	46	48
"J85"	"H91"	"Abscess of lung and mediastinum"	"Other and unspecified hearing loss"	1	51	176	227
"K56"	"I25"	"Paralytic ileus and intestinal obstruction without hernia"	"Chronic ischemic heart disease"	1	2137	3539	5676
"K08"	"K40"	"Other disorders of teeth and supporting structures"	"Inguinal hernia"	1	161	449	610
"J84"	"N83"	"Other interstitial pulmonary diseases"	"Noninflammatory disord of ovary, fallop and broad ligament"	1	18	97	115
"E66"	"H65"	"Overweight and obesity"	"Nonsuppurative otitis media"	1	0	1163	1163
"J22"	"K80"	"Unspecified acute lower respiratory infection"	"Cholelithiasis"	1	67	481	548
"E78"	"K51"	"Disorders of lipoprotein metabolism and other lipidemias"	"Ulcerative colitis"	1	423	894	1317
"L81"	"O68"	"Other disorders of pigmentation"	"Labor and delivery comp by abnlt of fetal acid-base balance"	1	38	123	161
"E46"	"M81"	"Unspecified protein-calorie malnutrition"	"Osteoporosis without current pathological fracture"	1	98	226	324
"K52"	"O00"	"Other and unsp noninfective gastroenteritis and colitis"	"Ectopic pregnancy"	1	25	130	155
"J84"	"K61"	"Other interstitial pulmonary diseases"	"Abscess of anal and rectal regions"	1	15	78	93
"M23"	"O26"	"Internal derangement of knee"	"Maternal care for oth conditions predom related to pregnancy"	1	730	995	1725
"K56"	"M47"	"Paralytic ileus and intestinal obstruction without hernia"	"Spondylosis"	1	283	813	1096
"D68"	"I83"	"Other coagulation defects"	"Varicose veins of lower extremities"	1	307	634	941
"N81"	"O47"	"Female genital prolapse"	"False labor"	1	6	931	937
"A49"	"H26"	"Bacterial infection of unspecified site"	"Other cataract"	1	234	1367	1601
"C15"	"C44"	"Malignant neoplasm of esophagus"	"Other and unspecified malignant neoplasm of skin"	1	35	193	228
"I34"	"D11"	"Nonrheumatic mitral valve disorders"	"Benign neoplasm of major salivary glands"	1	13	55	68
"F50"	"E10"	"Eating disorders"	"Type 1 diabetes mellitus"	1	27	86	113
"G31"	"H33"	"Oth degenerative diseases of nervous system, NEC"	"Retinal detachments and breaks"	1	0	54	54
"J81"	"M20"	"Pulmonary edema"	"Acquired deformities of fingers and toes"	1	2	174	176
"O86"	"O02"	"Other puerperal infections"	"Other abnormal products of conception"	1	581	1072	1653
"J69"	"G62"	"Pneumonitis due to solids and liquids"	"Other and unspecified polyneuropathies"	1	51	336	387
"D17"	"O02"	"Benign lipomatous neoplasm"	"Other abnormal products of conception"	1	10	439	449
"L60"	"L03"	"Nail disorders"	"Cellulitis and acute lymphangitis"	1	560	792	1352
"E03"	"O26"	"Other hypothyroidism"	"Maternal care for oth conditions predom related to pregnancy"	1	166	785	951
"M65"	"N80"	"Synovitis and tenosynovitis"	"Endometriosis"	1	186	371	557
"M70"	"Q53"	"Soft tissue disorders related to use, overuse and pressure"	"Undescended and ectopic testicle"	1	0	45	45
"M48"	"H20"	"Other spondylopathies"	"Iridocyclitis"	1	48	151	199
"M17"	"O12"	"Osteoarthritis of knee"	"Gestational edema and proteinuria without hypertension"	1	0	28	28
"C34"	"D47"	"Malignant neoplasm of bronchus and lung"	"Oth neoplm of uncrt behav of lymphoid, hematpoetc & rel tiss"	1	112	207	319
"O82"	"K35"	"Encounter for cesarean delivery without indication"	"Acute appendicitis"	1	624	1410	2034
"M32"	"O62"	"Systemic lupus erythematosus (SLE)"	"Abnormalities of forces of labor"	1	24	101	125
"K92"	"L72"	"Other diseases of digestive system"	"Follicular cysts of skin and subcutaneous tissue"	1	53	135	188
"M80"	"N87"	"Osteoporosis with current pathological fracture"	"Dysplasia of cervix uteri"	1	0	82	82
"I49"	"O04"	"Other cardiac arrhythmias"	"Complications following (induced) termination of pregnancy"	1	0	566	566
"A04"	"K40"	"Other bacterial intestinal infections"	"Inguinal hernia"	1	28	666	694
"J06"	"O68"	"Acute upper resp infections of multiple and unsp sites"	"Labor and delivery comp by abnlt of fetal acid-base balance"	1	10	554	564
"E23"	"G44"	"Hypofunction and other disorders of the pituitary gland"	"Other headache syndromes"	1	88	173	261
"E27"	"E11"	"Other disorders of adrenal gland"	"Type 2 diabetes mellitus"	1	273	546	819
"O92"	"E66"	"Oth disord of brst/lactatn assoc w pregnancy and the puerp"	"Overweight and obesity"	1	2358	3937	6295
"G47"	"G12"	"Sleep disorders"	"Spinal muscular atrophy and related syndromes"	1	71	235	306
"I21"	"H10"	"Acute myocardial infarction"	"Conjunctivitis"	1	201	1015	1216
"M21"	"J03"	"Other acquired deformities of limbs"	"Acute tonsillitis"	1	132	283	415
"M16"	"K35"	"Osteoarthritis of hip"	"Acute appendicitis"	1	249	690	939
"C15"	"M10"	"Malignant neoplasm of esophagus"	"Gout"	1	23	102	125
"I31"	"G56"	"Other diseases of pericardium"	"Mononeuropathies of upper limb"	1	31	100	131
"D63"	"E66"	"Anemia in chronic diseases classified elsewhere"	"Overweight and obesity"	1	91	925	1016
"N92"	"O01"	"Excessive, frequent and irregular menstruation"	"Hydatidiform mole"	1	0	96	96
"D50"	"O66"	"Iron deficiency anemia"	"Other obstructed labor"	1	0	74	74
"M07"	"J34"	"Enteropathic arthropathies"	"Other and unspecified disorders of nose and nasal sinuses"	1	22	89	111
"D63"	"C85"	"Anemia in chronic diseases classified elsewhere"	"Oth and unspecified types of non-Hodgkin lymphoma"	1	206	476	682
"G96"	"O99"	"Other disorders of central nervous system"	"Oth maternal diseases classd elsw but compl preg/chldbrth"	1	126	680	806
"I20"	"O36"	"Angina pectoris"	"Maternal care for other fetal problems"	1	0	134	134
"J32"	"H66"	"Chronic sinusitis"	"Suppurative and unspecified otitis media"	1	100	189	289
"J18"	"O99"	"Pneumonia, unspecified organism"	"Oth maternal diseases classd elsw but compl preg/chldbrth"	1	1025	2048	3073
"O26"	"A63"	"Maternal care for oth conditions predom related to pregnancy"	"Oth predominantly sexually transmitted diseases, NEC"	1	140	1051	1191
"C34"	"H57"	"Malignant neoplasm of bronchus and lung"	"Other disorders of eye and adnexa"	1	82	171	253
"H44"	"O62"	"Disorders of globe"	"Abnormalities of forces of labor"	1	0	278	278
"M45"	"M22"	"Ankylosing spondylitis"	"Disorder of patella"	1	3	78	81
"K56"	"E04"	"Paralytic ileus and intestinal obstruction without hernia"	"Other nontoxic goiter"	1	159	460	619
"C25"	"M47"	"Malignant neoplasm of pancreas"	"Spondylosis"	1	0	307	307
"I42"	"G71"	"Cardiomyopathy"	"Primary disorders of muscles"	1	16	113	129
"D22"	"H66"	"Melanocytic nevi"	"Suppurative and unspecified otitis media"	1	0	179	179
"C77"	"C64"	"Secondary and unspecified malignant neoplasm of lymph nodes"	"Malignant neoplasm of kidney, except renal pelvis"	1	285	763	1048
"J94"	"I47"	"Other pleural conditions"	"Paroxysmal tachycardia"	1	93	207	300
"C49"	"N40"	"Malignant neoplasm of other connective and soft tissue"	"Benign prostatic hyperplasia"	1	37	156	193
"G55"	"O62"	"Nerve root and plexus compressions in diseases classd elswhr"	"Abnormalities of forces of labor"	1	0	55	55
"J96"	"H11"	"Respiratory failure, not elsewhere classified"	"Other disorders of conjunctiva"	1	13	404	417
"J15"	"M70"	"Bacterial pneumonia, not elsewhere classified"	"Soft tissue disorders related to use, overuse and pressure"	1	228	1410	1638
"J95"	"K08"	"Intraop and postproc comp and disorders of resp sys, NEC"	"Other disorders of teeth and supporting structures"	1	43	166	209
"F03"	"K80"	"Unspecified dementia"	"Cholelithiasis"	1	480	2232	2712
"C79"	"M81"	"Secondary malignant neoplasm of other and unspecified sites"	"Osteoporosis without current pathological fracture"	1	354	1400	1754
"D75"	"N81"	"Other and unsp diseases of blood and blood-forming organs"	"Female genital prolapse"	1	32	98	130
"B34"	"O80"	"Viral infection of unspecified site"	"Encounter for full-term uncomplicated delivery"	1	418	2125	2543
"I24"	"D25"	"Other acute ischemic heart diseases"	"Leiomyoma of uterus"	1	4	60	64
"I49"	"I20"	"Other cardiac arrhythmias"	"Angina pectoris"	1	0	12463	12463
"C38"	"K40"	"Malignant neoplasm of heart, mediastinum and pleura"	"Inguinal hernia"	1	2	89	91
"I38"	"I15"	"Endocarditis, valve unspecified"	"Secondary hypertension"	1	17	69	86
"H93"	"H71"	"Other disorders of ear, not elsewhere classified"	"Cholesteatoma of middle ear"	1	113	225	338
"M21"	"Q90"	"Other acquired deformities of limbs"	"Down syndrome"	1	3	54	57
"C34"	"C06"	"Malignant neoplasm of bronchus and lung"	"Malignant neoplasm of other and unspecified parts of mouth"	1	71	260	331
"A46"	"M51"	"Erysipelas"	"Thoracic, thoracolum, and lumbosacral intvrt disc disorders"	1	373	1935	2308
"G96"	"J34"	"Other disorders of central nervous system"	"Other and unspecified disorders of nose and nasal sinuses"	1	17	332	349
"C15"	"M62"	"Malignant neoplasm of esophagus"	"Other disorders of muscle"	1	0	174	174
"J01"	"N60"	"Acute sinusitis"	"Benign mammary dysplasia"	1	36	98	134
"K22"	"E78"	"Other diseases of esophagus"	"Disorders of lipoprotein metabolism and other lipidemias"	1	938	1348	2286
"E11"	"O72"	"Type 2 diabetes mellitus"	"Postpartum hemorrhage"	1	217	361	578
"A49"	"D16"	"Bacterial infection of unspecified site"	"Benign neoplasm of bone and articular cartilage"	1	23	104	127
"C64"	"H66"	"Malignant neoplasm of kidney, except renal pelvis"	"Suppurative and unspecified otitis media"	1	1	37	38
"F03"	"I73"	"Unspecified dementia"	"Other peripheral vascular diseases"	1	183	1179	1362
"K64"	"M22"	"Hemorrhoids and perianal venous thrombosis"	"Disorder of patella"	1	0	328	328
"K56"	"M62"	"Paralytic ileus and intestinal obstruction without hernia"	"Other disorders of muscle"	1	178	1366	1544
"N39"	"N63"	"Other disorders of urinary system"	"Unspecified lump in breast"	1	324	1242	1566
"N94"	"N70"	"Pain and oth cond assoc w fem gntl org and menstrual cycle"	"Salpingitis and oophoritis"	1	389	954	1343
"I25"	"M75"	"Chronic ischemic heart disease"	"Shoulder lesions"	1	3567	4391	7958
"G96"	"O02"	"Other disorders of central nervous system"	"Other abnormal products of conception"	1	0	228	228
"C67"	"I83"	"Malignant neoplasm of bladder"	"Varicose veins of lower extremities"	1	59	267	326
"E20"	"I25"	"Hypoparathyroidism"	"Chronic ischemic heart disease"	1	308	517	825
"D86"	"I88"	"Sarcoidosis"	"Nonspecific lymphadenitis"	1	57	151	208
"K85"	"N97"	"Acute pancreatitis"	"Female infertility"	1	37	215	252
"M50"	"O30"	"Cervical disc disorders"	"Multiple gestation"	1	0	100	100
"I82"	"N87"	"Other venous embolism and thrombosis"	"Dysplasia of cervix uteri"	1	14	64	78
"C91"	"K40"	"Lymphoid leukemia"	"Inguinal hernia"	1	103	343	446
"N30"	"B34"	"Cystitis"	"Viral infection of unspecified site"	1	1893	2419	4312
"K72"	"K74"	"Hepatic failure, not elsewhere classified"	"Fibrosis and cirrhosis of liver"	1	1649	2078	3727
"L29"	"E10"	"Pruritus"	"Type 1 diabetes mellitus"	1	55	197	252
"J96"	"G95"	"Respiratory failure, not elsewhere classified"	"Other and unspecified diseases of spinal cord"	1	397	745	1142
"M85"	"K70"	"Other disorders of bone density and structure"	"Alcoholic liver disease"	1	93	222	315
"N28"	"M75"	"Oth disorders of kidney and ureter, not elsewhere classified"	"Shoulder lesions"	1	130	382	512
"M70"	"O63"	"Soft tissue disorders related to use, overuse and pressure"	"Long labor"	1	22	112	134
"D64"	"H81"	"Other anemias"	"Disorders of vestibular function"	1	616	2327	2943
"G44"	"K40"	"Other headache syndromes"	"Inguinal hernia"	1	260	569	829
"J15"	"N47"	"Bacterial pneumonia, not elsewhere classified"	"Disorders of prepuce"	1	257	682	939
"K85"	"N81"	"Acute pancreatitis"	"Female genital prolapse"	1	149	305	454
"K59"	"C15"	"Other functional intestinal disorders"	"Malignant neoplasm of esophagus"	1	503	1340	1843
"G30"	"H35"	"Alzheimer's disease"	"Other retinal disorders"	1	1	986	987
"E03"	"L20"	"Other hypothyroidism"	"Atopic dermatitis"	1	14	106	120
"K91"	"M62"	"Intraop and postproc comp and disorders of dgstv sys, NEC"	"Other disorders of muscle"	1	46	346	392
"O44"	"O08"	"Placenta previa"	"Complications following ectopic and molar pregnancy"	1	83	222	305
"K44"	"O04"	"Diaphragmatic hernia"	"Complications following (induced) termination of pregnancy"	1	0	772	772
"D09"	"J42"	"Carcinoma in situ of other and unspecified sites"	"Unspecified chronic bronchitis"	1	3	32	35
"I87"	"M35"	"Other disorders of veins"	"Other systemic involvement of connective tissue"	1	69	160	229
"J69"	"J38"	"Pneumonitis due to solids and liquids"	"Diseases of vocal cords and larynx, not elsewhere classified"	1	44	184	228
"K57"	"M19"	"Diverticular disease of intestine"	"Other and unspecified osteoarthritis"	1	2446	2975	5421
"H02"	"K35"	"Other disorders of eyelid"	"Acute appendicitis"	1	100	332	432
"K43"	"O70"	"Ventral hernia"	"Perineal laceration during delivery"	1	0	685	685
"I33"	"N03"	"Acute and subacute endocarditis"	"Chronic nephritic syndrome"	1	6	51	57
"I69"	"H52"	"Sequelae of cerebrovascular disease"	"Disorders of refraction and accommodation"	1	187	628	815
"M80"	"J35"	"Osteoporosis with current pathological fracture"	"Chronic diseases of tonsils and adenoids"	1	0	55	55
"C61"	"M24"	"Malignant neoplasm of prostate"	"Other specific joint derangements"	1	7	157	164
"E78"	"O30"	"Disorders of lipoprotein metabolism and other lipidemias"	"Multiple gestation"	1	0	54	54
"J09"	"C90"	"Influenza due to certain identified influenza viruses"	"Multiple myeloma and malignant plasma cell neoplasms"	1	8	109	117
"E86"	"K20"	"Volume depletion"	"Esophagitis"	1	977	2504	3481
"O80"	"O21"	"Encounter for full-term uncomplicated delivery"	"Excessive vomiting in pregnancy"	1	6002	7900	13902
"J96"	"E21"	"Respiratory failure, not elsewhere classified"	"Hyperparathyroidism and other disorders of parathyroid gland"	1	219	456	675
"I49"	"M17"	"Other cardiac arrhythmias"	"Osteoarthritis of knee"	1	1240	2663	3903
"D17"	"M51"	"Benign lipomatous neoplasm"	"Thoracic, thoracolum, and lumbosacral intvrt disc disorders"	1	953	1295	2248
"E55"	"N81"	"Vitamin D deficiency"	"Female genital prolapse"	1	20	355	375
"O62"	"N98"	"Abnormalities of forces of labor"	"Complications associated with artificial fertilization"	1	312	656	968
"M16"	"L05"	"Osteoarthritis of hip"	"Pilonidal cyst and sinus"	1	16	152	168
"J18"	"C10"	"Pneumonia, unspecified organism"	"Malignant neoplasm of oropharynx"	1	286	455	741
"L89"	"I47"	"Pressure ulcer"	"Paroxysmal tachycardia"	1	93	521	614
"C18"	"H60"	"Malignant neoplasm of colon"	"Otitis externa"	1	21	95	116
"I11"	"O99"	"Hypertensive heart disease"	"Oth maternal diseases classd elsw but compl preg/chldbrth"	1	0	43	43
"J44"	"H91"	"Other chronic obstructive pulmonary disease"	"Other and unspecified hearing loss"	1	0	19315	19315
"J90"	"N47"	"Pleural effusion, not elsewhere classified"	"Disorders of prepuce"	1	42	134	176
"D68"	"H83"	"Other coagulation defects"	"Other diseases of inner ear"	1	3	113	116
"M53"	"H10"	"Other and unspecified dorsopathies, not elsewhere classified"	"Conjunctivitis"	1	55	289	344
"G62"	"H80"	"Other and unspecified polyneuropathies"	"Otosclerosis"	1	0	60	60
"J13"	"J45"	"Pneumonia due to Streptococcus pneumoniae"	"Asthma"	1	702	993	1695
"I50"	"N76"	"Heart failure"	"Other inflammation of vagina and vulva"	1	93	276	369
"C16"	"N83"	"Malignant neoplasm of stomach"	"Noninflammatory disord of ovary, fallop and broad ligament"	1	9	55	64
"I82"	"G45"	"Other venous embolism and thrombosis"	"Transient cerebral ischemic attacks and related syndromes"	1	127	259	386
"D43"	"M77"	"Neoplasm of uncertain behavior of brain and cnsl"	"Other enthesopathies"	1	4	35	39
"I10"	"H74"	"Essential (primary) hypertension"	"Other disorders of middle ear mastoid"	1	5	212	217
"K02"	"N03"	"Dental caries"	"Chronic nephritic syndrome"	1	16	85	101
"K30"	"O64"	"Functional dyspepsia"	"Obstructed labor due to malposition and malpresent of fetus"	1	53	262	315
"M54"	"N40"	"Dorsalgia"	"Benign prostatic hyperplasia"	1	2439	2867	5306
"D62"	"N45"	"Acute posthemorrhagic anemia"	"Orchitis and epididymitis"	1	30	96	126
"C79"	"D14"	"Secondary malignant neoplasm of other and unspecified sites"	"Benign neoplasm of middle ear and respiratory system"	1	28	295	323
"N39"	"D25"	"Other disorders of urinary system"	"Leiomyoma of uterus"	1	931	3003	3934
"K29"	"H27"	"Gastritis and duodenitis"	"Other disorders of lens"	1	53	151	204
"I49"	"H10"	"Other cardiac arrhythmias"	"Conjunctivitis"	1	101	555	656
"M81"	"K25"	"Osteoporosis without current pathological fracture"	"Gastric ulcer"	1	1605	2663	4268
"O90"	"O20"	"Complications of the puerperium, not elsewhere classified"	"Hemorrhage in early pregnancy"	1	659	2423	3082
"I48"	"O32"	"Atrial fibrillation and flutter"	"Maternal care for malpresentation of fetus"	1	0	53	53
"I99"	"F99"	"Other and unspecified disorders of circulatory system"	"Mental disorder, not otherwise specified"	1	15	74	89
"I15"	"H91"	"Secondary hypertension"	"Other and unspecified hearing loss"	1	343	954	1297
"K30"	"N87"	"Functional dyspepsia"	"Dysplasia of cervix uteri"	1	279	503	782
"B34"	"E10"	"Viral infection of unspecified site"	"Type 1 diabetes mellitus"	1	356	521	877
"M85"	"N97"	"Other disorders of bone density and structure"	"Female infertility"	1	0	203	203
"M41"	"Q25"	"Scoliosis"	"Congenital malformations of great arteries"	1	0	63	63
"H34"	"K40"	"Retinal vascular occlusions"	"Inguinal hernia"	1	144	487	631
"D63"	"K56"	"Anemia in chronic diseases classified elsewhere"	"Paralytic ileus and intestinal obstruction without hernia"	1	695	900	1595
"D84"	"M75"	"Other immunodeficiencies"	"Shoulder lesions"	1	27	85	112
"M79"	"O36"	"Oth and unsp soft tissue disorders, not elsewhere classified"	"Maternal care for other fetal problems"	1	639	922	1561
"O34"	"O99"	"Maternal care for abnormality of pelvic organs"	"Oth maternal diseases classd elsw but compl preg/chldbrth"	1	9627	10491	20118
"J96"	"C84"	"Respiratory failure, not elsewhere classified"	"Mature T/NK-cell lymphomas"	1	63	136	199
"M05"	"D27"	"Rheumatoid arthritis with rheumatoid factor"	"Benign neoplasm of ovary"	1	54	153	207
"I42"	"I20"	"Cardiomyopathy"	"Angina pectoris"	1	1536	3840	5376
"E55"	"M13"	"Vitamin D deficiency"	"Other arthritis"	1	140	266	406
"H35"	"G56"	"Other retinal disorders"	"Mononeuropathies of upper limb"	1	806	1767	2573
"F41"	"L05"	"Other anxiety disorders"	"Pilonidal cyst and sinus"	1	38	148	186
"I87"	"K80"	"Other disorders of veins"	"Cholelithiasis"	1	131	301	432
"H01"	"M05"	"Other inflammation of eyelid"	"Rheumatoid arthritis with rheumatoid factor"	1	15	66	81
"J96"	"N99"	"Respiratory failure, not elsewhere classified"	"Intraop and postproc comp and disorders of GU sys, NEC"	1	228	478	706
"C18"	"K08"	"Malignant neoplasm of colon"	"Other disorders of teeth and supporting structures"	1	49	146	195
"I25"	"M50"	"Chronic ischemic heart disease"	"Cervical disc disorders"	1	623	1804	2427
"H57"	"O82"	"Other disorders of eye and adnexa"	"Encounter for cesarean delivery without indication"	1	20	397	417
"E23"	"D35"	"Hypofunction and other disorders of the pituitary gland"	"Benign neoplasm of other and unspecified endocrine glands"	1	959	1548	2507
"N81"	"K35"	"Female genital prolapse"	"Acute appendicitis"	1	175	456	631
"C02"	"M62"	"Malignant neoplasm of other and unspecified parts of tongue"	"Other disorders of muscle"	1	2	37	39
"O13"	"F10"	"Gestational hypertension without significant proteinuria"	"Alcohol related disorders"	1	0	129	129
"N30"	"C67"	"Cystitis"	"Malignant neoplasm of bladder"	1	1820	2868	4688
"M72"	"M54"	"Fibroblastic disorders"	"Dorsalgia"	1	1087	1609	2696
"M79"	"H93"	"Oth and unsp soft tissue disorders, not elsewhere classified"	"Other disorders of ear, not elsewhere classified"	1	1557	2024	3581
"J03"	"O65"	"Acute tonsillitis"	"Obstructed labor due to maternal pelvic abnormality"	1	64	334	398
"M81"	"M23"	"Osteoporosis without current pathological fracture"	"Internal derangement of knee"	1	0	3486	3486
"I10"	"N40"	"Essential (primary) hypertension"	"Benign prostatic hyperplasia"	1	9342	12845	22187
"O75"	"O14"	"Oth complications of labor and delivery, NEC"	"Pre-eclampsia"	1	1208	2326	3534
"I48"	"C32"	"Atrial fibrillation and flutter"	"Malignant neoplasm of larynx"	1	148	298	446
"N20"	"H66"	"Calculus of kidney and ureter"	"Suppurative and unspecified otitis media"	1	74	237	311
"K22"	"H80"	"Other diseases of esophagus"	"Otosclerosis"	1	6	83	89
"J86"	"H90"	"Pyothorax"	"Conductive and sensorineural hearing loss"	1	28	90	118
"H18"	"J34"	"Other disorders of cornea"	"Other and unspecified disorders of nose and nasal sinuses"	1	20	96	116
"I26"	"K58"	"Pulmonary embolism"	"Irritable bowel syndrome"	1	61	394	455
"M81"	"Q18"	"Osteoporosis without current pathological fracture"	"Other congenital malformations of face and neck"	1	8	89	97
"F03"	"G20"	"Unspecified dementia"	"Parkinson's disease"	1	1181	1638	2819
"A26"	"I73"	"Erysipeloid"	"Other peripheral vascular diseases"	1	21	111	132
"M35"	"N60"	"Other systemic involvement of connective tissue"	"Benign mammary dysplasia"	1	125	256	381
"I83"	"O04"	"Varicose veins of lower extremities"	"Complications following (induced) termination of pregnancy"	1	0	2344	2344
"K22"	"H40"	"Other diseases of esophagus"	"Glaucoma"	1	141	246	387
"G44"	"O86"	"Other headache syndromes"	"Other puerperal infections"	1	29	115	144
"K56"	"G40"	"Paralytic ileus and intestinal obstruction without hernia"	"Epilepsy and recurrent seizures"	1	339	791	1130
"I48"	"H91"	"Atrial fibrillation and flutter"	"Other and unspecified hearing loss"	1	0	29396	29396
"H91"	"Q30"	"Other and unspecified hearing loss"	"Congenital malformations of nose"	1	8	42	50
"E46"	"K40"	"Unspecified protein-calorie malnutrition"	"Inguinal hernia"	1	3	60	63
"F17"	"K58"	"Nicotine dependence"	"Irritable bowel syndrome"	1	326	799	1125
"J44"	"H72"	"Other chronic obstructive pulmonary disease"	"Perforation of tympanic membrane"	1	129	307	436
"N13"	"J42"	"Obstructive and reflux uropathy"	"Unspecified chronic bronchitis"	1	152	260	412
"I50"	"G44"	"Heart failure"	"Other headache syndromes"	1	160	522	682
"N19"	"L05"	"Unspecified kidney failure"	"Pilonidal cyst and sinus"	1	6	38	44
"O92"	"O04"	"Oth disord of brst/lactatn assoc w pregnancy and the puerp"	"Complications following (induced) termination of pregnancy"	1	308	1637	1945
"I61"	"G57"	"Nontraumatic intracerebral hemorrhage"	"Mononeuropathies of lower limb"	1	14	65	79
"J84"	"I80"	"Other interstitial pulmonary diseases"	"Phlebitis and thrombophlebitis"	1	177	405	582
"K91"	"N94"	"Intraop and postproc comp and disorders of dgstv sys, NEC"	"Pain and oth cond assoc w fem gntl org and menstrual cycle"	1	27	81	108
"J01"	"O71"	"Acute sinusitis"	"Other obstetric trauma"	1	9	166	175
"A08"	"Q25"	"Viral and other specified intestinal infections"	"Congenital malformations of great arteries"	1	78	262	340
"N30"	"J41"	"Cystitis"	"Simple and mucopurulent chronic bronchitis"	1	440	865	1305
"H72"	"A09"	"Perforation of tympanic membrane"	"Infectious gastroenteritis and colitis, unspecified"	1	130	300	430
"E87"	"J43"	"Other disorders of fluid, electrolyte and acid-base balance"	"Emphysema"	1	321	634	955
"M16"	"N60"	"Osteoarthritis of hip"	"Benign mammary dysplasia"	1	38	732	770
"K62"	"C62"	"Other diseases of anus and rectum"	"Malignant neoplasm of testis"	1	9	78	87
"D11"	"O70"	"Benign neoplasm of major salivary glands"	"Perineal laceration during delivery"	1	33	165	198
"J18"	"K61"	"Pneumonia, unspecified organism"	"Abscess of anal and rectal regions"	1	444	1554	1998
"H52"	"Q42"	"Disorders of refraction and accommodation"	"Congenital absence, atresia and stenosis of large intestine"	1	0	29	29
"M79"	"O41"	"Oth and unsp soft tissue disorders, not elsewhere classified"	"Other disorders of amniotic fluid and membranes"	1	92	217	309
"J93"	"I25"	"Pneumothorax and air leak"	"Chronic ischemic heart disease"	1	718	1086	1804
"C65"	"N20"	"Malignant neoplasm of renal pelvis"	"Calculus of kidney and ureter"	1	35	189	224
"D63"	"H04"	"Anemia in chronic diseases classified elsewhere"	"Disorders of lacrimal system"	1	12	82	94
"N32"	"M32"	"Other disorders of bladder"	"Systemic lupus erythematosus (SLE)"	1	9	89	98
"D30"	"I83"	"Benign neoplasm of urinary organs"	"Varicose veins of lower extremities"	1	149	257	406
"N39"	"O60"	"Other disorders of urinary system"	"Preterm labor"	1	0	161	161
"O62"	"L20"	"Abnormalities of forces of labor"	"Atopic dermatitis"	1	175	615	790
"C22"	"H40"	"Malignant neoplasm of liver and intrahepatic bile ducts"	"Glaucoma"	1	0	79	79
"C34"	"M23"	"Malignant neoplasm of bronchus and lung"	"Internal derangement of knee"	1	0	1259	1259
"I83"	"O65"	"Varicose veins of lower extremities"	"Obstructed labor due to maternal pelvic abnormality"	1	0	600	600
"J43"	"M22"	"Emphysema"	"Disorder of patella"	1	0	39	39
"M85"	"M23"	"Other disorders of bone density and structure"	"Internal derangement of knee"	1	0	2747	2747
"F17"	"N71"	"Nicotine dependence"	"Inflammatory disease of uterus, except cervix"	1	33	296	329
"H05"	"N92"	"Disorders of orbit"	"Excessive, frequent and irregular menstruation"	1	31	99	130
"K46"	"O68"	"Unspecified abdominal hernia"	"Labor and delivery comp by abnlt of fetal acid-base balance"	1	0	60	60
"F41"	"O71"	"Other anxiety disorders"	"Other obstetric trauma"	1	5	188	193
"D68"	"O80"	"Other coagulation defects"	"Encounter for full-term uncomplicated delivery"	1	331	1412	1743
"O99"	"M93"	"Oth maternal diseases classd elsw but compl preg/chldbrth"	"Other osteochondropathies"	1	3	143	146
"C18"	"D16"	"Malignant neoplasm of colon"	"Benign neoplasm of bone and articular cartilage"	1	5	39	44
"E83"	"C56"	"Disorders of mineral metabolism"	"Malignant neoplasm of ovary"	1	65	488	553
"I35"	"F10"	"Nonrheumatic aortic valve disorders"	"Alcohol related disorders"	1	375	1282	1657
"Q51"	"O02"	"Congenital malformations of uterus and cervix"	"Other abnormal products of conception"	1	230	472	702
"J98"	"N63"	"Other respiratory disorders"	"Unspecified lump in breast"	1	32	117	149
"M48"	"O63"	"Other spondylopathies"	"Long labor"	1	0	25	25
"N39"	"N83"	"Other disorders of urinary system"	"Noninflammatory disord of ovary, fallop and broad ligament"	1	1346	2244	3590
"F03"	"D23"	"Unspecified dementia"	"Other benign neoplasms of skin"	1	41	411	452
"E66"	"J32"	"Overweight and obesity"	"Chronic sinusitis"	1	334	535	869
"N17"	"K05"	"Acute kidney failure"	"Gingivitis and periodontal diseases"	1	153	482	635
"L40"	"O20"	"Psoriasis"	"Hemorrhage in early pregnancy"	1	35	173	208
"I73"	"H83"	"Other peripheral vascular diseases"	"Other diseases of inner ear"	1	47	982	1029
"D63"	"H50"	"Anemia in chronic diseases classified elsewhere"	"Other strabismus"	1	7	75	82
"H40"	"M23"	"Glaucoma"	"Internal derangement of knee"	1	273	714	987
"J44"	"D17"	"Other chronic obstructive pulmonary disease"	"Benign lipomatous neoplasm"	1	464	1221	1685
"N18"	"K09"	"Chronic kidney disease (CKD)"	"Cysts of oral region, not elsewhere classified"	1	11	53	64
"J96"	"L98"	"Respiratory failure, not elsewhere classified"	"Oth disorders of skin, subcu, not elsewhere classified"	1	541	1280	1821
"F31"	"O62"	"Bipolar disorder"	"Abnormalities of forces of labor"	1	3	71	74
"N88"	"O80"	"Other noninflammatory disorders of cervix uteri"	"Encounter for full-term uncomplicated delivery"	1	28	471	499
"M46"	"M02"	"Other inflammatory spondylopathies"	"Postinfective and reactive arthropathies"	1	97	278	375
"A40"	"G56"	"Streptococcal sepsis"	"Mononeuropathies of upper limb"	1	48	150	198
"K04"	"N03"	"Diseases of pulp and periapical tissues"	"Chronic nephritic syndrome"	1	23	135	158
"L90"	"K30"	"Atrophic disorders of skin"	"Functional dyspepsia"	1	232	525	757
"D14"	"M54"	"Benign neoplasm of middle ear and respiratory system"	"Dorsalgia"	1	322	546	868
"I50"	"M65"	"Heart failure"	"Synovitis and tenosynovitis"	1	260	1694	1954
"N95"	"O82"	"Menopausal and other perimenopausal disorders"	"Encounter for cesarean delivery without indication"	1	0	72	72
"M75"	"Q66"	"Shoulder lesions"	"Congenital deformities of feet"	1	116	326	442
"I69"	"N80"	"Sequelae of cerebrovascular disease"	"Endometriosis"	1	8	110	118
"I48"	"H04"	"Atrial fibrillation and flutter"	"Disorders of lacrimal system"	1	271	438	709
"D09"	"D41"	"Carcinoma in situ of other and unspecified sites"	"Neoplasm of uncertain behavior of urinary organs"	1	28	113	141
"M79"	"F98"	"Oth and unsp soft tissue disorders, not elsewhere classified"	"Oth behav/emotn disord w onset usly occur in chldhd and adol"	1	54	190	244
"O62"	"O00"	"Abnormalities of forces of labor"	"Ectopic pregnancy"	1	2141	2569	4710
"L89"	"J38"	"Pressure ulcer"	"Diseases of vocal cords and larynx, not elsewhere classified"	1	12	96	108
"N13"	"J38"	"Obstructive and reflux uropathy"	"Diseases of vocal cords and larynx, not elsewhere classified"	1	44	149	193
"E05"	"O00"	"Thyrotoxicosis [hyperthyroidism]"	"Ectopic pregnancy"	1	19	157	176
"J90"	"O99"	"Pleural effusion, not elsewhere classified"	"Oth maternal diseases classd elsw but compl preg/chldbrth"	1	15	62	77
"K60"	"B27"	"Fissure and fistula of anal and rectal regions"	"Infectious mononucleosis"	1	8	58	66
"I33"	"I12"	"Acute and subacute endocarditis"	"Hypertensive chronic kidney disease"	1	22	70	92
"K05"	"I83"	"Gingivitis and periodontal diseases"	"Varicose veins of lower extremities"	1	126	328	454
"C78"	"J47"	"Secondary malignant neoplasm of resp and digestive organs"	"Bronchiectasis"	1	10	84	94
"G47"	"L72"	"Sleep disorders"	"Follicular cysts of skin and subcutaneous tissue"	1	68	258	326
"J18"	"M47"	"Pneumonia, unspecified organism"	"Spondylosis"	1	0	7375	7375
"G30"	"N13"	"Alzheimer's disease"	"Obstructive and reflux uropathy"	1	24	123	147
"B34"	"Q31"	"Viral infection of unspecified site"	"Congenital malformations of larynx"	1	94	224	318
"K59"	"H52"	"Other functional intestinal disorders"	"Disorders of refraction and accommodation"	1	839	1163	2002
"D64"	"H33"	"Other anemias"	"Retinal detachments and breaks"	1	84	850	934
"E13"	"L02"	"Other specified diabetes mellitus"	"Cutaneous abscess, furuncle and carbuncle"	1	125	347	472
"I10"	"J36"	"Essential (primary) hypertension"	"Peritonsillar abscess"	1	69	673	742
"A46"	"K61"	"Erysipelas"	"Abscess of anal and rectal regions"	1	123	376	499
"I97"	"O68"	"Intraop and postproc comp and disorders of circ sys, NEC"	"Labor and delivery comp by abnlt of fetal acid-base balance"	1	0	28	28
"O82"	"O44"	"Encounter for cesarean delivery without indication"	"Placenta previa"	1	2666	3184	5850
"E05"	"K61"	"Thyrotoxicosis [hyperthyroidism]"	"Abscess of anal and rectal regions"	1	79	176	255
"C78"	"H34"	"Secondary malignant neoplasm of resp and digestive organs"	"Retinal vascular occlusions"	1	35	295	330
"F41"	"I70"	"Other anxiety disorders"	"Atherosclerosis"	1	187	695	882
"M65"	"O26"	"Synovitis and tenosynovitis"	"Maternal care for oth conditions predom related to pregnancy"	1	428	656	1084
"N13"	"D30"	"Obstructive and reflux uropathy"	"Benign neoplasm of urinary organs"	1	480	1118	1598
"O32"	"K35"	"Maternal care for malpresentation of fetus"	"Acute appendicitis"	1	133	317	450
"J84"	"O62"	"Other interstitial pulmonary diseases"	"Abnormalities of forces of labor"	1	0	58	58
"I48"	"N40"	"Atrial fibrillation and flutter"	"Benign prostatic hyperplasia"	1	0	15231	15231
"I80"	"O14"	"Phlebitis and thrombophlebitis"	"Pre-eclampsia"	1	31	202	233
"C78"	"C20"	"Secondary malignant neoplasm of resp and digestive organs"	"Malignant neoplasm of rectum"	1	0	10627	10627
"K21"	"N20"	"Gastro-esophageal reflux disease"	"Calculus of kidney and ureter"	1	836	1137	1973
"G98"	"D23"	"Other disorders of nervous system not elsewhere classified"	"Other benign neoplasms of skin"	1	9	103	112
"C34"	"F10"	"Malignant neoplasm of bronchus and lung"	"Alcohol related disorders"	1	0	2819	2819
"C34"	"K74"	"Malignant neoplasm of bronchus and lung"	"Fibrosis and cirrhosis of liver"	1	81	196	277
"C17"	"M20"	"Malignant neoplasm of small intestine"	"Acquired deformities of fingers and toes"	1	0	28	28
"C18"	"L50"	"Malignant neoplasm of colon"	"Urticaria"	1	40	121	161
"I48"	"K21"	"Atrial fibrillation and flutter"	"Gastro-esophageal reflux disease"	1	1552	3887	5439
"I70"	"M02"	"Atherosclerosis"	"Postinfective and reactive arthropathies"	1	88	197	285
"O92"	"F10"	"Oth disord of brst/lactatn assoc w pregnancy and the puerp"	"Alcohol related disorders"	1	2	353	355
"J96"	"I48"	"Respiratory failure, not elsewhere classified"	"Atrial fibrillation and flutter"	1	9693	15295	24988
"E50"	"I35"	"Vitamin A deficiency"	"Nonrheumatic aortic valve disorders"	1	69	144	213
"O72"	"K08"	"Postpartum hemorrhage"	"Other disorders of teeth and supporting structures"	1	93	291	384
"M48"	"M18"	"Other spondylopathies"	"Osteoarthritis of first carpometacarpal joint"	1	336	594	930
"C25"	"I67"	"Malignant neoplasm of pancreas"	"Other cerebrovascular diseases"	1	5	44	49
"C18"	"M76"	"Malignant neoplasm of colon"	"Enthesopathies, lower limb, excluding foot"	1	31	171	202
"L57"	"F10"	"Skin changes due to chronic expsr to nonionizing radiation"	"Alcohol related disorders"	1	55	149	204
"M85"	"M62"	"Other disorders of bone density and structure"	"Other disorders of muscle"	1	0	1305	1305
"J18"	"N40"	"Pneumonia, unspecified organism"	"Benign prostatic hyperplasia"	1	0	19665	19665
"A08"	"I20"	"Viral and other specified intestinal infections"	"Angina pectoris"	1	448	987	1435
"E21"	"K35"	"Hyperparathyroidism and other disorders of parathyroid gland"	"Acute appendicitis"	1	17	117	134
"D09"	"M06"	"Carcinoma in situ of other and unspecified sites"	"Other rheumatoid arthritis"	1	6	41	47
"N63"	"O26"	"Unspecified lump in breast"	"Maternal care for oth conditions predom related to pregnancy"	1	153	633	786
"I48"	"C00"	"Atrial fibrillation and flutter"	"Malignant neoplasm of lip"	1	17	112	129
"F32"	"O71"	"Depressive episode"	"Other obstetric trauma"	1	17	182	199
"O99"	"K00"	"Oth maternal diseases classd elsw but compl preg/chldbrth"	"Disorders of tooth development and eruption"	1	0	418	418
"O70"	"Q82"	"Perineal laceration during delivery"	"Other congenital malformations of skin"	1	148	278	426
"C85"	"D48"	"Oth and unspecified types of non-Hodgkin lymphoma"	"Neoplasm of uncertain behavior of other and unsp sites"	1	54	136	190
"L98"	"K21"	"Oth disorders of skin, subcu, not elsewhere classified"	"Gastro-esophageal reflux disease"	1	247	576	823
"A41"	"G61"	"Other sepsis"	"Inflammatory polyneuropathy"	1	104	225	329
"L89"	"H91"	"Pressure ulcer"	"Other and unspecified hearing loss"	1	0	2199	2199
"K64"	"M75"	"Hemorrhoids and perianal venous thrombosis"	"Shoulder lesions"	1	0	3513	3513
"C91"	"M47"	"Lymphoid leukemia"	"Spondylosis"	1	48	121	169
"E86"	"C10"	"Volume depletion"	"Malignant neoplasm of oropharynx"	1	197	362	559
"D25"	"O65"	"Leiomyoma of uterus"	"Obstructed labor due to maternal pelvic abnormality"	1	0	228	228
"F32"	"E11"	"Depressive episode"	"Type 2 diabetes mellitus"	1	2946	4270	7216
"O71"	"O47"	"Other obstetric trauma"	"False labor"	1	1644	2258	3902
"J96"	"C49"	"Respiratory failure, not elsewhere classified"	"Malignant neoplasm of other connective and soft tissue"	1	69	217	286
"I65"	"I20"	"Occls and stenosis of precerb art, not rslt in cereb infrc"	"Angina pectoris"	1	851	1677	2528
"N10"	"C61"	"Acute pyelonephritis"	"Malignant neoplasm of prostate"	1	294	465	759
"J90"	"C64"	"Pleural effusion, not elsewhere classified"	"Malignant neoplasm of kidney, except renal pelvis"	1	125	248	373
"J18"	"O04"	"Pneumonia, unspecified organism"	"Complications following (induced) termination of pregnancy"	1	0	2068	2068
"K55"	"N30"	"Vascular disorders of intestine"	"Cystitis"	1	467	707	1174
"A41"	"M96"	"Other sepsis"	"Intraop and postproc comp and disorders of ms sys, NEC"	1	42	192	234
"I70"	"M05"	"Atherosclerosis"	"Rheumatoid arthritis with rheumatoid factor"	1	400	760	1160
"A46"	"N84"	"Erysipelas"	"Polyp of female genital tract"	1	110	245	355
"F41"	"Q18"	"Other anxiety disorders"	"Other congenital malformations of face and neck"	1	4	44	48
"I70"	"M16"	"Atherosclerosis"	"Osteoarthritis of hip"	1	1657	3294	4951
"M48"	"G40"	"Other spondylopathies"	"Epilepsy and recurrent seizures"	1	342	497	839
"C53"	"D25"	"Malignant neoplasm of cervix uteri"	"Leiomyoma of uterus"	1	69	159	228
"M47"	"J34"	"Spondylosis"	"Other and unspecified disorders of nose and nasal sinuses"	1	116	627	743
"N17"	"K11"	"Acute kidney failure"	"Diseases of salivary glands"	1	34	92	126
"J22"	"L01"	"Unspecified acute lower respiratory infection"	"Impetigo"	1	7	57	64
"C44"	"M07"	"Other and unspecified malignant neoplasm of skin"	"Enteropathic arthropathies"	1	57	158	215
"O68"	"M22"	"Labor and delivery comp by abnlt of fetal acid-base balance"	"Disorder of patella"	1	0	2024	2024
"C34"	"M51"	"Malignant neoplasm of bronchus and lung"	"Thoracic, thoracolum, and lumbosacral intvrt disc disorders"	1	0	2254	2254
"K57"	"M62"	"Diverticular disease of intestine"	"Other disorders of muscle"	1	0	3720	3720
"F17"	"M75"	"Nicotine dependence"	"Shoulder lesions"	1	817	1543	2360
"N18"	"N50"	"Chronic kidney disease (CKD)"	"Other and unspecified disorders of male genital organs"	1	62	235	297
"M51"	"O02"	"Thoracic, thoracolum, and lumbosacral intvrt disc disorders"	"Other abnormal products of conception"	1	33	1213	1246
"D33"	"O26"	"Benign neoplasm of brain and oth prt central nervous system"	"Maternal care for oth conditions predom related to pregnancy"	1	1	41	42
"I10"	"O26"	"Essential (primary) hypertension"	"Maternal care for oth conditions predom related to pregnancy"	1	0	746	746
"A46"	"H36"	"Erysipelas"	"Retinal disorders in diseases classified elsewhere"	1	474	678	1152
"D04"	"M75"	"Carcinoma in situ of skin"	"Shoulder lesions"	1	48	117	165
"C78"	"G25"	"Secondary malignant neoplasm of resp and digestive organs"	"Other extrapyramidal and movement disorders"	1	25	122	147
"O61"	"O47"	"Failed induction of labor"	"False labor"	1	91	228	319
"D17"	"O32"	"Benign lipomatous neoplasm"	"Maternal care for malpresentation of fetus"	1	2	202	204
"G96"	"F32"	"Other disorders of central nervous system"	"Depressive episode"	1	637	1142	1779
"I69"	"K86"	"Sequelae of cerebrovascular disease"	"Other diseases of pancreas"	1	281	523	804
"J96"	"M53"	"Respiratory failure, not elsewhere classified"	"Other and unspecified dorsopathies, not elsewhere classified"	1	92	549	641
"O99"	"L20"	"Oth maternal diseases classd elsw but compl preg/chldbrth"	"Atopic dermatitis"	1	24	680	704
"K92"	"O03"	"Other diseases of digestive system"	"Spontaneous abortion"	1	41	190	231
"J96"	"O42"	"Respiratory failure, not elsewhere classified"	"Premature rupture of membranes"	1	0	77	77
"K12"	"C10"	"Stomatitis and related lesions"	"Malignant neoplasm of oropharynx"	1	181	515	696
"I34"	"M48"	"Nonrheumatic mitral valve disorders"	"Other spondylopathies"	1	292	479	771
"I51"	"K80"	"Complications and ill-defined descriptions of heart disease"	"Cholelithiasis"	1	252	707	959
"K65"	"C54"	"Peritonitis"	"Malignant neoplasm of corpus uteri"	1	50	155	205
"C20"	"M16"	"Malignant neoplasm of rectum"	"Osteoarthritis of hip"	1	268	634	902
"C78"	"N85"	"Secondary malignant neoplasm of resp and digestive organs"	"Other noninflammatory disorders of uterus, except cervix"	1	0	110	110
"H91"	"K61"	"Other and unspecified hearing loss"	"Abscess of anal and rectal regions"	1	289	502	791
"K59"	"K66"	"Other functional intestinal disorders"	"Other disorders of peritoneum"	1	277	508	785
"C77"	"H81"	"Secondary and unspecified malignant neoplasm of lymph nodes"	"Disorders of vestibular function"	1	71	228	299
"M81"	"H36"	"Osteoporosis without current pathological fracture"	"Retinal disorders in diseases classified elsewhere"	1	188	616	804
"C54"	"D07"	"Malignant neoplasm of corpus uteri"	"Carcinoma in situ of other and unspecified genital organs"	1	186	666	852
"N11"	"F10"	"Chronic tubulo-interstitial nephritis"	"Alcohol related disorders"	1	24	74	98
"C78"	"H05"	"Secondary malignant neoplasm of resp and digestive organs"	"Disorders of orbit"	1	14	64	78
"N73"	"J35"	"Other female pelvic inflammatory diseases"	"Chronic diseases of tonsils and adenoids"	1	23	99	122
"F72"	"J35"	"Severe intellectual disabilities"	"Chronic diseases of tonsils and adenoids"	1	6	42	48
"G47"	"C15"	"Sleep disorders"	"Malignant neoplasm of esophagus"	1	215	552	767
"N13"	"C20"	"Obstructive and reflux uropathy"	"Malignant neoplasm of rectum"	1	318	1365	1683
"K59"	"E11"	"Other functional intestinal disorders"	"Type 2 diabetes mellitus"	1	0	14670	14670
"M16"	"G35"	"Osteoarthritis of hip"	"Multiple sclerosis"	1	31	123	154
"M18"	"N92"	"Osteoarthritis of first carpometacarpal joint"	"Excessive, frequent and irregular menstruation"	1	0	790	790
"G95"	"M65"	"Other and unspecified diseases of spinal cord"	"Synovitis and tenosynovitis"	1	9	189	198
"C78"	"I51"	"Secondary malignant neoplasm of resp and digestive organs"	"Complications and ill-defined descriptions of heart disease"	1	171	286	457
"D64"	"O46"	"Other anemias"	"Antepartum hemorrhage, not elsewhere classified"	1	6	112	118
"B35"	"F10"	"Dermatophytosis"	"Alcohol related disorders"	1	80	169	249
"D86"	"O71"	"Sarcoidosis"	"Other obstetric trauma"	1	9	67	76
"K59"	"D16"	"Other functional intestinal disorders"	"Benign neoplasm of bone and articular cartilage"	1	90	352	442
"D63"	"G20"	"Anemia in chronic diseases classified elsewhere"	"Parkinson's disease"	1	82	219	301
"J43"	"N48"	"Emphysema"	"Other disorders of penis"	1	20	69	89
"D29"	"N40"	"Benign neoplasm of male genital organs"	"Benign prostatic hyperplasia"	1	202	334	536
"J69"	"K70"	"Pneumonitis due to solids and liquids"	"Alcoholic liver disease"	1	220	433	653
"E64"	"C11"	"Sequelae of malnutrition and other nutritional deficiencies"	"Malignant neoplasm of nasopharynx"	1	10	56	66
"I69"	"M17"	"Sequelae of cerebrovascular disease"	"Osteoarthritis of knee"	1	0	6646	6646
"I46"	"D12"	"Cardiac arrest"	"Benign neoplasm of colon, rectum, anus and anal canal"	1	146	1176	1322
"I48"	"L05"	"Atrial fibrillation and flutter"	"Pilonidal cyst and sinus"	1	10	195	205
"O14"	"O21"	"Pre-eclampsia"	"Excessive vomiting in pregnancy"	1	546	729	1275
"C41"	"M23"	"Malignant neoplasm of bone/artic cartl of and unsp sites"	"Internal derangement of knee"	1	7	43	50
"C25"	"L30"	"Malignant neoplasm of pancreas"	"Other and unspecified dermatitis"	1	5	92	97
"C76"	"C20"	"Malignant neoplasm of other and ill-defined sites"	"Malignant neoplasm of rectum"	1	63	139	202
"I48"	"D14"	"Atrial fibrillation and flutter"	"Benign neoplasm of middle ear and respiratory system"	1	287	708	995
"L40"	"D25"	"Psoriasis"	"Leiomyoma of uterus"	1	80	243	323
"O72"	"M62"	"Postpartum hemorrhage"	"Other disorders of muscle"	1	0	6111	6111
"H57"	"O47"	"Other disorders of eye and adnexa"	"False labor"	1	7	137	144
"C25"	"I48"	"Malignant neoplasm of pancreas"	"Atrial fibrillation and flutter"	1	327	1271	1598
"K04"	"C09"	"Diseases of pulp and periapical tissues"	"Malignant neoplasm of tonsil"	1	271	601	872
"H50"	"J20"	"Other strabismus"	"Acute bronchitis"	1	95	941	1036
"J01"	"M23"	"Acute sinusitis"	"Internal derangement of knee"	1	350	623	973
"K42"	"N92"	"Umbilical hernia"	"Excessive, frequent and irregular menstruation"	1	297	586	883
"J11"	"O65"	"Influenza due to unidentified influenza virus"	"Obstructed labor due to maternal pelvic abnormality"	1	18	88	106
"D27"	"N83"	"Benign neoplasm of ovary"	"Noninflammatory disord of ovary, fallop and broad ligament"	1	6306	7410	13716
"L05"	"Q17"	"Pilonidal cyst and sinus"	"Other congenital malformations of ear"	1	0	52	52
"J06"	"E11"	"Acute upper resp infections of multiple and unsp sites"	"Type 2 diabetes mellitus"	1	161	586	747
"H40"	"E04"	"Glaucoma"	"Other nontoxic goiter"	1	170	292	462
"K66"	"O04"	"Other disorders of peritoneum"	"Complications following (induced) termination of pregnancy"	1	13	143	156
"L23"	"O20"	"Allergic contact dermatitis"	"Hemorrhage in early pregnancy"	1	48	141	189
"H43"	"O36"	"Disorders of vitreous body"	"Maternal care for other fetal problems"	1	0	43	43
"H49"	"D33"	"Paralytic strabismus"	"Benign neoplasm of brain and oth prt central nervous system"	1	70	182	252
"O99"	"Q30"	"Oth maternal diseases classd elsw but compl preg/chldbrth"	"Congenital malformations of nose"	1	12	59	71
"C64"	"E11"	"Malignant neoplasm of kidney, except renal pelvis"	"Type 2 diabetes mellitus"	1	369	761	1130
"I42"	"K58"	"Cardiomyopathy"	"Irritable bowel syndrome"	1	54	141	195
"E68"	"O47"	"Sequelae of hyperalimentation"	"False labor"	1	0	222	222
"N60"	"O62"	"Benign mammary dysplasia"	"Abnormalities of forces of labor"	1	0	2260	2260
"J02"	"J20"	"Acute pharyngitis"	"Acute bronchitis"	1	315	486	801
"I21"	"M24"	"Acute myocardial infarction"	"Other specific joint derangements"	1	182	340	522
"J98"	"M77"	"Other respiratory disorders"	"Other enthesopathies"	1	50	126	176
"D43"	"O04"	"Neoplasm of uncertain behavior of brain and cnsl"	"Complications following (induced) termination of pregnancy"	1	0	38	38
"A49"	"C10"	"Bacterial infection of unspecified site"	"Malignant neoplasm of oropharynx"	1	51	117	168
"J90"	"K05"	"Pleural effusion, not elsewhere classified"	"Gingivitis and periodontal diseases"	1	125	437	562
"F05"	"E78"	"Delirium due to known physiological condition"	"Disorders of lipoprotein metabolism and other lipidemias"	1	0	2832	2832
"M20"	"L68"	"Acquired deformities of fingers and toes"	"Hypertrichosis"	1	32	170	202
"C76"	"N20"	"Malignant neoplasm of other and ill-defined sites"	"Calculus of kidney and ureter"	1	19	67	86
"J18"	"O12"	"Pneumonia, unspecified organism"	"Gestational edema and proteinuria without hypertension"	1	21	120	141
"L89"	"H81"	"Pressure ulcer"	"Disorders of vestibular function"	1	5	336	341
"H52"	"O36"	"Disorders of refraction and accommodation"	"Maternal care for other fetal problems"	1	167	307	474
"F41"	"O64"	"Other anxiety disorders"	"Obstructed labor due to malposition and malpresent of fetus"	1	17	178	195
"G80"	"K42"	"Cerebral palsy"	"Umbilical hernia"	1	19	65	84
"I46"	"M81"	"Cardiac arrest"	"Osteoporosis without current pathological fracture"	1	245	1636	1881
"H52"	"Q21"	"Disorders of refraction and accommodation"	"Congenital malformations of cardiac septa"	1	63	688	751
"L98"	"L20"	"Oth disorders of skin, subcu, not elsewhere classified"	"Atopic dermatitis"	1	169	276	445
"N28"	"N03"	"Oth disorders of kidney and ureter, not elsewhere classified"	"Chronic nephritic syndrome"	1	87	198	285
"L89"	"J01"	"Pressure ulcer"	"Acute sinusitis"	1	4	39	43
"I51"	"E04"	"Complications and ill-defined descriptions of heart disease"	"Other nontoxic goiter"	1	56	202	258
"F20"	"K35"	"Schizophrenia"	"Acute appendicitis"	1	95	205	300
"K56"	"M51"	"Paralytic ileus and intestinal obstruction without hernia"	"Thoracic, thoracolum, and lumbosacral intvrt disc disorders"	1	276	1425	1701
"D35"	"O03"	"Benign neoplasm of other and unspecified endocrine glands"	"Spontaneous abortion"	1	0	62	62
"M53"	"O63"	"Other and unspecified dorsopathies, not elsewhere classified"	"Long labor"	1	16	126	142
"H52"	"O65"	"Disorders of refraction and accommodation"	"Obstructed labor due to maternal pelvic abnormality"	1	0	199	199
"H90"	"Q25"	"Conductive and sensorineural hearing loss"	"Congenital malformations of great arteries"	1	25	174	199
"F03"	"I25"	"Unspecified dementia"	"Chronic ischemic heart disease"	1	0	11281	11281
"G20"	"M75"	"Parkinson's disease"	"Shoulder lesions"	1	125	615	740
"N31"	"M51"	"Neuromuscular dysfunction of bladder, NEC"	"Thoracic, thoracolum, and lumbosacral intvrt disc disorders"	1	398	1139	1537
"E86"	"L98"	"Volume depletion"	"Oth disorders of skin, subcu, not elsewhere classified"	1	989	1584	2573
"K63"	"N40"	"Other diseases of intestine"	"Benign prostatic hyperplasia"	1	99	667	766
"J22"	"A46"	"Unspecified acute lower respiratory infection"	"Erysipelas"	1	219	429	648
"J69"	"M65"	"Pneumonitis due to solids and liquids"	"Synovitis and tenosynovitis"	1	0	106	106
"M17"	"K80"	"Osteoarthritis of knee"	"Cholelithiasis"	1	2634	3903	6537
"J69"	"G50"	"Pneumonitis due to solids and liquids"	"Disorders of trigeminal nerve"	1	0	37	37
"L97"	"N20"	"Non-pressure chronic ulcer of lower limb, NEC"	"Calculus of kidney and ureter"	1	68	349	417
"N18"	"A69"	"Chronic kidney disease (CKD)"	"Other spirochetal infections"	1	0	49	49
"J39"	"O80"	"Other diseases of upper respiratory tract"	"Encounter for full-term uncomplicated delivery"	1	32	173	205
"C15"	"M54"	"Malignant neoplasm of esophagus"	"Dorsalgia"	1	55	339	394
"E89"	"O04"	"Postproc endocrine and metabolic comp and disorders, NEC"	"Complications following (induced) termination of pregnancy"	1	0	135	135
"N18"	"J38"	"Chronic kidney disease (CKD)"	"Diseases of vocal cords and larynx, not elsewhere classified"	1	57	282	339
"L21"	"G40"	"Seborrheic dermatitis"	"Epilepsy and recurrent seizures"	1	83	165	248
"L97"	"K57"	"Non-pressure chronic ulcer of lower limb, NEC"	"Diverticular disease of intestine"	1	367	887	1254
"G47"	"C34"	"Sleep disorders"	"Malignant neoplasm of bronchus and lung"	1	0	4891	4891
"L98"	"C50"	"Oth disorders of skin, subcu, not elsewhere classified"	"Malignant neoplasm of breast"	1	173	622	795
"O68"	"N70"	"Labor and delivery comp by abnlt of fetal acid-base balance"	"Salpingitis and oophoritis"	1	492	1053	1545
"N35"	"O04"	"Urethral stricture"	"Complications following (induced) termination of pregnancy"	1	0	28	28
"G96"	"O21"	"Other disorders of central nervous system"	"Excessive vomiting in pregnancy"	1	0	88	88
"M20"	"O65"	"Acquired deformities of fingers and toes"	"Obstructed labor due to maternal pelvic abnormality"	1	0	202	202
"N25"	"N18"	"Disorders resulting from impaired renal tubular function"	"Chronic kidney disease (CKD)"	1	582	1181	1763
"J47"	"N84"	"Bronchiectasis"	"Polyp of female genital tract"	1	10	77	87
"E63"	"I70"	"Other nutritional deficiencies"	"Atherosclerosis"	1	51	118	169
"M81"	"L03"	"Osteoporosis without current pathological fracture"	"Cellulitis and acute lymphangitis"	1	59	729	788
"M70"	"H10"	"Soft tissue disorders related to use, overuse and pressure"	"Conjunctivitis"	1	278	809	1087
"J47"	"H93"	"Bronchiectasis"	"Other disorders of ear, not elsewhere classified"	1	22	162	184
"J98"	"O62"	"Other respiratory disorders"	"Abnormalities of forces of labor"	1	13	137	150
"I42"	"N81"	"Cardiomyopathy"	"Female genital prolapse"	1	50	249	299
"M18"	"A63"	"Osteoarthritis of first carpometacarpal joint"	"Oth predominantly sexually transmitted diseases, NEC"	1	0	39	39
"C78"	"H25"	"Secondary malignant neoplasm of resp and digestive organs"	"Age-related cataract"	1	0	6933	6933
"M17"	"K60"	"Osteoarthritis of knee"	"Fissure and fistula of anal and rectal regions"	1	379	928	1307
"Q61"	"M50"	"Cystic kidney disease"	"Cervical disc disorders"	1	30	112	142
"A04"	"N20"	"Other bacterial intestinal infections"	"Calculus of kidney and ureter"	1	124	345	469
"E04"	"M51"	"Other nontoxic goiter"	"Thoracic, thoracolum, and lumbosacral intvrt disc disorders"	1	1020	1292	2312
"A49"	"F32"	"Bacterial infection of unspecified site"	"Depressive episode"	1	811	1541	2352
"D22"	"L05"	"Melanocytic nevi"	"Pilonidal cyst and sinus"	1	29	125	154
"G45"	"K61"	"Transient cerebral ischemic attacks and related syndromes"	"Abscess of anal and rectal regions"	1	88	277	365
"I20"	"O32"	"Angina pectoris"	"Maternal care for malpresentation of fetus"	1	0	79	79
"J44"	"D26"	"Other chronic obstructive pulmonary disease"	"Other benign neoplasms of uterus"	1	6	41	47
"C22"	"K60"	"Malignant neoplasm of liver and intrahepatic bile ducts"	"Fissure and fistula of anal and rectal regions"	1	1	48	49
"D64"	"M70"	"Other anemias"	"Soft tissue disorders related to use, overuse and pressure"	1	441	1586	2027
"G31"	"M16"	"Oth degenerative diseases of nervous system, NEC"	"Osteoarthritis of hip"	1	26	336	362
"M75"	"N43"	"Shoulder lesions"	"Hydrocele and spermatocele"	1	444	856	1300
"G50"	"D25"	"Disorders of trigeminal nerve"	"Leiomyoma of uterus"	1	52	122	174
"B37"	"O80"	"Candidiasis"	"Encounter for full-term uncomplicated delivery"	1	313	490	803
"F06"	"E10"	"Other mental disorders due to known physiological condition"	"Type 1 diabetes mellitus"	1	119	321	440
"O68"	"N97"	"Labor and delivery comp by abnlt of fetal acid-base balance"	"Female infertility"	1	0	19176	19176
"I50"	"K42"	"Heart failure"	"Umbilical hernia"	1	509	1246	1755
"I48"	"K43"	"Atrial fibrillation and flutter"	"Ventral hernia"	1	1072	2151	3223
"M10"	"I80"	"Gout"	"Phlebitis and thrombophlebitis"	1	731	1218	1949
"C22"	"M81"	"Malignant neoplasm of liver and intrahepatic bile ducts"	"Osteoporosis without current pathological fracture"	1	52	232	284
"A04"	"M32"	"Other bacterial intestinal infections"	"Systemic lupus erythematosus (SLE)"	1	6	52	58
"M19"	"H33"	"Other and unspecified osteoarthritis"	"Retinal detachments and breaks"	1	219	445	664
"N19"	"H33"	"Unspecified kidney failure"	"Retinal detachments and breaks"	1	34	289	323
"H02"	"H20"	"Other disorders of eyelid"	"Iridocyclitis"	1	115	250	365
"C78"	"H35"	"Secondary malignant neoplasm of resp and digestive organs"	"Other retinal disorders"	1	0	2155	2155
"I95"	"M23"	"Hypotension"	"Internal derangement of knee"	1	55	624	679
"C66"	"N40"	"Malignant neoplasm of ureter"	"Benign prostatic hyperplasia"	1	14	73	87
"N18"	"O86"	"Chronic kidney disease (CKD)"	"Other puerperal infections"	1	0	29	29
"J81"	"H35"	"Pulmonary edema"	"Other retinal disorders"	1	172	971	1143
"N17"	"D14"	"Acute kidney failure"	"Benign neoplasm of middle ear and respiratory system"	1	7	116	123
"H93"	"N97"	"Other disorders of ear, not elsewhere classified"	"Female infertility"	1	34	251	285
"M16"	"D28"	"Osteoarthritis of hip"	"Benign neoplasm of other and unsp female genital organs"	1	8	84	92
"M85"	"F43"	"Other disorders of bone density and structure"	"Reaction to severe stress, and adjustment disorders"	1	88	218	306
"D12"	"L50"	"Benign neoplasm of colon, rectum, anus and anal canal"	"Urticaria"	1	89	497	586
"O40"	"N87"	"Polyhydramnios"	"Dysplasia of cervix uteri"	1	70	161	231
"J45"	"Q39"	"Asthma"	"Congenital malformations of esophagus"	1	32	148	180
"H66"	"Q62"	"Suppurative and unspecified otitis media"	"Congen defects of renal pelvis and congen malform of ureter"	1	135	275	410
"N10"	"N40"	"Acute pyelonephritis"	"Benign prostatic hyperplasia"	1	764	1319	2083
"C78"	"H52"	"Secondary malignant neoplasm of resp and digestive organs"	"Disorders of refraction and accommodation"	1	6	241	247
"K22"	"I25"	"Other diseases of esophagus"	"Chronic ischemic heart disease"	1	1123	1809	2932
"I46"	"K27"	"Cardiac arrest"	"Peptic ulcer, site unspecified"	1	116	358	474
"D22"	"M21"	"Melanocytic nevi"	"Other acquired deformities of limbs"	1	61	183	244
"C78"	"M76"	"Secondary malignant neoplasm of resp and digestive organs"	"Enthesopathies, lower limb, excluding foot"	1	0	260	260
"K59"	"O60"	"Other functional intestinal disorders"	"Preterm labor"	1	26	121	147
"L50"	"K35"	"Urticaria"	"Acute appendicitis"	1	234	440	674
"C78"	"I42"	"Secondary malignant neoplasm of resp and digestive organs"	"Cardiomyopathy"	1	94	353	447
"I70"	"J11"	"Atherosclerosis"	"Influenza due to unidentified influenza virus"	1	91	203	294
"L89"	"J45"	"Pressure ulcer"	"Asthma"	1	44	504	548
"L08"	"K01"	"Other local infections of skin and subcutaneous tissue"	"Embedded and impacted teeth"	1	44	107	151
"B30"	"O80"	"Viral conjunctivitis"	"Encounter for full-term uncomplicated delivery"	1	57	194	251
"E23"	"D24"	"Hypofunction and other disorders of the pituitary gland"	"Benign neoplasm of breast"	1	5	49	54
"D12"	"I10"	"Benign neoplasm of colon, rectum, anus and anal canal"	"Essential (primary) hypertension"	1	9928	15249	25177
"M10"	"I21"	"Gout"	"Acute myocardial infarction"	1	1072	2533	3605
"K86"	"M22"	"Other diseases of pancreas"	"Disorder of patella"	1	0	73	73
"J81"	"N84"	"Pulmonary edema"	"Polyp of female genital tract"	1	9	58	67
"C73"	"O62"	"Malignant neoplasm of thyroid gland"	"Abnormalities of forces of labor"	1	0	145	145
"L89"	"G20"	"Pressure ulcer"	"Parkinson's disease"	1	171	664	835
"I89"	"N63"	"Oth noninfective disorders of lymphatic vessels and nodes"	"Unspecified lump in breast"	1	0	282	282
"N19"	"D17"	"Unspecified kidney failure"	"Benign lipomatous neoplasm"	1	41	201	242
"I10"	"M21"	"Essential (primary) hypertension"	"Other acquired deformities of limbs"	1	1462	2143	3605
"E66"	"A39"	"Overweight and obesity"	"Meningococcal infection"	1	0	26	26
"O23"	"H65"	"Infections of genitourinary tract in pregnancy"	"Nonsuppurative otitis media"	1	7	101	108
"J98"	"M75"	"Other respiratory disorders"	"Shoulder lesions"	1	319	544	863
"K52"	"J36"	"Other and unsp noninfective gastroenteritis and colitis"	"Peritonsillar abscess"	1	34	136	170
"E86"	"M06"	"Volume depletion"	"Other rheumatoid arthritis"	1	336	2067	2403
"I61"	"M22"	"Nontraumatic intracerebral hemorrhage"	"Disorder of patella"	1	0	54	54
"L98"	"N43"	"Oth disorders of skin, subcu, not elsewhere classified"	"Hydrocele and spermatocele"	1	47	153	200
"A49"	"C62"	"Bacterial infection of unspecified site"	"Malignant neoplasm of testis"	1	5	71	76
"N28"	"D64"	"Oth disorders of kidney and ureter, not elsewhere classified"	"Other anemias"	1	1071	1594	2665
"J42"	"O20"	"Unspecified chronic bronchitis"	"Hemorrhage in early pregnancy"	1	0	31	31
"K74"	"G40"	"Fibrosis and cirrhosis of liver"	"Epilepsy and recurrent seizures"	1	159	302	461
"I50"	"H66"	"Heart failure"	"Suppurative and unspecified otitis media"	1	69	621	690
"K60"	"O04"	"Fissure and fistula of anal and rectal regions"	"Complications following (induced) termination of pregnancy"	1	77	834	911
"O72"	"L21"	"Postpartum hemorrhage"	"Seborrheic dermatitis"	1	33	98	131
"K74"	"M19"	"Fibrosis and cirrhosis of liver"	"Other and unspecified osteoarthritis"	1	115	243	358
"C76"	"I83"	"Malignant neoplasm of other and ill-defined sites"	"Varicose veins of lower extremities"	1	14	65	79
"L02"	"O62"	"Cutaneous abscess, furuncle and carbuncle"	"Abnormalities of forces of labor"	1	688	1712	2400
"E23"	"O82"	"Hypofunction and other disorders of the pituitary gland"	"Encounter for cesarean delivery without indication"	1	26	89	115
"J18"	"G37"	"Pneumonia, unspecified organism"	"Other demyelinating diseases of central nervous system"	1	118	236	354
"D43"	"I20"	"Neoplasm of uncertain behavior of brain and cnsl"	"Angina pectoris"	1	27	269	296
"O72"	"L03"	"Postpartum hemorrhage"	"Cellulitis and acute lymphangitis"	1	0	583	583
"K00"	"Q17"	"Disorders of tooth development and eruption"	"Other congenital malformations of ear"	1	18	129	147
"F41"	"I44"	"Other anxiety disorders"	"Atrioventricular and left bundle-branch block"	1	119	253	372
"E66"	"N43"	"Overweight and obesity"	"Hydrocele and spermatocele"	1	189	437	626
"K05"	"N04"	"Gingivitis and periodontal diseases"	"Nephrotic syndrome"	1	24	83	107
"M70"	"N87"	"Soft tissue disorders related to use, overuse and pressure"	"Dysplasia of cervix uteri"	1	101	389	490
"E20"	"I10"	"Hypoparathyroidism"	"Essential (primary) hypertension"	1	376	555	931
"J06"	"D18"	"Acute upper resp infections of multiple and unsp sites"	"Hemangioma and lymphangioma, any site"	1	108	255	363
"K35"	"H66"	"Acute appendicitis"	"Suppurative and unspecified otitis media"	1	36	549	585
"O99"	"B27"	"Oth maternal diseases classd elsw but compl preg/chldbrth"	"Infectious mononucleosis"	1	0	310	310
"I61"	"H10"	"Nontraumatic intracerebral hemorrhage"	"Conjunctivitis"	1	41	263	304
"J96"	"H47"	"Respiratory failure, not elsewhere classified"	"Other disorders of optic [2nd] nerve and visual pathways"	1	113	226	339
"I80"	"K00"	"Phlebitis and thrombophlebitis"	"Disorders of tooth development and eruption"	1	6	46	52
"K59"	"L04"	"Other functional intestinal disorders"	"Acute lymphadenitis"	1	106	340	446
"N87"	"L20"	"Dysplasia of cervix uteri"	"Atopic dermatitis"	1	12	124	136
"J01"	"M62"	"Acute sinusitis"	"Other disorders of muscle"	1	248	827	1075
"J15"	"M80"	"Bacterial pneumonia, not elsewhere classified"	"Osteoporosis with current pathological fracture"	1	2366	3281	5647
"H36"	"O62"	"Retinal disorders in diseases classified elsewhere"	"Abnormalities of forces of labor"	1	0	214	214
"M13"	"O70"	"Other arthritis"	"Perineal laceration during delivery"	1	157	541	698
"M41"	"A09"	"Scoliosis"	"Infectious gastroenteritis and colitis, unspecified"	1	124	372	496
"J44"	"H40"	"Other chronic obstructive pulmonary disease"	"Glaucoma"	1	1202	1901	3103
"I71"	"K60"	"Aortic aneurysm and dissection"	"Fissure and fistula of anal and rectal regions"	1	20	154	174
"G47"	"C65"	"Sleep disorders"	"Malignant neoplasm of renal pelvis"	1	36	123	159
"N63"	"A63"	"Unspecified lump in breast"	"Oth predominantly sexually transmitted diseases, NEC"	1	12	302	314
"I49"	"I48"	"Other cardiac arrhythmias"	"Atrial fibrillation and flutter"	1	12311	15958	28269
"A49"	"H33"	"Bacterial infection of unspecified site"	"Retinal detachments and breaks"	1	17	336	353
"J15"	"M23"	"Bacterial pneumonia, not elsewhere classified"	"Internal derangement of knee"	1	0	2383	2383
"I95"	"G44"	"Hypotension"	"Other headache syndromes"	1	124	246	370
"L95"	"M23"	"Vasculitis limited to skin, not elsewhere classified"	"Internal derangement of knee"	1	39	100	139
"E86"	"M70"	"Volume depletion"	"Soft tissue disorders related to use, overuse and pressure"	1	219	1667	1886
"F05"	"O99"	"Delirium due to known physiological condition"	"Oth maternal diseases classd elsw but compl preg/chldbrth"	1	1	29	30
"C49"	"O70"	"Malignant neoplasm of other connective and soft tissue"	"Perineal laceration during delivery"	1	6	66	72
"K42"	"K80"	"Umbilical hernia"	"Cholelithiasis"	1	1160	1720	2880
"I48"	"N63"	"Atrial fibrillation and flutter"	"Unspecified lump in breast"	1	207	1091	1298
"K59"	"J20"	"Other functional intestinal disorders"	"Acute bronchitis"	1	1235	3207	4442
"G37"	"O04"	"Other demyelinating diseases of central nervous system"	"Complications following (induced) termination of pregnancy"	1	0	127	127
"K76"	"K51"	"Other diseases of liver"	"Ulcerative colitis"	1	126	226	352
"K02"	"C83"	"Dental caries"	"Non-follicular lymphoma"	1	107	238	345
"K58"	"J03"	"Irritable bowel syndrome"	"Acute tonsillitis"	1	205	424	629
"N12"	"O80"	"Tubulo-interstitial nephritis, not spcf as acute or chronic"	"Encounter for full-term uncomplicated delivery"	1	71	390	461
"H60"	"O82"	"Otitis externa"	"Encounter for cesarean delivery without indication"	1	127	230	357
"A41"	"M48"	"Other sepsis"	"Other spondylopathies"	1	0	4512	4512
"M87"	"M23"	"Osteonecrosis"	"Internal derangement of knee"	1	95	234	329
"J96"	"M17"	"Respiratory failure, not elsewhere classified"	"Osteoarthritis of knee"	1	0	4187	4187
"C16"	"M47"	"Malignant neoplasm of stomach"	"Spondylosis"	1	6	175	181
"G64"	"O70"	"Other disorders of peripheral nervous system"	"Perineal laceration during delivery"	1	5	47	52
"K27"	"J35"	"Peptic ulcer, site unspecified"	"Chronic diseases of tonsils and adenoids"	1	13	54	67
"K65"	"N60"	"Peritonitis"	"Benign mammary dysplasia"	1	24	79	103
"O47"	"B07"	"False labor"	"Viral warts"	1	3	55	58
"K57"	"D25"	"Diverticular disease of intestine"	"Leiomyoma of uterus"	1	0	1707	1707
"C79"	"I51"	"Secondary malignant neoplasm of other and unspecified sites"	"Complications and ill-defined descriptions of heart disease"	1	80	187	267
"M85"	"O47"	"Other disorders of bone density and structure"	"False labor"	1	0	59	59
"C15"	"E10"	"Malignant neoplasm of esophagus"	"Type 1 diabetes mellitus"	1	94	213	307
"M80"	"E03"	"Osteoporosis with current pathological fracture"	"Other hypothyroidism"	1	1166	1474	2640
"D63"	"N84"	"Anemia in chronic diseases classified elsewhere"	"Polyp of female genital tract"	1	1	159	160
"D64"	"M76"	"Other anemias"	"Enthesopathies, lower limb, excluding foot"	1	107	514	621
"M25"	"N47"	"Other joint disorder, not elsewhere classified"	"Disorders of prepuce"	1	137	358	495
"C34"	"N64"	"Malignant neoplasm of bronchus and lung"	"Other disorders of breast"	1	9	131	140
"M85"	"O92"	"Other disorders of bone density and structure"	"Oth disord of brst/lactatn assoc w pregnancy and the puerp"	1	2	41	43
"M75"	"A69"	"Shoulder lesions"	"Other spirochetal infections"	1	93	216	309
"O03"	"F10"	"Spontaneous abortion"	"Alcohol related disorders"	1	422	694	1116
"I50"	"J37"	"Heart failure"	"Chronic laryngitis and laryngotracheitis"	1	47	433	480
"J44"	"N63"	"Other chronic obstructive pulmonary disease"	"Unspecified lump in breast"	1	281	984	1265
"A41"	"O71"	"Other sepsis"	"Other obstetric trauma"	1	0	111	111
"J94"	"K80"	"Other pleural conditions"	"Cholelithiasis"	1	101	295	396
"B96"	"G20"	"Oth bacterial agents as the cause of diseases classd elswhr"	"Parkinson's disease"	1	27	102	129
"L97"	"M05"	"Non-pressure chronic ulcer of lower limb, NEC"	"Rheumatoid arthritis with rheumatoid factor"	1	111	569	680
"C22"	"D50"	"Malignant neoplasm of liver and intrahepatic bile ducts"	"Iron deficiency anemia"	1	56	217	273
"J95"	"H35"	"Intraop and postproc comp and disorders of resp sys, NEC"	"Other retinal disorders"	1	38	150	188
"H25"	"J45"	"Age-related cataract"	"Asthma"	1	2791	5749	8540
"O72"	"L20"	"Postpartum hemorrhage"	"Atopic dermatitis"	1	0	774	774
"M16"	"O42"	"Osteoarthritis of hip"	"Premature rupture of membranes"	1	0	88	88
"C79"	"C21"	"Secondary malignant neoplasm of other and unspecified sites"	"Malignant neoplasm of anus and anal canal"	1	31	120	151
"M50"	"O63"	"Cervical disc disorders"	"Long labor"	1	0	108	108
"M19"	"M89"	"Other and unspecified osteoarthritis"	"Other disorders of bone"	1	288	586	874
"E03"	"K44"	"Other hypothyroidism"	"Diaphragmatic hernia"	1	554	962	1516
"C44"	"D86"	"Other and unspecified malignant neoplasm of skin"	"Sarcoidosis"	1	31	135	166
"N47"	"J20"	"Disorders of prepuce"	"Acute bronchitis"	1	44	1210	1254
"N30"	"Q53"	"Cystitis"	"Undescended and ectopic testicle"	1	47	139	186
"I49"	"D23"	"Other cardiac arrhythmias"	"Other benign neoplasms of skin"	1	243	415	658
"J22"	"M72"	"Unspecified acute lower respiratory infection"	"Fibroblastic disorders"	1	0	137	137
"M90"	"N81"	"Osteopathies in diseases classified elsewhere"	"Female genital prolapse"	1	1	34	35
"L98"	"H91"	"Oth disorders of skin, subcu, not elsewhere classified"	"Other and unspecified hearing loss"	1	551	1640	2191
"E78"	"K13"	"Disorders of lipoprotein metabolism and other lipidemias"	"Other diseases of lip and oral mucosa"	1	200	371	571
"K58"	"K30"	"Irritable bowel syndrome"	"Functional dyspepsia"	1	2308	3186	5494
"I85"	"M16"	"Esophageal varices"	"Osteoarthritis of hip"	1	49	163	212
"O91"	"N98"	"Infect of breast assoc w pregnancy, the puerp and lactation"	"Complications associated with artificial fertilization"	1	21	86	107
"J96"	"O13"	"Respiratory failure, not elsewhere classified"	"Gestational hypertension without significant proteinuria"	1	2	32	34
"M07"	"O70"	"Enteropathic arthropathies"	"Perineal laceration during delivery"	1	0	411	411
"H30"	"O80"	"Chorioretinal inflammation"	"Encounter for full-term uncomplicated delivery"	1	23	100	123
"O89"	"O32"	"Complications of anesthesia during the puerperium"	"Maternal care for malpresentation of fetus"	1	49	134	183
"N19"	"H43"	"Unspecified kidney failure"	"Disorders of vitreous body"	1	125	534	659
"O21"	"N97"	"Excessive vomiting in pregnancy"	"Female infertility"	1	503	1870	2373
"O75"	"J36"	"Oth complications of labor and delivery, NEC"	"Peritonsillar abscess"	1	24	102	126
"M20"	"O68"	"Acquired deformities of fingers and toes"	"Labor and delivery comp by abnlt of fetal acid-base balance"	1	204	602	806
"N84"	"O68"	"Polyp of female genital tract"	"Labor and delivery comp by abnlt of fetal acid-base balance"	1	5	977	982
"J15"	"K62"	"Bacterial pneumonia, not elsewhere classified"	"Other diseases of anus and rectum"	1	1123	3216	4339
"L72"	"O14"	"Follicular cysts of skin and subcutaneous tissue"	"Pre-eclampsia"	1	2	32	34
"F32"	"N20"	"Depressive episode"	"Calculus of kidney and ureter"	1	341	755	1096
"M47"	"D27"	"Spondylosis"	"Benign neoplasm of ovary"	1	115	439	554
"I51"	"M16"	"Complications and ill-defined descriptions of heart disease"	"Osteoarthritis of hip"	1	158	724	882
"N19"	"K35"	"Unspecified kidney failure"	"Acute appendicitis"	1	78	257	335
"N28"	"C50"	"Oth disorders of kidney and ureter, not elsewhere classified"	"Malignant neoplasm of breast"	1	37	152	189
"C78"	"C09"	"Secondary malignant neoplasm of resp and digestive organs"	"Malignant neoplasm of tonsil"	1	37	233	270
"O90"	"K01"	"Complications of the puerperium, not elsewhere classified"	"Embedded and impacted teeth"	1	0	29	29
"L98"	"J35"	"Oth disorders of skin, subcu, not elsewhere classified"	"Chronic diseases of tonsils and adenoids"	1	16	271	287
"J96"	"C20"	"Respiratory failure, not elsewhere classified"	"Malignant neoplasm of rectum"	1	272	1108	1380
"I26"	"H18"	"Pulmonary embolism"	"Other disorders of cornea"	1	80	162	242
"I27"	"I25"	"Other pulmonary heart diseases"	"Chronic ischemic heart disease"	1	1299	1981	3280
"J44"	"M17"	"Other chronic obstructive pulmonary disease"	"Osteoarthritis of knee"	1	0	8872	8872
"N50"	"N43"	"Other and unspecified disorders of male genital organs"	"Hydrocele and spermatocele"	1	1030	1527	2557
"J44"	"F11"	"Other chronic obstructive pulmonary disease"	"Opioid related disorders"	1	218	393	611
"I48"	"H71"	"Atrial fibrillation and flutter"	"Cholesteatoma of middle ear"	1	21	244	265
"J84"	"H80"	"Other interstitial pulmonary diseases"	"Otosclerosis"	1	2	45	47
"I70"	"K58"	"Atherosclerosis"	"Irritable bowel syndrome"	1	305	621	926
"E89"	"M65"	"Postproc endocrine and metabolic comp and disorders, NEC"	"Synovitis and tenosynovitis"	1	47	146	193
"A26"	"L03"	"Erysipeloid"	"Cellulitis and acute lymphangitis"	1	8	70	78
"C80"	"M77"	"Malignant neoplasm without specification of site"	"Other enthesopathies"	1	0	47	47
"C78"	"N47"	"Secondary malignant neoplasm of resp and digestive organs"	"Disorders of prepuce"	1	21	275	296
"K85"	"J36"	"Acute pancreatitis"	"Peritonsillar abscess"	1	10	56	66
"M70"	"M62"	"Soft tissue disorders related to use, overuse and pressure"	"Other disorders of muscle"	1	1425	2292	3717
"C50"	"O08"	"Malignant neoplasm of breast"	"Complications following ectopic and molar pregnancy"	1	0	67	67
"K64"	"A63"	"Hemorrhoids and perianal venous thrombosis"	"Oth predominantly sexually transmitted diseases, NEC"	1	0	442	442
"M81"	"C73"	"Osteoporosis without current pathological fracture"	"Malignant neoplasm of thyroid gland"	1	28	92	120
"B95"	"E16"	"Strep as the cause of diseases classified elsewhere"	"Other disorders of pancreatic internal secretion"	1	14	60	74
"K70"	"M75"	"Alcoholic liver disease"	"Shoulder lesions"	1	257	510	767
"D34"	"N92"	"Benign neoplasm of thyroid gland"	"Excessive, frequent and irregular menstruation"	1	76	160	236
"B95"	"M50"	"Strep as the cause of diseases classified elsewhere"	"Cervical disc disorders"	1	2	28	30
"D61"	"C85"	"Oth aplastic anemias and other bone marrow failure syndromes"	"Oth and unspecified types of non-Hodgkin lymphoma"	1	156	281	437
"B36"	"I10"	"Other superficial mycoses"	"Essential (primary) hypertension"	1	211	539	750
"B37"	"J43"	"Candidiasis"	"Emphysema"	1	142	264	406
"N80"	"D27"	"Endometriosis"	"Benign neoplasm of ovary"	1	1818	2353	4171
"C22"	"G56"	"Malignant neoplasm of liver and intrahepatic bile ducts"	"Mononeuropathies of upper limb"	1	0	122	122
"K56"	"L60"	"Paralytic ileus and intestinal obstruction without hernia"	"Nail disorders"	1	45	114	159
"J42"	"M51"	"Unspecified chronic bronchitis"	"Thoracic, thoracolum, and lumbosacral intvrt disc disorders"	1	608	818	1426
"F32"	"M65"	"Depressive episode"	"Synovitis and tenosynovitis"	1	247	707	954
"M77"	"N97"	"Other enthesopathies"	"Female infertility"	1	48	542	590
"C44"	"O02"	"Other and unspecified malignant neoplasm of skin"	"Other abnormal products of conception"	1	0	81	81
"C43"	"O62"	"Malignant melanoma of skin"	"Abnormalities of forces of labor"	1	0	438	438
"H65"	"Q24"	"Nonsuppurative otitis media"	"Other congenital malformations of heart"	1	216	335	551
"F32"	"K21"	"Depressive episode"	"Gastro-esophageal reflux disease"	1	931	1534	2465
"A49"	"F13"	"Bacterial infection of unspecified site"	"Sedative, hypnotic, or anxiolytic related disorders"	1	58	140	198
"H25"	"O04"	"Age-related cataract"	"Complications following (induced) termination of pregnancy"	1	0	84	84
"M49"	"I20"	"Spondylopathies in diseases classified elsewhere"	"Angina pectoris"	1	9	84	93
"E78"	"K11"	"Disorders of lipoprotein metabolism and other lipidemias"	"Diseases of salivary glands"	1	275	473	748
"K22"	"H90"	"Other diseases of esophagus"	"Conductive and sensorineural hearing loss"	1	223	442	665
"M70"	"K00"	"Soft tissue disorders related to use, overuse and pressure"	"Disorders of tooth development and eruption"	1	18	78	96
"I46"	"O02"	"Cardiac arrest"	"Other abnormal products of conception"	1	0	30	30
"N45"	"J34"	"Orchitis and epididymitis"	"Other and unspecified disorders of nose and nasal sinuses"	1	131	246	377
"A46"	"I49"	"Erysipelas"	"Other cardiac arrhythmias"	1	694	965	1659
"F41"	"H43"	"Other anxiety disorders"	"Disorders of vitreous body"	1	60	167	227
"O72"	"L27"	"Postpartum hemorrhage"	"Dermatitis due to substances taken internally"	1	11	53	64
"G47"	"C24"	"Sleep disorders"	"Malignant neoplasm of other and unsp parts of biliary tract"	1	82	248	330
"C18"	"H20"	"Malignant neoplasm of colon"	"Iridocyclitis"	1	21	75	96
"J94"	"N20"	"Other pleural conditions"	"Calculus of kidney and ureter"	1	33	127	160
"K04"	"O65"	"Diseases of pulp and periapical tissues"	"Obstructed labor due to maternal pelvic abnormality"	1	0	44	44
"D17"	"C62"	"Benign lipomatous neoplasm"	"Malignant neoplasm of testis"	1	3	46	49
"K31"	"H25"	"Other diseases of stomach and duodenum"	"Age-related cataract"	1	424	699	1123
"A04"	"M17"	"Other bacterial intestinal infections"	"Osteoarthritis of knee"	1	54	1018	1072
"J96"	"A88"	"Respiratory failure, not elsewhere classified"	"Oth viral infections of central nervous system, NEC"	1	0	59	59
"I36"	"I10"	"Nonrheumatic tricuspid valve disorders"	"Essential (primary) hypertension"	1	387	634	1021
"H36"	"M23"	"Retinal disorders in diseases classified elsewhere"	"Internal derangement of knee"	1	245	636	881
"B34"	"N10"	"Viral infection of unspecified site"	"Acute pyelonephritis"	1	1097	1589	2686
"E64"	"D23"	"Sequelae of malnutrition and other nutritional deficiencies"	"Other benign neoplasms of skin"	1	26	115	141
"I69"	"C20"	"Sequelae of cerebrovascular disease"	"Malignant neoplasm of rectum"	1	456	635	1091
"M35"	"O80"	"Other systemic involvement of connective tissue"	"Encounter for full-term uncomplicated delivery"	1	374	1256	1630
"M35"	"Q90"	"Other systemic involvement of connective tissue"	"Down syndrome"	1	7	66	73
"I33"	"H25"	"Acute and subacute endocarditis"	"Age-related cataract"	1	256	550	806
"Q61"	"K40"	"Cystic kidney disease"	"Inguinal hernia"	1	88	350	438
"D64"	"M22"	"Other anemias"	"Disorder of patella"	1	0	291	291
"I10"	"K40"	"Essential (primary) hypertension"	"Inguinal hernia"	1	0	22627	22627
"L89"	"G61"	"Pressure ulcer"	"Inflammatory polyneuropathy"	1	28	85	113
"N18"	"M66"	"Chronic kidney disease (CKD)"	"Spontaneous rupture of synovium and tendon"	1	25	116	141
"E66"	"O04"	"Overweight and obesity"	"Complications following (induced) termination of pregnancy"	1	0	9768	9768
"K85"	"D25"	"Acute pancreatitis"	"Leiomyoma of uterus"	1	61	165	226
"D27"	"O02"	"Benign neoplasm of ovary"	"Other abnormal products of conception"	1	371	643	1014
"J06"	"L02"	"Acute upper resp infections of multiple and unsp sites"	"Cutaneous abscess, furuncle and carbuncle"	1	143	590	733
"G12"	"I21"	"Spinal muscular atrophy and related syndromes"	"Acute myocardial infarction"	1	34	91	125
"N28"	"H25"	"Oth disorders of kidney and ureter, not elsewhere classified"	"Age-related cataract"	1	504	1697	2201
"M54"	"H71"	"Dorsalgia"	"Cholesteatoma of middle ear"	1	90	233	323
"I95"	"H83"	"Hypotension"	"Other diseases of inner ear"	1	0	340	340
"M10"	"J34"	"Gout"	"Other and unspecified disorders of nose and nasal sinuses"	1	42	186	228
"O99"	"L02"	"Oth maternal diseases classd elsw but compl preg/chldbrth"	"Cutaneous abscess, furuncle and carbuncle"	1	992	1253	2245
"L98"	"M65"	"Oth disorders of skin, subcu, not elsewhere classified"	"Synovitis and tenosynovitis"	1	161	435	596
"D12"	"I83"	"Benign neoplasm of colon, rectum, anus and anal canal"	"Varicose veins of lower extremities"	1	0	3199	3199
"J13"	"O70"	"Pneumonia due to Streptococcus pneumoniae"	"Perineal laceration during delivery"	1	25	81	106
"J44"	"M41"	"Other chronic obstructive pulmonary disease"	"Scoliosis"	1	330	495	825
"C77"	"H25"	"Secondary and unspecified malignant neoplasm of lymph nodes"	"Age-related cataract"	1	746	1797	2543
"M80"	"M89"	"Osteoporosis with current pathological fracture"	"Other disorders of bone"	1	151	456	607
"J44"	"N43"	"Other chronic obstructive pulmonary disease"	"Hydrocele and spermatocele"	1	242	1067	1309
"E06"	"D24"	"Thyroiditis"	"Benign neoplasm of breast"	1	29	120	149
"G63"	"H83"	"Polyneuropathy in diseases classified elsewhere"	"Other diseases of inner ear"	1	3	54	57
"J93"	"H90"	"Pneumothorax and air leak"	"Conductive and sensorineural hearing loss"	1	79	187	266
"J69"	"I34"	"Pneumonitis due to solids and liquids"	"Nonrheumatic mitral valve disorders"	1	23	132	155
"O80"	"A08"	"Encounter for full-term uncomplicated delivery"	"Viral and other specified intestinal infections"	1	515	808	1323
"K36"	"K35"	"Other appendicitis"	"Acute appendicitis"	1	65	140	205
"N18"	"D51"	"Chronic kidney disease (CKD)"	"Vitamin B12 deficiency anemia"	1	270	597	867
"C25"	"I73"	"Malignant neoplasm of pancreas"	"Other peripheral vascular diseases"	1	41	367	408
"M50"	"J30"	"Cervical disc disorders"	"Vasomotor and allergic rhinitis"	1	121	330	451
"N18"	"M22"	"Chronic kidney disease (CKD)"	"Disorder of patella"	1	0	110	110
"D63"	"C79"	"Anemia in chronic diseases classified elsewhere"	"Secondary malignant neoplasm of other and unspecified sites"	1	2274	2988	5262
"F03"	"M19"	"Unspecified dementia"	"Other and unspecified osteoarthritis"	1	468	1530	1998
"C85"	"M20"	"Oth and unspecified types of non-Hodgkin lymphoma"	"Acquired deformities of fingers and toes"	1	28	83	111
"I50"	"M71"	"Heart failure"	"Other bursopathies"	1	202	648	850
"F43"	"K40"	"Reaction to severe stress, and adjustment disorders"	"Inguinal hernia"	1	141	422	563
"F41"	"F10"	"Other anxiety disorders"	"Alcohol related disorders"	1	1088	3233	4321
"E13"	"D17"	"Other specified diabetes mellitus"	"Benign lipomatous neoplasm"	1	24	81	105
"E03"	"M20"	"Other hypothyroidism"	"Acquired deformities of fingers and toes"	1	315	893	1208
"F03"	"J45"	"Unspecified dementia"	"Asthma"	1	175	1313	1488
"M96"	"N97"	"Intraop and postproc comp and disorders of ms sys, NEC"	"Female infertility"	1	0	26	26
"C17"	"H25"	"Malignant neoplasm of small intestine"	"Age-related cataract"	1	63	189	252
"J81"	"M79"	"Pulmonary edema"	"Oth and unsp soft tissue disorders, not elsewhere classified"	1	177	709	886
"G47"	"N13"	"Sleep disorders"	"Obstructive and reflux uropathy"	1	323	985	1308
"I63"	"L08"	"Cerebral infarction"	"Other local infections of skin and subcutaneous tissue"	1	512	752	1264
"O68"	"Q78"	"Labor and delivery comp by abnlt of fetal acid-base balance"	"Other osteochondrodysplasias"	1	2	42	44
"D46"	"N81"	"Myelodysplastic syndromes"	"Female genital prolapse"	1	0	87	87
"D50"	"O44"	"Iron deficiency anemia"	"Placenta previa"	1	1	27	28
"I47"	"O68"	"Paroxysmal tachycardia"	"Labor and delivery comp by abnlt of fetal acid-base balance"	1	161	364	525
"B02"	"C85"	"Zoster [herpes zoster]"	"Oth and unspecified types of non-Hodgkin lymphoma"	1	113	331	444
"Q61"	"I83"	"Cystic kidney disease"	"Varicose veins of lower extremities"	1	18	172	190
"C15"	"L98"	"Malignant neoplasm of esophagus"	"Oth disorders of skin, subcu, not elsewhere classified"	1	14	57	71
"D63"	"M66"	"Anemia in chronic diseases classified elsewhere"	"Spontaneous rupture of synovium and tendon"	1	6	47	53
"I50"	"D31"	"Heart failure"	"Benign neoplasm of eye and adnexa"	1	86	167	253
"E87"	"E04"	"Other disorders of fluid, electrolyte and acid-base balance"	"Other nontoxic goiter"	1	94	943	1037
"C79"	"I47"	"Secondary malignant neoplasm of other and unspecified sites"	"Paroxysmal tachycardia"	1	80	793	873
"D05"	"O04"	"Carcinoma in situ of breast"	"Complications following (induced) termination of pregnancy"	1	0	49	49
"H35"	"O82"	"Other retinal disorders"	"Encounter for cesarean delivery without indication"	1	41	226	267
"M93"	"H66"	"Other osteochondropathies"	"Suppurative and unspecified otitis media"	1	3	35	38
"M70"	"H80"	"Soft tissue disorders related to use, overuse and pressure"	"Otosclerosis"	1	25	126	151
"J32"	"J36"	"Chronic sinusitis"	"Peritonsillar abscess"	1	20	68	88
"I20"	"O46"	"Angina pectoris"	"Antepartum hemorrhage, not elsewhere classified"	1	0	53	53
"C85"	"M50"	"Oth and unspecified types of non-Hodgkin lymphoma"	"Cervical disc disorders"	1	18	64	82
"K70"	"F10"	"Alcoholic liver disease"	"Alcohol related disorders"	1	7265	10693	17958
"I42"	"J36"	"Cardiomyopathy"	"Peritonsillar abscess"	1	3	31	34
"C25"	"J44"	"Malignant neoplasm of pancreas"	"Other chronic obstructive pulmonary disease"	1	238	1091	1329
"G62"	"M17"	"Other and unspecified polyneuropathies"	"Osteoarthritis of knee"	1	599	1756	2355
"G30"	"G96"	"Alzheimer's disease"	"Other disorders of central nervous system"	1	159	503	662
"A04"	"M05"	"Other bacterial intestinal infections"	"Rheumatoid arthritis with rheumatoid factor"	1	24	290	314
"H25"	"M51"	"Age-related cataract"	"Thoracic, thoracolum, and lumbosacral intvrt disc disorders"	1	0	9332	9332
"M84"	"O03"	"Disorder of continuity of bone"	"Spontaneous abortion"	1	6	38	44
"H36"	"O47"	"Retinal disorders in diseases classified elsewhere"	"False labor"	1	5	61	66
"F06"	"D17"	"Other mental disorders due to known physiological condition"	"Benign lipomatous neoplasm"	1	9	57	66
"E66"	"J34"	"Overweight and obesity"	"Other and unspecified disorders of nose and nasal sinuses"	1	451	1186	1637
"C92"	"K30"	"Myeloid leukemia"	"Functional dyspepsia"	1	15	110	125
"M81"	"M62"	"Osteoporosis without current pathological fracture"	"Other disorders of muscle"	1	0	4474	4474
"C56"	"K51"	"Malignant neoplasm of ovary"	"Ulcerative colitis"	1	15	56	71
"B37"	"N81"	"Candidiasis"	"Female genital prolapse"	1	120	456	576
"E87"	"D34"	"Other disorders of fluid, electrolyte and acid-base balance"	"Benign neoplasm of thyroid gland"	1	3	56	59
"K21"	"M93"	"Gastro-esophageal reflux disease"	"Other osteochondropathies"	1	21	109	130
"H47"	"J45"	"Other disorders of optic [2nd] nerve and visual pathways"	"Asthma"	1	64	238	302
"E55"	"H81"	"Vitamin D deficiency"	"Disorders of vestibular function"	1	217	466	683
"A41"	"N14"	"Other sepsis"	"Drug- & heavy-metal-induced tubulo-interstitial & tublr cond"	1	132	235	367
"H93"	"I83"	"Other disorders of ear, not elsewhere classified"	"Varicose veins of lower extremities"	1	697	995	1692
"D50"	"L72"	"Iron deficiency anemia"	"Follicular cysts of skin and subcutaneous tissue"	1	22	90	112
"C18"	"I65"	"Malignant neoplasm of colon"	"Occls and stenosis of precerb art, not rslt in cereb infrc"	1	49	185	234
"I25"	"N87"	"Chronic ischemic heart disease"	"Dysplasia of cervix uteri"	1	1	308	309
"J22"	"O42"	"Unspecified acute lower respiratory infection"	"Premature rupture of membranes"	1	3	47	50
"C22"	"J44"	"Malignant neoplasm of liver and intrahepatic bile ducts"	"Other chronic obstructive pulmonary disease"	1	105	548	653
"M17"	"J37"	"Osteoarthritis of knee"	"Chronic laryngitis and laryngotracheitis"	1	104	302	406
"E11"	"M22"	"Type 2 diabetes mellitus"	"Disorder of patella"	1	0	598	598
"E78"	"O66"	"Disorders of lipoprotein metabolism and other lipidemias"	"Other obstructed labor"	1	0	58	58
"O61"	"N97"	"Failed induction of labor"	"Female infertility"	1	74	688	762
"N13"	"D25"	"Obstructive and reflux uropathy"	"Leiomyoma of uterus"	1	116	546	662
"D64"	"C32"	"Other anemias"	"Malignant neoplasm of larynx"	1	69	290	359
"E11"	"D24"	"Type 2 diabetes mellitus"	"Benign neoplasm of breast"	1	140	707	847
"K21"	"I83"	"Gastro-esophageal reflux disease"	"Varicose veins of lower extremities"	1	886	1584	2470
"J91"	"C16"	"Pleural effusion in conditions classified elsewhere"	"Malignant neoplasm of stomach"	1	66	166	232
"C80"	"C09"	"Malignant neoplasm without specification of site"	"Malignant neoplasm of tonsil"	1	22	76	98
"E10"	"M62"	"Type 1 diabetes mellitus"	"Other disorders of muscle"	1	750	1659	2409
"O72"	"A08"	"Postpartum hemorrhage"	"Viral and other specified intestinal infections"	1	0	508	508
"K31"	"O04"	"Other diseases of stomach and duodenum"	"Complications following (induced) termination of pregnancy"	1	0	81	81
"F02"	"F10"	"Dementia in other diseases classified elsewhere"	"Alcohol related disorders"	1	185	424	609
"G83"	"O04"	"Other paralytic syndromes"	"Complications following (induced) termination of pregnancy"	1	2	96	98
"N19"	"C44"	"Unspecified kidney failure"	"Other and unspecified malignant neoplasm of skin"	1	425	596	1021
"M53"	"A63"	"Other and unspecified dorsopathies, not elsewhere classified"	"Oth predominantly sexually transmitted diseases, NEC"	1	29	142	171
"F05"	"N99"	"Delirium due to known physiological condition"	"Intraop and postproc comp and disorders of GU sys, NEC"	1	0	102	102
"E28"	"E30"	"Ovarian dysfunction"	"Disorders of puberty, not elsewhere classified"	1	1	86	87
"I63"	"M76"	"Cerebral infarction"	"Enthesopathies, lower limb, excluding foot"	1	121	438	559
"E10"	"M51"	"Type 1 diabetes mellitus"	"Thoracic, thoracolum, and lumbosacral intvrt disc disorders"	1	1004	1582	2586
"I15"	"M50"	"Secondary hypertension"	"Cervical disc disorders"	1	46	171	217
"L30"	"O36"	"Other and unspecified dermatitis"	"Maternal care for other fetal problems"	1	99	186	285
"E87"	"I25"	"Other disorders of fluid, electrolyte and acid-base balance"	"Chronic ischemic heart disease"	1	0	12168	12168
"L98"	"J34"	"Oth disorders of skin, subcu, not elsewhere classified"	"Other and unspecified disorders of nose and nasal sinuses"	1	38	170	208
"K56"	"M75"	"Paralytic ileus and intestinal obstruction without hernia"	"Shoulder lesions"	1	538	1232	1770
"E53"	"O04"	"Deficiency of other B group vitamins"	"Complications following (induced) termination of pregnancy"	1	0	58	58
"O66"	"O02"	"Other obstructed labor"	"Other abnormal products of conception"	1	729	1518	2247
"C22"	"I21"	"Malignant neoplasm of liver and intrahepatic bile ducts"	"Acute myocardial infarction"	1	10	286	296
"L57"	"J44"	"Skin changes due to chronic expsr to nonionizing radiation"	"Other chronic obstructive pulmonary disease"	1	287	495	782
"E87"	"D07"	"Other disorders of fluid, electrolyte and acid-base balance"	"Carcinoma in situ of other and unspecified genital organs"	1	10	81	91
"H49"	"D25"	"Paralytic strabismus"	"Leiomyoma of uterus"	1	14	64	78
"J69"	"I25"	"Pneumonitis due to solids and liquids"	"Chronic ischemic heart disease"	1	183	1291	1474
"N17"	"K04"	"Acute kidney failure"	"Diseases of pulp and periapical tissues"	1	137	404	541
"J35"	"J03"	"Chronic diseases of tonsils and adenoids"	"Acute tonsillitis"	1	0	15564	15564
"L98"	"L08"	"Oth disorders of skin, subcu, not elsewhere classified"	"Other local infections of skin and subcutaneous tissue"	1	620	897	1517
"C82"	"M23"	"Follicular lymphoma"	"Internal derangement of knee"	1	27	117	144
"I95"	"E04"	"Hypotension"	"Other nontoxic goiter"	1	60	298	358
"J06"	"E66"	"Acute upper resp infections of multiple and unsp sites"	"Overweight and obesity"	1	317	869	1186
"O72"	"G00"	"Postpartum hemorrhage"	"Bacterial meningitis, not elsewhere classified"	1	0	48	48
"C34"	"I12"	"Malignant neoplasm of bronchus and lung"	"Hypertensive chronic kidney disease"	1	26	124	150
"C77"	"M24"	"Secondary and unspecified malignant neoplasm of lymph nodes"	"Other specific joint derangements"	1	1	65	66
"J91"	"M25"	"Pleural effusion in conditions classified elsewhere"	"Other joint disorder, not elsewhere classified"	1	38	102	140
"C71"	"N62"	"Malignant neoplasm of brain"	"Hypertrophy of breast"	1	6	44	50
"O72"	"Q30"	"Postpartum hemorrhage"	"Congenital malformations of nose"	1	15	112	127
"J69"	"E78"	"Pneumonitis due to solids and liquids"	"Disorders of lipoprotein metabolism and other lipidemias"	1	178	1340	1518
"F17"	"J03"	"Nicotine dependence"	"Acute tonsillitis"	1	159	560	719
"E86"	"Q03"	"Volume depletion"	"Congenital hydrocephalus"	1	11	76	87
"K12"	"N92"	"Stomatitis and related lesions"	"Excessive, frequent and irregular menstruation"	1	86	225	311
"O86"	"N97"	"Other puerperal infections"	"Female infertility"	1	249	1636	1885
"O23"	"O04"	"Infections of genitourinary tract in pregnancy"	"Complications following (induced) termination of pregnancy"	1	1142	2579	3721
"C92"	"M65"	"Myeloid leukemia"	"Synovitis and tenosynovitis"	1	4	60	64
"I25"	"C62"	"Chronic ischemic heart disease"	"Malignant neoplasm of testis"	1	3	127	130
"C50"	"O68"	"Malignant neoplasm of breast"	"Labor and delivery comp by abnlt of fetal acid-base balance"	1	0	394	394
"C24"	"M16"	"Malignant neoplasm of other and unsp parts of biliary tract"	"Osteoarthritis of hip"	1	0	170	170
"N17"	"J42"	"Acute kidney failure"	"Unspecified chronic bronchitis"	1	200	625	825
"K22"	"H93"	"Other diseases of esophagus"	"Other disorders of ear, not elsewhere classified"	1	160	505	665
"I25"	"N84"	"Chronic ischemic heart disease"	"Polyp of female genital tract"	1	409	575	984
"M79"	"O23"	"Oth and unsp soft tissue disorders, not elsewhere classified"	"Infections of genitourinary tract in pregnancy"	1	472	667	1139
"F41"	"N60"	"Other anxiety disorders"	"Benign mammary dysplasia"	1	26	284	310
"J96"	"O62"	"Respiratory failure, not elsewhere classified"	"Abnormalities of forces of labor"	1	0	261	261
"D62"	"H93"	"Acute posthemorrhagic anemia"	"Other disorders of ear, not elsewhere classified"	1	14	296	310
"H36"	"N46"	"Retinal disorders in diseases classified elsewhere"	"Male infertility"	1	29	112	141
"M70"	"O42"	"Soft tissue disorders related to use, overuse and pressure"	"Premature rupture of membranes"	1	66	182	248
"H40"	"O68"	"Glaucoma"	"Labor and delivery comp by abnlt of fetal acid-base balance"	1	0	50	50
"I49"	"H83"	"Other cardiac arrhythmias"	"Other diseases of inner ear"	1	140	898	1038
"C90"	"E66"	"Multiple myeloma and malignant plasma cell neoplasms"	"Overweight and obesity"	1	35	150	185
"L89"	"I83"	"Pressure ulcer"	"Varicose veins of lower extremities"	1	380	1161	1541
"J09"	"J34"	"Influenza due to certain identified influenza viruses"	"Other and unspecified disorders of nose and nasal sinuses"	1	2	31	33
"J84"	"L40"	"Other interstitial pulmonary diseases"	"Psoriasis"	1	43	120	163
"I25"	"O34"	"Chronic ischemic heart disease"	"Maternal care for abnormality of pelvic organs"	1	0	55	55
"E87"	"N03"	"Other disorders of fluid, electrolyte and acid-base balance"	"Chronic nephritic syndrome"	1	78	234	312
"F31"	"O26"	"Bipolar disorder"	"Maternal care for oth conditions predom related to pregnancy"	1	0	44	44
"J44"	"O64"	"Other chronic obstructive pulmonary disease"	"Obstructed labor due to malposition and malpresent of fetus"	1	0	35	35
"J84"	"H43"	"Other interstitial pulmonary diseases"	"Disorders of vitreous body"	1	36	108	144
"N63"	"H80"	"Unspecified lump in breast"	"Otosclerosis"	1	25	101	126
"J13"	"M17"	"Pneumonia due to Streptococcus pneumoniae"	"Osteoarthritis of knee"	1	70	284	354
"D72"	"O20"	"Other disorders of white blood cells"	"Hemorrhage in early pregnancy"	1	0	26	26
"C16"	"H52"	"Malignant neoplasm of stomach"	"Disorders of refraction and accommodation"	1	2	38	40
"A46"	"J42"	"Erysipelas"	"Unspecified chronic bronchitis"	1	503	1028	1531
"D12"	"C54"	"Benign neoplasm of colon, rectum, anus and anal canal"	"Malignant neoplasm of corpus uteri"	1	111	306	417
"D64"	"M34"	"Other anemias"	"Systemic sclerosis [scleroderma]"	1	41	105	146
"I72"	"I47"	"Other aneurysm"	"Paroxysmal tachycardia"	1	98	269	367
"K64"	"H26"	"Hemorrhoids and perianal venous thrombosis"	"Other cataract"	1	152	608	760
"I48"	"O66"	"Atrial fibrillation and flutter"	"Other obstructed labor"	1	0	28	28
"N17"	"D16"	"Acute kidney failure"	"Benign neoplasm of bone and articular cartilage"	1	0	26	26
"L02"	"O04"	"Cutaneous abscess, furuncle and carbuncle"	"Complications following (induced) termination of pregnancy"	1	457	2170	2627
"I31"	"I83"	"Other diseases of pericardium"	"Varicose veins of lower extremities"	1	19	104	123
"D63"	"K83"	"Anemia in chronic diseases classified elsewhere"	"Other diseases of biliary tract"	1	212	390	602
"E05"	"L20"	"Thyrotoxicosis [hyperthyroidism]"	"Atopic dermatitis"	1	16	70	86
"D69"	"I47"	"Purpura and other hemorrhagic conditions"	"Paroxysmal tachycardia"	1	150	341	491
"K72"	"L98"	"Hepatic failure, not elsewhere classified"	"Oth disorders of skin, subcu, not elsewhere classified"	1	60	134	194
"N18"	"N47"	"Chronic kidney disease (CKD)"	"Disorders of prepuce"	1	98	599	697
"K92"	"N87"	"Other diseases of digestive system"	"Dysplasia of cervix uteri"	1	56	176	232
"M54"	"D06"	"Dorsalgia"	"Carcinoma in situ of cervix uteri"	1	47	341	388
"G47"	"D17"	"Sleep disorders"	"Benign lipomatous neoplasm"	1	240	1017	1257
"E87"	"E10"	"Other disorders of fluid, electrolyte and acid-base balance"	"Type 1 diabetes mellitus"	1	0	5665	5665
"D59"	"E78"	"Acquired hemolytic anemia"	"Disorders of lipoprotein metabolism and other lipidemias"	1	71	155	226
"M80"	"K26"	"Osteoporosis with current pathological fracture"	"Duodenal ulcer"	1	564	1148	1712
"J47"	"L20"	"Bronchiectasis"	"Atopic dermatitis"	1	4	34	38
"I69"	"M25"	"Sequelae of cerebrovascular disease"	"Other joint disorder, not elsewhere classified"	1	424	917	1341
"J44"	"M75"	"Other chronic obstructive pulmonary disease"	"Shoulder lesions"	1	1835	4460	6295
"G56"	"O26"	"Mononeuropathies of upper limb"	"Maternal care for oth conditions predom related to pregnancy"	1	292	1481	1773
"M47"	"O80"	"Spondylosis"	"Encounter for full-term uncomplicated delivery"	1	0	663	663
"D12"	"J42"	"Benign neoplasm of colon, rectum, anus and anal canal"	"Unspecified chronic bronchitis"	1	564	843	1407
"E27"	"J42"	"Other disorders of adrenal gland"	"Unspecified chronic bronchitis"	1	37	114	151
"J15"	"O08"	"Bacterial pneumonia, not elsewhere classified"	"Complications following ectopic and molar pregnancy"	1	19	88	107
"C06"	"K30"	"Malignant neoplasm of other and unspecified parts of mouth"	"Functional dyspepsia"	1	17	70	87
"M35"	"N81"	"Other systemic involvement of connective tissue"	"Female genital prolapse"	1	490	735	1225
"K59"	"O32"	"Other functional intestinal disorders"	"Maternal care for malpresentation of fetus"	1	133	384	517
"K26"	"O68"	"Duodenal ulcer"	"Labor and delivery comp by abnlt of fetal acid-base balance"	1	24	74	98
"C91"	"F10"	"Lymphoid leukemia"	"Alcohol related disorders"	1	36	123	159
"J15"	"L98"	"Bacterial pneumonia, not elsewhere classified"	"Oth disorders of skin, subcu, not elsewhere classified"	1	637	1079	1716
"D47"	"M75"	"Oth neoplm of uncrt behav of lymphoid, hematpoetc & rel tiss"	"Shoulder lesions"	1	51	476	527
"E05"	"F10"	"Thyrotoxicosis [hyperthyroidism]"	"Alcohol related disorders"	1	257	629	886
"A49"	"G91"	"Bacterial infection of unspecified site"	"Hydrocephalus"	1	158	308	466
"E86"	"H35"	"Volume depletion"	"Other retinal disorders"	1	0	9442	9442
"N98"	"N70"	"Complications associated with artificial fertilization"	"Salpingitis and oophoritis"	1	57	153	210
"M85"	"O62"	"Other disorders of bone density and structure"	"Abnormalities of forces of labor"	1	0	275	275
"C79"	"D45"	"Secondary malignant neoplasm of other and unspecified sites"	"Polycythemia vera"	1	6	44	50
"N18"	"O13"	"Chronic kidney disease (CKD)"	"Gestational hypertension without significant proteinuria"	1	4	43	47
"I21"	"N70"	"Acute myocardial infarction"	"Salpingitis and oophoritis"	1	0	97	97
"I83"	"N87"	"Varicose veins of lower extremities"	"Dysplasia of cervix uteri"	1	244	751	995
"H93"	"O26"	"Other disorders of ear, not elsewhere classified"	"Maternal care for oth conditions predom related to pregnancy"	1	4	233	237
"I70"	"N80"	"Atherosclerosis"	"Endometriosis"	1	13	74	87
"J15"	"I05"	"Bacterial pneumonia, not elsewhere classified"	"Rheumatic mitral valve diseases"	1	59	160	219
"I50"	"F10"	"Heart failure"	"Alcohol related disorders"	1	2201	4884	7085
"J96"	"M79"	"Respiratory failure, not elsewhere classified"	"Oth and unsp soft tissue disorders, not elsewhere classified"	1	0	5286	5286
"I48"	"M16"	"Atrial fibrillation and flutter"	"Osteoarthritis of hip"	1	0	13582	13582
"C79"	"J44"	"Secondary malignant neoplasm of other and unspecified sites"	"Other chronic obstructive pulmonary disease"	1	0	4164	4164
"N94"	"O14"	"Pain and oth cond assoc w fem gntl org and menstrual cycle"	"Pre-eclampsia"	1	133	414	547
"B44"	"C92"	"Aspergillosis"	"Myeloid leukemia"	1	63	204	267
"I46"	"K61"	"Cardiac arrest"	"Abscess of anal and rectal regions"	1	0	198	198
"I95"	"I80"	"Hypotension"	"Phlebitis and thrombophlebitis"	1	263	860	1123
"A41"	"G37"	"Other sepsis"	"Other demyelinating diseases of central nervous system"	1	32	149	181
"B02"	"C91"	"Zoster [herpes zoster]"	"Lymphoid leukemia"	1	90	428	518
"M21"	"B34"	"Other acquired deformities of limbs"	"Viral infection of unspecified site"	1	112	533	645
"D43"	"J34"	"Neoplasm of uncertain behavior of brain and cnsl"	"Other and unspecified disorders of nose and nasal sinuses"	1	2	32	34
"M81"	"M17"	"Osteoporosis without current pathological fracture"	"Osteoarthritis of knee"	1	0	7371	7371
"I46"	"M70"	"Cardiac arrest"	"Soft tissue disorders related to use, overuse and pressure"	1	0	464	464
"H33"	"H36"	"Retinal detachments and breaks"	"Retinal disorders in diseases classified elsewhere"	1	503	942	1445
"N84"	"O48"	"Polyp of female genital tract"	"Late pregnancy"	1	0	267	267
"C71"	"D30"	"Malignant neoplasm of brain"	"Benign neoplasm of urinary organs"	1	7	95	102
"M19"	"B18"	"Other and unspecified osteoarthritis"	"Chronic viral hepatitis"	1	63	154	217
"C57"	"I83"	"Malignant neoplasm of other and unsp female genital organs"	"Varicose veins of lower extremities"	1	0	29	29
"K05"	"C90"	"Gingivitis and periodontal diseases"	"Multiple myeloma and malignant plasma cell neoplasms"	1	297	577	874
"O72"	"K22"	"Postpartum hemorrhage"	"Other diseases of esophagus"	1	80	169	249
"L70"	"K51"	"Acne"	"Ulcerative colitis"	1	55	143	198
"A41"	"H52"	"Other sepsis"	"Disorders of refraction and accommodation"	1	145	534	679
"N39"	"I49"	"Other disorders of urinary system"	"Other cardiac arrhythmias"	1	1635	3128	4763
"K76"	"K29"	"Other diseases of liver"	"Gastritis and duodenitis"	1	1051	1589	2640
"B02"	"M35"	"Zoster [herpes zoster]"	"Other systemic involvement of connective tissue"	1	146	251	397
"E60"	"J44"	"Dietary zinc deficiency"	"Other chronic obstructive pulmonary disease"	1	55	137	192
"M85"	"L53"	"Other disorders of bone density and structure"	"Other erythematous conditions"	1	4	38	42
"F41"	"O04"	"Other anxiety disorders"	"Complications following (induced) termination of pregnancy"	1	0	1100	1100
"A51"	"M23"	"Early syphilis"	"Internal derangement of knee"	1	8	45	53
"F03"	"K86"	"Unspecified dementia"	"Other diseases of pancreas"	1	71	287	358
"C24"	"I49"	"Malignant neoplasm of other and unsp parts of biliary tract"	"Other cardiac arrhythmias"	1	17	62	79
"I48"	"K44"	"Atrial fibrillation and flutter"	"Diaphragmatic hernia"	1	1576	3766	5342
"F60"	"O03"	"Specific personality disorders"	"Spontaneous abortion"	1	14	156	170
"C34"	"H44"	"Malignant neoplasm of bronchus and lung"	"Disorders of globe"	1	20	111	131
"C71"	"H36"	"Malignant neoplasm of brain"	"Retinal disorders in diseases classified elsewhere"	1	12	51	63
"K25"	"K35"	"Gastric ulcer"	"Acute appendicitis"	1	317	501	818
"C06"	"M72"	"Malignant neoplasm of other and unspecified parts of mouth"	"Fibroblastic disorders"	1	7	66	73
"K91"	"N97"	"Intraop and postproc comp and disorders of dgstv sys, NEC"	"Female infertility"	1	23	89	112
"M20"	"O46"	"Acquired deformities of fingers and toes"	"Antepartum hemorrhage, not elsewhere classified"	1	29	105	134
"D69"	"Q54"	"Purpura and other hemorrhagic conditions"	"Hypospadias"	1	4	38	42
"I73"	"H80"	"Other peripheral vascular diseases"	"Otosclerosis"	1	0	146	146
"E04"	"O30"	"Other nontoxic goiter"	"Multiple gestation"	1	27	233	260
"D12"	"H33"	"Benign neoplasm of colon, rectum, anus and anal canal"	"Retinal detachments and breaks"	1	263	764	1027
"C44"	"J38"	"Other and unspecified malignant neoplasm of skin"	"Diseases of vocal cords and larynx, not elsewhere classified"	1	92	237	329
"J69"	"K60"	"Pneumonitis due to solids and liquids"	"Fissure and fistula of anal and rectal regions"	1	5	72	77
"M23"	"O32"	"Internal derangement of knee"	"Maternal care for malpresentation of fetus"	1	269	458	727
"E66"	"H80"	"Overweight and obesity"	"Otosclerosis"	1	41	309	350
"M19"	"O75"	"Other and unspecified osteoarthritis"	"Oth complications of labor and delivery, NEC"	1	0	82	82
"H49"	"O03"	"Paralytic strabismus"	"Spontaneous abortion"	1	4	35	39
"E66"	"L91"	"Overweight and obesity"	"Hypertrophic disorders of skin"	1	35	115	150
"M21"	"H10"	"Other acquired deformities of limbs"	"Conjunctivitis"	1	97	306	403
"D09"	"I25"	"Carcinoma in situ of other and unspecified sites"	"Chronic ischemic heart disease"	1	42	507	549
"I44"	"I20"	"Atrioventricular and left bundle-branch block"	"Angina pectoris"	1	0	6691	6691
"C41"	"M54"	"Malignant neoplasm of bone/artic cartl of and unsp sites"	"Dorsalgia"	1	149	271	420
"L57"	"H02"	"Skin changes due to chronic expsr to nonionizing radiation"	"Other disorders of eyelid"	1	336	523	859
"C78"	"C43"	"Secondary malignant neoplasm of resp and digestive organs"	"Malignant melanoma of skin"	1	496	1853	2349
"C61"	"G44"	"Malignant neoplasm of prostate"	"Other headache syndromes"	1	19	130	149
"F31"	"H93"	"Bipolar disorder"	"Other disorders of ear, not elsewhere classified"	1	17	99	116
"C85"	"M23"	"Oth and unspecified types of non-Hodgkin lymphoma"	"Internal derangement of knee"	1	67	209	276
"M10"	"H35"	"Gout"	"Other retinal disorders"	1	587	878	1465
"I10"	"N20"	"Essential (primary) hypertension"	"Calculus of kidney and ureter"	1	3036	6462	9498
"C82"	"D11"	"Follicular lymphoma"	"Benign neoplasm of major salivary glands"	1	26	91	117
"I63"	"K61"	"Cerebral infarction"	"Abscess of anal and rectal regions"	1	88	437	525
"L08"	"O82"	"Other local infections of skin and subcutaneous tissue"	"Encounter for cesarean delivery without indication"	1	241	644	885
"C90"	"K44"	"Multiple myeloma and malignant plasma cell neoplasms"	"Diaphragmatic hernia"	1	34	145	179
"M96"	"O04"	"Intraop and postproc comp and disorders of ms sys, NEC"	"Complications following (induced) termination of pregnancy"	1	0	54	54
"F17"	"I60"	"Nicotine dependence"	"Nontraumatic subarachnoid hemorrhage"	1	57	138	195
"E22"	"O20"	"Hyperfunction of pituitary gland"	"Hemorrhage in early pregnancy"	1	25	81	106
"L98"	"C20"	"Oth disorders of skin, subcu, not elsewhere classified"	"Malignant neoplasm of rectum"	1	81	221	302
"D05"	"O80"	"Carcinoma in situ of breast"	"Encounter for full-term uncomplicated delivery"	1	0	116	116
"M17"	"O72"	"Osteoarthritis of knee"	"Postpartum hemorrhage"	1	128	602	730
"C83"	"I25"	"Non-follicular lymphoma"	"Chronic ischemic heart disease"	1	243	534	777
"L89"	"K57"	"Pressure ulcer"	"Diverticular disease of intestine"	1	170	827	997
"J90"	"H52"	"Pleural effusion, not elsewhere classified"	"Disorders of refraction and accommodation"	1	24	99	123
"J69"	"M72"	"Pneumonitis due to solids and liquids"	"Fibroblastic disorders"	1	0	126	126
"N17"	"N63"	"Acute kidney failure"	"Unspecified lump in breast"	1	0	144	144
"E78"	"M06"	"Disorders of lipoprotein metabolism and other lipidemias"	"Other rheumatoid arthritis"	1	831	1104	1935
"O35"	"M24"	"Maternal care for known or suspected fetal abnlt and damage"	"Other specific joint derangements"	1	7	52	59
"J18"	"C32"	"Pneumonia, unspecified organism"	"Malignant neoplasm of larynx"	1	311	1112	1423
"J47"	"E66"	"Bronchiectasis"	"Overweight and obesity"	1	101	303	404
"K58"	"H66"	"Irritable bowel syndrome"	"Suppurative and unspecified otitis media"	1	31	187	218
"O36"	"F10"	"Maternal care for other fetal problems"	"Alcohol related disorders"	1	107	670	777
"E86"	"G91"	"Volume depletion"	"Hydrocephalus"	1	340	703	1043
"F17"	"M23"	"Nicotine dependence"	"Internal derangement of knee"	1	421	2178	2599
"N10"	"O80"	"Acute pyelonephritis"	"Encounter for full-term uncomplicated delivery"	1	720	1007	1727
"A49"	"Q90"	"Bacterial infection of unspecified site"	"Down syndrome"	1	6	53	59
"K92"	"H43"	"Other diseases of digestive system"	"Disorders of vitreous body"	1	137	411	548
"I44"	"I70"	"Atrioventricular and left bundle-branch block"	"Atherosclerosis"	1	848	1303	2151
"K05"	"M75"	"Gingivitis and periodontal diseases"	"Shoulder lesions"	1	346	539	885
"C22"	"H93"	"Malignant neoplasm of liver and intrahepatic bile ducts"	"Other disorders of ear, not elsewhere classified"	1	0	116	116
"C22"	"G45"	"Malignant neoplasm of liver and intrahepatic bile ducts"	"Transient cerebral ischemic attacks and related syndromes"	1	12	178	190
"F06"	"K60"	"Other mental disorders due to known physiological condition"	"Fissure and fistula of anal and rectal regions"	1	4	46	50
"M46"	"L02"	"Other inflammatory spondylopathies"	"Cutaneous abscess, furuncle and carbuncle"	1	129	325	454
"K00"	"Q89"	"Disorders of tooth development and eruption"	"Other congenital malformations, not elsewhere classified"	1	0	38	38
"H36"	"J34"	"Retinal disorders in diseases classified elsewhere"	"Other and unspecified disorders of nose and nasal sinuses"	1	34	111	145
"H36"	"H66"	"Retinal disorders in diseases classified elsewhere"	"Suppurative and unspecified otitis media"	1	15	114	129
"B96"	"H93"	"Oth bacterial agents as the cause of diseases classd elswhr"	"Other disorders of ear, not elsewhere classified"	1	2	79	81
"I70"	"I83"	"Atherosclerosis"	"Varicose veins of lower extremities"	1	2430	2975	5405
"K81"	"J34"	"Cholecystitis"	"Other and unspecified disorders of nose and nasal sinuses"	1	22	89	111
"N48"	"K35"	"Other disorders of penis"	"Acute appendicitis"	1	79	165	244
"C90"	"M70"	"Multiple myeloma and malignant plasma cell neoplasms"	"Soft tissue disorders related to use, overuse and pressure"	1	16	72	88
"I35"	"N50"	"Nonrheumatic aortic valve disorders"	"Other and unspecified disorders of male genital organs"	1	75	195	270
"N39"	"O10"	"Other disorders of urinary system"	"Pre-existing hypertension compl preg/chldbrth"	1	30	130	160
"J32"	"O65"	"Chronic sinusitis"	"Obstructed labor due to maternal pelvic abnormality"	1	0	117	117
"E89"	"J03"	"Postproc endocrine and metabolic comp and disorders, NEC"	"Acute tonsillitis"	1	14	73	87
"K05"	"C85"	"Gingivitis and periodontal diseases"	"Oth and unspecified types of non-Hodgkin lymphoma"	1	167	347	514
"D22"	"H91"	"Melanocytic nevi"	"Other and unspecified hearing loss"	1	275	463	738
"G47"	"I48"	"Sleep disorders"	"Atrial fibrillation and flutter"	1	2029	3665	5694
"F03"	"M17"	"Unspecified dementia"	"Osteoarthritis of knee"	1	0	3397	3397
"K56"	"M21"	"Paralytic ileus and intestinal obstruction without hernia"	"Other acquired deformities of limbs"	1	94	203	297
"F41"	"O14"	"Other anxiety disorders"	"Pre-eclampsia"	1	52	158	210
"E89"	"O21"	"Postproc endocrine and metabolic comp and disorders, NEC"	"Excessive vomiting in pregnancy"	1	1	30	31
"J69"	"M41"	"Pneumonitis due to solids and liquids"	"Scoliosis"	1	14	78	92
"K62"	"D24"	"Other diseases of anus and rectum"	"Benign neoplasm of breast"	1	78	580	658
"D50"	"H04"	"Iron deficiency anemia"	"Disorders of lacrimal system"	1	25	106	131
"K76"	"M22"	"Other diseases of liver"	"Disorder of patella"	1	1	170	171
"J18"	"F10"	"Pneumonia, unspecified organism"	"Alcohol related disorders"	1	0	21250	21250
"K82"	"O70"	"Other diseases of gallbladder"	"Perineal laceration during delivery"	1	1	90	91
"K76"	"O82"	"Other diseases of liver"	"Encounter for cesarean delivery without indication"	1	14	271	285
"F41"	"C90"	"Other anxiety disorders"	"Multiple myeloma and malignant plasma cell neoplasms"	1	26	162	188
"G47"	"E64"	"Sleep disorders"	"Sequelae of malnutrition and other nutritional deficiencies"	1	180	427	607
"I95"	"M75"	"Hypotension"	"Shoulder lesions"	1	161	832	993
"G93"	"M02"	"Other disorders of brain"	"Postinfective and reactive arthropathies"	1	5	45	50
"K25"	"O04"	"Gastric ulcer"	"Complications following (induced) termination of pregnancy"	1	0	408	408
"K29"	"O48"	"Gastritis and duodenitis"	"Late pregnancy"	1	53	213	266
"J44"	"D27"	"Other chronic obstructive pulmonary disease"	"Benign neoplasm of ovary"	1	185	797	982
"K22"	"H33"	"Other diseases of esophagus"	"Retinal detachments and breaks"	1	64	151	215
"K81"	"O48"	"Cholecystitis"	"Late pregnancy"	1	0	140	140
"N31"	"H83"	"Neuromuscular dysfunction of bladder, NEC"	"Other diseases of inner ear"	1	75	195	270
"J15"	"J41"	"Bacterial pneumonia, not elsewhere classified"	"Simple and mucopurulent chronic bronchitis"	1	397	918	1315
"B18"	"L05"	"Chronic viral hepatitis"	"Pilonidal cyst and sinus"	1	8	55	63
"C43"	"M67"	"Malignant melanoma of skin"	"Other disorders of synovium and tendon"	1	114	207	321
"C50"	"N87"	"Malignant neoplasm of breast"	"Dysplasia of cervix uteri"	1	7	474	481
"F41"	"O20"	"Other anxiety disorders"	"Hemorrhage in early pregnancy"	1	6	548	554
"A46"	"O75"	"Erysipelas"	"Oth complications of labor and delivery, NEC"	1	10	67	77
"K86"	"D24"	"Other diseases of pancreas"	"Benign neoplasm of breast"	1	16	67	83
"J40"	"K40"	"Bronchitis, not specified as acute or chronic"	"Inguinal hernia"	1	115	223	338
"J15"	"N00"	"Bacterial pneumonia, not elsewhere classified"	"Acute nephritic syndrome"	1	117	209	326
"K55"	"B18"	"Vascular disorders of intestine"	"Chronic viral hepatitis"	1	1	27	28
"D47"	"C61"	"Oth neoplm of uncrt behav of lymphoid, hematpoetc & rel tiss"	"Malignant neoplasm of prostate"	1	79	191	270
"H43"	"K21"	"Disorders of vitreous body"	"Gastro-esophageal reflux disease"	1	242	427	669
"J91"	"I35"	"Pleural effusion in conditions classified elsewhere"	"Nonrheumatic aortic valve disorders"	1	290	603	893
"A49"	"E89"	"Bacterial infection of unspecified site"	"Postproc endocrine and metabolic comp and disorders, NEC"	1	83	163	246
"I35"	"N03"	"Nonrheumatic aortic valve disorders"	"Chronic nephritic syndrome"	1	32	161	193
"J90"	"N43"	"Pleural effusion, not elsewhere classified"	"Hydrocele and spermatocele"	1	15	180	195
"I10"	"N46"	"Essential (primary) hypertension"	"Male infertility"	1	56	515	571
"H04"	"O04"	"Disorders of lacrimal system"	"Complications following (induced) termination of pregnancy"	1	5	93	98
"M20"	"O42"	"Acquired deformities of fingers and toes"	"Premature rupture of membranes"	1	119	212	331
"I69"	"M18"	"Sequelae of cerebrovascular disease"	"Osteoarthritis of first carpometacarpal joint"	1	120	342	462
"I72"	"D17"	"Other aneurysm"	"Benign lipomatous neoplasm"	1	17	65	82
"J03"	"N10"	"Acute tonsillitis"	"Acute pyelonephritis"	1	585	1008	1593
"O72"	"K61"	"Postpartum hemorrhage"	"Abscess of anal and rectal regions"	1	163	594	757
"J70"	"K40"	"Respiratory conditions due to other external agents"	"Inguinal hernia"	1	6	46	52
"C71"	"I73"	"Malignant neoplasm of brain"	"Other peripheral vascular diseases"	1	24	141	165
"K22"	"M16"	"Other diseases of esophagus"	"Osteoarthritis of hip"	1	344	843	1187
"C25"	"H52"	"Malignant neoplasm of pancreas"	"Disorders of refraction and accommodation"	1	0	58	58
"K74"	"K80"	"Fibrosis and cirrhosis of liver"	"Cholelithiasis"	1	427	909	1336
"N84"	"A63"	"Polyp of female genital tract"	"Oth predominantly sexually transmitted diseases, NEC"	1	52	291	343
"O47"	"K01"	"False labor"	"Embedded and impacted teeth"	1	17	142	159
"I20"	"O70"	"Angina pectoris"	"Perineal laceration during delivery"	1	0	346	346
"G96"	"G43"	"Other disorders of central nervous system"	"Migraine"	1	450	752	1202
"N39"	"D23"	"Other disorders of urinary system"	"Other benign neoplasms of skin"	1	419	1242	1661
"F41"	"N95"	"Other anxiety disorders"	"Menopausal and other perimenopausal disorders"	1	141	466	607
"J44"	"B18"	"Other chronic obstructive pulmonary disease"	"Chronic viral hepatitis"	1	203	442	645
"G35"	"D06"	"Multiple sclerosis"	"Carcinoma in situ of cervix uteri"	1	2	35	37
"M53"	"K30"	"Other and unspecified dorsopathies, not elsewhere classified"	"Functional dyspepsia"	1	401	743	1144
"N99"	"D30"	"Intraop and postproc comp and disorders of GU sys, NEC"	"Benign neoplasm of urinary organs"	1	206	597	803
"K80"	"M02"	"Cholelithiasis"	"Postinfective and reactive arthropathies"	1	148	296	444
"A49"	"C24"	"Bacterial infection of unspecified site"	"Malignant neoplasm of other and unsp parts of biliary tract"	1	85	182	267
"D12"	"C53"	"Benign neoplasm of colon, rectum, anus and anal canal"	"Malignant neoplasm of cervix uteri"	1	19	122	141
"F03"	"F99"	"Unspecified dementia"	"Mental disorder, not otherwise specified"	1	62	141	203
"G82"	"H65"	"Paraplegia (paraparesis) and quadriplegia (quadriparesis)"	"Nonsuppurative otitis media"	1	59	187	246
"E86"	"K57"	"Volume depletion"	"Diverticular disease of intestine"	1	0	9291	9291
"A41"	"M20"	"Other sepsis"	"Acquired deformities of fingers and toes"	1	0	1472	1472
"I48"	"N20"	"Atrial fibrillation and flutter"	"Calculus of kidney and ureter"	1	1021	2632	3653
"C56"	"N87"	"Malignant neoplasm of ovary"	"Dysplasia of cervix uteri"	1	10	108	118
"H60"	"H83"	"Otitis externa"	"Other diseases of inner ear"	1	243	407	650
"K02"	"I35"	"Dental caries"	"Nonrheumatic aortic valve disorders"	1	647	1532	2179
"H52"	"Q35"	"Disorders of refraction and accommodation"	"Cleft palate"	1	13	103	116
"L89"	"D12"	"Pressure ulcer"	"Benign neoplasm of colon, rectum, anus and anal canal"	1	120	547	667
"C61"	"L05"	"Malignant neoplasm of prostate"	"Pilonidal cyst and sinus"	1	1	41	42
"G43"	"Q17"	"Migraine"	"Other congenital malformations of ear"	1	18	153	171
"K80"	"D28"	"Cholelithiasis"	"Benign neoplasm of other and unsp female genital organs"	1	79	164	243
"C24"	"I20"	"Malignant neoplasm of other and unsp parts of biliary tract"	"Angina pectoris"	1	0	253	253
"J32"	"O71"	"Chronic sinusitis"	"Other obstetric trauma"	1	14	123	137
"D25"	"O99"	"Leiomyoma of uterus"	"Oth maternal diseases classd elsw but compl preg/chldbrth"	1	291	1218	1509
"A04"	"K62"	"Other bacterial intestinal infections"	"Other diseases of anus and rectum"	1	476	963	1439
"N64"	"C50"	"Other disorders of breast"	"Malignant neoplasm of breast"	1	549	984	1533
"E27"	"I83"	"Other disorders of adrenal gland"	"Varicose veins of lower extremities"	1	27	158	185
"L57"	"N00"	"Skin changes due to chronic expsr to nonionizing radiation"	"Acute nephritic syndrome"	1	0	34	34
"J91"	"I21"	"Pleural effusion in conditions classified elsewhere"	"Acute myocardial infarction"	1	212	906	1118
"E86"	"I49"	"Volume depletion"	"Other cardiac arrhythmias"	1	0	5381	5381
"K59"	"J34"	"Other functional intestinal disorders"	"Other and unspecified disorders of nose and nasal sinuses"	1	255	1030	1285
"C16"	"L30"	"Malignant neoplasm of stomach"	"Other and unspecified dermatitis"	1	13	71	84
"A49"	"C77"	"Bacterial infection of unspecified site"	"Secondary and unspecified malignant neoplasm of lymph nodes"	1	453	982	1435
"C78"	"D45"	"Secondary malignant neoplasm of resp and digestive organs"	"Polycythemia vera"	1	4	51	55
"J84"	"H81"	"Other interstitial pulmonary diseases"	"Disorders of vestibular function"	1	53	218	271
"C44"	"M06"	"Other and unspecified malignant neoplasm of skin"	"Other rheumatoid arthritis"	1	177	513	690
"E27"	"M35"	"Other disorders of adrenal gland"	"Other systemic involvement of connective tissue"	1	88	353	441
"C77"	"N63"	"Secondary and unspecified malignant neoplasm of lymph nodes"	"Unspecified lump in breast"	1	116	1022	1138
"L08"	"O65"	"Other local infections of skin and subcutaneous tissue"	"Obstructed labor due to maternal pelvic abnormality"	1	0	123	123
"K12"	"B34"	"Stomatitis and related lesions"	"Viral infection of unspecified site"	1	358	545	903
"E78"	"D23"	"Disorders of lipoprotein metabolism and other lipidemias"	"Other benign neoplasms of skin"	1	710	1291	2001
"K31"	"E11"	"Other diseases of stomach and duodenum"	"Type 2 diabetes mellitus"	1	319	787	1106
"I46"	"H11"	"Cardiac arrest"	"Other disorders of conjunctiva"	1	0	121	121
"K92"	"H26"	"Other diseases of digestive system"	"Other cataract"	1	633	1833	2466
"L97"	"H72"	"Non-pressure chronic ulcer of lower limb, NEC"	"Perforation of tympanic membrane"	1	5	57	62
"M79"	"J34"	"Oth and unsp soft tissue disorders, not elsewhere classified"	"Other and unspecified disorders of nose and nasal sinuses"	1	917	1558	2475
"N13"	"K44"	"Obstructive and reflux uropathy"	"Diaphragmatic hernia"	1	229	463	692
"N20"	"N75"	"Calculus of kidney and ureter"	"Diseases of Bartholin's gland"	1	34	100	134
"G24"	"O04"	"Dystonia"	"Complications following (induced) termination of pregnancy"	1	0	120	120
"N50"	"Q54"	"Other and unspecified disorders of male genital organs"	"Hypospadias"	1	55	194	249
"K65"	"O68"	"Peritonitis"	"Labor and delivery comp by abnlt of fetal acid-base balance"	1	49	194	243
"E13"	"H10"	"Other specified diabetes mellitus"	"Conjunctivitis"	1	0	71	71
"M16"	"N92"	"Osteoarthritis of hip"	"Excessive, frequent and irregular menstruation"	1	0	1532	1532
"I70"	"D30"	"Atherosclerosis"	"Benign neoplasm of urinary organs"	1	470	685	1155
"J15"	"G44"	"Bacterial pneumonia, not elsewhere classified"	"Other headache syndromes"	1	132	557	689
"L89"	"H93"	"Pressure ulcer"	"Other disorders of ear, not elsewhere classified"	1	0	271	271
"G25"	"M23"	"Other extrapyramidal and movement disorders"	"Internal derangement of knee"	1	56	327	383
"J90"	"N21"	"Pleural effusion, not elsewhere classified"	"Calculus of lower urinary tract"	1	9	79	88
"I67"	"O02"	"Other cerebrovascular diseases"	"Other abnormal products of conception"	1	0	35	35
"J96"	"N62"	"Respiratory failure, not elsewhere classified"	"Hypertrophy of breast"	1	44	581	625
"C51"	"N92"	"Malignant neoplasm of vulva"	"Excessive, frequent and irregular menstruation"	1	10	48	58
"J18"	"Q65"	"Pneumonia, unspecified organism"	"Congenital deformities of hip"	1	338	486	824
"D64"	"C56"	"Other anemias"	"Malignant neoplasm of ovary"	1	326	1147	1473
"G31"	"H43"	"Oth degenerative diseases of nervous system, NEC"	"Disorders of vitreous body"	1	10	52	62
"N18"	"N83"	"Chronic kidney disease (CKD)"	"Noninflammatory disord of ovary, fallop and broad ligament"	1	121	320	441
"H35"	"K80"	"Other retinal disorders"	"Cholelithiasis"	1	1051	2486	3537
"E63"	"G56"	"Other nutritional deficiencies"	"Mononeuropathies of upper limb"	1	3	35	38
"I20"	"K66"	"Angina pectoris"	"Other disorders of peritoneum"	1	82	183	265
"N30"	"M71"	"Cystitis"	"Other bursopathies"	1	268	843	1111
"N83"	"O68"	"Noninflammatory disord of ovary, fallop and broad ligament"	"Labor and delivery comp by abnlt of fetal acid-base balance"	1	941	1755	2696
"C43"	"O99"	"Malignant melanoma of skin"	"Oth maternal diseases classd elsw but compl preg/chldbrth"	1	94	247	341
"N08"	"E11"	"Glomerular disorders in diseases classified elsewhere"	"Type 2 diabetes mellitus"	1	44	634	678
"C78"	"H65"	"Secondary malignant neoplasm of resp and digestive organs"	"Nonsuppurative otitis media"	1	0	228	228
"I35"	"I70"	"Nonrheumatic aortic valve disorders"	"Atherosclerosis"	1	1810	2541	4351
"O72"	"I95"	"Postpartum hemorrhage"	"Hypotension"	1	62	169	231
"C91"	"K30"	"Lymphoid leukemia"	"Functional dyspepsia"	1	45	129	174
"I89"	"L02"	"Oth noninfective disorders of lymphatic vessels and nodes"	"Cutaneous abscess, furuncle and carbuncle"	1	236	361	597
"O20"	"O04"	"Hemorrhage in early pregnancy"	"Complications following (induced) termination of pregnancy"	1	4212	6333	10545
"L98"	"K61"	"Oth disorders of skin, subcu, not elsewhere classified"	"Abscess of anal and rectal regions"	1	114	350	464
"E05"	"M65"	"Thyrotoxicosis [hyperthyroidism]"	"Synovitis and tenosynovitis"	1	474	692	1166
"M75"	"D27"	"Shoulder lesions"	"Benign neoplasm of ovary"	1	275	1066	1341
"G31"	"I47"	"Oth degenerative diseases of nervous system, NEC"	"Paroxysmal tachycardia"	1	27	167	194
"G23"	"I69"	"Other degenerative diseases of basal ganglia"	"Sequelae of cerebrovascular disease"	1	79	168	247
"K56"	"C67"	"Paralytic ileus and intestinal obstruction without hernia"	"Malignant neoplasm of bladder"	1	262	1144	1406
"D22"	"K50"	"Melanocytic nevi"	"Crohn's disease [regional enteritis]"	1	34	139	173
"I48"	"A69"	"Atrial fibrillation and flutter"	"Other spirochetal infections"	1	47	234	281
"I63"	"H10"	"Cerebral infarction"	"Conjunctivitis"	1	105	955	1060
"B37"	"H91"	"Candidiasis"	"Other and unspecified hearing loss"	1	359	1780	2139
"O13"	"O04"	"Gestational hypertension without significant proteinuria"	"Complications following (induced) termination of pregnancy"	1	241	707	948
"I46"	"C56"	"Cardiac arrest"	"Malignant neoplasm of ovary"	1	9	84	93
"C34"	"H50"	"Malignant neoplasm of bronchus and lung"	"Other strabismus"	1	16	142	158
"E87"	"O62"	"Other disorders of fluid, electrolyte and acid-base balance"	"Abnormalities of forces of labor"	1	0	189	189
"J10"	"B34"	"Influenza due to other identified influenza virus"	"Viral infection of unspecified site"	1	129	347	476
"L98"	"H25"	"Oth disorders of skin, subcu, not elsewhere classified"	"Age-related cataract"	1	1189	2125	3314
"K59"	"C53"	"Other functional intestinal disorders"	"Malignant neoplasm of cervix uteri"	1	119	764	883
"G30"	"E87"	"Alzheimer's disease"	"Other disorders of fluid, electrolyte and acid-base balance"	1	449	752	1201
"J15"	"J11"	"Bacterial pneumonia, not elsewhere classified"	"Influenza due to unidentified influenza virus"	1	256	613	869
"K55"	"M75"	"Vascular disorders of intestine"	"Shoulder lesions"	1	35	286	321
"E86"	"Q18"	"Volume depletion"	"Other congenital malformations of face and neck"	1	22	133	155
"E46"	"C15"	"Unspecified protein-calorie malnutrition"	"Malignant neoplasm of esophagus"	1	13	53	66
"K56"	"O20"	"Paralytic ileus and intestinal obstruction without hernia"	"Hemorrhage in early pregnancy"	1	0	209	209
"N47"	"H66"	"Disorders of prepuce"	"Suppurative and unspecified otitis media"	1	100	950	1050
"N63"	"O32"	"Unspecified lump in breast"	"Maternal care for malpresentation of fetus"	1	74	380	454
"I25"	"N95"	"Chronic ischemic heart disease"	"Menopausal and other perimenopausal disorders"	1	1044	1353	2397
"O72"	"J37"	"Postpartum hemorrhage"	"Chronic laryngitis and laryngotracheitis"	1	4	90	94
"O91"	"O62"	"Infect of breast assoc w pregnancy, the puerp and lactation"	"Abnormalities of forces of labor"	1	0	7522	7522
"O42"	"M22"	"Premature rupture of membranes"	"Disorder of patella"	1	27	837	864
"C34"	"J33"	"Malignant neoplasm of bronchus and lung"	"Nasal polyp"	1	3	120	123
"Q61"	"M20"	"Cystic kidney disease"	"Acquired deformities of fingers and toes"	1	25	133	158
"F05"	"A46"	"Delirium due to known physiological condition"	"Erysipelas"	1	480	1011	1491
"K57"	"N60"	"Diverticular disease of intestine"	"Benign mammary dysplasia"	1	3	802	805
"G23"	"I20"	"Other degenerative diseases of basal ganglia"	"Angina pectoris"	1	0	78	78
"I35"	"N43"	"Nonrheumatic aortic valve disorders"	"Hydrocele and spermatocele"	1	48	505	553
"I47"	"O00"	"Paroxysmal tachycardia"	"Ectopic pregnancy"	1	15	83	98
"C25"	"G43"	"Malignant neoplasm of pancreas"	"Migraine"	1	0	44	44
"I34"	"H35"	"Nonrheumatic mitral valve disorders"	"Other retinal disorders"	1	557	766	1323
"H35"	"M16"	"Other retinal disorders"	"Osteoarthritis of hip"	1	1516	3693	5209
"G37"	"N97"	"Other demyelinating diseases of central nervous system"	"Female infertility"	1	9	51	60
"H52"	"J35"	"Disorders of refraction and accommodation"	"Chronic diseases of tonsils and adenoids"	1	166	1074	1240
"E83"	"N40"	"Disorders of mineral metabolism"	"Benign prostatic hyperplasia"	1	51	501	552
"L97"	"H81"	"Non-pressure chronic ulcer of lower limb, NEC"	"Disorders of vestibular function"	1	74	478	552
"J94"	"H90"	"Other pleural conditions"	"Conductive and sensorineural hearing loss"	1	25	122	147
"M16"	"N62"	"Osteoarthritis of hip"	"Hypertrophy of breast"	1	199	418	617
"K63"	"O36"	"Other diseases of intestine"	"Maternal care for other fetal problems"	1	5	43	48
"K86"	"M67"	"Other diseases of pancreas"	"Other disorders of synovium and tendon"	1	33	114	147
"K60"	"O75"	"Fissure and fistula of anal and rectal regions"	"Oth complications of labor and delivery, NEC"	1	99	200	299
"D11"	"M51"	"Benign neoplasm of major salivary glands"	"Thoracic, thoracolum, and lumbosacral intvrt disc disorders"	1	136	253	389
"J96"	"G64"	"Respiratory failure, not elsewhere classified"	"Other disorders of peripheral nervous system"	1	36	168	204
"F17"	"O02"	"Nicotine dependence"	"Other abnormal products of conception"	1	119	735	854
"J96"	"G62"	"Respiratory failure, not elsewhere classified"	"Other and unspecified polyneuropathies"	1	618	1907	2525
"I26"	"H90"	"Pulmonary embolism"	"Conductive and sensorineural hearing loss"	1	171	735	906
"K45"	"K51"	"Other abdominal hernia"	"Ulcerative colitis"	1	29	83	112
"E83"	"M70"	"Disorders of mineral metabolism"	"Soft tissue disorders related to use, overuse and pressure"	1	43	281	324
"M80"	"G35"	"Osteoporosis with current pathological fracture"	"Multiple sclerosis"	1	0	120	120
"E64"	"E04"	"Sequelae of malnutrition and other nutritional deficiencies"	"Other nontoxic goiter"	1	37	153	190
"I10"	"K51"	"Essential (primary) hypertension"	"Ulcerative colitis"	1	1365	2058	3423
"I31"	"N81"	"Other diseases of pericardium"	"Female genital prolapse"	1	4	58	62
"J32"	"M22"	"Chronic sinusitis"	"Disorder of patella"	1	51	216	267
"J15"	"O32"	"Bacterial pneumonia, not elsewhere classified"	"Maternal care for malpresentation of fetus"	1	3	122	125
"F32"	"D12"	"Depressive episode"	"Benign neoplasm of colon, rectum, anus and anal canal"	1	988	1323	2311
"J18"	"D29"	"Pneumonia, unspecified organism"	"Benign neoplasm of male genital organs"	1	65	210	275
"K04"	"O04"	"Diseases of pulp and periapical tissues"	"Complications following (induced) termination of pregnancy"	1	1	406	407
"F32"	"D24"	"Depressive episode"	"Benign neoplasm of breast"	1	56	352	408
"K72"	"K57"	"Hepatic failure, not elsewhere classified"	"Diverticular disease of intestine"	1	104	294	398
"K55"	"D30"	"Vascular disorders of intestine"	"Benign neoplasm of urinary organs"	1	13	94	107
"M24"	"A09"	"Other specific joint derangements"	"Infectious gastroenteritis and colitis, unspecified"	1	321	629	950
"M65"	"H71"	"Synovitis and tenosynovitis"	"Cholesteatoma of middle ear"	1	28	85	113
"M23"	"N44"	"Internal derangement of knee"	"Noninflammatory disorders of testis"	1	56	240	296
"C79"	"M89"	"Secondary malignant neoplasm of other and unspecified sites"	"Other disorders of bone"	1	68	557	625
"C77"	"J42"	"Secondary and unspecified malignant neoplasm of lymph nodes"	"Unspecified chronic bronchitis"	1	85	288	373
"H36"	"O64"	"Retinal disorders in diseases classified elsewhere"	"Obstructed labor due to malposition and malpresent of fetus"	1	1	42	43
"M84"	"H10"	"Disorder of continuity of bone"	"Conjunctivitis"	1	22	115	137
"K59"	"O70"	"Other functional intestinal disorders"	"Perineal laceration during delivery"	1	953	2080	3033
"J96"	"A63"	"Respiratory failure, not elsewhere classified"	"Oth predominantly sexually transmitted diseases, NEC"	1	0	192	192
"A41"	"G35"	"Other sepsis"	"Multiple sclerosis"	1	0	533	533
"I22"	"I21"	"Subsequent STEMI & NSTEMI mocard infrc"	"Acute myocardial infarction"	1	1031	1566	2597
"K57"	"K30"	"Diverticular disease of intestine"	"Functional dyspepsia"	1	0	5123	5123
"M99"	"M17"	"Biomechanical lesions, not elsewhere classified"	"Osteoarthritis of knee"	1	524	798	1322
"M96"	"M54"	"Intraop and postproc comp and disorders of ms sys, NEC"	"Dorsalgia"	1	819	1895	2714
"E87"	"N60"	"Other disorders of fluid, electrolyte and acid-base balance"	"Benign mammary dysplasia"	1	0	323	323
"M99"	"N97"	"Biomechanical lesions, not elsewhere classified"	"Female infertility"	1	0	130	130
"J93"	"O04"	"Pneumothorax and air leak"	"Complications following (induced) termination of pregnancy"	1	22	191	213
"L03"	"O04"	"Cellulitis and acute lymphangitis"	"Complications following (induced) termination of pregnancy"	1	357	531	888
"M50"	"H66"	"Cervical disc disorders"	"Suppurative and unspecified otitis media"	1	34	124	158
"H25"	"D21"	"Age-related cataract"	"Other benign neoplasms of connective and other soft tissue"	1	206	414	620
"K44"	"O64"	"Diaphragmatic hernia"	"Obstructed labor due to malposition and malpresent of fetus"	1	3	163	166
"E64"	"K08"	"Sequelae of malnutrition and other nutritional deficiencies"	"Other disorders of teeth and supporting structures"	1	116	341	457
"C80"	"G45"	"Malignant neoplasm without specification of site"	"Transient cerebral ischemic attacks and related syndromes"	1	8	197	205
"N28"	"I20"	"Oth disorders of kidney and ureter, not elsewhere classified"	"Angina pectoris"	1	143	1422	1565
"K59"	"C73"	"Other functional intestinal disorders"	"Malignant neoplasm of thyroid gland"	1	61	152	213
"N19"	"C18"	"Unspecified kidney failure"	"Malignant neoplasm of colon"	1	337	647	984
"E16"	"N20"	"Other disorders of pancreatic internal secretion"	"Calculus of kidney and ureter"	1	110	252	362
"J85"	"F10"	"Abscess of lung and mediastinum"	"Alcohol related disorders"	1	141	412	553
"I38"	"I25"	"Endocarditis, valve unspecified"	"Chronic ischemic heart disease"	1	237	576	813
"K52"	"I63"	"Other and unsp noninfective gastroenteritis and colitis"	"Cerebral infarction"	1	1279	1662	2941
"I25"	"K35"	"Chronic ischemic heart disease"	"Acute appendicitis"	1	745	1169	1914
"E41"	"K76"	"Nutritional marasmus"	"Other diseases of liver"	1	24	74	98
"M81"	"N70"	"Osteoporosis without current pathological fracture"	"Salpingitis and oophoritis"	1	0	116	116
"D50"	"O03"	"Iron deficiency anemia"	"Spontaneous abortion"	1	0	472	472
"I47"	"O82"	"Paroxysmal tachycardia"	"Encounter for cesarean delivery without indication"	1	213	408	621
"N13"	"J34"	"Obstructive and reflux uropathy"	"Other and unspecified disorders of nose and nasal sinuses"	1	41	128	169
"C49"	"M65"	"Malignant neoplasm of other connective and soft tissue"	"Synovitis and tenosynovitis"	1	13	55	68
"C24"	"N81"	"Malignant neoplasm of other and unsp parts of biliary tract"	"Female genital prolapse"	1	0	77	77
"O67"	"O26"	"Labor and delivery comp by intrapartum hemorrhage, NEC"	"Maternal care for oth conditions predom related to pregnancy"	1	177	309	486
"D50"	"M72"	"Iron deficiency anemia"	"Fibroblastic disorders"	1	33	397	430
"K73"	"O62"	"Chronic hepatitis, not elsewhere classified"	"Abnormalities of forces of labor"	1	10	62	72
"D64"	"M24"	"Other anemias"	"Other specific joint derangements"	1	128	401	529
"J96"	"D86"	"Respiratory failure, not elsewhere classified"	"Sarcoidosis"	1	59	439	498
"A40"	"M17"	"Streptococcal sepsis"	"Osteoarthritis of knee"	1	59	333	392
"C92"	"K21"	"Myeloid leukemia"	"Gastro-esophageal reflux disease"	1	22	91	113
"M85"	"D05"	"Other disorders of bone density and structure"	"Carcinoma in situ of breast"	1	42	124	166
"O21"	"O04"	"Excessive vomiting in pregnancy"	"Complications following (induced) termination of pregnancy"	1	1010	1690	2700
"I63"	"I21"	"Cerebral infarction"	"Acute myocardial infarction"	1	4216	5722	9938
"H65"	"J20"	"Nonsuppurative otitis media"	"Acute bronchitis"	1	2478	3996	6474
"E89"	"L05"	"Postproc endocrine and metabolic comp and disorders, NEC"	"Pilonidal cyst and sinus"	1	2	40	42
"E13"	"I70"	"Other specified diabetes mellitus"	"Atherosclerosis"	1	213	397	610
"I31"	"M75"	"Other diseases of pericardium"	"Shoulder lesions"	1	61	181	242
"C18"	"N75"	"Malignant neoplasm of colon"	"Diseases of Bartholin's gland"	1	1	29	30
"A41"	"L02"	"Other sepsis"	"Cutaneous abscess, furuncle and carbuncle"	1	1285	3899	5184
"H91"	"Q17"	"Other and unspecified hearing loss"	"Other congenital malformations of ear"	1	57	151	208
"N20"	"O80"	"Calculus of kidney and ureter"	"Encounter for full-term uncomplicated delivery"	1	0	3175	3175
"I50"	"O70"	"Heart failure"	"Perineal laceration during delivery"	1	0	86	86
"M62"	"H66"	"Other disorders of muscle"	"Suppurative and unspecified otitis media"	1	281	610	891
"C67"	"N60"	"Malignant neoplasm of bladder"	"Benign mammary dysplasia"	1	1	28	29
"B25"	"Q61"	"Cytomegaloviral disease"	"Cystic kidney disease"	1	0	33	33
"G96"	"O34"	"Other disorders of central nervous system"	"Maternal care for abnormality of pelvic organs"	1	23	146	169
"D27"	"O26"	"Benign neoplasm of ovary"	"Maternal care for oth conditions predom related to pregnancy"	1	217	436	653
"J95"	"M77"	"Intraop and postproc comp and disorders of resp sys, NEC"	"Other enthesopathies"	1	0	33	33
"I85"	"N20"	"Esophageal varices"	"Calculus of kidney and ureter"	1	26	80	106
"M25"	"F10"	"Other joint disorder, not elsewhere classified"	"Alcohol related disorders"	1	484	1168	1652
"N18"	"I34"	"Chronic kidney disease (CKD)"	"Nonrheumatic mitral valve disorders"	1	785	1377	2162
"K04"	"I83"	"Diseases of pulp and periapical tissues"	"Varicose veins of lower extremities"	1	183	355	538
"O36"	"J35"	"Maternal care for other fetal problems"	"Chronic diseases of tonsils and adenoids"	1	0	916	916
"I13"	"M16"	"Hypertensive heart and chronic kidney disease"	"Osteoarthritis of hip"	1	17	89	106
"I63"	"N63"	"Cerebral infarction"	"Unspecified lump in breast"	1	54	534	588
"K59"	"O14"	"Other functional intestinal disorders"	"Pre-eclampsia"	1	108	307	415
"K61"	"O64"	"Abscess of anal and rectal regions"	"Obstructed labor due to malposition and malpresent of fetus"	1	26	99	125
"N19"	"I69"	"Unspecified kidney failure"	"Sequelae of cerebrovascular disease"	1	1567	2018	3585
"N25"	"E11"	"Disorders resulting from impaired renal tubular function"	"Type 2 diabetes mellitus"	1	88	298	386
"C25"	"G51"	"Malignant neoplasm of pancreas"	"Facial nerve disorders"	1	2	41	43
"G44"	"H80"	"Other headache syndromes"	"Otosclerosis"	1	14	77	91
"C34"	"I35"	"Malignant neoplasm of bronchus and lung"	"Nonrheumatic aortic valve disorders"	1	529	1217	1746
"N94"	"O62"	"Pain and oth cond assoc w fem gntl org and menstrual cycle"	"Abnormalities of forces of labor"	1	0	4658	4658
"M79"	"Q82"	"Oth and unsp soft tissue disorders, not elsewhere classified"	"Other congenital malformations of skin"	1	177	369	546
"J98"	"C62"	"Other respiratory disorders"	"Malignant neoplasm of testis"	1	1	36	37
"O24"	"O20"	"Diabetes in pregnancy, childbirth, and the puerperium"	"Hemorrhage in early pregnancy"	1	683	2708	3391
"M25"	"Q21"	"Other joint disorder, not elsewhere classified"	"Congenital malformations of cardiac septa"	1	11	100	111
"C34"	"K81"	"Malignant neoplasm of bronchus and lung"	"Cholecystitis"	1	85	420	505
"G95"	"N43"	"Other and unspecified diseases of spinal cord"	"Hydrocele and spermatocele"	1	3	89	92
"J15"	"N93"	"Bacterial pneumonia, not elsewhere classified"	"Other abnormal uterine and vaginal bleeding"	1	56	141	197
"I69"	"N94"	"Sequelae of cerebrovascular disease"	"Pain and oth cond assoc w fem gntl org and menstrual cycle"	1	12	210	222
"E34"	"Q21"	"Other endocrine disorders"	"Congenital malformations of cardiac septa"	1	5	195	200
"I74"	"H10"	"Arterial embolism and thrombosis"	"Conjunctivitis"	1	15	87	102
"C78"	"M10"	"Secondary malignant neoplasm of resp and digestive organs"	"Gout"	1	88	556	644
"L82"	"E78"	"Seborrheic keratosis"	"Disorders of lipoprotein metabolism and other lipidemias"	1	230	408	638
"K92"	"G62"	"Other diseases of digestive system"	"Other and unspecified polyneuropathies"	1	584	782	1366
"M48"	"H36"	"Other spondylopathies"	"Retinal disorders in diseases classified elsewhere"	1	274	439	713
"I08"	"K04"	"Multiple valve diseases"	"Diseases of pulp and periapical tissues"	1	32	110	142
"C64"	"M23"	"Malignant neoplasm of kidney, except renal pelvis"	"Internal derangement of knee"	1	12	314	326
"C45"	"K40"	"Mesothelioma"	"Inguinal hernia"	1	0	129	129
"K86"	"M51"	"Other diseases of pancreas"	"Thoracic, thoracolum, and lumbosacral intvrt disc disorders"	1	168	530	698
"I47"	"O14"	"Paroxysmal tachycardia"	"Pre-eclampsia"	1	49	140	189
"I74"	"K80"	"Arterial embolism and thrombosis"	"Cholelithiasis"	1	172	371	543
"I89"	"D25"	"Oth noninfective disorders of lymphatic vessels and nodes"	"Leiomyoma of uterus"	1	12	198	210
"I83"	"L05"	"Varicose veins of lower extremities"	"Pilonidal cyst and sinus"	1	30	203	233
"K57"	"K60"	"Diverticular disease of intestine"	"Fissure and fistula of anal and rectal regions"	1	678	950	1628
"M54"	"O48"	"Dorsalgia"	"Late pregnancy"	1	103	1268	1371
"M80"	"M77"	"Osteoporosis with current pathological fracture"	"Other enthesopathies"	1	29	360	389
"M54"	"D25"	"Dorsalgia"	"Leiomyoma of uterus"	1	1609	2415	4024
"J96"	"D23"	"Respiratory failure, not elsewhere classified"	"Other benign neoplasms of skin"	1	94	898	992
"K52"	"N85"	"Other and unsp noninfective gastroenteritis and colitis"	"Other noninflammatory disorders of uterus, except cervix"	1	25	100	125
"K25"	"M72"	"Gastric ulcer"	"Fibroblastic disorders"	1	230	457	687
"O72"	"K51"	"Postpartum hemorrhage"	"Ulcerative colitis"	1	309	1034	1343
"C01"	"K70"	"Malignant neoplasm of base of tongue"	"Alcoholic liver disease"	1	2	43	45
"L28"	"K40"	"Lichen simplex chronicus and prurigo"	"Inguinal hernia"	1	39	119	158
"G62"	"C62"	"Other and unspecified polyneuropathies"	"Malignant neoplasm of testis"	1	3	78	81
"E55"	"I70"	"Vitamin D deficiency"	"Atherosclerosis"	1	248	500	748
"K74"	"J30"	"Fibrosis and cirrhosis of liver"	"Vasomotor and allergic rhinitis"	1	0	40	40
"I35"	"K11"	"Nonrheumatic aortic valve disorders"	"Diseases of salivary glands"	1	56	181	237
"N31"	"M50"	"Neuromuscular dysfunction of bladder, NEC"	"Cervical disc disorders"	1	156	296	452
"C01"	"M54"	"Malignant neoplasm of base of tongue"	"Dorsalgia"	1	6	44	50
"I73"	"O02"	"Other peripheral vascular diseases"	"Other abnormal products of conception"	1	12	74	86
"F17"	"O03"	"Nicotine dependence"	"Spontaneous abortion"	1	6	798	804
"C73"	"O75"	"Malignant neoplasm of thyroid gland"	"Oth complications of labor and delivery, NEC"	1	1	29	30
"M67"	"Q54"	"Other disorders of synovium and tendon"	"Hypospadias"	1	11	72	83
"C56"	"O68"	"Malignant neoplasm of ovary"	"Labor and delivery comp by abnlt of fetal acid-base balance"	1	1	42	43
"I69"	"H27"	"Sequelae of cerebrovascular disease"	"Other disorders of lens"	1	21	299	320
"E55"	"C20"	"Vitamin D deficiency"	"Malignant neoplasm of rectum"	1	27	98	125
"K59"	"I45"	"Other functional intestinal disorders"	"Other conduction disorders"	1	447	857	1304
"I44"	"Q21"	"Atrioventricular and left bundle-branch block"	"Congenital malformations of cardiac septa"	1	75	177	252
"O03"	"B27"	"Spontaneous abortion"	"Infectious mononucleosis"	1	0	130	130
"C10"	"M70"	"Malignant neoplasm of oropharynx"	"Soft tissue disorders related to use, overuse and pressure"	1	1	37	38
"K62"	"O21"	"Other diseases of anus and rectum"	"Excessive vomiting in pregnancy"	1	36	153	189
"I80"	"M54"	"Phlebitis and thrombophlebitis"	"Dorsalgia"	1	2158	3159	5317
"D64"	"N87"	"Other anemias"	"Dysplasia of cervix uteri"	1	44	343	387
"K56"	"H33"	"Paralytic ileus and intestinal obstruction without hernia"	"Retinal detachments and breaks"	1	70	197	267
"I25"	"H90"	"Chronic ischemic heart disease"	"Conductive and sensorineural hearing loss"	1	1989	3113	5102
"K80"	"K01"	"Cholelithiasis"	"Embedded and impacted teeth"	1	49	190	239
"H02"	"K80"	"Other disorders of eyelid"	"Cholelithiasis"	1	559	1107	1666
"M15"	"O80"	"Polyosteoarthritis"	"Encounter for full-term uncomplicated delivery"	1	0	48	48
"N21"	"O80"	"Calculus of lower urinary tract"	"Encounter for full-term uncomplicated delivery"	1	46	119	165
"N85"	"N87"	"Other noninflammatory disorders of uterus, except cervix"	"Dysplasia of cervix uteri"	1	83	236	319
"C16"	"N63"	"Malignant neoplasm of stomach"	"Unspecified lump in breast"	1	1	39	40
"L89"	"F31"	"Pressure ulcer"	"Bipolar disorder"	1	50	121	171
"O34"	"L68"	"Maternal care for abnormality of pelvic organs"	"Hypertrichosis"	1	43	126	169
"I47"	"H83"	"Paroxysmal tachycardia"	"Other diseases of inner ear"	1	272	733	1005
"J09"	"N04"	"Influenza due to certain identified influenza viruses"	"Nephrotic syndrome"	1	0	25	25
"J15"	"K09"	"Bacterial pneumonia, not elsewhere classified"	"Cysts of oral region, not elsewhere classified"	1	20	111	131
"N13"	"N62"	"Obstructive and reflux uropathy"	"Hypertrophy of breast"	1	66	141	207
"C71"	"M20"	"Malignant neoplasm of brain"	"Acquired deformities of fingers and toes"	1	6	109	115
"H36"	"K80"	"Retinal disorders in diseases classified elsewhere"	"Cholelithiasis"	1	301	580	881
"I69"	"N60"	"Sequelae of cerebrovascular disease"	"Benign mammary dysplasia"	1	3	389	392
"D70"	"C56"	"Neutropenia"	"Malignant neoplasm of ovary"	1	13	94	107
"E86"	"N47"	"Volume depletion"	"Disorders of prepuce"	1	487	855	1342
"A04"	"O04"	"Other bacterial intestinal infections"	"Complications following (induced) termination of pregnancy"	1	25	222	247
"E66"	"O62"	"Overweight and obesity"	"Abnormalities of forces of labor"	1	10154	14115	24269
"Q23"	"M51"	"Congenital malformations of aortic and mitral valves"	"Thoracic, thoracolum, and lumbosacral intvrt disc disorders"	1	9	69	78
"K91"	"J30"	"Intraop and postproc comp and disorders of dgstv sys, NEC"	"Vasomotor and allergic rhinitis"	1	8	44	52
"I69"	"M70"	"Sequelae of cerebrovascular disease"	"Soft tissue disorders related to use, overuse and pressure"	1	371	1223	1594
"E04"	"O65"	"Other nontoxic goiter"	"Obstructed labor due to maternal pelvic abnormality"	1	0	373	373
"A49"	"O66"	"Bacterial infection of unspecified site"	"Other obstructed labor"	1	3	36	39
"N64"	"Q17"	"Other disorders of breast"	"Other congenital malformations of ear"	1	3	91	94
"M85"	"I47"	"Other disorders of bone density and structure"	"Paroxysmal tachycardia"	1	122	751	873
"O90"	"E10"	"Complications of the puerperium, not elsewhere classified"	"Type 1 diabetes mellitus"	1	15	71	86
"D25"	"O90"	"Leiomyoma of uterus"	"Complications of the puerperium, not elsewhere classified"	1	16	168	184
"K76"	"L05"	"Other diseases of liver"	"Pilonidal cyst and sinus"	1	17	62	79
"M17"	"O82"	"Osteoarthritis of knee"	"Encounter for cesarean delivery without indication"	1	0	602	602
"C39"	"C34"	"Malig neoplm of sites in the resp sys and intrathorac organs"	"Malignant neoplasm of bronchus and lung"	1	124	255	379
"K59"	"F48"	"Other functional intestinal disorders"	"Other nonpsychotic mental disorders"	1	87	180	267
"O23"	"G40"	"Infections of genitourinary tract in pregnancy"	"Epilepsy and recurrent seizures"	1	42	206	248
"A38"	"J18"	"Scarlet fever"	"Pneumonia, unspecified organism"	1	72	148	220
"A40"	"K30"	"Streptococcal sepsis"	"Functional dyspepsia"	1	27	136	163
"C61"	"K42"	"Malignant neoplasm of prostate"	"Umbilical hernia"	1	128	477	605
"O70"	"L03"	"Perineal laceration during delivery"	"Cellulitis and acute lymphangitis"	1	248	489	737
"E87"	"L98"	"Other disorders of fluid, electrolyte and acid-base balance"	"Oth disorders of skin, subcu, not elsewhere classified"	1	656	927	1583
"J69"	"C44"	"Pneumonitis due to solids and liquids"	"Other and unspecified malignant neoplasm of skin"	1	45	400	445
"K76"	"O99"	"Other diseases of liver"	"Oth maternal diseases classd elsw but compl preg/chldbrth"	1	99	338	437
"O32"	"G40"	"Maternal care for malpresentation of fetus"	"Epilepsy and recurrent seizures"	1	57	143	200
"I80"	"M62"	"Phlebitis and thrombophlebitis"	"Other disorders of muscle"	1	890	2387	3277
"I63"	"C43"	"Cerebral infarction"	"Malignant melanoma of skin"	1	215	396	611
"C78"	"G00"	"Secondary malignant neoplasm of resp and digestive organs"	"Bacterial meningitis, not elsewhere classified"	1	11	62	73
"C76"	"I70"	"Malignant neoplasm of other and ill-defined sites"	"Atherosclerosis"	1	67	161	228
"M86"	"L03"	"Osteomyelitis"	"Cellulitis and acute lymphangitis"	1	284	565	849
"O91"	"N87"	"Infect of breast assoc w pregnancy, the puerp and lactation"	"Dysplasia of cervix uteri"	1	106	194	300
"F52"	"M23"	"Sexual dysfnct not due to a substance or known physiol cond"	"Internal derangement of knee"	1	85	200	285
"A41"	"G56"	"Other sepsis"	"Mononeuropathies of upper limb"	1	0	2598	2598
"I46"	"I72"	"Cardiac arrest"	"Other aneurysm"	1	62	179	241
"C41"	"M51"	"Malignant neoplasm of bone/artic cartl of and unsp sites"	"Thoracic, thoracolum, and lumbosacral intvrt disc disorders"	1	37	114	151
"N39"	"A46"	"Other disorders of urinary system"	"Erysipelas"	1	2838	3734	6572
"O41"	"N97"	"Other disorders of amniotic fluid and membranes"	"Female infertility"	1	247	1530	1777
"E46"	"M16"	"Unspecified protein-calorie malnutrition"	"Osteoarthritis of hip"	1	0	89	89
"N95"	"O02"	"Menopausal and other perimenopausal disorders"	"Other abnormal products of conception"	1	0	60	60
"E23"	"C71"	"Hypofunction and other disorders of the pituitary gland"	"Malignant neoplasm of brain"	1	91	243	334
"H26"	"H52"	"Other cataract"	"Disorders of refraction and accommodation"	1	1883	2448	4331
"G35"	"O30"	"Multiple sclerosis"	"Multiple gestation"	1	10	49	59
"N94"	"O20"	"Pain and oth cond assoc w fem gntl org and menstrual cycle"	"Hemorrhage in early pregnancy"	1	488	1457	1945
"I21"	"O26"	"Acute myocardial infarction"	"Maternal care for oth conditions predom related to pregnancy"	1	0	60	60
"H54"	"M75"	"Blindness and low vision"	"Shoulder lesions"	1	129	307	436
"J94"	"D17"	"Other pleural conditions"	"Benign lipomatous neoplasm"	1	12	85	97
"G50"	"O64"	"Disorders of trigeminal nerve"	"Obstructed labor due to malposition and malpresent of fetus"	1	0	31	31
"M17"	"N96"	"Osteoarthritis of knee"	"Recurrent pregnancy loss"	1	0	26	26
"A46"	"I25"	"Erysipelas"	"Chronic ischemic heart disease"	1	2789	4661	7450
"L72"	"O02"	"Follicular cysts of skin and subcutaneous tissue"	"Other abnormal products of conception"	1	8	127	135
"M81"	"J41"	"Osteoporosis without current pathological fracture"	"Simple and mucopurulent chronic bronchitis"	1	321	635	956
"K52"	"K21"	"Other and unsp noninfective gastroenteritis and colitis"	"Gastro-esophageal reflux disease"	1	1230	2144	3374
"K92"	"K35"	"Other diseases of digestive system"	"Acute appendicitis"	1	268	749	1017
"M48"	"M42"	"Other spondylopathies"	"Spinal osteochondrosis"	1	165	331	496
"K92"	"H18"	"Other diseases of digestive system"	"Other disorders of cornea"	1	113	207	320
"K59"	"I83"	"Other functional intestinal disorders"	"Varicose veins of lower extremities"	1	0	4256	4256
"M81"	"L93"	"Osteoporosis without current pathological fracture"	"Lupus erythematosus"	1	56	168	224
"E06"	"E10"	"Thyroiditis"	"Type 1 diabetes mellitus"	1	98	198	296
"L02"	"K35"	"Cutaneous abscess, furuncle and carbuncle"	"Acute appendicitis"	1	617	1524	2141
"J44"	"L91"	"Other chronic obstructive pulmonary disease"	"Hypertrophic disorders of skin"	1	7	43	50
"H54"	"O70"	"Blindness and low vision"	"Perineal laceration during delivery"	1	26	77	103
"K83"	"O82"	"Other diseases of biliary tract"	"Encounter for cesarean delivery without indication"	1	27	199	226
"H25"	"J32"	"Age-related cataract"	"Chronic sinusitis"	1	202	845	1047
"I49"	"O24"	"Other cardiac arrhythmias"	"Diabetes in pregnancy, childbirth, and the puerperium"	1	15	74	89
"I70"	"L05"	"Atherosclerosis"	"Pilonidal cyst and sinus"	1	25	85	110
"D64"	"N94"	"Other anemias"	"Pain and oth cond assoc w fem gntl org and menstrual cycle"	1	176	372	548
"N08"	"H91"	"Glomerular disorders in diseases classified elsewhere"	"Other and unspecified hearing loss"	1	16	91	107
"M67"	"O70"	"Other disorders of synovium and tendon"	"Perineal laceration during delivery"	1	1320	1642	2962
"H57"	"A63"	"Other disorders of eye and adnexa"	"Oth predominantly sexually transmitted diseases, NEC"	1	24	142	166
"O48"	"A63"	"Late pregnancy"	"Oth predominantly sexually transmitted diseases, NEC"	1	79	489	568
"C09"	"E11"	"Malignant neoplasm of tonsil"	"Type 2 diabetes mellitus"	1	42	104	146
"M48"	"F10"	"Other spondylopathies"	"Alcohol related disorders"	1	541	1421	1962
"J36"	"J45"	"Peritonsillar abscess"	"Asthma"	1	196	353	549
"N99"	"N80"	"Intraop and postproc comp and disorders of GU sys, NEC"	"Endometriosis"	1	249	620	869
"D75"	"M20"	"Other and unsp diseases of blood and blood-forming organs"	"Acquired deformities of fingers and toes"	1	28	89	117
"E73"	"O62"	"Lactose intolerance"	"Abnormalities of forces of labor"	1	26	205	231
"M51"	"D25"	"Thoracic, thoracolum, and lumbosacral intvrt disc disorders"	"Leiomyoma of uterus"	1	971	1737	2708
"E64"	"K25"	"Sequelae of malnutrition and other nutritional deficiencies"	"Gastric ulcer"	1	198	548	746
"E53"	"M23"	"Deficiency of other B group vitamins"	"Internal derangement of knee"	1	7	166	173
"K62"	"M95"	"Other diseases of anus and rectum"	"Oth acquired deformities of ms sys and connective tissue"	1	66	181	247
"N97"	"N91"	"Female infertility"	"Absent, scanty and rare menstruation"	1	675	895	1570
"J18"	"N97"	"Pneumonia, unspecified organism"	"Female infertility"	1	79	847	926
"O36"	"Q66"	"Maternal care for other fetal problems"	"Congenital deformities of feet"	1	16	67	83
"M07"	"L02"	"Enteropathic arthropathies"	"Cutaneous abscess, furuncle and carbuncle"	1	85	214	299
"A41"	"N62"	"Other sepsis"	"Hypertrophy of breast"	1	108	615	723
"M48"	"D39"	"Other spondylopathies"	"Neoplasm of uncertain behavior of female genital organs"	1	7	41	48
"G47"	"M24"	"Sleep disorders"	"Other specific joint derangements"	1	102	554	656
"N64"	"O42"	"Other disorders of breast"	"Premature rupture of membranes"	1	347	841	1188
"C71"	"K25"	"Malignant neoplasm of brain"	"Gastric ulcer"	1	49	132	181
"K83"	"I20"	"Other diseases of biliary tract"	"Angina pectoris"	1	222	1203	1425
"C77"	"N83"	"Secondary and unspecified malignant neoplasm of lymph nodes"	"Noninflammatory disord of ovary, fallop and broad ligament"	1	55	265	320
"J93"	"H83"	"Pneumothorax and air leak"	"Other diseases of inner ear"	1	12	217	229
"D68"	"I34"	"Other coagulation defects"	"Nonrheumatic mitral valve disorders"	1	123	353	476
"C38"	"I70"	"Malignant neoplasm of heart, mediastinum and pleura"	"Atherosclerosis"	1	7	67	74
"A04"	"N43"	"Other bacterial intestinal infections"	"Hydrocele and spermatocele"	1	11	118	129
"N19"	"D23"	"Unspecified kidney failure"	"Other benign neoplasms of skin"	1	91	237	328
"D12"	"M75"	"Benign neoplasm of colon, rectum, anus and anal canal"	"Shoulder lesions"	1	0	7077	7077
"E23"	"C91"	"Hypofunction and other disorders of the pituitary gland"	"Lymphoid leukemia"	1	0	72	72
"C78"	"Q54"	"Secondary malignant neoplasm of resp and digestive organs"	"Hypospadias"	1	0	29	29
"M23"	"D24"	"Internal derangement of knee"	"Benign neoplasm of breast"	1	578	1097	1675
"M19"	"O86"	"Other and unspecified osteoarthritis"	"Other puerperal infections"	1	0	34	34
"O34"	"N62"	"Maternal care for abnormality of pelvic organs"	"Hypertrophy of breast"	1	33	130	163
"I35"	"M35"	"Nonrheumatic aortic valve disorders"	"Other systemic involvement of connective tissue"	1	459	1411	1870
"O36"	"B07"	"Maternal care for other fetal problems"	"Viral warts"	1	4	64	68
"C17"	"E78"	"Malignant neoplasm of small intestine"	"Disorders of lipoprotein metabolism and other lipidemias"	1	47	136	183
"I73"	"A69"	"Other peripheral vascular diseases"	"Other spirochetal infections"	1	8	45	53
"N50"	"J03"	"Other and unspecified disorders of male genital organs"	"Acute tonsillitis"	1	83	207	290
"H43"	"K60"	"Disorders of vitreous body"	"Fissure and fistula of anal and rectal regions"	1	27	119	146
"O44"	"M22"	"Placenta previa"	"Disorder of patella"	1	0	67	67
"D61"	"M50"	"Oth aplastic anemias and other bone marrow failure syndromes"	"Cervical disc disorders"	1	3	31	34
"J06"	"O80"	"Acute upper resp infections of multiple and unsp sites"	"Encounter for full-term uncomplicated delivery"	1	0	898	898
"J18"	"H53"	"Pneumonia, unspecified organism"	"Visual disturbances"	1	1375	2115	3490
"G62"	"E10"	"Other and unspecified polyneuropathies"	"Type 1 diabetes mellitus"	1	458	1206	1664
"O13"	"J45"	"Gestational hypertension without significant proteinuria"	"Asthma"	1	143	269	412
"I33"	"M79"	"Acute and subacute endocarditis"	"Oth and unsp soft tissue disorders, not elsewhere classified"	1	108	236	344
"J91"	"C64"	"Pleural effusion in conditions classified elsewhere"	"Malignant neoplasm of kidney, except renal pelvis"	1	89	187	276
"G56"	"N88"	"Mononeuropathies of upper limb"	"Other noninflammatory disorders of cervix uteri"	1	22	83	105
"L90"	"H80"	"Atrophic disorders of skin"	"Otosclerosis"	1	3	50	53
"D68"	"I65"	"Other coagulation defects"	"Occls and stenosis of precerb art, not rslt in cereb infrc"	1	43	137	180
"J13"	"C50"	"Pneumonia due to Streptococcus pneumoniae"	"Malignant neoplasm of breast"	1	47	119	166
"N39"	"K60"	"Other disorders of urinary system"	"Fissure and fistula of anal and rectal regions"	1	333	829	1162
"A41"	"H83"	"Other sepsis"	"Other diseases of inner ear"	1	0	1377	1377
"I48"	"C54"	"Atrial fibrillation and flutter"	"Malignant neoplasm of corpus uteri"	1	252	760	1012
"E70"	"L02"	"Disorders of aromatic amino-acid metabolism"	"Cutaneous abscess, furuncle and carbuncle"	1	21	67	88
"K25"	"L03"	"Gastric ulcer"	"Cellulitis and acute lymphangitis"	1	216	405	621
"M46"	"N87"	"Other inflammatory spondylopathies"	"Dysplasia of cervix uteri"	1	12	88	100
"C24"	"H35"	"Malignant neoplasm of other and unsp parts of biliary tract"	"Other retinal disorders"	1	19	128	147
"I70"	"D23"	"Atherosclerosis"	"Other benign neoplasms of skin"	1	320	465	785
"C22"	"H43"	"Malignant neoplasm of liver and intrahepatic bile ducts"	"Disorders of vitreous body"	1	3	50	53
"J69"	"I67"	"Pneumonitis due to solids and liquids"	"Other cerebrovascular diseases"	1	38	148	186
"G96"	"J32"	"Other disorders of central nervous system"	"Chronic sinusitis"	1	55	275	330
"M05"	"K40"	"Rheumatoid arthritis with rheumatoid factor"	"Inguinal hernia"	1	263	426	689
"D50"	"M79"	"Iron deficiency anemia"	"Oth and unsp soft tissue disorders, not elsewhere classified"	1	895	1813	2708
"I48"	"M99"	"Atrial fibrillation and flutter"	"Biomechanical lesions, not elsewhere classified"	1	323	657	980
"O47"	"N96"	"False labor"	"Recurrent pregnancy loss"	1	193	402	595
"N85"	"N97"	"Other noninflammatory disorders of uterus, except cervix"	"Female infertility"	1	146	348	494
"J86"	"O04"	"Pyothorax"	"Complications following (induced) termination of pregnancy"	1	4	53	57
"D84"	"H65"	"Other immunodeficiencies"	"Nonsuppurative otitis media"	1	89	232	321
"H57"	"H25"	"Other disorders of eye and adnexa"	"Age-related cataract"	1	1429	2214	3643
"I46"	"G62"	"Cardiac arrest"	"Other and unspecified polyneuropathies"	1	79	579	658
"L57"	"H90"	"Skin changes due to chronic expsr to nonionizing radiation"	"Conductive and sensorineural hearing loss"	1	71	294	365
"E64"	"C77"	"Sequelae of malnutrition and other nutritional deficiencies"	"Secondary and unspecified malignant neoplasm of lymph nodes"	1	172	372	544
"H18"	"K80"	"Other disorders of cornea"	"Cholelithiasis"	1	139	286	425
"I51"	"K62"	"Complications and ill-defined descriptions of heart disease"	"Other diseases of anus and rectum"	1	377	611	988
"E87"	"I80"	"Other disorders of fluid, electrolyte and acid-base balance"	"Phlebitis and thrombophlebitis"	1	755	2371	3126
"C90"	"D17"	"Multiple myeloma and malignant plasma cell neoplasms"	"Benign lipomatous neoplasm"	1	5	68	73
"C18"	"I25"	"Malignant neoplasm of colon"	"Chronic ischemic heart disease"	1	2075	3080	5155
"N19"	"N62"	"Unspecified kidney failure"	"Hypertrophy of breast"	1	74	181	255
"M07"	"J30"	"Enteropathic arthropathies"	"Vasomotor and allergic rhinitis"	1	15	93	108
"M54"	"N62"	"Dorsalgia"	"Hypertrophy of breast"	1	943	1178	2121
"I42"	"L05"	"Cardiomyopathy"	"Pilonidal cyst and sinus"	1	1	43	44
"E83"	"M79"	"Disorders of mineral metabolism"	"Oth and unsp soft tissue disorders, not elsewhere classified"	1	223	874	1097
"L97"	"M71"	"Non-pressure chronic ulcer of lower limb, NEC"	"Other bursopathies"	1	17	173	190
"M53"	"N80"	"Other and unspecified dorsopathies, not elsewhere classified"	"Endometriosis"	1	54	182	236
"O08"	"M41"	"Complications following ectopic and molar pregnancy"	"Scoliosis"	1	0	52	52
"M79"	"O48"	"Oth and unsp soft tissue disorders, not elsewhere classified"	"Late pregnancy"	1	50	858	908
"L97"	"I15"	"Non-pressure chronic ulcer of lower limb, NEC"	"Secondary hypertension"	1	206	381	587
"N18"	"K57"	"Chronic kidney disease (CKD)"	"Diverticular disease of intestine"	1	1104	2939	4043
"A41"	"F10"	"Other sepsis"	"Alcohol related disorders"	1	0	9014	9014
"F60"	"N63"	"Specific personality disorders"	"Unspecified lump in breast"	1	13	54	67
"K91"	"I10"	"Intraop and postproc comp and disorders of dgstv sys, NEC"	"Essential (primary) hypertension"	1	957	1659	2616
"N94"	"L05"	"Pain and oth cond assoc w fem gntl org and menstrual cycle"	"Pilonidal cyst and sinus"	1	30	106	136
"E41"	"K70"	"Nutritional marasmus"	"Alcoholic liver disease"	1	73	195	268
"I61"	"M20"	"Nontraumatic intracerebral hemorrhage"	"Acquired deformities of fingers and toes"	1	47	344	391
"B37"	"M75"	"Candidiasis"	"Shoulder lesions"	1	297	599	896
"E87"	"C32"	"Other disorders of fluid, electrolyte and acid-base balance"	"Malignant neoplasm of larynx"	1	63	270	333
"D62"	"E04"	"Acute posthemorrhagic anemia"	"Other nontoxic goiter"	1	59	156	215
"M85"	"M34"	"Other disorders of bone density and structure"	"Systemic sclerosis [scleroderma]"	1	35	116	151
"L98"	"N75"	"Oth disorders of skin, subcu, not elsewhere classified"	"Diseases of Bartholin's gland"	1	8	47	55
"A49"	"K90"	"Bacterial infection of unspecified site"	"Intestinal malabsorption"	1	51	134	185
"O99"	"F10"	"Oth maternal diseases classd elsw but compl preg/chldbrth"	"Alcohol related disorders"	1	0	2398	2398
"K42"	"J34"	"Umbilical hernia"	"Other and unspecified disorders of nose and nasal sinuses"	1	77	335	412
"J84"	"E04"	"Other interstitial pulmonary diseases"	"Other nontoxic goiter"	1	61	158	219
"J96"	"D21"	"Respiratory failure, not elsewhere classified"	"Other benign neoplasms of connective and other soft tissue"	1	31	183	214
"N19"	"E66"	"Unspecified kidney failure"	"Overweight and obesity"	1	394	1648	2042
"E27"	"M05"	"Other disorders of adrenal gland"	"Rheumatoid arthritis with rheumatoid factor"	1	17	103	120
"I48"	"M71"	"Atrial fibrillation and flutter"	"Other bursopathies"	1	231	953	1184
"M25"	"Q25"	"Other joint disorder, not elsewhere classified"	"Congenital malformations of great arteries"	1	5	39	44
"E83"	"G56"	"Disorders of mineral metabolism"	"Mononeuropathies of upper limb"	1	59	424	483
"M16"	"O00"	"Osteoarthritis of hip"	"Ectopic pregnancy"	1	0	37	37
"O90"	"O42"	"Complications of the puerperium, not elsewhere classified"	"Premature rupture of membranes"	1	1065	2584	3649
"I34"	"O62"	"Nonrheumatic mitral valve disorders"	"Abnormalities of forces of labor"	1	5	108	113
"K22"	"O62"	"Other diseases of esophagus"	"Abnormalities of forces of labor"	1	14	156	170
"E66"	"O71"	"Overweight and obesity"	"Other obstetric trauma"	1	2116	2848	4964
"A04"	"E04"	"Other bacterial intestinal infections"	"Other nontoxic goiter"	1	55	217	272
"D47"	"K80"	"Oth neoplm of uncrt behav of lymphoid, hematpoetc & rel tiss"	"Cholelithiasis"	1	56	384	440
"M16"	"I83"	"Osteoarthritis of hip"	"Varicose veins of lower extremities"	1	1318	2768	4086
"D12"	"D37"	"Benign neoplasm of colon, rectum, anus and anal canal"	"Neoplasm of uncrt behavior of oral cavity and dgstv organs"	1	459	822	1281
"I49"	"N63"	"Other cardiac arrhythmias"	"Unspecified lump in breast"	1	136	301	437
"K50"	"M62"	"Crohn's disease [regional enteritis]"	"Other disorders of muscle"	1	239	370	609
"C67"	"K44"	"Malignant neoplasm of bladder"	"Diaphragmatic hernia"	1	94	224	318
"C34"	"N89"	"Malignant neoplasm of bronchus and lung"	"Other noninflammatory disorders of vagina"	1	1	58	59
"J96"	"C21"	"Respiratory failure, not elsewhere classified"	"Malignant neoplasm of anus and anal canal"	1	33	89	122
"M75"	"D23"	"Shoulder lesions"	"Other benign neoplasms of skin"	1	971	1391	2362
"D62"	"I35"	"Acute posthemorrhagic anemia"	"Nonrheumatic aortic valve disorders"	1	709	1176	1885
"C16"	"I50"	"Malignant neoplasm of stomach"	"Heart failure"	1	277	461	738
"J22"	"M17"	"Unspecified acute lower respiratory infection"	"Osteoarthritis of knee"	1	6	569	575
"D68"	"N60"	"Other coagulation defects"	"Benign mammary dysplasia"	1	36	115	151
"I73"	"N81"	"Other peripheral vascular diseases"	"Female genital prolapse"	1	197	787	984
"M81"	"O72"	"Osteoporosis without current pathological fracture"	"Postpartum hemorrhage"	1	40	163	203
"O21"	"M41"	"Excessive vomiting in pregnancy"	"Scoliosis"	1	1	59	60
"G98"	"H10"	"Other disorders of nervous system not elsewhere classified"	"Conjunctivitis"	1	0	158	158
"G12"	"G64"	"Spinal muscular atrophy and related syndromes"	"Other disorders of peripheral nervous system"	1	16	61	77
"M48"	"N85"	"Other spondylopathies"	"Other noninflammatory disorders of uterus, except cervix"	1	16	136	152
"G20"	"D14"	"Parkinson's disease"	"Benign neoplasm of middle ear and respiratory system"	1	12	59	71
"I49"	"D48"	"Other cardiac arrhythmias"	"Neoplasm of uncertain behavior of other and unsp sites"	1	17	103	120
"C80"	"I48"	"Malignant neoplasm without specification of site"	"Atrial fibrillation and flutter"	1	241	625	866
"O48"	"O21"	"Late pregnancy"	"Excessive vomiting in pregnancy"	1	525	787	1312
"A54"	"O62"	"Gonococcal infection"	"Abnormalities of forces of labor"	1	3	78	81
"M18"	"O72"	"Osteoarthritis of first carpometacarpal joint"	"Postpartum hemorrhage"	1	5	64	69
"M10"	"G45"	"Gout"	"Transient cerebral ischemic attacks and related syndromes"	1	537	970	1507
"I42"	"H81"	"Cardiomyopathy"	"Disorders of vestibular function"	1	125	234	359
"J96"	"G60"	"Respiratory failure, not elsewhere classified"	"Hereditary and idiopathic neuropathy"	1	44	178	222
"C22"	"D69"	"Malignant neoplasm of liver and intrahepatic bile ducts"	"Purpura and other hemorrhagic conditions"	1	27	110	137
"M75"	"O02"	"Shoulder lesions"	"Other abnormal products of conception"	1	0	1198	1198
"G96"	"O26"	"Other disorders of central nervous system"	"Maternal care for oth conditions predom related to pregnancy"	1	0	249	249
"E11"	"C62"	"Type 2 diabetes mellitus"	"Malignant neoplasm of testis"	1	1	122	123
"M05"	"M65"	"Rheumatoid arthritis with rheumatoid factor"	"Synovitis and tenosynovitis"	1	441	820	1261
"K21"	"H80"	"Gastro-esophageal reflux disease"	"Otosclerosis"	1	45	230	275
"D43"	"I25"	"Neoplasm of uncertain behavior of brain and cnsl"	"Chronic ischemic heart disease"	1	103	236	339
"N95"	"I83"	"Menopausal and other perimenopausal disorders"	"Varicose veins of lower extremities"	1	536	1345	1881
"M85"	"N04"	"Other disorders of bone density and structure"	"Nephrotic syndrome"	1	8	76	84
"C50"	"H74"	"Malignant neoplasm of breast"	"Other disorders of middle ear mastoid"	1	4	35	39
"K30"	"O63"	"Functional dyspepsia"	"Long labor"	1	81	194	275
"K22"	"H65"	"Other diseases of esophagus"	"Nonsuppurative otitis media"	1	32	152	184
"C80"	"C20"	"Malignant neoplasm without specification of site"	"Malignant neoplasm of rectum"	1	43	201	244
"J91"	"K40"	"Pleural effusion in conditions classified elsewhere"	"Inguinal hernia"	1	28	429	457
"K59"	"D17"	"Other functional intestinal disorders"	"Benign lipomatous neoplasm"	1	433	1592	2025
"K21"	"D06"	"Gastro-esophageal reflux disease"	"Carcinoma in situ of cervix uteri"	1	0	79	79
"F06"	"H53"	"Other mental disorders due to known physiological condition"	"Visual disturbances"	1	68	142	210
"N64"	"N61"	"Other disorders of breast"	"Inflammatory disorders of breast"	1	424	678	1102
"M25"	"O00"	"Other joint disorder, not elsewhere classified"	"Ectopic pregnancy"	1	0	234	234
"C76"	"N92"	"Malignant neoplasm of other and ill-defined sites"	"Excessive, frequent and irregular menstruation"	1	15	86	101
"O61"	"O04"	"Failed induction of labor"	"Complications following (induced) termination of pregnancy"	1	35	280	315
"G40"	"I63"	"Epilepsy and recurrent seizures"	"Cerebral infarction"	1	5080	6750	11830
"M79"	"O01"	"Oth and unsp soft tissue disorders, not elsewhere classified"	"Hydatidiform mole"	1	4	39	43
"N83"	"L20"	"Noninflammatory disord of ovary, fallop and broad ligament"	"Atopic dermatitis"	1	36	147	183
"J06"	"O03"	"Acute upper resp infections of multiple and unsp sites"	"Spontaneous abortion"	1	0	234	234
"C44"	"O70"	"Other and unspecified malignant neoplasm of skin"	"Perineal laceration during delivery"	1	0	209	209
"L50"	"O82"	"Urticaria"	"Encounter for cesarean delivery without indication"	1	347	618	965
"I35"	"C32"	"Nonrheumatic aortic valve disorders"	"Malignant neoplasm of larynx"	1	24	99	123
"G25"	"M62"	"Other extrapyramidal and movement disorders"	"Other disorders of muscle"	1	42	321	363
"I35"	"N21"	"Nonrheumatic aortic valve disorders"	"Calculus of lower urinary tract"	1	60	181	241
"D27"	"O71"	"Benign neoplasm of ovary"	"Other obstetric trauma"	1	114	250	364
"D68"	"O14"	"Other coagulation defects"	"Pre-eclampsia"	1	113	493	606
"N99"	"D27"	"Intraop and postproc comp and disorders of GU sys, NEC"	"Benign neoplasm of ovary"	1	237	498	735
"J90"	"O03"	"Pleural effusion, not elsewhere classified"	"Spontaneous abortion"	1	0	34	34
"M19"	"H10"	"Other and unspecified osteoarthritis"	"Conjunctivitis"	1	35	1114	1149
"H25"	"D33"	"Age-related cataract"	"Benign neoplasm of brain and oth prt central nervous system"	1	160	407	567
"L02"	"J30"	"Cutaneous abscess, furuncle and carbuncle"	"Vasomotor and allergic rhinitis"	1	209	371	580
"G95"	"N20"	"Other and unspecified diseases of spinal cord"	"Calculus of kidney and ureter"	1	30	230	260
"B96"	"M17"	"Oth bacterial agents as the cause of diseases classd elswhr"	"Osteoarthritis of knee"	1	7	299	306
"M13"	"L03"	"Other arthritis"	"Cellulitis and acute lymphangitis"	1	175	485	660
"M48"	"M20"	"Other spondylopathies"	"Acquired deformities of fingers and toes"	1	416	1406	1822
"J18"	"M99"	"Pneumonia, unspecified organism"	"Biomechanical lesions, not elsewhere classified"	1	418	1078	1496
"J15"	"O41"	"Bacterial pneumonia, not elsewhere classified"	"Other disorders of amniotic fluid and membranes"	1	1	44	45
"K80"	"O42"	"Cholelithiasis"	"Premature rupture of membranes"	1	451	1975	2426
"C56"	"F10"	"Malignant neoplasm of ovary"	"Alcohol related disorders"	1	41	104	145
"I85"	"G56"	"Esophageal varices"	"Mononeuropathies of upper limb"	1	23	153	176
"I10"	"H50"	"Essential (primary) hypertension"	"Other strabismus"	1	523	986	1509
"I97"	"M51"	"Intraop and postproc comp and disorders of circ sys, NEC"	"Thoracic, thoracolum, and lumbosacral intvrt disc disorders"	1	18	113	131
"A46"	"O24"	"Erysipelas"	"Diabetes in pregnancy, childbirth, and the puerperium"	1	7	77	84
"L98"	"K57"	"Oth disorders of skin, subcu, not elsewhere classified"	"Diverticular disease of intestine"	1	506	707	1213
"J44"	"L71"	"Other chronic obstructive pulmonary disease"	"Rosacea"	1	60	160	220
"Q66"	"H65"	"Congenital deformities of feet"	"Nonsuppurative otitis media"	1	223	446	669
"K86"	"K85"	"Other diseases of pancreas"	"Acute pancreatitis"	1	2748	5831	8579
"J06"	"Q31"	"Acute upper resp infections of multiple and unsp sites"	"Congenital malformations of larynx"	1	54	143	197
"K43"	"K56"	"Ventral hernia"	"Paralytic ileus and intestinal obstruction without hernia"	1	2422	2924	5346
"K52"	"E10"	"Other and unsp noninfective gastroenteritis and colitis"	"Type 1 diabetes mellitus"	1	745	1794	2539
"M51"	"N60"	"Thoracic, thoracolum, and lumbosacral intvrt disc disorders"	"Benign mammary dysplasia"	1	489	907	1396
"G95"	"K44"	"Other and unspecified diseases of spinal cord"	"Diaphragmatic hernia"	1	43	209	252
"K59"	"H10"	"Other functional intestinal disorders"	"Conjunctivitis"	1	583	2088	2671
"M07"	"H20"	"Enteropathic arthropathies"	"Iridocyclitis"	1	44	110	154
"N18"	"H50"	"Chronic kidney disease (CKD)"	"Other strabismus"	1	13	170	183
"F95"	"H65"	"Tic disorder"	"Nonsuppurative otitis media"	1	0	129	129
"J44"	"F12"	"Other chronic obstructive pulmonary disease"	"Cannabis related disorders"	1	66	139	205
"M81"	"H50"	"Osteoporosis without current pathological fracture"	"Other strabismus"	1	85	398	483
"H52"	"D25"	"Disorders of refraction and accommodation"	"Leiomyoma of uterus"	1	229	487	716
"G20"	"I65"	"Parkinson's disease"	"Occls and stenosis of precerb art, not rslt in cereb infrc"	1	24	130	154
"F32"	"H93"	"Depressive episode"	"Other disorders of ear, not elsewhere classified"	1	213	1036	1249
"I20"	"L05"	"Angina pectoris"	"Pilonidal cyst and sinus"	1	63	281	344
"F03"	"D27"	"Unspecified dementia"	"Benign neoplasm of ovary"	1	0	243	243
"N39"	"H66"	"Other disorders of urinary system"	"Suppurative and unspecified otitis media"	1	182	1087	1269
"K52"	"I70"	"Other and unsp noninfective gastroenteritis and colitis"	"Atherosclerosis"	1	886	1545	2431
"I49"	"H33"	"Other cardiac arrhythmias"	"Retinal detachments and breaks"	1	163	367	530
"G44"	"H66"	"Other headache syndromes"	"Suppurative and unspecified otitis media"	1	0	281	281
"N20"	"O46"	"Calculus of kidney and ureter"	"Antepartum hemorrhage, not elsewhere classified"	1	53	149	202
"G30"	"I71"	"Alzheimer's disease"	"Aortic aneurysm and dissection"	1	53	219	272
"E11"	"J45"	"Type 2 diabetes mellitus"	"Asthma"	1	2756	4200	6956
"J18"	"G20"	"Pneumonia, unspecified organism"	"Parkinson's disease"	1	2571	4029	6600
"C76"	"H90"	"Malignant neoplasm of other and ill-defined sites"	"Conductive and sensorineural hearing loss"	1	19	81	100
"J84"	"M19"	"Other interstitial pulmonary diseases"	"Other and unspecified osteoarthritis"	1	169	390	559
"I21"	"M21"	"Acute myocardial infarction"	"Other acquired deformities of limbs"	1	254	484	738
"J47"	"O03"	"Bronchiectasis"	"Spontaneous abortion"	1	0	40	40
"M54"	"O04"	"Dorsalgia"	"Complications following (induced) termination of pregnancy"	1	0	7192	7192
"H81"	"O71"	"Disorders of vestibular function"	"Other obstetric trauma"	1	8	178	186
"H35"	"M22"	"Other retinal disorders"	"Disorder of patella"	1	0	212	212
"E87"	"N81"	"Other disorders of fluid, electrolyte and acid-base balance"	"Female genital prolapse"	1	0	1872	1872
"C79"	"C06"	"Secondary malignant neoplasm of other and unspecified sites"	"Malignant neoplasm of other and unspecified parts of mouth"	1	36	179	215
"N10"	"J20"	"Acute pyelonephritis"	"Acute bronchitis"	1	316	580	896
"O42"	"O04"	"Premature rupture of membranes"	"Complications following (induced) termination of pregnancy"	1	1423	4063	5486
"N20"	"J36"	"Calculus of kidney and ureter"	"Peritonsillar abscess"	1	44	183	227
"E66"	"O26"	"Overweight and obesity"	"Maternal care for oth conditions predom related to pregnancy"	1	4200	5440	9640
"A41"	"K27"	"Other sepsis"	"Peptic ulcer, site unspecified"	1	868	1127	1995
"K08"	"M17"	"Other disorders of teeth and supporting structures"	"Osteoarthritis of knee"	1	343	538	881
"H35"	"E05"	"Other retinal disorders"	"Thyrotoxicosis [hyperthyroidism]"	1	745	1302	2047
"K57"	"N83"	"Diverticular disease of intestine"	"Noninflammatory disord of ovary, fallop and broad ligament"	1	501	1402	1903
"G56"	"O32"	"Mononeuropathies of upper limb"	"Maternal care for malpresentation of fetus"	1	80	641	721
"M62"	"O71"	"Other disorders of muscle"	"Other obstetric trauma"	1	337	899	1236
"N39"	"A08"	"Other disorders of urinary system"	"Viral and other specified intestinal infections"	1	972	1407	2379
"C85"	"I20"	"Oth and unspecified types of non-Hodgkin lymphoma"	"Angina pectoris"	1	169	487	656
"M16"	"O36"	"Osteoarthritis of hip"	"Maternal care for other fetal problems"	1	0	97	97
"M19"	"O20"	"Other and unspecified osteoarthritis"	"Hemorrhage in early pregnancy"	1	0	217	217
"L89"	"M18"	"Pressure ulcer"	"Osteoarthritis of first carpometacarpal joint"	1	12	66	78
"D73"	"C91"	"Diseases of spleen"	"Lymphoid leukemia"	1	14	58	72
"M50"	"D24"	"Cervical disc disorders"	"Benign neoplasm of breast"	1	136	373	509
"K90"	"E10"	"Intestinal malabsorption"	"Type 1 diabetes mellitus"	1	176	627	803
"I82"	"H40"	"Other venous embolism and thrombosis"	"Glaucoma"	1	30	110	140
"I33"	"H93"	"Acute and subacute endocarditis"	"Other disorders of ear, not elsewhere classified"	1	9	78	87
"G35"	"M62"	"Multiple sclerosis"	"Other disorders of muscle"	1	164	301	465
"H91"	"N81"	"Other and unspecified hearing loss"	"Female genital prolapse"	1	2091	3476	5567
"J84"	"M48"	"Other interstitial pulmonary diseases"	"Other spondylopathies"	1	175	347	522
"K70"	"A15"	"Alcoholic liver disease"	"Respiratory tuberculosis"	1	49	144	193
"J91"	"K57"	"Pleural effusion in conditions classified elsewhere"	"Diverticular disease of intestine"	1	140	378	518
"I34"	"M16"	"Nonrheumatic mitral valve disorders"	"Osteoarthritis of hip"	1	308	990	1298
"D14"	"M22"	"Benign neoplasm of middle ear and respiratory system"	"Disorder of patella"	1	7	86	93
"H54"	"H33"	"Blindness and low vision"	"Retinal detachments and breaks"	1	222	608	830
"I25"	"N80"	"Chronic ischemic heart disease"	"Endometriosis"	1	23	169	192
"K02"	"A09"	"Dental caries"	"Infectious gastroenteritis and colitis, unspecified"	1	306	536	842
"I28"	"I10"	"Other diseases of pulmonary vessels"	"Essential (primary) hypertension"	1	67	153	220
"E46"	"I70"	"Unspecified protein-calorie malnutrition"	"Atherosclerosis"	1	28	117	145
"E86"	"M47"	"Volume depletion"	"Spondylosis"	1	0	3348	3348
"F17"	"N61"	"Nicotine dependence"	"Inflammatory disorders of breast"	1	98	246	344
"E61"	"C50"	"Deficiency of other nutrient elements"	"Malignant neoplasm of breast"	1	6	38	44
"M46"	"K51"	"Other inflammatory spondylopathies"	"Ulcerative colitis"	1	14	234	248
"K80"	"J35"	"Cholelithiasis"	"Chronic diseases of tonsils and adenoids"	1	0	1397	1397
"J81"	"C20"	"Pulmonary edema"	"Malignant neoplasm of rectum"	1	61	224	285
"I35"	"D05"	"Nonrheumatic aortic valve disorders"	"Carcinoma in situ of breast"	1	14	72	86
"C34"	"I97"	"Malignant neoplasm of bronchus and lung"	"Intraop and postproc comp and disorders of circ sys, NEC"	1	13	65	78
"D84"	"J12"	"Other immunodeficiencies"	"Viral pneumonia, not elsewhere classified"	1	34	117	151
"I49"	"O71"	"Other cardiac arrhythmias"	"Other obstetric trauma"	1	0	152	152
"O04"	"Q72"	"Complications following (induced) termination of pregnancy"	"Reduction defects of lower limb"	1	12	62	74
"D12"	"H90"	"Benign neoplasm of colon, rectum, anus and anal canal"	"Conductive and sensorineural hearing loss"	1	762	1559	2321
"D21"	"J20"	"Other benign neoplasms of connective and other soft tissue"	"Acute bronchitis"	1	15	78	93
"M80"	"N31"	"Osteoporosis with current pathological fracture"	"Neuromuscular dysfunction of bladder, NEC"	1	57	253	310
"A41"	"K85"	"Other sepsis"	"Acute pancreatitis"	1	1265	1943	3208
"J93"	"M51"	"Pneumothorax and air leak"	"Thoracic, thoracolum, and lumbosacral intvrt disc disorders"	1	132	404	536
"H11"	"O68"	"Other disorders of conjunctiva"	"Labor and delivery comp by abnlt of fetal acid-base balance"	1	32	123	155
"N18"	"G40"	"Chronic kidney disease (CKD)"	"Epilepsy and recurrent seizures"	1	382	884	1266
"I10"	"H52"	"Essential (primary) hypertension"	"Disorders of refraction and accommodation"	1	1161	2058	3219
"I69"	"C53"	"Sequelae of cerebrovascular disease"	"Malignant neoplasm of cervix uteri"	1	40	124	164
"C61"	"D14"	"Malignant neoplasm of prostate"	"Benign neoplasm of middle ear and respiratory system"	1	65	150	215
"B96"	"D30"	"Oth bacterial agents as the cause of diseases classd elswhr"	"Benign neoplasm of urinary organs"	1	8	54	62
"D25"	"J35"	"Leiomyoma of uterus"	"Chronic diseases of tonsils and adenoids"	1	19	329	348
"I31"	"M50"	"Other diseases of pericardium"	"Cervical disc disorders"	1	7	52	59
"J44"	"N64"	"Other chronic obstructive pulmonary disease"	"Other disorders of breast"	1	173	351	524
"L27"	"O62"	"Dermatitis due to substances taken internally"	"Abnormalities of forces of labor"	1	18	70	88
"I82"	"O68"	"Other venous embolism and thrombosis"	"Labor and delivery comp by abnlt of fetal acid-base balance"	1	21	116	137
"N19"	"N20"	"Unspecified kidney failure"	"Calculus of kidney and ureter"	1	278	961	1239
"J45"	"O20"	"Asthma"	"Hemorrhage in early pregnancy"	1	683	1104	1787
"M05"	"M06"	"Rheumatoid arthritis with rheumatoid factor"	"Other rheumatoid arthritis"	1	4500	5057	9557
"H60"	"H65"	"Otitis externa"	"Nonsuppurative otitis media"	1	803	1127	1930
"J15"	"C16"	"Bacterial pneumonia, not elsewhere classified"	"Malignant neoplasm of stomach"	1	268	440	708
"G90"	"K40"	"Disorders of autonomic nervous system"	"Inguinal hernia"	1	40	163	203
"K25"	"O36"	"Gastric ulcer"	"Maternal care for other fetal problems"	1	13	85	98
"F01"	"K80"	"Vascular dementia"	"Cholelithiasis"	1	35	388	423
"M67"	"M62"	"Other disorders of synovium and tendon"	"Other disorders of muscle"	1	961	1648	2609
"K08"	"C90"	"Other disorders of teeth and supporting structures"	"Multiple myeloma and malignant plasma cell neoplasms"	1	145	282	427
"E21"	"I25"	"Hyperparathyroidism and other disorders of parathyroid gland"	"Chronic ischemic heart disease"	1	583	967	1550
"D64"	"I34"	"Other anemias"	"Nonrheumatic mitral valve disorders"	1	1424	2138	3562
"M10"	"I25"	"Gout"	"Chronic ischemic heart disease"	1	2563	5031	7594
"L89"	"Q05"	"Pressure ulcer"	"Spina bifida"	1	1	83	84
"C43"	"J35"	"Malignant melanoma of skin"	"Chronic diseases of tonsils and adenoids"	1	1	92	93
"N92"	"J36"	"Excessive, frequent and irregular menstruation"	"Peritonsillar abscess"	1	52	302	354
"F17"	"M41"	"Nicotine dependence"	"Scoliosis"	1	29	166	195
"N18"	"H91"	"Chronic kidney disease (CKD)"	"Other and unspecified hearing loss"	1	0	5918	5918
"K83"	"M79"	"Other diseases of biliary tract"	"Oth and unsp soft tissue disorders, not elsewhere classified"	1	256	593	849
"H04"	"J20"	"Disorders of lacrimal system"	"Acute bronchitis"	1	64	154	218
"H25"	"M35"	"Age-related cataract"	"Other systemic involvement of connective tissue"	1	2824	3462	6286
"C18"	"M62"	"Malignant neoplasm of colon"	"Other disorders of muscle"	1	74	758	832
"N28"	"H36"	"Oth disorders of kidney and ureter, not elsewhere classified"	"Retinal disorders in diseases classified elsewhere"	1	39	374	413
"K92"	"C50"	"Other diseases of digestive system"	"Malignant neoplasm of breast"	1	240	1041	1281
"I21"	"L02"	"Acute myocardial infarction"	"Cutaneous abscess, furuncle and carbuncle"	1	1091	1602	2693
"G47"	"M17"	"Sleep disorders"	"Osteoarthritis of knee"	1	1386	3481	4867
"E86"	"E89"	"Volume depletion"	"Postproc endocrine and metabolic comp and disorders, NEC"	1	221	438	659
"J15"	"Q07"	"Bacterial pneumonia, not elsewhere classified"	"Other congenital malformations of nervous system"	1	8	45	53
"A09"	"K25"	"Infectious gastroenteritis and colitis, unspecified"	"Gastric ulcer"	1	1368	1667	3035
"I50"	"H25"	"Heart failure"	"Age-related cataract"	1	0	33961	33961
"C83"	"I83"	"Non-follicular lymphoma"	"Varicose veins of lower extremities"	1	25	213	238
"F41"	"K08"	"Other anxiety disorders"	"Other disorders of teeth and supporting structures"	1	126	368	494
"N81"	"M23"	"Female genital prolapse"	"Internal derangement of knee"	1	1277	1687	2964
"L89"	"N95"	"Pressure ulcer"	"Menopausal and other perimenopausal disorders"	1	35	277	312
"I44"	"O04"	"Atrioventricular and left bundle-branch block"	"Complications following (induced) termination of pregnancy"	1	0	54	54
"C79"	"E34"	"Secondary malignant neoplasm of other and unspecified sites"	"Other endocrine disorders"	1	96	185	281
"K57"	"H40"	"Diverticular disease of intestine"	"Glaucoma"	1	674	968	1642
"I46"	"K35"	"Cardiac arrest"	"Acute appendicitis"	1	2	275	277
"A49"	"N64"	"Bacterial infection of unspecified site"	"Other disorders of breast"	1	79	176	255
"I21"	"O72"	"Acute myocardial infarction"	"Postpartum hemorrhage"	1	4	90	94
"H54"	"I20"	"Blindness and low vision"	"Angina pectoris"	1	140	823	963
"B37"	"G40"	"Candidiasis"	"Epilepsy and recurrent seizures"	1	280	511	791
"E86"	"K65"	"Volume depletion"	"Peritonitis"	1	1153	1421	2574
"D53"	"M17"	"Other nutritional anemias"	"Osteoarthritis of knee"	1	21	102	123
"C78"	"N87"	"Secondary malignant neoplasm of resp and digestive organs"	"Dysplasia of cervix uteri"	1	0	181	181
"J20"	"O48"	"Acute bronchitis"	"Late pregnancy"	1	20	73	93
"N30"	"H90"	"Cystitis"	"Conductive and sensorineural hearing loss"	1	0	4773	4773
"M19"	"M50"	"Other and unspecified osteoarthritis"	"Cervical disc disorders"	1	1052	2043	3095
"C65"	"H91"	"Malignant neoplasm of renal pelvis"	"Other and unspecified hearing loss"	1	91	205	296
"L60"	"J05"	"Nail disorders"	"Acute obstructive laryngitis [croup] and epiglottitis"	1	0	81	81
"J96"	"C18"	"Respiratory failure, not elsewhere classified"	"Malignant neoplasm of colon"	1	1009	1929	2938
"I46"	"M71"	"Cardiac arrest"	"Other bursopathies"	1	0	135	135
"L97"	"J36"	"Non-pressure chronic ulcer of lower limb, NEC"	"Peritonsillar abscess"	1	0	40	40
"C50"	"D05"	"Malignant neoplasm of breast"	"Carcinoma in situ of breast"	1	1696	2074	3770
"K56"	"E10"	"Paralytic ileus and intestinal obstruction without hernia"	"Type 1 diabetes mellitus"	1	869	1255	2124
"C25"	"G44"	"Malignant neoplasm of pancreas"	"Other headache syndromes"	1	0	45	45
"M10"	"H71"	"Gout"	"Cholesteatoma of middle ear"	1	4	51	55
"C34"	"I67"	"Malignant neoplasm of bronchus and lung"	"Other cerebrovascular diseases"	1	73	248	321
"E41"	"K20"	"Nutritional marasmus"	"Esophagitis"	1	22	152	174
"L97"	"K30"	"Non-pressure chronic ulcer of lower limb, NEC"	"Functional dyspepsia"	1	86	535	621
"N50"	"K40"	"Other and unspecified disorders of male genital organs"	"Inguinal hernia"	1	790	1896	2686
"K83"	"L03"	"Other diseases of biliary tract"	"Cellulitis and acute lymphangitis"	1	13	127	140
"J96"	"M02"	"Respiratory failure, not elsewhere classified"	"Postinfective and reactive arthropathies"	1	38	349	387
"C93"	"M19"	"Monocytic leukemia"	"Other and unspecified osteoarthritis"	1	0	30	30
"D64"	"M50"	"Other anemias"	"Cervical disc disorders"	1	88	958	1046
"M54"	"N60"	"Dorsalgia"	"Benign mammary dysplasia"	1	787	1340	2127
"M47"	"O13"	"Spondylosis"	"Gestational hypertension without significant proteinuria"	1	0	44	44
"I50"	"Q65"	"Heart failure"	"Congenital deformities of hip"	1	26	82	108
"A46"	"O62"	"Erysipelas"	"Abnormalities of forces of labor"	1	0	393	393
"I99"	"G99"	"Other and unspecified disorders of circulatory system"	"Oth disorders of nervous system in diseases classd elswhr"	1	24	81	105
"C44"	"M21"	"Other and unspecified malignant neoplasm of skin"	"Other acquired deformities of limbs"	1	88	298	386
"K62"	"O28"	"Other diseases of anus and rectum"	"Abnormal findings on antenatal screening of mother"	1	16	77	93
"N20"	"O70"	"Calculus of kidney and ureter"	"Perineal laceration during delivery"	1	441	1475	1916
"C15"	"K61"	"Malignant neoplasm of esophagus"	"Abscess of anal and rectal regions"	1	0	54	54
"J98"	"K21"	"Other respiratory disorders"	"Gastro-esophageal reflux disease"	1	341	545	886
"I26"	"C54"	"Pulmonary embolism"	"Malignant neoplasm of corpus uteri"	1	91	346	437
"D32"	"I83"	"Benign neoplasm of meninges"	"Varicose veins of lower extremities"	1	26	152	178
"A41"	"K86"	"Other sepsis"	"Other diseases of pancreas"	1	651	1509	2160
"J86"	"M17"	"Pyothorax"	"Osteoarthritis of knee"	1	82	261	343
"E73"	"N30"	"Lactose intolerance"	"Cystitis"	1	132	236	368
"K31"	"O70"	"Other diseases of stomach and duodenum"	"Perineal laceration during delivery"	1	4	48	52
"M99"	"J36"	"Biomechanical lesions, not elsewhere classified"	"Peritonsillar abscess"	1	3	47	50
"J41"	"N92"	"Simple and mucopurulent chronic bronchitis"	"Excessive, frequent and irregular menstruation"	1	33	121	154
"K63"	"O65"	"Other diseases of intestine"	"Obstructed labor due to maternal pelvic abnormality"	1	0	35	35
"O04"	"K01"	"Complications following (induced) termination of pregnancy"	"Embedded and impacted teeth"	1	182	343	525
"M00"	"H83"	"Pyogenic arthritis"	"Other diseases of inner ear"	1	24	92	116
"I48"	"H72"	"Atrial fibrillation and flutter"	"Perforation of tympanic membrane"	1	97	345	442
"N80"	"L05"	"Endometriosis"	"Pilonidal cyst and sinus"	1	10	56	66
"M85"	"M08"	"Other disorders of bone density and structure"	"Juvenile arthritis"	1	0	59	59
"H36"	"O99"	"Retinal disorders in diseases classified elsewhere"	"Oth maternal diseases classd elsw but compl preg/chldbrth"	1	96	266	362
"N18"	"Q82"	"Chronic kidney disease (CKD)"	"Other congenital malformations of skin"	1	11	51	62
"I69"	"E03"	"Sequelae of cerebrovascular disease"	"Other hypothyroidism"	1	2108	2468	4576
"E83"	"I63"	"Disorders of mineral metabolism"	"Cerebral infarction"	1	290	608	898
"I30"	"O04"	"Acute pericarditis"	"Complications following (induced) termination of pregnancy"	1	5	101	106
"I26"	"E05"	"Pulmonary embolism"	"Thyrotoxicosis [hyperthyroidism]"	1	390	667	1057
"E87"	"H44"	"Other disorders of fluid, electrolyte and acid-base balance"	"Disorders of globe"	1	30	173	203
"J44"	"K61"	"Other chronic obstructive pulmonary disease"	"Abscess of anal and rectal regions"	1	208	921	1129
"I44"	"N95"	"Atrioventricular and left bundle-branch block"	"Menopausal and other perimenopausal disorders"	1	73	234	307
"C95"	"H25"	"Leukemia of unspecified cell type"	"Age-related cataract"	1	77	180	257
"C79"	"K35"	"Secondary malignant neoplasm of other and unspecified sites"	"Acute appendicitis"	1	0	348	348
"C77"	"H71"	"Secondary and unspecified malignant neoplasm of lymph nodes"	"Cholesteatoma of middle ear"	1	2	35	37
"N30"	"L03"	"Cystitis"	"Cellulitis and acute lymphangitis"	1	445	1655	2100
"G20"	"C61"	"Parkinson's disease"	"Malignant neoplasm of prostate"	1	207	417	624
"I49"	"M20"	"Other cardiac arrhythmias"	"Acquired deformities of fingers and toes"	1	280	703	983
"M72"	"O47"	"Fibroblastic disorders"	"False labor"	1	0	58	58
"J44"	"H52"	"Other chronic obstructive pulmonary disease"	"Disorders of refraction and accommodation"	1	344	677	1021
"F03"	"I72"	"Unspecified dementia"	"Other aneurysm"	1	40	153	193
"E86"	"I63"	"Volume depletion"	"Cerebral infarction"	1	0	15039	15039
"J22"	"M67"	"Unspecified acute lower respiratory infection"	"Other disorders of synovium and tendon"	1	14	128	142
"O99"	"M76"	"Oth maternal diseases classd elsw but compl preg/chldbrth"	"Enthesopathies, lower limb, excluding foot"	1	466	649	1115
"K56"	"N63"	"Paralytic ileus and intestinal obstruction without hernia"	"Unspecified lump in breast"	1	55	318	373
"C83"	"N81"	"Non-follicular lymphoma"	"Female genital prolapse"	1	23	156	179
"H57"	"O26"	"Other disorders of eye and adnexa"	"Maternal care for oth conditions predom related to pregnancy"	1	7	196	203
"I63"	"H81"	"Cerebral infarction"	"Disorders of vestibular function"	1	1149	2243	3392
"M19"	"H93"	"Other and unspecified osteoarthritis"	"Other disorders of ear, not elsewhere classified"	1	590	1474	2064
"J90"	"C61"	"Pleural effusion, not elsewhere classified"	"Malignant neoplasm of prostate"	1	225	476	701
"C50"	"J35"	"Malignant neoplasm of breast"	"Chronic diseases of tonsils and adenoids"	1	10	146	156
"H20"	"O82"	"Iridocyclitis"	"Encounter for cesarean delivery without indication"	1	62	180	242
"G31"	"H81"	"Oth degenerative diseases of nervous system, NEC"	"Disorders of vestibular function"	1	93	285	378
"H25"	"K08"	"Age-related cataract"	"Other disorders of teeth and supporting structures"	1	655	957	1612
"O72"	"H72"	"Postpartum hemorrhage"	"Perforation of tympanic membrane"	1	0	398	398
"O99"	"L70"	"Oth maternal diseases classd elsw but compl preg/chldbrth"	"Acne"	1	57	229	286
"O70"	"N62"	"Perineal laceration during delivery"	"Hypertrophy of breast"	1	410	907	1317
"N39"	"O02"	"Other disorders of urinary system"	"Other abnormal products of conception"	1	46	1184	1230
"D13"	"O34"	"Benign neoplasm of and ill-defined parts of digestive system"	"Maternal care for abnormality of pelvic organs"	1	3	32	35
"C80"	"D27"	"Malignant neoplasm without specification of site"	"Benign neoplasm of ovary"	1	0	49	49
"N18"	"N41"	"Chronic kidney disease (CKD)"	"Inflammatory diseases of prostate"	1	26	119	145
"K73"	"O80"	"Chronic hepatitis, not elsewhere classified"	"Encounter for full-term uncomplicated delivery"	1	11	90	101
"H52"	"O99"	"Disorders of refraction and accommodation"	"Oth maternal diseases classd elsw but compl preg/chldbrth"	1	651	879	1530
"C25"	"A09"	"Malignant neoplasm of pancreas"	"Infectious gastroenteritis and colitis, unspecified"	1	80	240	320
"F33"	"D23"	"Major depressive disorder, recurrent"	"Other benign neoplasms of skin"	1	57	247	304
"M16"	"M51"	"Osteoarthritis of hip"	"Thoracic, thoracolum, and lumbosacral intvrt disc disorders"	1	4165	4957	9122
"G95"	"K21"	"Other and unspecified diseases of spinal cord"	"Gastro-esophageal reflux disease"	1	53	248	301
"C71"	"K57"	"Malignant neoplasm of brain"	"Diverticular disease of intestine"	1	60	212	272
"I70"	"J36"	"Atherosclerosis"	"Peritonsillar abscess"	1	23	74	97
"O30"	"O20"	"Multiple gestation"	"Hemorrhage in early pregnancy"	1	1322	2423	3745
"O48"	"M22"	"Late pregnancy"	"Disorder of patella"	1	174	457	631
"H26"	"N70"	"Other cataract"	"Salpingitis and oophoritis"	1	0	76	76
"A09"	"H91"	"Infectious gastroenteritis and colitis, unspecified"	"Other and unspecified hearing loss"	1	1997	3920	5917
"D63"	"J18"	"Anemia in chronic diseases classified elsewhere"	"Pneumonia, unspecified organism"	1	3435	3922	7357
"J86"	"O62"	"Pyothorax"	"Abnormalities of forces of labor"	1	1	51	52
"C79"	"C53"	"Secondary malignant neoplasm of other and unspecified sites"	"Malignant neoplasm of cervix uteri"	1	77	384	461
"G47"	"H52"	"Sleep disorders"	"Disorders of refraction and accommodation"	1	311	698	1009
"N39"	"O08"	"Other disorders of urinary system"	"Complications following ectopic and molar pregnancy"	1	115	441	556
"I47"	"Q17"	"Paroxysmal tachycardia"	"Other congenital malformations of ear"	1	2	40	42
"J10"	"E66"	"Influenza due to other identified influenza virus"	"Overweight and obesity"	1	42	224	266
"M85"	"C81"	"Other disorders of bone density and structure"	"Hodgkin lymphoma"	1	2	48	50
"C22"	"I42"	"Malignant neoplasm of liver and intrahepatic bile ducts"	"Cardiomyopathy"	1	6	52	58
"I50"	"G35"	"Heart failure"	"Multiple sclerosis"	1	19	282	301
"E23"	"O26"	"Hypofunction and other disorders of the pituitary gland"	"Maternal care for oth conditions predom related to pregnancy"	1	4	80	84
"A31"	"J18"	"Infection due to other mycobacteria"	"Pneumonia, unspecified organism"	1	134	238	372
"L20"	"J05"	"Atopic dermatitis"	"Acute obstructive laryngitis [croup] and epiglottitis"	1	286	489	775
"A49"	"L05"	"Bacterial infection of unspecified site"	"Pilonidal cyst and sinus"	1	34	155	189
"J15"	"M25"	"Bacterial pneumonia, not elsewhere classified"	"Other joint disorder, not elsewhere classified"	1	392	1149	1541
"N30"	"M66"	"Cystitis"	"Spontaneous rupture of synovium and tendon"	1	190	306	496
"N95"	"N93"	"Menopausal and other perimenopausal disorders"	"Other abnormal uterine and vaginal bleeding"	1	586	782	1368
"K25"	"O80"	"Gastric ulcer"	"Encounter for full-term uncomplicated delivery"	1	0	499	499
"J14"	"I83"	"Pneumonia due to Hemophilus influenzae"	"Varicose veins of lower extremities"	1	26	87	113
"C64"	"K51"	"Malignant neoplasm of kidney, except renal pelvis"	"Ulcerative colitis"	1	12	69	81
"E66"	"L20"	"Overweight and obesity"	"Atopic dermatitis"	1	56	724	780
"J96"	"L21"	"Respiratory failure, not elsewhere classified"	"Seborrheic dermatitis"	1	68	221	289
"D80"	"J35"	"Immunodeficiency with predominantly antibody defects"	"Chronic diseases of tonsils and adenoids"	1	18	65	83
"B96"	"I48"	"Oth bacterial agents as the cause of diseases classd elswhr"	"Atrial fibrillation and flutter"	1	332	633	965
"J81"	"K42"	"Pulmonary edema"	"Umbilical hernia"	1	25	126	151
"E89"	"M54"	"Postproc endocrine and metabolic comp and disorders, NEC"	"Dorsalgia"	1	167	467	634
"N80"	"K01"	"Endometriosis"	"Embedded and impacted teeth"	1	10	54	64
"K74"	"C50"	"Fibrosis and cirrhosis of liver"	"Malignant neoplasm of breast"	1	68	144	212
"M80"	"H50"	"Osteoporosis with current pathological fracture"	"Other strabismus"	1	28	157	185
"I50"	"M34"	"Heart failure"	"Systemic sclerosis [scleroderma]"	1	59	173	232
"I49"	"O62"	"Other cardiac arrhythmias"	"Abnormalities of forces of labor"	1	0	658	658
"I46"	"M47"	"Cardiac arrest"	"Spondylosis"	1	0	571	571
"E11"	"D25"	"Type 2 diabetes mellitus"	"Leiomyoma of uterus"	1	318	1474	1792
"G20"	"D27"	"Parkinson's disease"	"Benign neoplasm of ovary"	1	4	67	71
"N10"	"G35"	"Acute pyelonephritis"	"Multiple sclerosis"	1	10	168	178
"I72"	"I25"	"Other aneurysm"	"Chronic ischemic heart disease"	1	769	1408	2177
"G51"	"J20"	"Facial nerve disorders"	"Acute bronchitis"	1	31	104	135
"C06"	"K86"	"Malignant neoplasm of other and unspecified parts of mouth"	"Other diseases of pancreas"	1	17	69	86
"G96"	"M72"	"Other disorders of central nervous system"	"Fibroblastic disorders"	1	44	339	383
"O28"	"N98"	"Abnormal findings on antenatal screening of mother"	"Complications associated with artificial fertilization"	1	21	108	129
"M81"	"D06"	"Osteoporosis without current pathological fracture"	"Carcinoma in situ of cervix uteri"	1	0	81	81
"C77"	"C56"	"Secondary and unspecified malignant neoplasm of lymph nodes"	"Malignant neoplasm of ovary"	1	200	511	711
"I26"	"C53"	"Pulmonary embolism"	"Malignant neoplasm of cervix uteri"	1	46	135	181
"F55"	"F10"	"Abuse of non-psychoactive substances"	"Alcohol related disorders"	1	118	265	383
"I70"	"E10"	"Atherosclerosis"	"Type 1 diabetes mellitus"	1	4168	5286	9454
"N31"	"G35"	"Neuromuscular dysfunction of bladder, NEC"	"Multiple sclerosis"	1	63	1164	1227
"M24"	"G40"	"Other specific joint derangements"	"Epilepsy and recurrent seizures"	1	216	483	699
"A63"	"J35"	"Oth predominantly sexually transmitted diseases, NEC"	"Chronic diseases of tonsils and adenoids"	1	183	802	985
"F43"	"L05"	"Reaction to severe stress, and adjustment disorders"	"Pilonidal cyst and sinus"	1	23	109	132
"I21"	"M41"	"Acute myocardial infarction"	"Scoliosis"	1	131	233	364
"J06"	"N18"	"Acute upper resp infections of multiple and unsp sites"	"Chronic kidney disease (CKD)"	1	133	249	382
"H44"	"O70"	"Disorders of globe"	"Perineal laceration during delivery"	1	53	336	389
"E23"	"J35"	"Hypofunction and other disorders of the pituitary gland"	"Chronic diseases of tonsils and adenoids"	1	6	130	136
"E41"	"H93"	"Nutritional marasmus"	"Other disorders of ear, not elsewhere classified"	1	0	64	64
"H20"	"H65"	"Iridocyclitis"	"Nonsuppurative otitis media"	1	14	68	82
"K01"	"Q17"	"Embedded and impacted teeth"	"Other congenital malformations of ear"	1	9	85	94
"D69"	"H93"	"Purpura and other hemorrhagic conditions"	"Other disorders of ear, not elsewhere classified"	1	52	243	295
"D10"	"O04"	"Benign neoplasm of mouth and pharynx"	"Complications following (induced) termination of pregnancy"	1	0	152	152
"I73"	"Q18"	"Other peripheral vascular diseases"	"Other congenital malformations of face and neck"	1	1	41	42
"K59"	"G12"	"Other functional intestinal disorders"	"Spinal muscular atrophy and related syndromes"	1	122	267	389
"H60"	"O68"	"Otitis externa"	"Labor and delivery comp by abnlt of fetal acid-base balance"	1	122	230	352
"E86"	"K27"	"Volume depletion"	"Peptic ulcer, site unspecified"	1	817	1335	2152
"I42"	"D17"	"Cardiomyopathy"	"Benign lipomatous neoplasm"	1	68	203	271
"D09"	"G45"	"Carcinoma in situ of other and unspecified sites"	"Transient cerebral ischemic attacks and related syndromes"	1	18	153	171
"B37"	"K50"	"Candidiasis"	"Crohn's disease [regional enteritis]"	1	71	186	257
"O24"	"M23"	"Diabetes in pregnancy, childbirth, and the puerperium"	"Internal derangement of knee"	1	270	415	685
"K58"	"O20"	"Irritable bowel syndrome"	"Hemorrhage in early pregnancy"	1	239	492	731
"O72"	"O21"	"Postpartum hemorrhage"	"Excessive vomiting in pregnancy"	1	0	11990	11990
"O89"	"O47"	"Complications of anesthesia during the puerperium"	"False labor"	1	46	122	168
"L97"	"K61"	"Non-pressure chronic ulcer of lower limb, NEC"	"Abscess of anal and rectal regions"	1	29	223	252
"I50"	"O47"	"Heart failure"	"False labor"	1	0	28	28
"L90"	"D48"	"Atrophic disorders of skin"	"Neoplasm of uncertain behavior of other and unsp sites"	1	0	134	134
"M79"	"D24"	"Oth and unsp soft tissue disorders, not elsewhere classified"	"Benign neoplasm of breast"	1	596	1325	1921
"H44"	"O03"	"Disorders of globe"	"Spontaneous abortion"	1	3	105	108
"A49"	"D14"	"Bacterial infection of unspecified site"	"Benign neoplasm of middle ear and respiratory system"	1	38	225	263
"K92"	"N85"	"Other diseases of digestive system"	"Other noninflammatory disorders of uterus, except cervix"	1	12	52	64
"I85"	"L40"	"Esophageal varices"	"Psoriasis"	1	39	119	158
"K85"	"H50"	"Acute pancreatitis"	"Other strabismus"	1	24	77	101
"I15"	"O03"	"Secondary hypertension"	"Spontaneous abortion"	1	0	88	88
"M06"	"D25"	"Other rheumatoid arthritis"	"Leiomyoma of uterus"	1	89	353	442
"C78"	"C90"	"Secondary malignant neoplasm of resp and digestive organs"	"Multiple myeloma and malignant plasma cell neoplasms"	1	35	96	131
"E25"	"I49"	"Adrenogenital disorders"	"Other cardiac arrhythmias"	1	40	102	142
"E13"	"I50"	"Other specified diabetes mellitus"	"Heart failure"	1	356	557	913
"N99"	"J35"	"Intraop and postproc comp and disorders of GU sys, NEC"	"Chronic diseases of tonsils and adenoids"	1	12	74	86
"O70"	"K01"	"Perineal laceration during delivery"	"Embedded and impacted teeth"	1	4	573	577
"I34"	"K35"	"Nonrheumatic mitral valve disorders"	"Acute appendicitis"	1	54	164	218
"C90"	"K57"	"Multiple myeloma and malignant plasma cell neoplasms"	"Diverticular disease of intestine"	1	115	229	344
"C34"	"K76"	"Malignant neoplasm of bronchus and lung"	"Other diseases of liver"	1	63	355	418
"A09"	"M51"	"Infectious gastroenteritis and colitis, unspecified"	"Thoracic, thoracolum, and lumbosacral intvrt disc disorders"	1	1258	1675	2933
"M81"	"M54"	"Osteoporosis without current pathological fracture"	"Dorsalgia"	1	5907	10734	16641
"N39"	"N10"	"Other disorders of urinary system"	"Acute pyelonephritis"	1	3737	4584	8321
"A41"	"N47"	"Other sepsis"	"Disorders of prepuce"	1	385	1080	1465
"D31"	"N92"	"Benign neoplasm of eye and adnexa"	"Excessive, frequent and irregular menstruation"	1	11	85	96
"H91"	"O30"	"Other and unspecified hearing loss"	"Multiple gestation"	1	8	85	93
"C18"	"O42"	"Malignant neoplasm of colon"	"Premature rupture of membranes"	1	0	25	25
"I35"	"I83"	"Nonrheumatic aortic valve disorders"	"Varicose veins of lower extremities"	1	0	2230	2230
"K56"	"K60"	"Paralytic ileus and intestinal obstruction without hernia"	"Fissure and fistula of anal and rectal regions"	1	267	464	731
"C44"	"K80"	"Other and unspecified malignant neoplasm of skin"	"Cholelithiasis"	1	378	1593	1971
"C91"	"M20"	"Lymphoid leukemia"	"Acquired deformities of fingers and toes"	1	19	93	112
"I67"	"M17"	"Other cerebrovascular diseases"	"Osteoarthritis of knee"	1	179	544	723
"C79"	"E03"	"Secondary malignant neoplasm of other and unspecified sites"	"Other hypothyroidism"	1	218	514	732
"E83"	"G62"	"Disorders of mineral metabolism"	"Other and unspecified polyneuropathies"	1	162	279	441
"L40"	"H80"	"Psoriasis"	"Otosclerosis"	1	11	53	64
"A31"	"J44"	"Infection due to other mycobacteria"	"Other chronic obstructive pulmonary disease"	1	79	223	302
"I60"	"L03"	"Nontraumatic subarachnoid hemorrhage"	"Cellulitis and acute lymphangitis"	1	20	102	122
"E64"	"O02"	"Sequelae of malnutrition and other nutritional deficiencies"	"Other abnormal products of conception"	1	0	29	29
"G62"	"O80"	"Other and unspecified polyneuropathies"	"Encounter for full-term uncomplicated delivery"	1	0	188	188
"M85"	"M06"	"Other disorders of bone density and structure"	"Other rheumatoid arthritis"	1	368	1213	1581
"K80"	"M24"	"Cholelithiasis"	"Other specific joint derangements"	1	332	511	843
"M80"	"K35"	"Osteoporosis with current pathological fracture"	"Acute appendicitis"	1	41	323	364
"I42"	"O99"	"Cardiomyopathy"	"Oth maternal diseases classd elsw but compl preg/chldbrth"	1	59	135	194
"D68"	"K30"	"Other coagulation defects"	"Functional dyspepsia"	1	124	360	484
"J03"	"G40"	"Acute tonsillitis"	"Epilepsy and recurrent seizures"	1	581	770	1351
"O80"	"Q52"	"Encounter for full-term uncomplicated delivery"	"Other congenital malformations of female genitalia"	1	27	149	176
"K57"	"O30"	"Diverticular disease of intestine"	"Multiple gestation"	1	0	29	29
"F32"	"O70"	"Depressive episode"	"Perineal laceration during delivery"	1	337	745	1082
"G24"	"G82"	"Dystonia"	"Paraplegia (paraparesis) and quadriplegia (quadriparesis)"	1	63	141	204
"J96"	"L60"	"Respiratory failure, not elsewhere classified"	"Nail disorders"	1	57	315	372
"J44"	"N70"	"Other chronic obstructive pulmonary disease"	"Salpingitis and oophoritis"	1	0	231	231
"E11"	"O48"	"Type 2 diabetes mellitus"	"Late pregnancy"	1	0	59	59
"E86"	"I25"	"Volume depletion"	"Chronic ischemic heart disease"	1	0	23950	23950
"L29"	"K51"	"Pruritus"	"Ulcerative colitis"	1	28	98	126
"I47"	"O47"	"Paroxysmal tachycardia"	"False labor"	1	118	210	328
"C06"	"K13"	"Malignant neoplasm of other and unspecified parts of mouth"	"Other diseases of lip and oral mucosa"	1	190	361	551
"D62"	"O65"	"Acute posthemorrhagic anemia"	"Obstructed labor due to maternal pelvic abnormality"	1	0	43	43
"F41"	"C24"	"Other anxiety disorders"	"Malignant neoplasm of other and unsp parts of biliary tract"	1	79	261	340
"F41"	"C43"	"Other anxiety disorders"	"Malignant melanoma of skin"	1	75	382	457
"L90"	"D05"	"Atrophic disorders of skin"	"Carcinoma in situ of breast"	1	36	210	246
"F41"	"D12"	"Other anxiety disorders"	"Benign neoplasm of colon, rectum, anus and anal canal"	1	470	942	1412
"E83"	"E05"	"Disorders of mineral metabolism"	"Thyrotoxicosis [hyperthyroidism]"	1	142	518	660
"C22"	"I70"	"Malignant neoplasm of liver and intrahepatic bile ducts"	"Atherosclerosis"	1	30	242	272
"I49"	"M22"	"Other cardiac arrhythmias"	"Disorder of patella"	1	4	336	340
"E03"	"M65"	"Other hypothyroidism"	"Synovitis and tenosynovitis"	1	385	1005	1390
"E11"	"O85"	"Type 2 diabetes mellitus"	"Puerperal sepsis"	1	0	31	31
"J91"	"E78"	"Pleural effusion in conditions classified elsewhere"	"Disorders of lipoprotein metabolism and other lipidemias"	1	255	900	1155
"I31"	"I25"	"Other diseases of pericardium"	"Chronic ischemic heart disease"	1	701	1072	1773
"J96"	"C65"	"Respiratory failure, not elsewhere classified"	"Malignant neoplasm of renal pelvis"	1	47	114	161
"D64"	"J38"	"Other anemias"	"Diseases of vocal cords and larynx, not elsewhere classified"	1	149	661	810
"J18"	"C83"	"Pneumonia, unspecified organism"	"Non-follicular lymphoma"	1	1129	1932	3061
"G53"	"G56"	"Cranial nerve disorders in diseases classified elsewhere"	"Mononeuropathies of upper limb"	1	17	72	89
"N19"	"H36"	"Unspecified kidney failure"	"Retinal disorders in diseases classified elsewhere"	1	243	1270	1513
"C18"	"J33"	"Malignant neoplasm of colon"	"Nasal polyp"	1	12	101	113
"J15"	"M65"	"Bacterial pneumonia, not elsewhere classified"	"Synovitis and tenosynovitis"	1	88	1387	1475
"C78"	"O42"	"Secondary malignant neoplasm of resp and digestive organs"	"Premature rupture of membranes"	1	0	33	33
"L90"	"Q83"	"Atrophic disorders of skin"	"Congenital malformations of breast"	1	47	118	165
"E68"	"F10"	"Sequelae of hyperalimentation"	"Alcohol related disorders"	1	16	150	166
"K45"	"O14"	"Other abdominal hernia"	"Pre-eclampsia"	1	0	52	52
"N80"	"O48"	"Endometriosis"	"Late pregnancy"	1	72	150	222
"N47"	"M02"	"Disorders of prepuce"	"Postinfective and reactive arthropathies"	1	90	206	296
"E64"	"N63"	"Sequelae of malnutrition and other nutritional deficiencies"	"Unspecified lump in breast"	1	0	76	76
"C50"	"O46"	"Malignant neoplasm of breast"	"Antepartum hemorrhage, not elsewhere classified"	1	0	50	50
"G55"	"K40"	"Nerve root and plexus compressions in diseases classd elswhr"	"Inguinal hernia"	1	41	145	186
"N39"	"Q05"	"Other disorders of urinary system"	"Spina bifida"	1	26	202	228
"M19"	"O63"	"Other and unspecified osteoarthritis"	"Long labor"	1	0	72	72
"K91"	"E11"	"Intraop and postproc comp and disorders of dgstv sys, NEC"	"Type 2 diabetes mellitus"	1	348	553	901
"I48"	"H65"	"Atrial fibrillation and flutter"	"Nonsuppurative otitis media"	1	76	798	874
"H90"	"I83"	"Conductive and sensorineural hearing loss"	"Varicose veins of lower extremities"	1	553	1002	1555
"J90"	"N48"	"Pleural effusion, not elsewhere classified"	"Other disorders of penis"	1	22	122	144
"J12"	"C92"	"Viral pneumonia, not elsewhere classified"	"Myeloid leukemia"	1	11	52	63
"E86"	"F10"	"Volume depletion"	"Alcohol related disorders"	1	0	11006	11006
"L08"	"I25"	"Other local infections of skin and subcutaneous tissue"	"Chronic ischemic heart disease"	1	1183	1666	2849
"A46"	"L72"	"Erysipelas"	"Follicular cysts of skin and subcutaneous tissue"	1	53	149	202
"M19"	"M42"	"Other and unspecified osteoarthritis"	"Spinal osteochondrosis"	1	23	218	241
"A41"	"M75"	"Other sepsis"	"Shoulder lesions"	1	0	3614	3614
"J96"	"N83"	"Respiratory failure, not elsewhere classified"	"Noninflammatory disord of ovary, fallop and broad ligament"	1	48	645	693
"I63"	"N95"	"Cerebral infarction"	"Menopausal and other perimenopausal disorders"	1	367	974	1341
"I10"	"O82"	"Essential (primary) hypertension"	"Encounter for cesarean delivery without indication"	1	0	2511	2511
"M20"	"L20"	"Acquired deformities of fingers and toes"	"Atopic dermatitis"	1	35	115	150
"M54"	"D48"	"Dorsalgia"	"Neoplasm of uncertain behavior of other and unsp sites"	1	117	314	431
"J96"	"L82"	"Respiratory failure, not elsewhere classified"	"Seborrheic keratosis"	1	79	176	255
"L98"	"J36"	"Oth disorders of skin, subcu, not elsewhere classified"	"Peritonsillar abscess"	1	13	66	79
"J22"	"C43"	"Unspecified acute lower respiratory infection"	"Malignant melanoma of skin"	1	7	64	71
"H52"	"D24"	"Disorders of refraction and accommodation"	"Benign neoplasm of breast"	1	129	229	358
"D84"	"J00"	"Other immunodeficiencies"	"Acute nasopharyngitis [common cold]"	1	64	252	316
"K76"	"J34"	"Other diseases of liver"	"Other and unspecified disorders of nose and nasal sinuses"	1	32	161	193
"J06"	"K44"	"Acute upper resp infections of multiple and unsp sites"	"Diaphragmatic hernia"	1	28	151	179
"I60"	"M51"	"Nontraumatic subarachnoid hemorrhage"	"Thoracic, thoracolum, and lumbosacral intvrt disc disorders"	1	119	297	416
"J96"	"Q54"	"Respiratory failure, not elsewhere classified"	"Hypospadias"	1	7	100	107
"N19"	"I11"	"Unspecified kidney failure"	"Hypertensive heart disease"	1	515	871	1386
"I50"	"D25"	"Heart failure"	"Leiomyoma of uterus"	1	21	546	567
"M48"	"E04"	"Other spondylopathies"	"Other nontoxic goiter"	1	289	868	1157
"N39"	"I44"	"Other disorders of urinary system"	"Atrioventricular and left bundle-branch block"	1	1442	2086	3528
"I48"	"J37"	"Atrial fibrillation and flutter"	"Chronic laryngitis and laryngotracheitis"	1	48	514	562
"E03"	"K00"	"Other hypothyroidism"	"Disorders of tooth development and eruption"	1	5	74	79
"I51"	"N47"	"Complications and ill-defined descriptions of heart disease"	"Disorders of prepuce"	1	48	122	170
"N12"	"O71"	"Tubulo-interstitial nephritis, not spcf as acute or chronic"	"Other obstetric trauma"	1	10	52	62
"Q61"	"O82"	"Cystic kidney disease"	"Encounter for cesarean delivery without indication"	1	24	88	112
"A46"	"N97"	"Erysipelas"	"Female infertility"	1	0	155	155
"K22"	"M54"	"Other diseases of esophagus"	"Dorsalgia"	1	655	1403	2058
"C78"	"Q82"	"Secondary malignant neoplasm of resp and digestive organs"	"Other congenital malformations of skin"	1	3	49	52
"G45"	"N20"	"Transient cerebral ischemic attacks and related syndromes"	"Calculus of kidney and ureter"	1	431	888	1319
"E87"	"C56"	"Other disorders of fluid, electrolyte and acid-base balance"	"Malignant neoplasm of ovary"	1	109	536	645
"D68"	"F10"	"Other coagulation defects"	"Alcohol related disorders"	1	187	521	708
"F41"	"M75"	"Other anxiety disorders"	"Shoulder lesions"	1	392	1067	1459
"G31"	"L02"	"Oth degenerative diseases of nervous system, NEC"	"Cutaneous abscess, furuncle and carbuncle"	1	46	147	193
"B37"	"H40"	"Candidiasis"	"Glaucoma"	1	77	287	364
"I61"	"N84"	"Nontraumatic intracerebral hemorrhage"	"Polyp of female genital tract"	1	25	105	130
"M17"	"O23"	"Osteoarthritis of knee"	"Infections of genitourinary tract in pregnancy"	1	0	144	144
"E61"	"J44"	"Deficiency of other nutrient elements"	"Other chronic obstructive pulmonary disease"	1	112	207	319
"I50"	"K11"	"Heart failure"	"Diseases of salivary glands"	1	259	406	665
"H26"	"M67"	"Other cataract"	"Other disorders of synovium and tendon"	1	215	566	781
"K31"	"N60"	"Other diseases of stomach and duodenum"	"Benign mammary dysplasia"	1	6	43	49
"G47"	"C10"	"Sleep disorders"	"Malignant neoplasm of oropharynx"	1	64	193	257
"O63"	"G40"	"Long labor"	"Epilepsy and recurrent seizures"	1	36	148	184
"I25"	"I20"	"Chronic ischemic heart disease"	"Angina pectoris"	1	0	141468	141468
"F17"	"J37"	"Nicotine dependence"	"Chronic laryngitis and laryngotracheitis"	1	41	179	220
"F32"	"M93"	"Depressive episode"	"Other osteochondropathies"	1	3	39	42
"G93"	"O30"	"Other disorders of brain"	"Multiple gestation"	1	0	25	25
"L92"	"O62"	"Granulomatous disorders of skin and subcutaneous tissue"	"Abnormalities of forces of labor"	1	14	117	131
"D25"	"O66"	"Leiomyoma of uterus"	"Other obstructed labor"	1	0	102	102
"I26"	"H40"	"Pulmonary embolism"	"Glaucoma"	1	138	477	615
"J84"	"N84"	"Other interstitial pulmonary diseases"	"Polyp of female genital tract"	1	20	74	94
"G47"	"C45"	"Sleep disorders"	"Mesothelioma"	1	50	199	249
"I71"	"N48"	"Aortic aneurysm and dissection"	"Other disorders of penis"	1	54	213	267
"H90"	"C11"	"Conductive and sensorineural hearing loss"	"Malignant neoplasm of nasopharynx"	1	18	78	96
"E87"	"M32"	"Other disorders of fluid, electrolyte and acid-base balance"	"Systemic lupus erythematosus (SLE)"	1	15	85	100
"O99"	"D06"	"Oth maternal diseases classd elsw but compl preg/chldbrth"	"Carcinoma in situ of cervix uteri"	1	245	433	678
"C34"	"G57"	"Malignant neoplasm of bronchus and lung"	"Mononeuropathies of lower limb"	1	13	192	205
"F17"	"A09"	"Nicotine dependence"	"Infectious gastroenteritis and colitis, unspecified"	1	665	1316	1981
"E86"	"F99"	"Volume depletion"	"Mental disorder, not otherwise specified"	1	119	294	413
"G56"	"H72"	"Mononeuropathies of upper limb"	"Perforation of tympanic membrane"	1	84	179	263
"A41"	"K41"	"Other sepsis"	"Femoral hernia"	1	53	242	295
"I26"	"M19"	"Pulmonary embolism"	"Other and unspecified osteoarthritis"	1	547	927	1474
"F33"	"O68"	"Major depressive disorder, recurrent"	"Labor and delivery comp by abnlt of fetal acid-base balance"	1	243	543	786
"H50"	"J45"	"Other strabismus"	"Asthma"	1	556	1028	1584
"M76"	"N87"	"Enthesopathies, lower limb, excluding foot"	"Dysplasia of cervix uteri"	1	120	305	425
"M41"	"J03"	"Scoliosis"	"Acute tonsillitis"	1	113	227	340
"C79"	"L43"	"Secondary malignant neoplasm of other and unspecified sites"	"Lichen planus"	1	5	49	54
"K12"	"H66"	"Stomatitis and related lesions"	"Suppurative and unspecified otitis media"	1	215	366	581
"J06"	"K50"	"Acute upper resp infections of multiple and unsp sites"	"Crohn's disease [regional enteritis]"	1	26	118	144
"L98"	"N81"	"Oth disorders of skin, subcu, not elsewhere classified"	"Female genital prolapse"	1	127	381	508
"D43"	"N92"	"Neoplasm of uncertain behavior of brain and cnsl"	"Excessive, frequent and irregular menstruation"	1	6	94	100
"H53"	"O26"	"Visual disturbances"	"Maternal care for oth conditions predom related to pregnancy"	1	24	234	258
"D23"	"O80"	"Other benign neoplasms of skin"	"Encounter for full-term uncomplicated delivery"	1	0	2501	2501
"E86"	"O70"	"Volume depletion"	"Perineal laceration during delivery"	1	178	313	491
"E29"	"F10"	"Testicular dysfunction"	"Alcohol related disorders"	1	4	94	98
"D64"	"L30"	"Other anemias"	"Other and unspecified dermatitis"	1	658	1046	1704
"E11"	"O47"	"Type 2 diabetes mellitus"	"False labor"	1	0	176	176
"J35"	"Q21"	"Chronic diseases of tonsils and adenoids"	"Congenital malformations of cardiac septa"	1	207	884	1091
"J15"	"A08"	"Bacterial pneumonia, not elsewhere classified"	"Viral and other specified intestinal infections"	1	565	1126	1691
"D62"	"H90"	"Acute posthemorrhagic anemia"	"Conductive and sensorineural hearing loss"	1	55	401	456
"G43"	"M62"	"Migraine"	"Other disorders of muscle"	1	1427	1942	3369
"C80"	"J34"	"Malignant neoplasm without specification of site"	"Other and unspecified disorders of nose and nasal sinuses"	1	0	30	30
"E87"	"D11"	"Other disorders of fluid, electrolyte and acid-base balance"	"Benign neoplasm of major salivary glands"	1	34	244	278
"O30"	"L05"	"Multiple gestation"	"Pilonidal cyst and sinus"	1	3	64	67
"H52"	"H10"	"Disorders of refraction and accommodation"	"Conjunctivitis"	1	544	845	1389
"L89"	"E66"	"Pressure ulcer"	"Overweight and obesity"	1	177	999	1176
"J06"	"K40"	"Acute upper resp infections of multiple and unsp sites"	"Inguinal hernia"	1	163	653	816
"O72"	"J12"	"Postpartum hemorrhage"	"Viral pneumonia, not elsewhere classified"	1	0	38	38
"C79"	"C64"	"Secondary malignant neoplasm of other and unspecified sites"	"Malignant neoplasm of kidney, except renal pelvis"	1	1160	2289	3449
"J69"	"G44"	"Pneumonitis due to solids and liquids"	"Other headache syndromes"	1	6	56	62
"C16"	"G51"	"Malignant neoplasm of stomach"	"Facial nerve disorders"	1	2	32	34
"G96"	"I10"	"Other disorders of central nervous system"	"Essential (primary) hypertension"	1	0	11108	11108
"O99"	"M02"	"Oth maternal diseases classd elsw but compl preg/chldbrth"	"Postinfective and reactive arthropathies"	1	123	297	420
"C25"	"M16"	"Malignant neoplasm of pancreas"	"Osteoarthritis of hip"	1	0	683	683
"C44"	"M22"	"Other and unspecified malignant neoplasm of skin"	"Disorder of patella"	1	0	135	135
"N93"	"M22"	"Other abnormal uterine and vaginal bleeding"	"Disorder of patella"	1	12	398	410
"C15"	"M77"	"Malignant neoplasm of esophagus"	"Other enthesopathies"	1	0	53	53
"I51"	"N87"	"Complications and ill-defined descriptions of heart disease"	"Dysplasia of cervix uteri"	1	10	78	88
"K51"	"O20"	"Ulcerative colitis"	"Hemorrhage in early pregnancy"	1	139	264	403
"K35"	"Q66"	"Acute appendicitis"	"Congenital deformities of feet"	1	61	201	262
"L81"	"D05"	"Other disorders of pigmentation"	"Carcinoma in situ of breast"	1	13	68	81
"L98"	"N76"	"Oth disorders of skin, subcu, not elsewhere classified"	"Other inflammation of vagina and vulva"	1	67	176	243
"N18"	"Q53"	"Chronic kidney disease (CKD)"	"Undescended and ectopic testicle"	1	4	50	54
"H93"	"D06"	"Other disorders of ear, not elsewhere classified"	"Carcinoma in situ of cervix uteri"	1	3	68	71
"K52"	"E66"	"Other and unsp noninfective gastroenteritis and colitis"	"Overweight and obesity"	1	1437	1850	3287
"F20"	"M65"	"Schizophrenia"	"Synovitis and tenosynovitis"	1	28	95	123
"C79"	"M72"	"Secondary malignant neoplasm of other and unspecified sites"	"Fibroblastic disorders"	1	0	513	513
"G62"	"N63"	"Other and unspecified polyneuropathies"	"Unspecified lump in breast"	1	33	191	224
"L97"	"D21"	"Non-pressure chronic ulcer of lower limb, NEC"	"Other benign neoplasms of connective and other soft tissue"	1	10	56	66
"C79"	"C49"	"Secondary malignant neoplasm of other and unspecified sites"	"Malignant neoplasm of other connective and soft tissue"	1	231	404	635
"D24"	"O64"	"Benign neoplasm of breast"	"Obstructed labor due to malposition and malpresent of fetus"	1	90	323	413
"E41"	"F17"	"Nutritional marasmus"	"Nicotine dependence"	1	56	214	270
"E63"	"M17"	"Other nutritional deficiencies"	"Osteoarthritis of knee"	1	3	81	84
"M20"	"O26"	"Acquired deformities of fingers and toes"	"Maternal care for oth conditions predom related to pregnancy"	1	89	353	442
"M75"	"O68"	"Shoulder lesions"	"Labor and delivery comp by abnlt of fetal acid-base balance"	1	0	1639	1639
"M50"	"N75"	"Cervical disc disorders"	"Diseases of Bartholin's gland"	1	31	94	125
"C79"	"N89"	"Secondary malignant neoplasm of other and unspecified sites"	"Other noninflammatory disorders of vagina"	1	9	48	57
"L82"	"M17"	"Seborrheic keratosis"	"Osteoarthritis of knee"	1	129	481	610
"I48"	"H26"	"Atrial fibrillation and flutter"	"Other cataract"	1	3948	5976	9924
"I70"	"D24"	"Atherosclerosis"	"Benign neoplasm of breast"	1	47	278	325
"H43"	"O80"	"Disorders of vitreous body"	"Encounter for full-term uncomplicated delivery"	1	0	188	188
"K50"	"H83"	"Crohn's disease [regional enteritis]"	"Other diseases of inner ear"	1	27	80	107
"N18"	"K61"	"Chronic kidney disease (CKD)"	"Abscess of anal and rectal regions"	1	79	377	456
"C83"	"M62"	"Non-follicular lymphoma"	"Other disorders of muscle"	1	10	170	180
"G93"	"O03"	"Other disorders of brain"	"Spontaneous abortion"	1	0	63	63
"J15"	"Q25"	"Bacterial pneumonia, not elsewhere classified"	"Congenital malformations of great arteries"	1	66	233	299
"G31"	"C50"	"Oth degenerative diseases of nervous system, NEC"	"Malignant neoplasm of breast"	1	20	119	139
"M51"	"Q17"	"Thoracic, thoracolum, and lumbosacral intvrt disc disorders"	"Other congenital malformations of ear"	1	0	67	67
"I80"	"L05"	"Phlebitis and thrombophlebitis"	"Pilonidal cyst and sinus"	1	35	169	204
"O46"	"N98"	"Antepartum hemorrhage, not elsewhere classified"	"Complications associated with artificial fertilization"	1	34	151	185
"G47"	"O75"	"Sleep disorders"	"Oth complications of labor and delivery, NEC"	1	0	77	77
"I46"	"H25"	"Cardiac arrest"	"Age-related cataract"	1	0	4823	4823
"A41"	"J20"	"Other sepsis"	"Acute bronchitis"	1	459	1437	1896
"M77"	"K40"	"Other enthesopathies"	"Inguinal hernia"	1	525	715	1240
"G45"	"O04"	"Transient cerebral ischemic attacks and related syndromes"	"Complications following (induced) termination of pregnancy"	1	0	244	244
"H18"	"E10"	"Other disorders of cornea"	"Type 1 diabetes mellitus"	1	94	323	417
"J16"	"M51"	"Pneumonia due to oth infectious organisms, NEC"	"Thoracic, thoracolum, and lumbosacral intvrt disc disorders"	1	25	80	105
"I25"	"O70"	"Chronic ischemic heart disease"	"Perineal laceration during delivery"	1	0	77	77
"N18"	"N02"	"Chronic kidney disease (CKD)"	"Recurrent and persistent hematuria"	1	70	161	231
"E87"	"M79"	"Other disorders of fluid, electrolyte and acid-base balance"	"Oth and unsp soft tissue disorders, not elsewhere classified"	1	0	4848	4848
"B37"	"J41"	"Candidiasis"	"Simple and mucopurulent chronic bronchitis"	1	71	178	249
"E55"	"I25"	"Vitamin D deficiency"	"Chronic ischemic heart disease"	1	599	1582	2181
"D50"	"M24"	"Iron deficiency anemia"	"Other specific joint derangements"	1	65	183	248
"J15"	"D31"	"Bacterial pneumonia, not elsewhere classified"	"Benign neoplasm of eye and adnexa"	1	29	115	144
"O70"	"O65"	"Perineal laceration during delivery"	"Obstructed labor due to maternal pelvic abnormality"	1	5306	9454	14760
"K72"	"E04"	"Hepatic failure, not elsewhere classified"	"Other nontoxic goiter"	1	8	56	64
"D64"	"K09"	"Other anemias"	"Cysts of oral region, not elsewhere classified"	1	22	136	158
"L57"	"H83"	"Skin changes due to chronic expsr to nonionizing radiation"	"Other diseases of inner ear"	1	0	183	183
"I67"	"G45"	"Other cerebrovascular diseases"	"Transient cerebral ischemic attacks and related syndromes"	1	1010	1427	2437
"M19"	"I47"	"Other and unspecified osteoarthritis"	"Paroxysmal tachycardia"	1	483	1072	1555
"J44"	"I70"	"Other chronic obstructive pulmonary disease"	"Atherosclerosis"	1	5216	6914	12130
"N48"	"I83"	"Other disorders of penis"	"Varicose veins of lower extremities"	1	154	272	426
"F33"	"C43"	"Major depressive disorder, recurrent"	"Malignant melanoma of skin"	1	71	168	239
"L98"	"M06"	"Oth disorders of skin, subcu, not elsewhere classified"	"Other rheumatoid arthritis"	1	156	579	735
"G45"	"N83"	"Transient cerebral ischemic attacks and related syndromes"	"Noninflammatory disord of ovary, fallop and broad ligament"	1	147	373	520
"C77"	"H36"	"Secondary and unspecified malignant neoplasm of lymph nodes"	"Retinal disorders in diseases classified elsewhere"	1	74	154	228
"C64"	"I65"	"Malignant neoplasm of kidney, except renal pelvis"	"Occls and stenosis of precerb art, not rslt in cereb infrc"	1	9	50	59
"E20"	"G20"	"Hypoparathyroidism"	"Parkinson's disease"	1	73	185	258
"C44"	"O62"	"Other and unspecified malignant neoplasm of skin"	"Abnormalities of forces of labor"	1	0	176	176
"I21"	"O70"	"Acute myocardial infarction"	"Perineal laceration during delivery"	1	0	87	87
"N18"	"K58"	"Chronic kidney disease (CKD)"	"Irritable bowel syndrome"	1	38	571	609
"I46"	"J98"	"Cardiac arrest"	"Other respiratory disorders"	1	300	510	810
"J43"	"H83"	"Emphysema"	"Other diseases of inner ear"	1	46	277	323
"L40"	"O36"	"Psoriasis"	"Maternal care for other fetal problems"	1	49	127	176
"G47"	"N60"	"Sleep disorders"	"Benign mammary dysplasia"	1	0	330	330
"J15"	"A63"	"Bacterial pneumonia, not elsewhere classified"	"Oth predominantly sexually transmitted diseases, NEC"	1	8	202	210
"J18"	"D36"	"Pneumonia, unspecified organism"	"Benign neoplasm of other and unspecified sites"	1	66	221	287
"D50"	"J34"	"Iron deficiency anemia"	"Other and unspecified disorders of nose and nasal sinuses"	1	37	186	223
"G45"	"O36"	"Transient cerebral ischemic attacks and related syndromes"	"Maternal care for other fetal problems"	1	0	93	93
"M77"	"O63"	"Other enthesopathies"	"Long labor"	1	22	191	213
"K80"	"O92"	"Cholelithiasis"	"Oth disord of brst/lactatn assoc w pregnancy and the puerp"	1	313	563	876
"K72"	"G45"	"Hepatic failure, not elsewhere classified"	"Transient cerebral ischemic attacks and related syndromes"	1	35	220	255
"D83"	"B34"	"Common variable immunodeficiency"	"Viral infection of unspecified site"	1	51	148	199
"F41"	"J93"	"Other anxiety disorders"	"Pneumothorax and air leak"	1	102	457	559
"K43"	"L20"	"Ventral hernia"	"Atopic dermatitis"	1	14	57	71
"J94"	"M20"	"Other pleural conditions"	"Acquired deformities of fingers and toes"	1	6	81	87
"K20"	"O26"	"Esophagitis"	"Maternal care for oth conditions predom related to pregnancy"	1	13	88	101
"A09"	"I21"	"Infectious gastroenteritis and colitis, unspecified"	"Acute myocardial infarction"	1	1817	2567	4384
"E78"	"C53"	"Disorders of lipoprotein metabolism and other lipidemias"	"Malignant neoplasm of cervix uteri"	1	43	127	170
"K52"	"D30"	"Other and unsp noninfective gastroenteritis and colitis"	"Benign neoplasm of urinary organs"	1	118	313	431
"O68"	"F10"	"Labor and delivery comp by abnlt of fetal acid-base balance"	"Alcohol related disorders"	1	100	1312	1412
"D64"	"N40"	"Other anemias"	"Benign prostatic hyperplasia"	1	0	9164	9164
"K08"	"C07"	"Other disorders of teeth and supporting structures"	"Malignant neoplasm of parotid gland"	1	32	89	121
"I50"	"D10"	"Heart failure"	"Benign neoplasm of mouth and pharynx"	1	171	357	528
"D10"	"D25"	"Benign neoplasm of mouth and pharynx"	"Leiomyoma of uterus"	1	27	185	212
"E83"	"D27"	"Disorders of mineral metabolism"	"Benign neoplasm of ovary"	1	0	142	142
"I71"	"G35"	"Aortic aneurysm and dissection"	"Multiple sclerosis"	1	1	44	45
"C64"	"I70"	"Malignant neoplasm of kidney, except renal pelvis"	"Atherosclerosis"	1	124	269	393
"C20"	"M50"	"Malignant neoplasm of rectum"	"Cervical disc disorders"	1	11	125	136
"I25"	"M70"	"Chronic ischemic heart disease"	"Soft tissue disorders related to use, overuse and pressure"	1	1408	1729	3137
"C90"	"M75"	"Multiple myeloma and malignant plasma cell neoplasms"	"Shoulder lesions"	1	47	243	290
"O68"	"O24"	"Labor and delivery comp by abnlt of fetal acid-base balance"	"Diabetes in pregnancy, childbirth, and the puerperium"	1	3080	4069	7149
"D13"	"O42"	"Benign neoplasm of and ill-defined parts of digestive system"	"Premature rupture of membranes"	1	2	32	34
"D69"	"O65"	"Purpura and other hemorrhagic conditions"	"Obstructed labor due to maternal pelvic abnormality"	1	8	64	72
"H50"	"Q25"	"Other strabismus"	"Congenital malformations of great arteries"	1	26	312	338
"C43"	"K35"	"Malignant melanoma of skin"	"Acute appendicitis"	1	43	185	228
"D47"	"K29"	"Oth neoplm of uncrt behav of lymphoid, hematpoetc & rel tiss"	"Gastritis and duodenitis"	1	96	419	515
"C78"	"I95"	"Secondary malignant neoplasm of resp and digestive organs"	"Hypotension"	1	192	347	539
"O34"	"F50"	"Maternal care for abnormality of pelvic organs"	"Eating disorders"	1	2	66	68
"G31"	"K61"	"Oth degenerative diseases of nervous system, NEC"	"Abscess of anal and rectal regions"	1	5	40	45
"O42"	"N98"	"Premature rupture of membranes"	"Complications associated with artificial fertilization"	1	80	319	399
"K02"	"H65"	"Dental caries"	"Nonsuppurative otitis media"	1	141	556	697
"I26"	"H25"	"Pulmonary embolism"	"Age-related cataract"	1	1788	4297	6085
"F32"	"H81"	"Depressive episode"	"Disorders of vestibular function"	1	758	1577	2335
"I26"	"K40"	"Pulmonary embolism"	"Inguinal hernia"	1	155	1380	1535
"A87"	"O80"	"Viral meningitis"	"Encounter for full-term uncomplicated delivery"	1	137	448	585
"K59"	"M00"	"Other functional intestinal disorders"	"Pyogenic arthritis"	1	166	363	529
"O04"	"M92"	"Complications following (induced) termination of pregnancy"	"Other juvenile osteochondrosis"	1	20	97	117
"C71"	"O82"	"Malignant neoplasm of brain"	"Encounter for cesarean delivery without indication"	1	1	58	59
"G96"	"N80"	"Other disorders of central nervous system"	"Endometriosis"	1	0	147	147
"J96"	"B90"	"Respiratory failure, not elsewhere classified"	"Sequelae of tuberculosis"	1	52	233	285
"M13"	"E04"	"Other arthritis"	"Other nontoxic goiter"	1	182	308	490
"A46"	"J41"	"Erysipelas"	"Simple and mucopurulent chronic bronchitis"	1	105	225	330
"K91"	"M16"	"Intraop and postproc comp and disorders of dgstv sys, NEC"	"Osteoarthritis of hip"	1	115	250	365
"L30"	"M51"	"Other and unspecified dermatitis"	"Thoracic, thoracolum, and lumbosacral intvrt disc disorders"	1	405	952	1357
"I46"	"O80"	"Cardiac arrest"	"Encounter for full-term uncomplicated delivery"	1	0	54	54
"E86"	"H90"	"Volume depletion"	"Conductive and sensorineural hearing loss"	1	0	3345	3345
"L98"	"G82"	"Oth disorders of skin, subcu, not elsewhere classified"	"Paraplegia (paraparesis) and quadriplegia (quadriparesis)"	1	84	212	296
"G62"	"M31"	"Other and unspecified polyneuropathies"	"Other necrotizing vasculopathies"	1	148	253	401
"K63"	"M50"	"Other diseases of intestine"	"Cervical disc disorders"	1	29	197	226
"I44"	"M22"	"Atrioventricular and left bundle-branch block"	"Disorder of patella"	1	0	78	78
"J15"	"C54"	"Bacterial pneumonia, not elsewhere classified"	"Malignant neoplasm of corpus uteri"	1	5	304	309
"F17"	"G43"	"Nicotine dependence"	"Migraine"	1	197	554	751
"C77"	"M10"	"Secondary and unspecified malignant neoplasm of lymph nodes"	"Gout"	1	67	193	260
"I26"	"C20"	"Pulmonary embolism"	"Malignant neoplasm of rectum"	1	259	691	950
"K62"	"H60"	"Other diseases of anus and rectum"	"Otitis externa"	1	123	217	340
"G30"	"M75"	"Alzheimer's disease"	"Shoulder lesions"	1	0	363	363
"Q61"	"K60"	"Cystic kidney disease"	"Fissure and fistula of anal and rectal regions"	1	11	66	77
"K21"	"O36"	"Gastro-esophageal reflux disease"	"Maternal care for other fetal problems"	1	77	311	388
"M85"	"I77"	"Other disorders of bone density and structure"	"Other disorders of arteries and arterioles"	1	21	108	129
"K43"	"O68"	"Ventral hernia"	"Labor and delivery comp by abnlt of fetal acid-base balance"	1	0	630	630
"K92"	"L02"	"Other diseases of digestive system"	"Cutaneous abscess, furuncle and carbuncle"	1	631	1353	1984
"C18"	"K29"	"Malignant neoplasm of colon"	"Gastritis and duodenitis"	1	650	1483	2133
"N18"	"D48"	"Chronic kidney disease (CKD)"	"Neoplasm of uncertain behavior of other and unsp sites"	1	13	95	108
"M19"	"E05"	"Other and unspecified osteoarthritis"	"Thyrotoxicosis [hyperthyroidism]"	1	516	907	1423
"K57"	"H66"	"Diverticular disease of intestine"	"Suppurative and unspecified otitis media"	1	12	329	341
"I63"	"J32"	"Cerebral infarction"	"Chronic sinusitis"	1	81	340	421
"N39"	"J32"	"Other disorders of urinary system"	"Chronic sinusitis"	1	158	593	751
"N62"	"K35"	"Hypertrophy of breast"	"Acute appendicitis"	1	225	399	624
"I89"	"M65"	"Oth noninfective disorders of lymphatic vessels and nodes"	"Synovitis and tenosynovitis"	1	69	182	251
"J44"	"M93"	"Other chronic obstructive pulmonary disease"	"Other osteochondropathies"	1	1	77	78
"C73"	"N92"	"Malignant neoplasm of thyroid gland"	"Excessive, frequent and irregular menstruation"	1	44	111	155
"O61"	"O02"	"Failed induction of labor"	"Other abnormal products of conception"	1	134	405	539
"M81"	"I77"	"Osteoporosis without current pathological fracture"	"Other disorders of arteries and arterioles"	1	87	232	319
"E63"	"K44"	"Other nutritional deficiencies"	"Diaphragmatic hernia"	1	29	115	144
"A41"	"N40"	"Other sepsis"	"Benign prostatic hyperplasia"	1	0	11370	11370
"K60"	"O66"	"Fissure and fistula of anal and rectal regions"	"Other obstructed labor"	1	28	93	121
"K70"	"N94"	"Alcoholic liver disease"	"Pain and oth cond assoc w fem gntl org and menstrual cycle"	1	0	53	53
"I34"	"I20"	"Nonrheumatic mitral valve disorders"	"Angina pectoris"	1	2417	4227	6644
"C80"	"A46"	"Malignant neoplasm without specification of site"	"Erysipelas"	1	36	163	199
"H43"	"O26"	"Disorders of vitreous body"	"Maternal care for oth conditions predom related to pregnancy"	1	0	44	44
"I50"	"D16"	"Heart failure"	"Benign neoplasm of bone and articular cartilage"	1	31	198	229
"J43"	"L03"	"Emphysema"	"Cellulitis and acute lymphangitis"	1	19	92	111
"C78"	"G46"	"Secondary malignant neoplasm of resp and digestive organs"	"Vascular syndromes of brain in cerebrovascular diseases"	1	2	46	48
"O46"	"O03"	"Antepartum hemorrhage, not elsewhere classified"	"Spontaneous abortion"	1	841	1762	2603
"N32"	"C53"	"Other disorders of bladder"	"Malignant neoplasm of cervix uteri"	1	10	124	134
"O73"	"O21"	"Retained placenta and membranes, without hemorrhage"	"Excessive vomiting in pregnancy"	1	113	298	411
"M80"	"M31"	"Osteoporosis with current pathological fracture"	"Other necrotizing vasculopathies"	1	262	906	1168
"C91"	"C85"	"Lymphoid leukemia"	"Oth and unspecified types of non-Hodgkin lymphoma"	1	338	511	849
"C78"	"I97"	"Secondary malignant neoplasm of resp and digestive organs"	"Intraop and postproc comp and disorders of circ sys, NEC"	1	57	204	261
"M79"	"J30"	"Oth and unsp soft tissue disorders, not elsewhere classified"	"Vasomotor and allergic rhinitis"	1	792	1399	2191
"J69"	"K51"	"Pneumonitis due to solids and liquids"	"Ulcerative colitis"	1	6	88	94
"N39"	"N40"	"Other disorders of urinary system"	"Benign prostatic hyperplasia"	1	0	12746	12746
"I25"	"J03"	"Chronic ischemic heart disease"	"Acute tonsillitis"	1	160	319	479
"M75"	"H71"	"Shoulder lesions"	"Cholesteatoma of middle ear"	1	33	161	194
"K83"	"I83"	"Other diseases of biliary tract"	"Varicose veins of lower extremities"	1	65	387	452
"A04"	"D14"	"Other bacterial intestinal infections"	"Benign neoplasm of middle ear and respiratory system"	1	14	82	96
"J15"	"F10"	"Bacterial pneumonia, not elsewhere classified"	"Alcohol related disorders"	1	0	6969	6969
"E87"	"H02"	"Other disorders of fluid, electrolyte and acid-base balance"	"Other disorders of eyelid"	1	264	1088	1352
"H52"	"H65"	"Disorders of refraction and accommodation"	"Nonsuppurative otitis media"	1	160	1191	1351
"K60"	"O63"	"Fissure and fistula of anal and rectal regions"	"Long labor"	1	57	250	307
"K56"	"G56"	"Paralytic ileus and intestinal obstruction without hernia"	"Mononeuropathies of upper limb"	1	290	828	1118
"E13"	"D25"	"Other specified diabetes mellitus"	"Leiomyoma of uterus"	1	0	54	54
"K91"	"G56"	"Intraop and postproc comp and disorders of dgstv sys, NEC"	"Mononeuropathies of upper limb"	1	87	183	270
"M17"	"I83"	"Osteoarthritis of knee"	"Varicose veins of lower extremities"	1	2196	5070	7266
"I27"	"M23"	"Other pulmonary heart diseases"	"Internal derangement of knee"	1	24	278	302
"L98"	"M47"	"Oth disorders of skin, subcu, not elsewhere classified"	"Spondylosis"	1	215	501	716
"D13"	"O02"	"Benign neoplasm of and ill-defined parts of digestive system"	"Other abnormal products of conception"	1	0	60	60
"M15"	"K40"	"Polyosteoarthritis"	"Inguinal hernia"	1	142	334	476
"C78"	"K30"	"Secondary malignant neoplasm of resp and digestive organs"	"Functional dyspepsia"	1	0	1729	1729
"H53"	"M75"	"Visual disturbances"	"Shoulder lesions"	1	584	980	1564
"O31"	"O20"	"Complications specific to multiple gestation"	"Hemorrhage in early pregnancy"	1	106	233	339
"K63"	"L05"	"Other diseases of intestine"	"Pilonidal cyst and sinus"	1	10	76	86
"F03"	"M77"	"Unspecified dementia"	"Other enthesopathies"	1	0	223	223
"B18"	"O20"	"Chronic viral hepatitis"	"Hemorrhage in early pregnancy"	1	18	163	181
"C79"	"C57"	"Secondary malignant neoplasm of other and unspecified sites"	"Malignant neoplasm of other and unsp female genital organs"	1	50	129	179
"B95"	"O70"	"Strep as the cause of diseases classified elsewhere"	"Perineal laceration during delivery"	1	101	254	355
"K92"	"N47"	"Other diseases of digestive system"	"Disorders of prepuce"	1	189	378	567
"D64"	"H10"	"Other anemias"	"Conjunctivitis"	1	111	1014	1125
"I48"	"M22"	"Atrial fibrillation and flutter"	"Disorder of patella"	1	0	384	384
"M08"	"J00"	"Juvenile arthritis"	"Acute nasopharyngitis [common cold]"	1	0	87	87
"C78"	"K29"	"Secondary malignant neoplasm of resp and digestive organs"	"Gastritis and duodenitis"	1	0	2312	2312
"M10"	"E66"	"Gout"	"Overweight and obesity"	1	1395	2130	3525
"M47"	"M51"	"Spondylosis"	"Thoracic, thoracolum, and lumbosacral intvrt disc disorders"	1	14592	17132	31724
"M81"	"D33"	"Osteoporosis without current pathological fracture"	"Benign neoplasm of brain and oth prt central nervous system"	1	49	190	239
"F90"	"F10"	"Attention-deficit hyperactivity disorders"	"Alcohol related disorders"	1	164	324	488
"M99"	"O20"	"Biomechanical lesions, not elsewhere classified"	"Hemorrhage in early pregnancy"	1	0	126	126
"N80"	"N62"	"Endometriosis"	"Hypertrophy of breast"	1	57	158	215
"G20"	"I49"	"Parkinson's disease"	"Other cardiac arrhythmias"	1	210	354	564
"E87"	"M41"	"Other disorders of fluid, electrolyte and acid-base balance"	"Scoliosis"	1	99	331	430
"E41"	"K05"	"Nutritional marasmus"	"Gingivitis and periodontal diseases"	1	17	154	171
"C77"	"K85"	"Secondary and unspecified malignant neoplasm of lymph nodes"	"Acute pancreatitis"	1	35	172	207
"C91"	"M65"	"Lymphoid leukemia"	"Synovitis and tenosynovitis"	1	22	103	125
"F44"	"O20"	"Dissociative and conversion disorders"	"Hemorrhage in early pregnancy"	1	11	52	63
"D12"	"Q28"	"Benign neoplasm of colon, rectum, anus and anal canal"	"Other congenital malformations of circulatory system"	1	1	43	44
"E55"	"M54"	"Vitamin D deficiency"	"Dorsalgia"	1	905	1803	2708
"I63"	"G99"	"Cerebral infarction"	"Oth disorders of nervous system in diseases classd elswhr"	1	60	183	243
"O72"	"H53"	"Postpartum hemorrhage"	"Visual disturbances"	1	253	435	688
"C78"	"M50"	"Secondary malignant neoplasm of resp and digestive organs"	"Cervical disc disorders"	1	0	389	389
"F05"	"M77"	"Delirium due to known physiological condition"	"Other enthesopathies"	1	0	127	127
"E21"	"N87"	"Hyperparathyroidism and other disorders of parathyroid gland"	"Dysplasia of cervix uteri"	1	0	67	67
"G98"	"O82"	"Other disorders of nervous system not elsewhere classified"	"Encounter for cesarean delivery without indication"	1	0	229	229
"I74"	"O62"	"Arterial embolism and thrombosis"	"Abnormalities of forces of labor"	1	0	42	42
"E86"	"J45"	"Volume depletion"	"Asthma"	1	0	6512	6512
"N17"	"H90"	"Acute kidney failure"	"Conductive and sensorineural hearing loss"	1	25	524	549
"K62"	"M17"	"Other diseases of anus and rectum"	"Osteoarthritis of knee"	1	1817	3179	4996
"D62"	"L50"	"Acute posthemorrhagic anemia"	"Urticaria"	1	25	80	105
"C78"	"J04"	"Secondary malignant neoplasm of resp and digestive organs"	"Acute laryngitis and tracheitis"	1	0	57	57
"H81"	"N87"	"Disorders of vestibular function"	"Dysplasia of cervix uteri"	1	61	221	282
"J96"	"O00"	"Respiratory failure, not elsewhere classified"	"Ectopic pregnancy"	1	0	45	45
"I26"	"C71"	"Pulmonary embolism"	"Malignant neoplasm of brain"	1	140	258	398
"C67"	"D23"	"Malignant neoplasm of bladder"	"Other benign neoplasms of skin"	1	53	125	178
"D17"	"D25"	"Benign lipomatous neoplasm"	"Leiomyoma of uterus"	1	255	813	1068
"K52"	"H83"	"Other and unsp noninfective gastroenteritis and colitis"	"Other diseases of inner ear"	1	26	533	559
"K85"	"H83"	"Acute pancreatitis"	"Other diseases of inner ear"	1	90	264	354
"N28"	"H90"	"Oth disorders of kidney and ureter, not elsewhere classified"	"Conductive and sensorineural hearing loss"	1	29	231	260
"G24"	"K40"	"Dystonia"	"Inguinal hernia"	1	38	130	168
"N28"	"K50"	"Oth disorders of kidney and ureter, not elsewhere classified"	"Crohn's disease [regional enteritis]"	1	17	72	89
"E29"	"M75"	"Testicular dysfunction"	"Shoulder lesions"	1	51	134	185
"N19"	"M75"	"Unspecified kidney failure"	"Shoulder lesions"	1	157	628	785
"J95"	"H81"	"Intraop and postproc comp and disorders of resp sys, NEC"	"Disorders of vestibular function"	1	14	73	87
"I70"	"M35"	"Atherosclerosis"	"Other systemic involvement of connective tissue"	1	661	1119	1780
"K65"	"N19"	"Peritonitis"	"Unspecified kidney failure"	1	1023	1386	2409
"I21"	"M06"	"Acute myocardial infarction"	"Other rheumatoid arthritis"	1	796	1175	1971
"C34"	"J04"	"Malignant neoplasm of bronchus and lung"	"Acute laryngitis and tracheitis"	1	2	75	77
"N17"	"J35"	"Acute kidney failure"	"Chronic diseases of tonsils and adenoids"	1	1	58	59
"L30"	"K80"	"Other and unspecified dermatitis"	"Cholelithiasis"	1	333	641	974
"I33"	"M17"	"Acute and subacute endocarditis"	"Osteoarthritis of knee"	1	42	249	291
"C71"	"M25"	"Malignant neoplasm of brain"	"Other joint disorder, not elsewhere classified"	1	19	78	97
"O99"	"M62"	"Oth maternal diseases classd elsw but compl preg/chldbrth"	"Other disorders of muscle"	1	2305	3252	5557
"N88"	"O04"	"Other noninflammatory disorders of cervix uteri"	"Complications following (induced) termination of pregnancy"	1	8	175	183
"K35"	"J00"	"Acute appendicitis"	"Acute nasopharyngitis [common cold]"	1	0	307	307
"K56"	"C43"	"Paralytic ileus and intestinal obstruction without hernia"	"Malignant melanoma of skin"	1	118	250	368
"E89"	"D43"	"Postproc endocrine and metabolic comp and disorders, NEC"	"Neoplasm of uncertain behavior of brain and cnsl"	1	27	93	120
"I85"	"M50"	"Esophageal varices"	"Cervical disc disorders"	1	3	68	71
"M80"	"M53"	"Osteoporosis with current pathological fracture"	"Other and unspecified dorsopathies, not elsewhere classified"	1	242	406	648
"I46"	"F10"	"Cardiac arrest"	"Alcohol related disorders"	1	0	2752	2752
"J98"	"N92"	"Other respiratory disorders"	"Excessive, frequent and irregular menstruation"	1	18	300	318
"N20"	"K35"	"Calculus of kidney and ureter"	"Acute appendicitis"	1	485	1148	1633
"C78"	"D16"	"Secondary malignant neoplasm of resp and digestive organs"	"Benign neoplasm of bone and articular cartilage"	1	4	141	145
"O08"	"L20"	"Complications following ectopic and molar pregnancy"	"Atopic dermatitis"	1	7	72	79
"A60"	"O04"	"Anogenital herpesviral [herpes simplex] infections"	"Complications following (induced) termination of pregnancy"	1	105	274	379
"K21"	"G35"	"Gastro-esophageal reflux disease"	"Multiple sclerosis"	1	62	138	200
"J96"	"N45"	"Respiratory failure, not elsewhere classified"	"Orchitis and epididymitis"	1	88	678	766
"H50"	"G91"	"Other strabismus"	"Hydrocephalus"	1	118	339	457
"I11"	"M62"	"Hypertensive heart disease"	"Other disorders of muscle"	1	86	753	839
"J98"	"Q25"	"Other respiratory disorders"	"Congenital malformations of great arteries"	1	60	221	281
"M62"	"J00"	"Other disorders of muscle"	"Acute nasopharyngitis [common cold]"	1	116	362	478
"K40"	"O03"	"Inguinal hernia"	"Spontaneous abortion"	1	45	227	272
"L98"	"O26"	"Oth disorders of skin, subcu, not elsewhere classified"	"Maternal care for oth conditions predom related to pregnancy"	1	38	211	249
"F41"	"C25"	"Other anxiety disorders"	"Malignant neoplasm of pancreas"	1	271	1042	1313
"I89"	"M20"	"Oth noninfective disorders of lymphatic vessels and nodes"	"Acquired deformities of fingers and toes"	1	59	180	239
"M81"	"D21"	"Osteoporosis without current pathological fracture"	"Other benign neoplasms of connective and other soft tissue"	1	86	225	311
"A09"	"H80"	"Infectious gastroenteritis and colitis, unspecified"	"Otosclerosis"	1	37	166	203
"N30"	"I49"	"Cystitis"	"Other cardiac arrhythmias"	1	2547	3874	6421
"M05"	"M02"	"Rheumatoid arthritis with rheumatoid factor"	"Postinfective and reactive arthropathies"	1	238	648	886
"O35"	"O21"	"Maternal care for known or suspected fetal abnlt and damage"	"Excessive vomiting in pregnancy"	1	176	322	498
"I80"	"O30"	"Phlebitis and thrombophlebitis"	"Multiple gestation"	1	28	113	141
"A09"	"Q32"	"Infectious gastroenteritis and colitis, unspecified"	"Congenital malformations of trachea and bronchus"	1	27	89	116
"N13"	"N80"	"Obstructive and reflux uropathy"	"Endometriosis"	1	101	253	354
"K57"	"O90"	"Diverticular disease of intestine"	"Complications of the puerperium, not elsewhere classified"	1	0	28	28
"O72"	"G81"	"Postpartum hemorrhage"	"Hemiplegia and hemiparesis"	1	0	26	26
"J98"	"H25"	"Other respiratory disorders"	"Age-related cataract"	1	1021	1378	2399
"I50"	"K44"	"Heart failure"	"Diaphragmatic hernia"	1	1414	3342	4756
"K72"	"N40"	"Hepatic failure, not elsewhere classified"	"Benign prostatic hyperplasia"	1	33	213	246
"K63"	"G45"	"Other diseases of intestine"	"Transient cerebral ischemic attacks and related syndromes"	1	85	500	585
"M47"	"H83"	"Spondylosis"	"Other diseases of inner ear"	1	348	773	1121
"F33"	"K40"	"Major depressive disorder, recurrent"	"Inguinal hernia"	1	104	888	992
"D09"	"M75"	"Carcinoma in situ of other and unspecified sites"	"Shoulder lesions"	1	3	272	275
"K76"	"D25"	"Other diseases of liver"	"Leiomyoma of uterus"	1	33	351	384
"M77"	"I83"	"Other enthesopathies"	"Varicose veins of lower extremities"	1	628	1031	1659
"D63"	"N47"	"Anemia in chronic diseases classified elsewhere"	"Disorders of prepuce"	1	39	236	275
"C80"	"I73"	"Malignant neoplasm without specification of site"	"Other peripheral vascular diseases"	1	20	221	241
"M80"	"L02"	"Osteoporosis with current pathological fracture"	"Cutaneous abscess, furuncle and carbuncle"	1	214	710	924
"K56"	"C21"	"Paralytic ileus and intestinal obstruction without hernia"	"Malignant neoplasm of anus and anal canal"	1	59	207	266
"H35"	"H83"	"Other retinal disorders"	"Other diseases of inner ear"	1	0	1638	1638
"O32"	"N97"	"Maternal care for malpresentation of fetus"	"Female infertility"	1	0	5850	5850
"N19"	"Q61"	"Unspecified kidney failure"	"Cystic kidney disease"	1	303	532	835
"E13"	"K42"	"Other specified diabetes mellitus"	"Umbilical hernia"	1	25	75	100
"M47"	"O47"	"Spondylosis"	"False labor"	1	0	152	152
"N18"	"H65"	"Chronic kidney disease (CKD)"	"Nonsuppurative otitis media"	1	25	274	299
"A41"	"I20"	"Other sepsis"	"Angina pectoris"	1	0	9868	9868
"J98"	"N87"	"Other respiratory disorders"	"Dysplasia of cervix uteri"	1	10	73	83
"L97"	"H80"	"Non-pressure chronic ulcer of lower limb, NEC"	"Otosclerosis"	1	0	82	82
"A40"	"O62"	"Streptococcal sepsis"	"Abnormalities of forces of labor"	1	2	75	77
"H81"	"J35"	"Disorders of vestibular function"	"Chronic diseases of tonsils and adenoids"	1	49	335	384
"I48"	"L03"	"Atrial fibrillation and flutter"	"Cellulitis and acute lymphangitis"	1	379	1352	1731
"K30"	"D48"	"Functional dyspepsia"	"Neoplasm of uncertain behavior of other and unsp sites"	1	46	138	184
"J96"	"H04"	"Respiratory failure, not elsewhere classified"	"Disorders of lacrimal system"	1	36	236	272
"N39"	"H50"	"Other disorders of urinary system"	"Other strabismus"	1	183	639	822
"M19"	"J45"	"Other and unspecified osteoarthritis"	"Asthma"	1	1267	2489	3756
"E73"	"O20"	"Lactose intolerance"	"Hemorrhage in early pregnancy"	1	16	82	98
"I10"	"H16"	"Essential (primary) hypertension"	"Keratitis"	1	692	926	1618
"I82"	"C50"	"Other venous embolism and thrombosis"	"Malignant neoplasm of breast"	1	60	443	503
"G31"	"J45"	"Oth degenerative diseases of nervous system, NEC"	"Asthma"	1	34	178	212
"I10"	"L41"	"Essential (primary) hypertension"	"Parapsoriasis"	1	46	108	154
"C77"	"N31"	"Secondary and unspecified malignant neoplasm of lymph nodes"	"Neuromuscular dysfunction of bladder, NEC"	1	13	73	86
"E03"	"A63"	"Other hypothyroidism"	"Oth predominantly sexually transmitted diseases, NEC"	1	0	275	275
"E46"	"H90"	"Unspecified protein-calorie malnutrition"	"Conductive and sensorineural hearing loss"	1	2	35	37
"K63"	"M48"	"Other diseases of intestine"	"Other spondylopathies"	1	179	397	576
"K52"	"M72"	"Other and unsp noninfective gastroenteritis and colitis"	"Fibroblastic disorders"	1	163	400	563
"C25"	"D30"	"Malignant neoplasm of pancreas"	"Benign neoplasm of urinary organs"	1	6	168	174
"G20"	"M54"	"Parkinson's disease"	"Dorsalgia"	1	531	971	1502
"E66"	"M79"	"Overweight and obesity"	"Oth and unsp soft tissue disorders, not elsewhere classified"	1	5128	6979	12107
"E23"	"N43"	"Hypofunction and other disorders of the pituitary gland"	"Hydrocele and spermatocele"	1	1	37	38
"D63"	"K61"	"Anemia in chronic diseases classified elsewhere"	"Abscess of anal and rectal regions"	1	36	164	200
"A46"	"N43"	"Erysipelas"	"Hydrocele and spermatocele"	1	117	321	438
"I26"	"H52"	"Pulmonary embolism"	"Disorders of refraction and accommodation"	1	60	224	284
"N75"	"O71"	"Diseases of Bartholin's gland"	"Other obstetric trauma"	1	60	173	233
"G96"	"K57"	"Other disorders of central nervous system"	"Diverticular disease of intestine"	1	400	844	1244
"F03"	"K42"	"Unspecified dementia"	"Umbilical hernia"	1	41	270	311
"E87"	"I10"	"Other disorders of fluid, electrolyte and acid-base balance"	"Essential (primary) hypertension"	1	0	39068	39068
"K52"	"M35"	"Other and unsp noninfective gastroenteritis and colitis"	"Other systemic involvement of connective tissue"	1	518	908	1426
"H92"	"B34"	"Otalgia and effusion of ear"	"Viral infection of unspecified site"	1	237	729	966
"E28"	"F10"	"Ovarian dysfunction"	"Alcohol related disorders"	1	14	195	209
"E41"	"K85"	"Nutritional marasmus"	"Acute pancreatitis"	1	12	103	115
"N17"	"M22"	"Acute kidney failure"	"Disorder of patella"	1	0	50	50
"K25"	"M51"	"Gastric ulcer"	"Thoracic, thoracolum, and lumbosacral intvrt disc disorders"	1	1006	1818	2824
"K85"	"M51"	"Acute pancreatitis"	"Thoracic, thoracolum, and lumbosacral intvrt disc disorders"	1	342	713	1055
"I10"	"M95"	"Essential (primary) hypertension"	"Oth acquired deformities of ms sys and connective tissue"	1	179	479	658
"N20"	"N97"	"Calculus of kidney and ureter"	"Female infertility"	1	151	455	606
"E66"	"B08"	"Overweight and obesity"	"Oth viral infect with skin and mucous membrane lesions, NEC"	1	9	67	76
"D50"	"H27"	"Iron deficiency anemia"	"Other disorders of lens"	1	2	94	96
"E86"	"D36"	"Volume depletion"	"Benign neoplasm of other and unspecified sites"	1	9	108	117
"M19"	"G56"	"Other and unspecified osteoarthritis"	"Mononeuropathies of upper limb"	1	2451	4778	7229
"M19"	"H61"	"Other and unspecified osteoarthritis"	"Other disorders of external ear"	1	106	193	299
"C50"	"O32"	"Malignant neoplasm of breast"	"Maternal care for malpresentation of fetus"	1	0	127	127
"C67"	"H10"	"Malignant neoplasm of bladder"	"Conjunctivitis"	1	15	87	102
"A49"	"M20"	"Bacterial infection of unspecified site"	"Acquired deformities of fingers and toes"	1	63	822	885
"K29"	"O04"	"Gastritis and duodenitis"	"Complications following (induced) termination of pregnancy"	1	281	1609	1890
"G37"	"O26"	"Other demyelinating diseases of central nervous system"	"Maternal care for oth conditions predom related to pregnancy"	1	2	56	58
"J03"	"A09"	"Acute tonsillitis"	"Infectious gastroenteritis and colitis, unspecified"	1	2403	4506	6909
"C92"	"M23"	"Myeloid leukemia"	"Internal derangement of knee"	1	17	139	156
"A40"	"L02"	"Streptococcal sepsis"	"Cutaneous abscess, furuncle and carbuncle"	1	151	265	416
"D07"	"A63"	"Carcinoma in situ of other and unspecified genital organs"	"Oth predominantly sexually transmitted diseases, NEC"	1	68	173	241
"E11"	"C50"	"Type 2 diabetes mellitus"	"Malignant neoplasm of breast"	1	1649	2101	3750
"I48"	"H80"	"Atrial fibrillation and flutter"	"Otosclerosis"	1	0	799	799
"L57"	"H91"	"Skin changes due to chronic expsr to nonionizing radiation"	"Other and unspecified hearing loss"	1	218	1173	1391
"D63"	"I35"	"Anemia in chronic diseases classified elsewhere"	"Nonrheumatic aortic valve disorders"	1	478	997	1475
"J96"	"K08"	"Respiratory failure, not elsewhere classified"	"Other disorders of teeth and supporting structures"	1	206	910	1116
"M79"	"L04"	"Oth and unsp soft tissue disorders, not elsewhere classified"	"Acute lymphadenitis"	1	130	399	529
"N19"	"M20"	"Unspecified kidney failure"	"Acquired deformities of fingers and toes"	1	24	268	292
"B96"	"N81"	"Oth bacterial agents as the cause of diseases classd elswhr"	"Female genital prolapse"	1	10	111	121
"C78"	"N97"	"Secondary malignant neoplasm of resp and digestive organs"	"Female infertility"	1	0	87	87
"O42"	"O02"	"Premature rupture of membranes"	"Other abnormal products of conception"	1	2632	5160	7792
"K57"	"O04"	"Diverticular disease of intestine"	"Complications following (induced) termination of pregnancy"	1	0	183	183
"M79"	"O60"	"Oth and unsp soft tissue disorders, not elsewhere classified"	"Preterm labor"	1	42	244	286
"G24"	"O68"	"Dystonia"	"Labor and delivery comp by abnlt of fetal acid-base balance"	1	7	43	50
"E87"	"O80"	"Other disorders of fluid, electrolyte and acid-base balance"	"Encounter for full-term uncomplicated delivery"	1	0	290	290
"E78"	"Q54"	"Disorders of lipoprotein metabolism and other lipidemias"	"Hypospadias"	1	30	183	213
"A08"	"Q90"	"Viral and other specified intestinal infections"	"Down syndrome"	1	9	79	88
"F17"	"L02"	"Nicotine dependence"	"Cutaneous abscess, furuncle and carbuncle"	1	976	2449	3425
"M81"	"D27"	"Osteoporosis without current pathological fracture"	"Benign neoplasm of ovary"	1	55	900	955
"E65"	"O20"	"Localized adiposity"	"Hemorrhage in early pregnancy"	1	0	518	518
"I95"	"E78"	"Hypotension"	"Disorders of lipoprotein metabolism and other lipidemias"	1	1168	3599	4767
"L29"	"O82"	"Pruritus"	"Encounter for cesarean delivery without indication"	1	34	168	202
"H47"	"Q04"	"Other disorders of optic [2nd] nerve and visual pathways"	"Other congenital malformations of brain"	1	26	85	111
"H25"	"M31"	"Age-related cataract"	"Other necrotizing vasculopathies"	1	1363	1912	3275
"Q65"	"O80"	"Congenital deformities of hip"	"Encounter for full-term uncomplicated delivery"	1	36	435	471
"M20"	"O71"	"Acquired deformities of fingers and toes"	"Other obstetric trauma"	1	38	272	310
"D50"	"K61"	"Iron deficiency anemia"	"Abscess of anal and rectal regions"	1	48	196	244
"C10"	"J45"	"Malignant neoplasm of oropharynx"	"Asthma"	1	6	65	71
"M79"	"K30"	"Oth and unsp soft tissue disorders, not elsewhere classified"	"Functional dyspepsia"	1	2634	4076	6710
"I46"	"M18"	"Cardiac arrest"	"Osteoarthritis of first carpometacarpal joint"	1	4	99	103
"L82"	"I15"	"Seborrheic keratosis"	"Secondary hypertension"	1	19	104	123
"C78"	"J02"	"Secondary malignant neoplasm of resp and digestive organs"	"Acute pharyngitis"	1	4	56	60
"M71"	"O03"	"Other bursopathies"	"Spontaneous abortion"	1	4	88	92
"K62"	"G40"	"Other diseases of anus and rectum"	"Epilepsy and recurrent seizures"	1	611	1125	1736
"K64"	"C62"	"Hemorrhoids and perianal venous thrombosis"	"Malignant neoplasm of testis"	1	0	37	37
"D22"	"K80"	"Melanocytic nevi"	"Cholelithiasis"	1	229	513	742
"Q61"	"M17"	"Cystic kidney disease"	"Osteoarthritis of knee"	1	108	458	566
"F41"	"C49"	"Other anxiety disorders"	"Malignant neoplasm of other connective and soft tissue"	1	45	203	248
"Q61"	"E11"	"Cystic kidney disease"	"Type 2 diabetes mellitus"	1	244	372	616
"J33"	"O70"	"Nasal polyp"	"Perineal laceration during delivery"	1	56	161	217
"I10"	"Q82"	"Essential (primary) hypertension"	"Other congenital malformations of skin"	1	144	322	466
"M21"	"A09"	"Other acquired deformities of limbs"	"Infectious gastroenteritis and colitis, unspecified"	1	290	529	819
"C79"	"B18"	"Secondary malignant neoplasm of other and unspecified sites"	"Chronic viral hepatitis"	1	3	47	50
"F03"	"D05"	"Unspecified dementia"	"Carcinoma in situ of breast"	1	9	53	62
"J94"	"D12"	"Other pleural conditions"	"Benign neoplasm of colon, rectum, anus and anal canal"	1	143	253	396
"F03"	"E15"	"Unspecified dementia"	"Nondiabetic hypoglycemic coma"	1	50	126	176
"A41"	"K51"	"Other sepsis"	"Ulcerative colitis"	1	249	1287	1536
"M85"	"M02"	"Other disorders of bone density and structure"	"Postinfective and reactive arthropathies"	1	20	266	286
"H26"	"M20"	"Other cataract"	"Acquired deformities of fingers and toes"	1	414	1108	1522
"I69"	"N43"	"Sequelae of cerebrovascular disease"	"Hydrocele and spermatocele"	1	111	669	780
"I27"	"N63"	"Other pulmonary heart diseases"	"Unspecified lump in breast"	1	12	85	97
"G62"	"N83"	"Other and unspecified polyneuropathies"	"Noninflammatory disord of ovary, fallop and broad ligament"	1	43	237	280
"K65"	"O65"	"Peritonitis"	"Obstructed labor due to maternal pelvic abnormality"	1	0	57	57
"K64"	"O24"	"Hemorrhoids and perianal venous thrombosis"	"Diabetes in pregnancy, childbirth, and the puerperium"	1	0	226	226
"K64"	"I70"	"Hemorrhoids and perianal venous thrombosis"	"Atherosclerosis"	1	25	407	432
"A41"	"D45"	"Other sepsis"	"Polycythemia vera"	1	32	246	278
"F17"	"K01"	"Nicotine dependence"	"Embedded and impacted teeth"	1	19	128	147
"E78"	"M23"	"Disorders of lipoprotein metabolism and other lipidemias"	"Internal derangement of knee"	1	0	8220	8220
"M75"	"L01"	"Shoulder lesions"	"Impetigo"	1	33	99	132
"J44"	"O03"	"Other chronic obstructive pulmonary disease"	"Spontaneous abortion"	1	0	171	171
"J34"	"O80"	"Other and unspecified disorders of nose and nasal sinuses"	"Encounter for full-term uncomplicated delivery"	1	403	1181	1584
"N45"	"F10"	"Orchitis and epididymitis"	"Alcohol related disorders"	1	363	620	983
"F32"	"G45"	"Depressive episode"	"Transient cerebral ischemic attacks and related syndromes"	1	1206	2389	3595
"I38"	"I47"	"Endocarditis, valve unspecified"	"Paroxysmal tachycardia"	1	68	168	236
"K85"	"N87"	"Acute pancreatitis"	"Dysplasia of cervix uteri"	1	42	107	149
"O32"	"O03"	"Maternal care for malpresentation of fetus"	"Spontaneous abortion"	1	1432	3473	4905
"G82"	"Q05"	"Paraplegia (paraparesis) and quadriplegia (quadriparesis)"	"Spina bifida"	1	0	166	166
"B08"	"J00"	"Oth viral infect with skin and mucous membrane lesions, NEC"	"Acute nasopharyngitis [common cold]"	1	168	327	495
"D70"	"C62"	"Neutropenia"	"Malignant neoplasm of testis"	1	3	42	45
"C71"	"D17"	"Malignant neoplasm of brain"	"Benign lipomatous neoplasm"	1	11	119	130
"E11"	"L73"	"Type 2 diabetes mellitus"	"Other follicular disorders"	1	186	318	504
"D21"	"O36"	"Other benign neoplasms of connective and other soft tissue"	"Maternal care for other fetal problems"	1	21	71	92
"C22"	"M62"	"Malignant neoplasm of liver and intrahepatic bile ducts"	"Other disorders of muscle"	1	0	120	120
"K06"	"N03"	"Other disorders of gingiva and edentulous alveolar ridge"	"Chronic nephritic syndrome"	1	17	62	79
"H44"	"O20"	"Disorders of globe"	"Hemorrhage in early pregnancy"	1	4	79	83
"K02"	"C32"	"Dental caries"	"Malignant neoplasm of larynx"	1	283	603	886
"I26"	"D24"	"Pulmonary embolism"	"Benign neoplasm of breast"	1	18	226	244
"I44"	"N60"	"Atrioventricular and left bundle-branch block"	"Benign mammary dysplasia"	1	3	73	76
"H47"	"Q53"	"Other disorders of optic [2nd] nerve and visual pathways"	"Undescended and ectopic testicle"	1	8	49	57
"J96"	"F11"	"Respiratory failure, not elsewhere classified"	"Opioid related disorders"	1	210	479	689
"H04"	"O70"	"Disorders of lacrimal system"	"Perineal laceration during delivery"	1	29	108	137
"G95"	"K58"	"Other and unspecified diseases of spinal cord"	"Irritable bowel syndrome"	1	16	96	112
"C90"	"H25"	"Multiple myeloma and malignant plasma cell neoplasms"	"Age-related cataract"	1	330	526	856
"I73"	"N95"	"Other peripheral vascular diseases"	"Menopausal and other perimenopausal disorders"	1	153	432	585
"J10"	"C92"	"Influenza due to other identified influenza virus"	"Myeloid leukemia"	1	18	94	112
"O72"	"Q37"	"Postpartum hemorrhage"	"Cleft palate with cleft lip"	1	0	83	83
"M70"	"J30"	"Soft tissue disorders related to use, overuse and pressure"	"Vasomotor and allergic rhinitis"	1	130	377	507
"O72"	"F48"	"Postpartum hemorrhage"	"Other nonpsychotic mental disorders"	1	12	59	71
"N83"	"K01"	"Noninflammatory disord of ovary, fallop and broad ligament"	"Embedded and impacted teeth"	1	32	117	149
"I33"	"K04"	"Acute and subacute endocarditis"	"Diseases of pulp and periapical tissues"	1	121	291	412
"K45"	"M23"	"Other abdominal hernia"	"Internal derangement of knee"	1	177	331	508
"B96"	"O80"	"Oth bacterial agents as the cause of diseases classd elswhr"	"Encounter for full-term uncomplicated delivery"	1	3	65	68
"N92"	"O04"	"Excessive, frequent and irregular menstruation"	"Complications following (induced) termination of pregnancy"	1	0	8778	8778
"D51"	"O04"	"Vitamin B12 deficiency anemia"	"Complications following (induced) termination of pregnancy"	1	2	103	105
"O72"	"Q21"	"Postpartum hemorrhage"	"Congenital malformations of cardiac septa"	1	38	302	340
"C92"	"H93"	"Myeloid leukemia"	"Other disorders of ear, not elsewhere classified"	1	7	111	118
"E53"	"K29"	"Deficiency of other B group vitamins"	"Gastritis and duodenitis"	1	136	296	432
"G95"	"L03"	"Other and unspecified diseases of spinal cord"	"Cellulitis and acute lymphangitis"	1	3	85	88
"I10"	"O68"	"Essential (primary) hypertension"	"Labor and delivery comp by abnlt of fetal acid-base balance"	1	0	1268	1268
"M35"	"I77"	"Other systemic involvement of connective tissue"	"Other disorders of arteries and arterioles"	1	154	267	421
"I27"	"M47"	"Other pulmonary heart diseases"	"Spondylosis"	1	51	253	304
"M47"	"O65"	"Spondylosis"	"Obstructed labor due to maternal pelvic abnormality"	1	0	44	44
"E86"	"I70"	"Volume depletion"	"Atherosclerosis"	1	0	9732	9732
"C78"	"J43"	"Secondary malignant neoplasm of resp and digestive organs"	"Emphysema"	1	64	405	469
"M77"	"Q53"	"Other enthesopathies"	"Undescended and ectopic testicle"	1	0	47	47
"L02"	"H80"	"Cutaneous abscess, furuncle and carbuncle"	"Otosclerosis"	1	38	145	183
"H93"	"J36"	"Other disorders of ear, not elsewhere classified"	"Peritonsillar abscess"	1	43	128	171
"I70"	"K35"	"Atherosclerosis"	"Acute appendicitis"	1	268	445	713
"M05"	"O64"	"Rheumatoid arthritis with rheumatoid factor"	"Obstructed labor due to malposition and malpresent of fetus"	1	0	66	66
"I10"	"O73"	"Essential (primary) hypertension"	"Retained placenta and membranes, without hemorrhage"	1	0	77	77
"J18"	"D30"	"Pneumonia, unspecified organism"	"Benign neoplasm of urinary organs"	1	0	3651	3651
"N12"	"M17"	"Tubulo-interstitial nephritis, not spcf as acute or chronic"	"Osteoarthritis of knee"	1	71	226	297
"C80"	"M70"	"Malignant neoplasm without specification of site"	"Soft tissue disorders related to use, overuse and pressure"	1	0	93	93
"C13"	"I10"	"Malignant neoplasm of hypopharynx"	"Essential (primary) hypertension"	1	111	296	407
"C24"	"K76"	"Malignant neoplasm of other and unsp parts of biliary tract"	"Other diseases of liver"	1	56	183	239
"Q61"	"O68"	"Cystic kidney disease"	"Labor and delivery comp by abnlt of fetal acid-base balance"	1	13	76	89
"J47"	"J32"	"Bronchiectasis"	"Chronic sinusitis"	1	53	212	265
"F17"	"K44"	"Nicotine dependence"	"Diaphragmatic hernia"	1	672	1060	1732
"M75"	"J34"	"Shoulder lesions"	"Other and unspecified disorders of nose and nasal sinuses"	1	535	1921	2456
"J81"	"M65"	"Pulmonary edema"	"Synovitis and tenosynovitis"	1	10	169	179
"N31"	"O70"	"Neuromuscular dysfunction of bladder, NEC"	"Perineal laceration during delivery"	1	38	116	154
"B96"	"J32"	"Oth bacterial agents as the cause of diseases classd elswhr"	"Chronic sinusitis"	1	16	63	79
"G45"	"K40"	"Transient cerebral ischemic attacks and related syndromes"	"Inguinal hernia"	1	1001	2393	3394
"K22"	"N87"	"Other diseases of esophagus"	"Dysplasia of cervix uteri"	1	8	76	84
"M50"	"O04"	"Cervical disc disorders"	"Complications following (induced) termination of pregnancy"	1	0	809	809
"M53"	"Q17"	"Other and unspecified dorsopathies, not elsewhere classified"	"Other congenital malformations of ear"	1	0	38	38
"K92"	"Q18"	"Other diseases of digestive system"	"Other congenital malformations of face and neck"	1	12	55	67
"M48"	"M17"	"Other spondylopathies"	"Osteoarthritis of knee"	1	2279	5416	7695
"I27"	"M65"	"Other pulmonary heart diseases"	"Synovitis and tenosynovitis"	1	16	160	176
"F10"	"Q76"	"Alcohol related disorders"	"Congenital malformations of spine and bony thorax"	1	7	50	57
"G95"	"L02"	"Other and unspecified diseases of spinal cord"	"Cutaneous abscess, furuncle and carbuncle"	1	69	256	325
"H44"	"J45"	"Disorders of globe"	"Asthma"	1	75	187	262
"K83"	"G40"	"Other diseases of biliary tract"	"Epilepsy and recurrent seizures"	1	76	186	262
"C34"	"K29"	"Malignant neoplasm of bronchus and lung"	"Gastritis and duodenitis"	1	0	2552	2552
"B02"	"O62"	"Zoster [herpes zoster]"	"Abnormalities of forces of labor"	1	18	119	137
"M17"	"Q83"	"Osteoarthritis of knee"	"Congenital malformations of breast"	1	2	38	40
"K25"	"N94"	"Gastric ulcer"	"Pain and oth cond assoc w fem gntl org and menstrual cycle"	1	65	182	247
"L82"	"F10"	"Seborrheic keratosis"	"Alcohol related disorders"	1	20	146	166
"B37"	"K70"	"Candidiasis"	"Alcoholic liver disease"	1	317	484	801
"M53"	"M51"	"Other and unspecified dorsopathies, not elsewhere classified"	"Thoracic, thoracolum, and lumbosacral intvrt disc disorders"	1	2969	4355	7324
"G23"	"E78"	"Other degenerative diseases of basal ganglia"	"Disorders of lipoprotein metabolism and other lipidemias"	1	13	126	139
"Q61"	"M22"	"Cystic kidney disease"	"Disorder of patella"	1	2	58	60
"K08"	"C09"	"Other disorders of teeth and supporting structures"	"Malignant neoplasm of tonsil"	1	194	325	519
"I87"	"H91"	"Other disorders of veins"	"Other and unspecified hearing loss"	1	229	692	921
"E55"	"J45"	"Vitamin D deficiency"	"Asthma"	1	147	673	820
"C24"	"K21"	"Malignant neoplasm of other and unsp parts of biliary tract"	"Gastro-esophageal reflux disease"	1	4	83	87
"I46"	"L72"	"Cardiac arrest"	"Follicular cysts of skin and subcutaneous tissue"	1	0	91	91
"N18"	"M42"	"Chronic kidney disease (CKD)"	"Spinal osteochondrosis"	1	0	49	49
"I46"	"M50"	"Cardiac arrest"	"Cervical disc disorders"	1	0	232	232
"H26"	"M17"	"Other cataract"	"Osteoarthritis of knee"	1	1647	3818	5465
"K12"	"F10"	"Stomatitis and related lesions"	"Alcohol related disorders"	1	160	493	653
"M19"	"Q78"	"Other and unspecified osteoarthritis"	"Other osteochondrodysplasias"	1	22	107	129
"E86"	"C50"	"Volume depletion"	"Malignant neoplasm of breast"	1	0	4697	4697
"J84"	"J35"	"Other interstitial pulmonary diseases"	"Chronic diseases of tonsils and adenoids"	1	7	62	69
"D69"	"J45"	"Purpura and other hemorrhagic conditions"	"Asthma"	1	314	780	1094
"J98"	"J45"	"Other respiratory disorders"	"Asthma"	1	1828	2519	4347
"F05"	"G62"	"Delirium due to known physiological condition"	"Other and unspecified polyneuropathies"	1	135	595	730
"C16"	"I21"	"Malignant neoplasm of stomach"	"Acute myocardial infarction"	1	66	500	566
"E07"	"H90"	"Other disorders of thyroid"	"Conductive and sensorineural hearing loss"	1	43	116	159
"G56"	"Q53"	"Mononeuropathies of upper limb"	"Undescended and ectopic testicle"	1	0	53	53
"F01"	"I70"	"Vascular dementia"	"Atherosclerosis"	1	261	742	1003
"J94"	"I25"	"Other pleural conditions"	"Chronic ischemic heart disease"	1	558	1248	1806
"J16"	"K40"	"Pneumonia due to oth infectious organisms, NEC"	"Inguinal hernia"	1	35	121	156
"I63"	"B18"	"Cerebral infarction"	"Chronic viral hepatitis"	1	51	127	178
"I42"	"H10"	"Cardiomyopathy"	"Conjunctivitis"	1	12	185	197
"D63"	"K35"	"Anemia in chronic diseases classified elsewhere"	"Acute appendicitis"	1	9	242	251
"D62"	"K80"	"Acute posthemorrhagic anemia"	"Cholelithiasis"	1	270	742	1012
"K70"	"L02"	"Alcoholic liver disease"	"Cutaneous abscess, furuncle and carbuncle"	1	312	760	1072
"I10"	"M47"	"Essential (primary) hypertension"	"Spondylosis"	1	6068	6892	12960
"G93"	"M79"	"Other disorders of brain"	"Oth and unsp soft tissue disorders, not elsewhere classified"	1	207	491	698
"L97"	"M85"	"Non-pressure chronic ulcer of lower limb, NEC"	"Other disorders of bone density and structure"	1	158	409	567
"N25"	"N19"	"Disorders resulting from impaired renal tubular function"	"Unspecified kidney failure"	1	274	522	796
"O44"	"N97"	"Placenta previa"	"Female infertility"	1	137	1464	1601
"N17"	"O99"	"Acute kidney failure"	"Oth maternal diseases classd elsw but compl preg/chldbrth"	1	19	98	117
"I11"	"M77"	"Hypertensive heart disease"	"Other enthesopathies"	1	25	130	155
"G40"	"J21"	"Epilepsy and recurrent seizures"	"Acute bronchiolitis"	1	45	115	160
"I48"	"A63"	"Atrial fibrillation and flutter"	"Oth predominantly sexually transmitted diseases, NEC"	1	15	183	198
"D07"	"N92"	"Carcinoma in situ of other and unspecified genital organs"	"Excessive, frequent and irregular menstruation"	1	176	580	756
"I73"	"O62"	"Other peripheral vascular diseases"	"Abnormalities of forces of labor"	1	6	179	185
"D12"	"F43"	"Benign neoplasm of colon, rectum, anus and anal canal"	"Reaction to severe stress, and adjustment disorders"	1	165	394	559
"N30"	"M18"	"Cystitis"	"Osteoarthritis of first carpometacarpal joint"	1	376	587	963
"C41"	"N92"	"Malignant neoplasm of bone/artic cartl of and unsp sites"	"Excessive, frequent and irregular menstruation"	1	2	28	30
"J96"	"C13"	"Respiratory failure, not elsewhere classified"	"Malignant neoplasm of hypopharynx"	1	118	320	438
"O24"	"M41"	"Diabetes in pregnancy, childbirth, and the puerperium"	"Scoliosis"	1	0	25	25
"B37"	"D23"	"Candidiasis"	"Other benign neoplasms of skin"	1	81	167	248
"G45"	"O20"	"Transient cerebral ischemic attacks and related syndromes"	"Hemorrhage in early pregnancy"	1	0	125	125
"D30"	"D25"	"Benign neoplasm of urinary organs"	"Leiomyoma of uterus"	1	12	156	168
"J69"	"G35"	"Pneumonitis due to solids and liquids"	"Multiple sclerosis"	1	0	78	78
"E83"	"H33"	"Disorders of mineral metabolism"	"Retinal detachments and breaks"	1	8	108	116
"H26"	"M51"	"Other cataract"	"Thoracic, thoracolum, and lumbosacral intvrt disc disorders"	1	560	2237	2797
"I89"	"M70"	"Oth noninfective disorders of lymphatic vessels and nodes"	"Soft tissue disorders related to use, overuse and pressure"	1	66	139	205
"L89"	"N83"	"Pressure ulcer"	"Noninflammatory disord of ovary, fallop and broad ligament"	1	21	108	129
"M85"	"O30"	"Other disorders of bone density and structure"	"Multiple gestation"	1	0	45	45
"K61"	"Q53"	"Abscess of anal and rectal regions"	"Undescended and ectopic testicle"	1	3	41	44
"N19"	"J34"	"Unspecified kidney failure"	"Other and unspecified disorders of nose and nasal sinuses"	1	8	84	92
"A04"	"D11"	"Other bacterial intestinal infections"	"Benign neoplasm of major salivary glands"	1	9	64	73
"B34"	"D25"	"Viral infection of unspecified site"	"Leiomyoma of uterus"	1	75	260	335
"E64"	"G71"	"Sequelae of malnutrition and other nutritional deficiencies"	"Primary disorders of muscles"	1	1	33	34
"D35"	"I20"	"Benign neoplasm of other and unspecified endocrine glands"	"Angina pectoris"	1	125	530	655
"E41"	"K50"	"Nutritional marasmus"	"Crohn's disease [regional enteritis]"	1	4	36	40
"K64"	"N46"	"Hemorrhoids and perianal venous thrombosis"	"Male infertility"	1	3	250	253
"I74"	"N97"	"Arterial embolism and thrombosis"	"Female infertility"	1	2	29	31
"G62"	"D23"	"Other and unspecified polyneuropathies"	"Other benign neoplasms of skin"	1	109	265	374
"I21"	"N60"	"Acute myocardial infarction"	"Benign mammary dysplasia"	1	26	338	364
"L60"	"J45"	"Nail disorders"	"Asthma"	1	143	573	716
"J10"	"D17"	"Influenza due to other identified influenza virus"	"Benign lipomatous neoplasm"	1	3	45	48
"M18"	"D24"	"Osteoarthritis of first carpometacarpal joint"	"Benign neoplasm of breast"	1	0	207	207
"M47"	"G56"	"Spondylosis"	"Mononeuropathies of upper limb"	1	2046	3605	5651
"G98"	"J03"	"Other disorders of nervous system not elsewhere classified"	"Acute tonsillitis"	1	8	180	188
"A41"	"K35"	"Other sepsis"	"Acute appendicitis"	1	414	1303	1717
"K63"	"M23"	"Other diseases of intestine"	"Internal derangement of knee"	1	68	587	655
"D12"	"N95"	"Benign neoplasm of colon, rectum, anus and anal canal"	"Menopausal and other perimenopausal disorders"	1	467	1496	1963
"H25"	"M53"	"Age-related cataract"	"Other and unspecified dorsopathies, not elsewhere classified"	1	485	846	1331
"E66"	"J11"	"Overweight and obesity"	"Influenza due to unidentified influenza virus"	1	230	458	688
"K92"	"M54"	"Other diseases of digestive system"	"Dorsalgia"	1	1599	3644	5243
"K64"	"F17"	"Hemorrhoids and perianal venous thrombosis"	"Nicotine dependence"	1	510	1073	1583
"K55"	"H35"	"Vascular disorders of intestine"	"Other retinal disorders"	1	120	397	517
"N10"	"M23"	"Acute pyelonephritis"	"Internal derangement of knee"	1	496	714	1210
"J84"	"N60"	"Other interstitial pulmonary diseases"	"Benign mammary dysplasia"	1	2	71	73
"E66"	"Q25"	"Overweight and obesity"	"Congenital malformations of great arteries"	1	13	81	94
"D64"	"M19"	"Other anemias"	"Other and unspecified osteoarthritis"	1	1823	3214	5037
"E86"	"J00"	"Volume depletion"	"Acute nasopharyngitis [common cold]"	1	795	1255	2050
"M99"	"K51"	"Biomechanical lesions, not elsewhere classified"	"Ulcerative colitis"	1	34	95	129
"E70"	"I73"	"Disorders of aromatic amino-acid metabolism"	"Other peripheral vascular diseases"	1	97	209	306
"G03"	"O70"	"Meningitis due to other and unspecified causes"	"Perineal laceration during delivery"	1	31	99	130
"L03"	"Q53"	"Cellulitis and acute lymphangitis"	"Undescended and ectopic testicle"	1	40	112	152
"K92"	"K80"	"Other diseases of digestive system"	"Cholelithiasis"	1	1541	2526	4067
"D05"	"N60"	"Carcinoma in situ of breast"	"Benign mammary dysplasia"	1	180	570	750
"J90"	"M79"	"Pleural effusion, not elsewhere classified"	"Oth and unsp soft tissue disorders, not elsewhere classified"	1	185	853	1038
"C79"	"Q18"	"Secondary malignant neoplasm of other and unspecified sites"	"Other congenital malformations of face and neck"	1	0	45	45
"K61"	"K35"	"Abscess of anal and rectal regions"	"Acute appendicitis"	1	134	297	431
"L57"	"C85"	"Skin changes due to chronic expsr to nonionizing radiation"	"Oth and unspecified types of non-Hodgkin lymphoma"	1	20	96	116
"O75"	"O03"	"Oth complications of labor and delivery, NEC"	"Spontaneous abortion"	1	1413	3129	4542
"G47"	"C09"	"Sleep disorders"	"Malignant neoplasm of tonsil"	1	35	133	168
"L98"	"I70"	"Oth disorders of skin, subcu, not elsewhere classified"	"Atherosclerosis"	1	1711	2878	4589
"I89"	"I80"	"Oth noninfective disorders of lymphatic vessels and nodes"	"Phlebitis and thrombophlebitis"	1	289	672	961
"H35"	"O48"	"Other retinal disorders"	"Late pregnancy"	1	0	60	60
"E21"	"J35"	"Hyperparathyroidism and other disorders of parathyroid gland"	"Chronic diseases of tonsils and adenoids"	1	2	64	66
"K59"	"H20"	"Other functional intestinal disorders"	"Iridocyclitis"	1	109	424	533
"A49"	"M43"	"Bacterial infection of unspecified site"	"Other deforming dorsopathies"	1	49	345	394
"K43"	"O02"	"Ventral hernia"	"Other abnormal products of conception"	1	0	301	301
"J44"	"N80"	"Other chronic obstructive pulmonary disease"	"Endometriosis"	1	14	204	218
"L57"	"M05"	"Skin changes due to chronic expsr to nonionizing radiation"	"Rheumatoid arthritis with rheumatoid factor"	1	11	143	154
"J96"	"F22"	"Respiratory failure, not elsewhere classified"	"Delusional disorders"	1	78	213	291
"K59"	"C07"	"Other functional intestinal disorders"	"Malignant neoplasm of parotid gland"	1	17	80	97
"J18"	"G12"	"Pneumonia, unspecified organism"	"Spinal muscular atrophy and related syndromes"	1	324	727	1051
"G95"	"H81"	"Other and unspecified diseases of spinal cord"	"Disorders of vestibular function"	1	31	181	212
"O99"	"K58"	"Oth maternal diseases classd elsw but compl preg/chldbrth"	"Irritable bowel syndrome"	1	807	1673	2480
"C23"	"M79"	"Malignant neoplasm of gallbladder"	"Oth and unsp soft tissue disorders, not elsewhere classified"	1	2	27	29
"N80"	"O04"	"Endometriosis"	"Complications following (induced) termination of pregnancy"	1	63	1283	1346
"C78"	"K26"	"Secondary malignant neoplasm of resp and digestive organs"	"Duodenal ulcer"	1	274	1217	1491
"N13"	"N60"	"Obstructive and reflux uropathy"	"Benign mammary dysplasia"	1	24	149	173
"G24"	"J45"	"Dystonia"	"Asthma"	1	81	189	270
"N17"	"M24"	"Acute kidney failure"	"Other specific joint derangements"	1	19	139	158
"H26"	"J34"	"Other cataract"	"Other and unspecified disorders of nose and nasal sinuses"	1	54	241	295
"G98"	"K40"	"Other disorders of nervous system not elsewhere classified"	"Inguinal hernia"	1	13	333	346
"H01"	"M17"	"Other inflammation of eyelid"	"Osteoarthritis of knee"	1	105	273	378
"N47"	"H83"	"Disorders of prepuce"	"Other diseases of inner ear"	1	99	384	483
"O92"	"M62"	"Oth disord of brst/lactatn assoc w pregnancy and the puerp"	"Other disorders of muscle"	1	243	396	639
"C83"	"M21"	"Non-follicular lymphoma"	"Other acquired deformities of limbs"	1	8	44	52
"A49"	"G80"	"Bacterial infection of unspecified site"	"Cerebral palsy"	1	27	151	178
"N10"	"M22"	"Acute pyelonephritis"	"Disorder of patella"	1	104	323	427
"M19"	"N46"	"Other and unspecified osteoarthritis"	"Male infertility"	1	61	257	318
"E03"	"O21"	"Other hypothyroidism"	"Excessive vomiting in pregnancy"	1	78	360	438
"J01"	"O70"	"Acute sinusitis"	"Perineal laceration during delivery"	1	270	1209	1479
"N28"	"C18"	"Oth disorders of kidney and ureter, not elsewhere classified"	"Malignant neoplasm of colon"	1	113	208	321
"M19"	"I86"	"Other and unspecified osteoarthritis"	"Varicose veins of other sites"	1	36	101	137
"J91"	"G40"	"Pleural effusion in conditions classified elsewhere"	"Epilepsy and recurrent seizures"	1	53	144	197
"K56"	"D14"	"Paralytic ileus and intestinal obstruction without hernia"	"Benign neoplasm of middle ear and respiratory system"	1	64	179	243
"C78"	"C69"	"Secondary malignant neoplasm of resp and digestive organs"	"Malignant neoplasm of eye and adnexa"	1	60	292	352
"C79"	"D68"	"Secondary malignant neoplasm of other and unspecified sites"	"Other coagulation defects"	1	56	147	203
"L89"	"H66"	"Pressure ulcer"	"Suppurative and unspecified otitis media"	1	0	73	73
"C34"	"I11"	"Malignant neoplasm of bronchus and lung"	"Hypertensive heart disease"	1	177	438	615
"D63"	"I78"	"Anemia in chronic diseases classified elsewhere"	"Diseases of capillaries"	1	18	93	111
"D64"	"J30"	"Other anemias"	"Vasomotor and allergic rhinitis"	1	28	278	306
"G47"	"J36"	"Sleep disorders"	"Peritonsillar abscess"	1	10	229	239
"E86"	"K76"	"Volume depletion"	"Other diseases of liver"	1	810	1288	2098
"D75"	"M23"	"Other and unsp diseases of blood and blood-forming organs"	"Internal derangement of knee"	1	55	256	311
"C61"	"M31"	"Malignant neoplasm of prostate"	"Other necrotizing vasculopathies"	1	93	184	277
"I61"	"M71"	"Nontraumatic intracerebral hemorrhage"	"Other bursopathies"	1	8	115	123
"L97"	"M75"	"Non-pressure chronic ulcer of lower limb, NEC"	"Shoulder lesions"	1	154	795	949
"D46"	"M79"	"Myelodysplastic syndromes"	"Oth and unsp soft tissue disorders, not elsewhere classified"	1	42	202	244
"I73"	"M79"	"Other peripheral vascular diseases"	"Oth and unsp soft tissue disorders, not elsewhere classified"	1	1749	2766	4515
"F05"	"N95"	"Delirium due to known physiological condition"	"Menopausal and other perimenopausal disorders"	1	0	249	249
"E73"	"O04"	"Lactose intolerance"	"Complications following (induced) termination of pregnancy"	1	17	210	227
"O70"	"Q74"	"Perineal laceration during delivery"	"Other congenital malformations of limb(s)"	1	0	66	66
"J03"	"Q90"	"Acute tonsillitis"	"Down syndrome"	1	17	130	147
"O08"	"A09"	"Complications following ectopic and molar pregnancy"	"Infectious gastroenteritis and colitis, unspecified"	1	132	280	412
"F03"	"J32"	"Unspecified dementia"	"Chronic sinusitis"	1	0	100	100
"C18"	"O80"	"Malignant neoplasm of colon"	"Encounter for full-term uncomplicated delivery"	1	0	108	108
"G31"	"D12"	"Oth degenerative diseases of nervous system, NEC"	"Benign neoplasm of colon, rectum, anus and anal canal"	1	85	238	323
"I35"	"H83"	"Nonrheumatic aortic valve disorders"	"Other diseases of inner ear"	1	0	1349	1349
"L97"	"M65"	"Non-pressure chronic ulcer of lower limb, NEC"	"Synovitis and tenosynovitis"	1	37	391	428
"C85"	"N40"	"Oth and unspecified types of non-Hodgkin lymphoma"	"Benign prostatic hyperplasia"	1	146	344	490
"D50"	"O20"	"Iron deficiency anemia"	"Hemorrhage in early pregnancy"	1	0	454	454
"H25"	"D39"	"Age-related cataract"	"Neoplasm of uncertain behavior of female genital organs"	1	38	164	202
"M85"	"K50"	"Other disorders of bone density and structure"	"Crohn's disease [regional enteritis]"	1	19	523	542
"E66"	"G71"	"Overweight and obesity"	"Primary disorders of muscles"	1	36	109	145
"N18"	"O82"	"Chronic kidney disease (CKD)"	"Encounter for cesarean delivery without indication"	1	7	221	228
"M23"	"F98"	"Internal derangement of knee"	"Oth behav/emotn disord w onset usly occur in chldhd and adol"	1	0	118	118
"K59"	"L23"	"Other functional intestinal disorders"	"Allergic contact dermatitis"	1	117	391	508
"E11"	"M67"	"Type 2 diabetes mellitus"	"Other disorders of synovium and tendon"	1	464	1193	1657
"K66"	"N80"	"Other disorders of peritoneum"	"Endometriosis"	1	318	567	885
"M18"	"N84"	"Osteoarthritis of first carpometacarpal joint"	"Polyp of female genital tract"	1	64	220	284
"M48"	"N94"	"Other spondylopathies"	"Pain and oth cond assoc w fem gntl org and menstrual cycle"	1	0	340	340
"D14"	"N97"	"Benign neoplasm of middle ear and respiratory system"	"Female infertility"	1	7	66	73
"M47"	"O20"	"Spondylosis"	"Hemorrhage in early pregnancy"	1	0	214	214
"J38"	"O80"	"Diseases of vocal cords and larynx, not elsewhere classified"	"Encounter for full-term uncomplicated delivery"	1	104	457	561
"M66"	"O99"	"Spontaneous rupture of synovium and tendon"	"Oth maternal diseases classd elsw but compl preg/chldbrth"	1	11	49	60
"C13"	"K70"	"Malignant neoplasm of hypopharynx"	"Alcoholic liver disease"	1	10	136	146
"I21"	"M20"	"Acute myocardial infarction"	"Acquired deformities of fingers and toes"	1	414	962	1376
"L98"	"M72"	"Oth disorders of skin, subcu, not elsewhere classified"	"Fibroblastic disorders"	1	153	330	483
"D72"	"O68"	"Other disorders of white blood cells"	"Labor and delivery comp by abnlt of fetal acid-base balance"	1	2	42	44
"G47"	"C90"	"Sleep disorders"	"Multiple myeloma and malignant plasma cell neoplasms"	1	68	152	220
"D64"	"H11"	"Other anemias"	"Other disorders of conjunctiva"	1	103	460	563
"A04"	"D24"	"Other bacterial intestinal infections"	"Benign neoplasm of breast"	1	5	121	126
"G20"	"K21"	"Parkinson's disease"	"Gastro-esophageal reflux disease"	1	104	332	436
"C44"	"M19"	"Other and unspecified malignant neoplasm of skin"	"Other and unspecified osteoarthritis"	1	729	1165	1894
"H57"	"H81"	"Other disorders of eye and adnexa"	"Disorders of vestibular function"	1	141	340	481
"O72"	"L04"	"Postpartum hemorrhage"	"Acute lymphadenitis"	1	0	226	226
"O90"	"Q17"	"Complications of the puerperium, not elsewhere classified"	"Other congenital malformations of ear"	1	0	28	28
"E46"	"M05"	"Unspecified protein-calorie malnutrition"	"Rheumatoid arthritis with rheumatoid factor"	1	0	25	25
"D25"	"O46"	"Leiomyoma of uterus"	"Antepartum hemorrhage, not elsewhere classified"	1	0	171	171
"C78"	"E21"	"Secondary malignant neoplasm of resp and digestive organs"	"Hyperparathyroidism and other disorders of parathyroid gland"	1	61	187	248
"I49"	"G56"	"Other cardiac arrhythmias"	"Mononeuropathies of upper limb"	1	556	1090	1646
"K21"	"H10"	"Gastro-esophageal reflux disease"	"Conjunctivitis"	1	305	1003	1308
"N97"	"H72"	"Female infertility"	"Perforation of tympanic membrane"	1	33	90	123
"E16"	"I25"	"Other disorders of pancreatic internal secretion"	"Chronic ischemic heart disease"	1	1211	2437	3648
"K70"	"H10"	"Alcoholic liver disease"	"Conjunctivitis"	1	27	283	310
"F01"	"K43"	"Vascular dementia"	"Ventral hernia"	1	1	136	137
"D47"	"D30"	"Oth neoplm of uncrt behav of lymphoid, hematpoetc & rel tiss"	"Benign neoplasm of urinary organs"	1	10	105	115
"J15"	"E78"	"Bacterial pneumonia, not elsewhere classified"	"Disorders of lipoprotein metabolism and other lipidemias"	1	0	10623	10623
"K86"	"G43"	"Other diseases of pancreas"	"Migraine"	1	32	100	132
"J94"	"G56"	"Other pleural conditions"	"Mononeuropathies of upper limb"	1	32	168	200
"E46"	"K25"	"Unspecified protein-calorie malnutrition"	"Gastric ulcer"	1	38	128	166
"H54"	"M51"	"Blindness and low vision"	"Thoracic, thoracolum, and lumbosacral intvrt disc disorders"	1	58	374	432
"C71"	"N35"	"Malignant neoplasm of brain"	"Urethral stricture"	1	1	27	28
"A46"	"O03"	"Erysipelas"	"Spontaneous abortion"	1	0	163	163
"M77"	"O41"	"Other enthesopathies"	"Other disorders of amniotic fluid and membranes"	1	5	61	66
"N17"	"H10"	"Acute kidney failure"	"Conjunctivitis"	1	0	243	243
"E21"	"J34"	"Hyperparathyroidism and other disorders of parathyroid gland"	"Other and unspecified disorders of nose and nasal sinuses"	1	4	58	62
"E86"	"O71"	"Volume depletion"	"Other obstetric trauma"	1	15	88	103
"I42"	"H93"	"Cardiomyopathy"	"Other disorders of ear, not elsewhere classified"	1	79	328	407
"A09"	"G45"	"Infectious gastroenteritis and colitis, unspecified"	"Transient cerebral ischemic attacks and related syndromes"	1	1027	1411	2438
"G96"	"K61"	"Other disorders of central nervous system"	"Abscess of anal and rectal regions"	1	0	166	166
"H02"	"O62"	"Other disorders of eyelid"	"Abnormalities of forces of labor"	1	0	456	456
"G98"	"O63"	"Other disorders of nervous system not elsewhere classified"	"Long labor"	1	0	35	35
"N30"	"N70"	"Cystitis"	"Salpingitis and oophoritis"	1	656	1098	1754
"I15"	"D25"	"Secondary hypertension"	"Leiomyoma of uterus"	1	39	180	219
"H36"	"N43"	"Retinal disorders in diseases classified elsewhere"	"Hydrocele and spermatocele"	1	41	120	161
"J18"	"H90"	"Pneumonia, unspecified organism"	"Conductive and sensorineural hearing loss"	1	0	7716	7716
"H65"	"Q54"	"Nonsuppurative otitis media"	"Hypospadias"	1	95	245	340
"B59"	"K40"	"Pneumocystosis"	"Inguinal hernia"	1	1	30	31
"O61"	"E10"	"Failed induction of labor"	"Type 1 diabetes mellitus"	1	6	41	47
"I89"	"C21"	"Oth noninfective disorders of lymphatic vessels and nodes"	"Malignant neoplasm of anus and anal canal"	1	13	58	71
"B96"	"I10"	"Oth bacterial agents as the cause of diseases classd elswhr"	"Essential (primary) hypertension"	1	260	1271	1531
"B44"	"J44"	"Aspergillosis"	"Other chronic obstructive pulmonary disease"	1	102	296	398
"H17"	"N92"	"Corneal scars and opacities"	"Excessive, frequent and irregular menstruation"	1	3	39	42
"I46"	"D50"	"Cardiac arrest"	"Iron deficiency anemia"	1	167	912	1079
"D09"	"L02"	"Carcinoma in situ of other and unspecified sites"	"Cutaneous abscess, furuncle and carbuncle"	1	4	84	88
"H43"	"O34"	"Disorders of vitreous body"	"Maternal care for abnormality of pelvic organs"	1	0	26	26
"E55"	"E10"	"Vitamin D deficiency"	"Type 1 diabetes mellitus"	1	244	709	953
"H49"	"I20"	"Paralytic strabismus"	"Angina pectoris"	1	126	262	388
"C25"	"C43"	"Malignant neoplasm of pancreas"	"Malignant melanoma of skin"	1	3	85	88
"J43"	"C50"	"Emphysema"	"Malignant neoplasm of breast"	1	97	212	309
"O32"	"F10"	"Maternal care for malpresentation of fetus"	"Alcohol related disorders"	1	40	313	353
"F41"	"H33"	"Other anxiety disorders"	"Retinal detachments and breaks"	1	24	140	164
"O82"	"N70"	"Encounter for cesarean delivery without indication"	"Salpingitis and oophoritis"	1	491	1322	1813
"G12"	"C50"	"Spinal muscular atrophy and related syndromes"	"Malignant neoplasm of breast"	1	0	31	31
"E86"	"H66"	"Volume depletion"	"Suppurative and unspecified otitis media"	1	1313	1606	2919
"C80"	"N84"	"Malignant neoplasm without specification of site"	"Polyp of female genital tract"	1	1	63	64
"O71"	"B27"	"Other obstetric trauma"	"Infectious mononucleosis"	1	0	63	63
"I50"	"C53"	"Heart failure"	"Malignant neoplasm of cervix uteri"	1	65	200	265
"E55"	"F10"	"Vitamin D deficiency"	"Alcohol related disorders"	1	373	1123	1496
"I70"	"J35"	"Atherosclerosis"	"Chronic diseases of tonsils and adenoids"	1	14	77	91
"M47"	"N83"	"Spondylosis"	"Noninflammatory disord of ovary, fallop and broad ligament"	1	188	751	939
"I15"	"O80"	"Secondary hypertension"	"Encounter for full-term uncomplicated delivery"	1	0	251	251
"M80"	"N64"	"Osteoporosis with current pathological fracture"	"Other disorders of breast"	1	19	135	154
"E11"	"O03"	"Type 2 diabetes mellitus"	"Spontaneous abortion"	1	0	498	498
"H92"	"A09"	"Otalgia and effusion of ear"	"Infectious gastroenteritis and colitis, unspecified"	1	138	515	653
"I67"	"N83"	"Other cerebrovascular diseases"	"Noninflammatory disord of ovary, fallop and broad ligament"	1	37	97	134
"E55"	"A15"	"Vitamin D deficiency"	"Respiratory tuberculosis"	1	30	115	145
"D64"	"I67"	"Other anemias"	"Other cerebrovascular diseases"	1	402	644	1046
"B95"	"N30"	"Strep as the cause of diseases classified elsewhere"	"Cystitis"	1	197	366	563
"C34"	"N60"	"Malignant neoplasm of bronchus and lung"	"Benign mammary dysplasia"	1	0	302	302
"N39"	"O48"	"Other disorders of urinary system"	"Late pregnancy"	1	0	634	634
"D25"	"O92"	"Leiomyoma of uterus"	"Oth disord of brst/lactatn assoc w pregnancy and the puerp"	1	15	117	132
"E86"	"Q54"	"Volume depletion"	"Hypospadias"	1	13	189	202
"M79"	"B27"	"Oth and unsp soft tissue disorders, not elsewhere classified"	"Infectious mononucleosis"	1	157	423	580
"K21"	"N97"	"Gastro-esophageal reflux disease"	"Female infertility"	1	73	479	552
"I10"	"O41"	"Essential (primary) hypertension"	"Other disorders of amniotic fluid and membranes"	1	0	180	180
"J95"	"I70"	"Intraop and postproc comp and disorders of resp sys, NEC"	"Atherosclerosis"	1	76	277	353
"L08"	"M20"	"Other local infections of skin and subcutaneous tissue"	"Acquired deformities of fingers and toes"	1	373	612	985
"K56"	"N20"	"Paralytic ileus and intestinal obstruction without hernia"	"Calculus of kidney and ureter"	1	468	716	1184
"E86"	"N85"	"Volume depletion"	"Other noninflammatory disorders of uterus, except cervix"	1	0	152	152
"E03"	"N96"	"Other hypothyroidism"	"Recurrent pregnancy loss"	1	61	191	252
"M50"	"O75"	"Cervical disc disorders"	"Oth complications of labor and delivery, NEC"	1	0	152	152
"M02"	"O80"	"Postinfective and reactive arthropathies"	"Encounter for full-term uncomplicated delivery"	1	274	597	871
"H57"	"G35"	"Other disorders of eye and adnexa"	"Multiple sclerosis"	1	86	360	446
"D63"	"G40"	"Anemia in chronic diseases classified elsewhere"	"Epilepsy and recurrent seizures"	1	131	377	508
"G62"	"J32"	"Other and unspecified polyneuropathies"	"Chronic sinusitis"	1	45	144	189
"I27"	"K80"	"Other pulmonary heart diseases"	"Cholelithiasis"	1	127	489	616
"D35"	"O82"	"Benign neoplasm of other and unspecified endocrine glands"	"Encounter for cesarean delivery without indication"	1	9	88	97
"M20"	"O20"	"Acquired deformities of fingers and toes"	"Hemorrhage in early pregnancy"	1	51	434	485
"C43"	"J36"	"Malignant melanoma of skin"	"Peritonsillar abscess"	1	4	34	38
"N19"	"G35"	"Unspecified kidney failure"	"Multiple sclerosis"	1	1	37	38
"A41"	"J36"	"Other sepsis"	"Peritonsillar abscess"	1	17	219	236
"M10"	"M75"	"Gout"	"Shoulder lesions"	1	625	1071	1696
"D69"	"H83"	"Purpura and other hemorrhagic conditions"	"Other diseases of inner ear"	1	0	175	175
"M70"	"O04"	"Soft tissue disorders related to use, overuse and pressure"	"Complications following (induced) termination of pregnancy"	1	38	922	960
"M10"	"H43"	"Gout"	"Disorders of vitreous body"	1	122	230	352
"C13"	"M47"	"Malignant neoplasm of hypopharynx"	"Spondylosis"	1	3	32	35
"G50"	"O04"	"Disorders of trigeminal nerve"	"Complications following (induced) termination of pregnancy"	1	0	176	176
"I15"	"N70"	"Secondary hypertension"	"Salpingitis and oophoritis"	1	0	34	34
"D64"	"F11"	"Other anemias"	"Opioid related disorders"	1	174	314	488
"D50"	"D30"	"Iron deficiency anemia"	"Benign neoplasm of urinary organs"	1	93	417	510
"M25"	"Q67"	"Other joint disorder, not elsewhere classified"	"Congenital ms deformities of head, face, spine and chest"	1	16	58	74
"K44"	"L05"	"Diaphragmatic hernia"	"Pilonidal cyst and sinus"	1	47	145	192
"E86"	"C02"	"Volume depletion"	"Malignant neoplasm of other and unspecified parts of tongue"	1	97	241	338
"M23"	"H71"	"Internal derangement of knee"	"Cholesteatoma of middle ear"	1	79	181	260
"K65"	"H83"	"Peritonitis"	"Other diseases of inner ear"	1	10	182	192
"F41"	"I73"	"Other anxiety disorders"	"Other peripheral vascular diseases"	1	189	583	772
"O36"	"J30"	"Maternal care for other fetal problems"	"Vasomotor and allergic rhinitis"	1	162	282	444
"B96"	"M31"	"Oth bacterial agents as the cause of diseases classd elswhr"	"Other necrotizing vasculopathies"	1	12	65	77
"K76"	"N92"	"Other diseases of liver"	"Excessive, frequent and irregular menstruation"	1	17	627	644
"H25"	"O20"	"Age-related cataract"	"Hemorrhage in early pregnancy"	1	0	42	42
"F43"	"O80"	"Reaction to severe stress, and adjustment disorders"	"Encounter for full-term uncomplicated delivery"	1	0	1866	1866
"K83"	"C20"	"Other diseases of biliary tract"	"Malignant neoplasm of rectum"	1	74	293	367
"F33"	"I21"	"Major depressive disorder, recurrent"	"Acute myocardial infarction"	1	455	1149	1604
"J01"	"J03"	"Acute sinusitis"	"Acute tonsillitis"	1	479	690	1169
"G20"	"M17"	"Parkinson's disease"	"Osteoarthritis of knee"	1	218	1102	1320
"F41"	"I21"	"Other anxiety disorders"	"Acute myocardial infarction"	1	340	1386	1726
"C67"	"J34"	"Malignant neoplasm of bladder"	"Other and unspecified disorders of nose and nasal sinuses"	1	1	43	44
"E03"	"N87"	"Other hypothyroidism"	"Dysplasia of cervix uteri"	1	61	590	651
"D10"	"O68"	"Benign neoplasm of mouth and pharynx"	"Labor and delivery comp by abnlt of fetal acid-base balance"	1	19	136	155
"J44"	"J36"	"Other chronic obstructive pulmonary disease"	"Peritonsillar abscess"	1	23	210	233
"C15"	"N95"	"Malignant neoplasm of esophagus"	"Menopausal and other perimenopausal disorders"	1	0	44	44
"I51"	"H35"	"Complications and ill-defined descriptions of heart disease"	"Other retinal disorders"	1	252	609	861
"G98"	"I25"	"Other disorders of nervous system not elsewhere classified"	"Chronic ischemic heart disease"	1	135	552	687
"M50"	"N46"	"Cervical disc disorders"	"Male infertility"	1	51	182	233
"H72"	"J45"	"Perforation of tympanic membrane"	"Asthma"	1	192	564	756
"I73"	"H26"	"Other peripheral vascular diseases"	"Other cataract"	1	964	1232	2196
"D50"	"O60"	"Iron deficiency anemia"	"Preterm labor"	1	0	55	55
"I50"	"D21"	"Heart failure"	"Other benign neoplasms of connective and other soft tissue"	1	89	237	326
"N18"	"G57"	"Chronic kidney disease (CKD)"	"Mononeuropathies of lower limb"	1	37	239	276
"C56"	"N92"	"Malignant neoplasm of ovary"	"Excessive, frequent and irregular menstruation"	1	1	506	507
"I69"	"G35"	"Sequelae of cerebrovascular disease"	"Multiple sclerosis"	1	92	239	331
"C15"	"K05"	"Malignant neoplasm of esophagus"	"Gingivitis and periodontal diseases"	1	44	148	192
"J15"	"D64"	"Bacterial pneumonia, not elsewhere classified"	"Other anemias"	1	6670	8164	14834
"M80"	"H90"	"Osteoporosis with current pathological fracture"	"Conductive and sensorineural hearing loss"	1	118	1073	1191
"E83"	"I21"	"Disorders of mineral metabolism"	"Acute myocardial infarction"	1	142	595	737
"K59"	"M13"	"Other functional intestinal disorders"	"Other arthritis"	1	786	1195	1981
"J43"	"M16"	"Emphysema"	"Osteoarthritis of hip"	1	160	406	566
"M13"	"N43"	"Other arthritis"	"Hydrocele and spermatocele"	1	57	160	217
"G96"	"N83"	"Other disorders of central nervous system"	"Noninflammatory disord of ovary, fallop and broad ligament"	1	32	341	373
"M70"	"O34"	"Soft tissue disorders related to use, overuse and pressure"	"Maternal care for abnormality of pelvic organs"	1	54	148	202
"M31"	"O80"	"Other necrotizing vasculopathies"	"Encounter for full-term uncomplicated delivery"	1	0	117	117
"M85"	"D23"	"Other disorders of bone density and structure"	"Other benign neoplasms of skin"	1	121	600	721
"C79"	"J84"	"Secondary malignant neoplasm of other and unspecified sites"	"Other interstitial pulmonary diseases"	1	104	256	360
"K44"	"K35"	"Diaphragmatic hernia"	"Acute appendicitis"	1	274	639	913
"C25"	"N95"	"Malignant neoplasm of pancreas"	"Menopausal and other perimenopausal disorders"	1	0	178	178
"N84"	"O64"	"Polyp of female genital tract"	"Obstructed labor due to malposition and malpresent of fetus"	1	0	244	244
"M66"	"O82"	"Spontaneous rupture of synovium and tendon"	"Encounter for cesarean delivery without indication"	1	0	40	40
"M19"	"M23"	"Other and unspecified osteoarthritis"	"Internal derangement of knee"	1	0	8119	8119
"C44"	"O36"	"Other and unspecified malignant neoplasm of skin"	"Maternal care for other fetal problems"	1	0	44	44
"F43"	"A63"	"Reaction to severe stress, and adjustment disorders"	"Oth predominantly sexually transmitted diseases, NEC"	1	46	195	241
"E34"	"J44"	"Other endocrine disorders"	"Other chronic obstructive pulmonary disease"	1	164	359	523
"N39"	"L20"	"Other disorders of urinary system"	"Atopic dermatitis"	1	109	303	412
"O75"	"O04"	"Oth complications of labor and delivery, NEC"	"Complications following (induced) termination of pregnancy"	1	859	2435	3294
"C79"	"I50"	"Secondary malignant neoplasm of other and unspecified sites"	"Heart failure"	1	868	1794	2662
"J11"	"J35"	"Influenza due to unidentified influenza virus"	"Chronic diseases of tonsils and adenoids"	1	134	344	478
"J18"	"F52"	"Pneumonia, unspecified organism"	"Sexual dysfnct not due to a substance or known physiol cond"	1	41	104	145
"C18"	"I10"	"Malignant neoplasm of colon"	"Essential (primary) hypertension"	1	6415	7149	13564
"D75"	"I80"	"Other and unsp diseases of blood and blood-forming organs"	"Phlebitis and thrombophlebitis"	1	215	406	621
"I21"	"N83"	"Acute myocardial infarction"	"Noninflammatory disord of ovary, fallop and broad ligament"	1	158	360	518
"K43"	"O91"	"Ventral hernia"	"Infect of breast assoc w pregnancy, the puerp and lactation"	1	6	58	64
"J47"	"H25"	"Bronchiectasis"	"Age-related cataract"	1	365	604	969
"D12"	"M79"	"Benign neoplasm of colon, rectum, anus and anal canal"	"Oth and unsp soft tissue disorders, not elsewhere classified"	1	1545	3911	5456
"K11"	"Q53"	"Diseases of salivary glands"	"Undescended and ectopic testicle"	1	5	40	45
"N30"	"I45"	"Cystitis"	"Other conduction disorders"	1	823	1180	2003
"G23"	"M17"	"Other degenerative diseases of basal ganglia"	"Osteoarthritis of knee"	1	0	97	97
"F43"	"L03"	"Reaction to severe stress, and adjustment disorders"	"Cellulitis and acute lymphangitis"	1	47	226	273
"O23"	"L05"	"Infections of genitourinary tract in pregnancy"	"Pilonidal cyst and sinus"	1	14	106	120
"I71"	"M15"	"Aortic aneurysm and dissection"	"Polyosteoarthritis"	1	57	146	203
"M85"	"G80"	"Other disorders of bone density and structure"	"Cerebral palsy"	1	3	35	38
"L28"	"J45"	"Lichen simplex chronicus and prurigo"	"Asthma"	1	110	215	325
"K57"	"O71"	"Diverticular disease of intestine"	"Other obstetric trauma"	1	0	29	29
"I27"	"E10"	"Other pulmonary heart diseases"	"Type 1 diabetes mellitus"	1	349	513	862
"O62"	"K35"	"Abnormalities of forces of labor"	"Acute appendicitis"	1	1171	1867	3038
"N13"	"H91"	"Obstructive and reflux uropathy"	"Other and unspecified hearing loss"	1	545	1906	2451
"M25"	"F98"	"Other joint disorder, not elsewhere classified"	"Oth behav/emotn disord w onset usly occur in chldhd and adol"	1	7	48	55
"C10"	"C09"	"Malignant neoplasm of oropharynx"	"Malignant neoplasm of tonsil"	1	421	878	1299
"G62"	"D27"	"Other and unspecified polyneuropathies"	"Benign neoplasm of ovary"	1	14	175	189
"K59"	"G55"	"Other functional intestinal disorders"	"Nerve root and plexus compressions in diseases classd elswhr"	1	150	295	445
"J81"	"K22"	"Pulmonary edema"	"Other diseases of esophagus"	1	80	222	302
"J70"	"M17"	"Respiratory conditions due to other external agents"	"Osteoarthritis of knee"	1	11	77	88
"K59"	"M66"	"Other functional intestinal disorders"	"Spontaneous rupture of synovium and tendon"	1	116	209	325
"M51"	"O87"	"Thoracic, thoracolum, and lumbosacral intvrt disc disorders"	"Venous complications and hemorrhoids in the puerperium"	1	15	79	94
"N20"	"K50"	"Calculus of kidney and ureter"	"Crohn's disease [regional enteritis]"	1	151	342	493
"O72"	"O32"	"Postpartum hemorrhage"	"Maternal care for malpresentation of fetus"	1	8058	11973	20031
"D26"	"O80"	"Other benign neoplasms of uterus"	"Encounter for full-term uncomplicated delivery"	1	6	138	144
"D46"	"D51"	"Myelodysplastic syndromes"	"Vitamin B12 deficiency anemia"	1	73	189	262
"N50"	"J05"	"Other and unspecified disorders of male genital organs"	"Acute obstructive laryngitis [croup] and epiglottitis"	1	0	100	100
"N44"	"A09"	"Noninflammatory disorders of testis"	"Infectious gastroenteritis and colitis, unspecified"	1	40	157	197
"E78"	"H90"	"Disorders of lipoprotein metabolism and other lipidemias"	"Conductive and sensorineural hearing loss"	1	1343	2254	3597
"K22"	"K40"	"Other diseases of esophagus"	"Inguinal hernia"	1	356	1060	1416
"I85"	"D25"	"Esophageal varices"	"Leiomyoma of uterus"	1	2	56	58
"G98"	"O71"	"Other disorders of nervous system not elsewhere classified"	"Other obstetric trauma"	1	0	67	67
"O75"	"H50"	"Oth complications of labor and delivery, NEC"	"Other strabismus"	1	13	54	67
"G44"	"J30"	"Other headache syndromes"	"Vasomotor and allergic rhinitis"	1	176	360	536
"H52"	"K35"	"Disorders of refraction and accommodation"	"Acute appendicitis"	1	245	463	708
"D70"	"C20"	"Neutropenia"	"Malignant neoplasm of rectum"	1	9	46	55
"K22"	"N83"	"Other diseases of esophagus"	"Noninflammatory disord of ovary, fallop and broad ligament"	1	84	171	255
"J81"	"D24"	"Pulmonary edema"	"Benign neoplasm of breast"	1	1	63	64
"D50"	"G56"	"Iron deficiency anemia"	"Mononeuropathies of upper limb"	1	239	1070	1309
"M70"	"K35"	"Soft tissue disorders related to use, overuse and pressure"	"Acute appendicitis"	1	244	715	959
"N30"	"D17"	"Cystitis"	"Benign lipomatous neoplasm"	1	585	1268	1853
"J15"	"M41"	"Bacterial pneumonia, not elsewhere classified"	"Scoliosis"	1	144	487	631
"C77"	"C50"	"Secondary and unspecified malignant neoplasm of lymph nodes"	"Malignant neoplasm of breast"	1	0	11524	11524
"H18"	"H10"	"Other disorders of cornea"	"Conjunctivitis"	1	267	435	702
"D12"	"K04"	"Benign neoplasm of colon, rectum, anus and anal canal"	"Diseases of pulp and periapical tissues"	1	279	637	916
"C77"	"K44"	"Secondary and unspecified malignant neoplasm of lymph nodes"	"Diaphragmatic hernia"	1	92	510	602
"F03"	"N81"	"Unspecified dementia"	"Female genital prolapse"	1	0	1517	1517
"K43"	"O66"	"Ventral hernia"	"Other obstructed labor"	1	0	86	86
"M51"	"O67"	"Thoracic, thoracolum, and lumbosacral intvrt disc disorders"	"Labor and delivery comp by intrapartum hemorrhage, NEC"	1	8	51	59
"M25"	"K35"	"Other joint disorder, not elsewhere classified"	"Acute appendicitis"	1	240	917	1157
"G25"	"M79"	"Other extrapyramidal and movement disorders"	"Oth and unsp soft tissue disorders, not elsewhere classified"	1	223	454	677
"H81"	"O02"	"Disorders of vestibular function"	"Other abnormal products of conception"	1	42	312	354
"I10"	"K35"	"Essential (primary) hypertension"	"Acute appendicitis"	1	2222	3660	5882
"D68"	"M16"	"Other coagulation defects"	"Osteoarthritis of hip"	1	174	398	572
"D22"	"M51"	"Melanocytic nevi"	"Thoracic, thoracolum, and lumbosacral intvrt disc disorders"	1	299	703	1002
"O64"	"K35"	"Obstructed labor due to malposition and malpresent of fetus"	"Acute appendicitis"	1	178	318	496
"J84"	"M65"	"Other interstitial pulmonary diseases"	"Synovitis and tenosynovitis"	1	34	241	275
"I69"	"M77"	"Sequelae of cerebrovascular disease"	"Other enthesopathies"	1	101	608	709
"K50"	"H65"	"Crohn's disease [regional enteritis]"	"Nonsuppurative otitis media"	1	2	80	82
"J81"	"I73"	"Pulmonary edema"	"Other peripheral vascular diseases"	1	314	775	1089
"L97"	"J32"	"Non-pressure chronic ulcer of lower limb, NEC"	"Chronic sinusitis"	1	5	97	102
"O70"	"Q30"	"Perineal laceration during delivery"	"Congenital malformations of nose"	1	16	75	91
"E87"	"C61"	"Other disorders of fluid, electrolyte and acid-base balance"	"Malignant neoplasm of prostate"	1	414	1421	1835
"K55"	"F10"	"Vascular disorders of intestine"	"Alcohol related disorders"	1	86	521	607
"G47"	"H80"	"Sleep disorders"	"Otosclerosis"	1	7	173	180
"J15"	"I45"	"Bacterial pneumonia, not elsewhere classified"	"Other conduction disorders"	1	343	829	1172
"H90"	"J30"	"Conductive and sensorineural hearing loss"	"Vasomotor and allergic rhinitis"	1	134	313	447
"J15"	"N31"	"Bacterial pneumonia, not elsewhere classified"	"Neuromuscular dysfunction of bladder, NEC"	1	113	707	820
"D13"	"M16"	"Benign neoplasm of and ill-defined parts of digestive system"	"Osteoarthritis of hip"	1	149	258	407
"F40"	"F10"	"Phobic anxiety disorders"	"Alcohol related disorders"	1	122	290	412
"E26"	"O80"	"Hyperaldosteronism"	"Encounter for full-term uncomplicated delivery"	1	0	28	28
"M54"	"O68"	"Dorsalgia"	"Labor and delivery comp by abnlt of fetal acid-base balance"	1	1140	3356	4496
"G36"	"O80"	"Other acute disseminated demyelination"	"Encounter for full-term uncomplicated delivery"	1	0	37	37
"C90"	"D25"	"Multiple myeloma and malignant plasma cell neoplasms"	"Leiomyoma of uterus"	1	0	31	31
"L89"	"D51"	"Pressure ulcer"	"Vitamin B12 deficiency anemia"	1	105	241	346
"C44"	"E66"	"Other and unspecified malignant neoplasm of skin"	"Overweight and obesity"	1	530	1005	1535
"D22"	"J20"	"Melanocytic nevi"	"Acute bronchitis"	1	0	175	175
"D50"	"K05"	"Iron deficiency anemia"	"Gingivitis and periodontal diseases"	1	162	333	495
"J69"	"M67"	"Pneumonitis due to solids and liquids"	"Other disorders of synovium and tendon"	1	4	56	60
"G45"	"O70"	"Transient cerebral ischemic attacks and related syndromes"	"Perineal laceration during delivery"	1	0	271	271
"D86"	"O62"	"Sarcoidosis"	"Abnormalities of forces of labor"	1	48	320	368
"A49"	"D12"	"Bacterial infection of unspecified site"	"Benign neoplasm of colon, rectum, anus and anal canal"	1	615	1783	2398
"C78"	"M16"	"Secondary malignant neoplasm of resp and digestive organs"	"Osteoarthritis of hip"	1	0	2243	2243
"F33"	"N81"	"Major depressive disorder, recurrent"	"Female genital prolapse"	1	126	869	995
"L02"	"O26"	"Cutaneous abscess, furuncle and carbuncle"	"Maternal care for oth conditions predom related to pregnancy"	1	275	525	800
"D64"	"I63"	"Other anemias"	"Cerebral infarction"	1	4161	7709	11870
"J22"	"M76"	"Unspecified acute lower respiratory infection"	"Enthesopathies, lower limb, excluding foot"	1	10	54	64
"N96"	"O03"	"Recurrent pregnancy loss"	"Spontaneous abortion"	1	0	4668	4668
"L98"	"H35"	"Oth disorders of skin, subcu, not elsewhere classified"	"Other retinal disorders"	1	401	743	1144
"K05"	"J35"	"Gingivitis and periodontal diseases"	"Chronic diseases of tonsils and adenoids"	1	44	211	255
"E04"	"O91"	"Other nontoxic goiter"	"Infect of breast assoc w pregnancy, the puerp and lactation"	1	17	76	93
"E11"	"Q76"	"Type 2 diabetes mellitus"	"Congenital malformations of spine and bony thorax"	1	0	48	48
"C83"	"G56"	"Non-follicular lymphoma"	"Mononeuropathies of upper limb"	1	34	195	229
"N25"	"I50"	"Disorders resulting from impaired renal tubular function"	"Heart failure"	1	152	289	441
"F19"	"L02"	"Other psychoactive substance related disorders"	"Cutaneous abscess, furuncle and carbuncle"	1	155	324	479
"I80"	"E04"	"Phlebitis and thrombophlebitis"	"Other nontoxic goiter"	1	366	553	919
"K72"	"O80"	"Hepatic failure, not elsewhere classified"	"Encounter for full-term uncomplicated delivery"	1	0	53	53
"O71"	"A63"	"Other obstetric trauma"	"Oth predominantly sexually transmitted diseases, NEC"	1	134	548	682
"I10"	"K00"	"Essential (primary) hypertension"	"Disorders of tooth development and eruption"	1	16	128	144
"M90"	"E66"	"Osteopathies in diseases classified elsewhere"	"Overweight and obesity"	1	11	60	71
"C44"	"F10"	"Other and unspecified malignant neoplasm of skin"	"Alcohol related disorders"	1	344	790	1134
"N19"	"H40"	"Unspecified kidney failure"	"Glaucoma"	1	104	585	689
"M06"	"K40"	"Other rheumatoid arthritis"	"Inguinal hernia"	1	345	543	888
"L90"	"M02"	"Atrophic disorders of skin"	"Postinfective and reactive arthropathies"	1	28	114	142
"L08"	"J30"	"Other local infections of skin and subcutaneous tissue"	"Vasomotor and allergic rhinitis"	1	130	282	412
"K57"	"K29"	"Diverticular disease of intestine"	"Gastritis and duodenitis"	1	3132	4749	7881
"F43"	"D16"	"Reaction to severe stress, and adjustment disorders"	"Benign neoplasm of bone and articular cartilage"	1	16	71	87
"I89"	"C49"	"Oth noninfective disorders of lymphatic vessels and nodes"	"Malignant neoplasm of other connective and soft tissue"	1	24	78	102
"I69"	"H44"	"Sequelae of cerebrovascular disease"	"Disorders of globe"	1	75	236	311
"L30"	"N97"	"Other and unspecified dermatitis"	"Female infertility"	1	77	273	350
"C22"	"K25"	"Malignant neoplasm of liver and intrahepatic bile ducts"	"Gastric ulcer"	1	70	419	489
"A46"	"M35"	"Erysipelas"	"Other systemic involvement of connective tissue"	1	428	808	1236
"C34"	"E88"	"Malignant neoplasm of bronchus and lung"	"Other and unspecified metabolic disorders"	1	18	90	108
"I31"	"M54"	"Other diseases of pericardium"	"Dorsalgia"	1	88	224	312
"C80"	"M65"	"Malignant neoplasm without specification of site"	"Synovitis and tenosynovitis"	1	0	78	78
"I49"	"O30"	"Other cardiac arrhythmias"	"Multiple gestation"	1	4	96	100
"M16"	"H66"	"Osteoarthritis of hip"	"Suppurative and unspecified otitis media"	1	39	262	301
"G95"	"M24"	"Other and unspecified diseases of spinal cord"	"Other specific joint derangements"	1	6	66	72
"M75"	"Q53"	"Shoulder lesions"	"Undescended and ectopic testicle"	1	0	115	115
"B97"	"D14"	"Viral agents as the cause of diseases classified elsewhere"	"Benign neoplasm of middle ear and respiratory system"	1	2	32	34
"N95"	"O04"	"Menopausal and other perimenopausal disorders"	"Complications following (induced) termination of pregnancy"	1	0	96	96
"B96"	"C91"	"Oth bacterial agents as the cause of diseases classd elswhr"	"Lymphoid leukemia"	1	11	80	91
"G47"	"Q78"	"Sleep disorders"	"Other osteochondrodysplasias"	1	2	52	54
"C16"	"K30"	"Malignant neoplasm of stomach"	"Functional dyspepsia"	1	176	474	650
"E21"	"E05"	"Hyperparathyroidism and other disorders of parathyroid gland"	"Thyrotoxicosis [hyperthyroidism]"	1	407	626	1033
"K74"	"G43"	"Fibrosis and cirrhosis of liver"	"Migraine"	1	6	41	47
"I27"	"M54"	"Other pulmonary heart diseases"	"Dorsalgia"	1	260	730	990
"I51"	"M85"	"Complications and ill-defined descriptions of heart disease"	"Other disorders of bone density and structure"	1	143	338	481
"L98"	"I15"	"Oth disorders of skin, subcu, not elsewhere classified"	"Secondary hypertension"	1	138	304	442
"C79"	"O68"	"Secondary malignant neoplasm of other and unspecified sites"	"Labor and delivery comp by abnlt of fetal acid-base balance"	1	0	67	67
"F02"	"K43"	"Dementia in other diseases classified elsewhere"	"Ventral hernia"	1	4	34	38
"M41"	"Q89"	"Scoliosis"	"Other congenital malformations, not elsewhere classified"	1	5	54	59
"K57"	"K42"	"Diverticular disease of intestine"	"Umbilical hernia"	1	581	1066	1647
"I50"	"G45"	"Heart failure"	"Transient cerebral ischemic attacks and related syndromes"	1	0	10164	10164
"E27"	"H91"	"Other disorders of adrenal gland"	"Other and unspecified hearing loss"	1	100	312	412
"A49"	"I47"	"Bacterial infection of unspecified site"	"Paroxysmal tachycardia"	1	208	1244	1452
"J47"	"J00"	"Bronchiectasis"	"Acute nasopharyngitis [common cold]"	1	7	50	57
"G96"	"K40"	"Other disorders of central nervous system"	"Inguinal hernia"	1	14	955	969
"H33"	"N97"	"Retinal detachments and breaks"	"Female infertility"	1	0	43	43
"N28"	"O03"	"Oth disorders of kidney and ureter, not elsewhere classified"	"Spontaneous abortion"	1	4	58	62
"M05"	"O34"	"Rheumatoid arthritis with rheumatoid factor"	"Maternal care for abnormality of pelvic organs"	1	7	64	71
"K92"	"H02"	"Other diseases of digestive system"	"Other disorders of eyelid"	1	320	628	948
"E23"	"E22"	"Hypofunction and other disorders of the pituitary gland"	"Hyperfunction of pituitary gland"	1	295	457	752
"I10"	"M20"	"Essential (primary) hypertension"	"Acquired deformities of fingers and toes"	1	2573	5599	8172
"N18"	"M54"	"Chronic kidney disease (CKD)"	"Dorsalgia"	1	0	3622	3622
"G91"	"C50"	"Hydrocephalus"	"Malignant neoplasm of breast"	1	24	108	132
"M51"	"N92"	"Thoracic, thoracolum, and lumbosacral intvrt disc disorders"	"Excessive, frequent and irregular menstruation"	1	1652	4274	5926
"E46"	"M23"	"Unspecified protein-calorie malnutrition"	"Internal derangement of knee"	1	0	35	35
"O80"	"K35"	"Encounter for full-term uncomplicated delivery"	"Acute appendicitis"	1	2293	3143	5436
"M23"	"O71"	"Internal derangement of knee"	"Other obstetric trauma"	1	363	785	1148
"H25"	"H65"	"Age-related cataract"	"Nonsuppurative otitis media"	1	277	1055	1332
"C20"	"F10"	"Malignant neoplasm of rectum"	"Alcohol related disorders"	1	225	433	658
"J22"	"D27"	"Unspecified acute lower respiratory infection"	"Benign neoplasm of ovary"	1	0	43	43
"L97"	"I71"	"Non-pressure chronic ulcer of lower limb, NEC"	"Aortic aneurysm and dissection"	1	239	365	604
"J91"	"C44"	"Pleural effusion in conditions classified elsewhere"	"Other and unspecified malignant neoplasm of skin"	1	93	230	323
"I35"	"H61"	"Nonrheumatic aortic valve disorders"	"Other disorders of external ear"	1	74	175	249
"C06"	"I10"	"Malignant neoplasm of other and unspecified parts of mouth"	"Essential (primary) hypertension"	1	272	460	732
"M85"	"G45"	"Other disorders of bone density and structure"	"Transient cerebral ischemic attacks and related syndromes"	1	376	806	1182
"J69"	"D32"	"Pneumonitis due to solids and liquids"	"Benign neoplasm of meninges"	1	6	57	63
"O33"	"O48"	"Maternal care for disproportion"	"Late pregnancy"	1	89	242	331
"L97"	"H10"	"Non-pressure chronic ulcer of lower limb, NEC"	"Conjunctivitis"	1	18	306	324
"C71"	"I83"	"Malignant neoplasm of brain"	"Varicose veins of lower extremities"	1	0	207	207
"H33"	"J34"	"Retinal detachments and breaks"	"Other and unspecified disorders of nose and nasal sinuses"	1	24	140	164
"K70"	"K60"	"Alcoholic liver disease"	"Fissure and fistula of anal and rectal regions"	1	75	216	291
"I46"	"O99"	"Cardiac arrest"	"Oth maternal diseases classd elsw but compl preg/chldbrth"	1	3	65	68
"H60"	"Q21"	"Otitis externa"	"Congenital malformations of cardiac septa"	1	6	71	77
"M81"	"H72"	"Osteoporosis without current pathological fracture"	"Perforation of tympanic membrane"	1	37	186	223
"J96"	"I30"	"Respiratory failure, not elsewhere classified"	"Acute pericarditis"	1	127	338	465
"C34"	"E05"	"Malignant neoplasm of bronchus and lung"	"Thyrotoxicosis [hyperthyroidism]"	1	227	1240	1467
"L97"	"I83"	"Non-pressure chronic ulcer of lower limb, NEC"	"Varicose veins of lower extremities"	1	2642	3335	5977
"J31"	"J00"	"Chronic rhinitis, nasopharyngitis and pharyngitis"	"Acute nasopharyngitis [common cold]"	1	23	100	123
"I50"	"H74"	"Heart failure"	"Other disorders of middle ear mastoid"	1	5	147	152
"C48"	"K40"	"Malignant neoplasm of retroperitoneum and peritoneum"	"Inguinal hernia"	1	3	54	57
"F05"	"D23"	"Delirium due to known physiological condition"	"Other benign neoplasms of skin"	1	0	232	232
"L57"	"M07"	"Skin changes due to chronic expsr to nonionizing radiation"	"Enteropathic arthropathies"	1	18	66	84
"A46"	"M32"	"Erysipelas"	"Systemic lupus erythematosus (SLE)"	1	24	89	113
"O48"	"N97"	"Late pregnancy"	"Female infertility"	1	0	4270	4270
"K81"	"K40"	"Cholecystitis"	"Inguinal hernia"	1	243	546	789
"C78"	"H33"	"Secondary malignant neoplasm of resp and digestive organs"	"Retinal detachments and breaks"	1	6	420	426
"H44"	"H33"	"Disorders of globe"	"Retinal detachments and breaks"	1	835	1617	2452
"I11"	"H33"	"Hypertensive heart disease"	"Retinal detachments and breaks"	1	41	137	178
"C79"	"I77"	"Secondary malignant neoplasm of other and unspecified sites"	"Other disorders of arteries and arterioles"	1	2	36	38
"C95"	"M16"	"Leukemia of unspecified cell type"	"Osteoarthritis of hip"	1	21	75	96
"M16"	"M72"	"Osteoarthritis of hip"	"Fibroblastic disorders"	1	614	958	1572
"K86"	"N80"	"Other diseases of pancreas"	"Endometriosis"	1	2	38	40
"O34"	"O03"	"Maternal care for abnormality of pelvic organs"	"Spontaneous abortion"	1	0	6029	6029
"G44"	"O65"	"Other headache syndromes"	"Obstructed labor due to maternal pelvic abnormality"	1	0	241	241
"K82"	"O80"	"Other diseases of gallbladder"	"Encounter for full-term uncomplicated delivery"	1	0	141	141
"E11"	"G43"	"Type 2 diabetes mellitus"	"Migraine"	1	255	723	978
"J69"	"C43"	"Pneumonitis due to solids and liquids"	"Malignant melanoma of skin"	1	3	73	76
"E22"	"J20"	"Hyperfunction of pituitary gland"	"Acute bronchitis"	1	0	83	83
"J35"	"J45"	"Chronic diseases of tonsils and adenoids"	"Asthma"	1	3996	4821	8817
"I82"	"O23"	"Other venous embolism and thrombosis"	"Infections of genitourinary tract in pregnancy"	1	5	40	45
"C92"	"I83"	"Myeloid leukemia"	"Varicose veins of lower extremities"	1	13	158	171
"C44"	"M31"	"Other and unspecified malignant neoplasm of skin"	"Other necrotizing vasculopathies"	1	102	300	402
"G44"	"M62"	"Other headache syndromes"	"Other disorders of muscle"	1	2260	2924	5184
"O32"	"O20"	"Maternal care for malpresentation of fetus"	"Hemorrhage in early pregnancy"	1	1717	4647	6364
"I33"	"M23"	"Acute and subacute endocarditis"	"Internal derangement of knee"	1	12	111	123
"I82"	"I25"	"Other venous embolism and thrombosis"	"Chronic ischemic heart disease"	1	353	714	1067
"K08"	"J30"	"Other disorders of teeth and supporting structures"	"Vasomotor and allergic rhinitis"	1	26	101	127
"J96"	"J99"	"Respiratory failure, not elsewhere classified"	"Respiratory disorders in diseases classified elsewhere"	1	65	288	353
"L97"	"M53"	"Non-pressure chronic ulcer of lower limb, NEC"	"Other and unspecified dorsopathies, not elsewhere classified"	1	38	164	202
"B96"	"D64"	"Oth bacterial agents as the cause of diseases classd elswhr"	"Other anemias"	1	331	528	859
"H35"	"O99"	"Other retinal disorders"	"Oth maternal diseases classd elsw but compl preg/chldbrth"	1	85	222	307
"F41"	"O42"	"Other anxiety disorders"	"Premature rupture of membranes"	1	120	308	428
"E86"	"G50"	"Volume depletion"	"Disorders of trigeminal nerve"	1	97	478	575
"A41"	"A08"	"Other sepsis"	"Viral and other specified intestinal infections"	1	727	1152	1879
"K41"	"O80"	"Femoral hernia"	"Encounter for full-term uncomplicated delivery"	1	0	255	255
"M47"	"H93"	"Spondylosis"	"Other disorders of ear, not elsewhere classified"	1	727	1041	1768
"D63"	"M10"	"Anemia in chronic diseases classified elsewhere"	"Gout"	1	321	596	917
"N17"	"M20"	"Acute kidney failure"	"Acquired deformities of fingers and toes"	1	16	333	349
"K80"	"J05"	"Cholelithiasis"	"Acute obstructive laryngitis [croup] and epiglottitis"	1	0	53	53
"M33"	"O80"	"Dermatopolymyositis"	"Encounter for full-term uncomplicated delivery"	1	0	45	45
"A49"	"C91"	"Bacterial infection of unspecified site"	"Lymphoid leukemia"	1	111	466	577
"C50"	"N70"	"Malignant neoplasm of breast"	"Salpingitis and oophoritis"	1	0	176	176
"H36"	"N81"	"Retinal disorders in diseases classified elsewhere"	"Female genital prolapse"	1	114	225	339
"D63"	"N92"	"Anemia in chronic diseases classified elsewhere"	"Excessive, frequent and irregular menstruation"	1	0	294	294
"K80"	"O04"	"Cholelithiasis"	"Complications following (induced) termination of pregnancy"	1	0	4302	4302
"N64"	"O70"	"Other disorders of breast"	"Perineal laceration during delivery"	1	1264	3152	4416
"H35"	"M75"	"Other retinal disorders"	"Shoulder lesions"	1	1061	2400	3461
"K75"	"N92"	"Other inflammatory liver diseases"	"Excessive, frequent and irregular menstruation"	1	4	70	74
"M80"	"D37"	"Osteoporosis with current pathological fracture"	"Neoplasm of uncrt behavior of oral cavity and dgstv organs"	1	18	73	91
"E23"	"C43"	"Hypofunction and other disorders of the pituitary gland"	"Malignant melanoma of skin"	1	26	82	108
"N13"	"H40"	"Obstructive and reflux uropathy"	"Glaucoma"	1	119	243	362
"J13"	"O04"	"Pneumonia due to Streptococcus pneumoniae"	"Complications following (induced) termination of pregnancy"	1	10	73	83
"O72"	"L51"	"Postpartum hemorrhage"	"Erythema multiforme"	1	1	54	55
"H57"	"O08"	"Other disorders of eye and adnexa"	"Complications following ectopic and molar pregnancy"	1	8	89	97
"M76"	"D24"	"Enthesopathies, lower limb, excluding foot"	"Benign neoplasm of breast"	1	108	273	381
"M17"	"L73"	"Osteoarthritis of knee"	"Other follicular disorders"	1	86	210	296
"C79"	"H02"	"Secondary malignant neoplasm of other and unspecified sites"	"Other disorders of eyelid"	1	105	575	680
"H44"	"H36"	"Disorders of globe"	"Retinal disorders in diseases classified elsewhere"	1	121	244	365
"N32"	"H83"	"Other disorders of bladder"	"Other diseases of inner ear"	1	46	146	192
"C78"	"M96"	"Secondary malignant neoplasm of resp and digestive organs"	"Intraop and postproc comp and disorders of ms sys, NEC"	1	7	105	112
"M85"	"O75"	"Other disorders of bone density and structure"	"Oth complications of labor and delivery, NEC"	1	0	60	60
"O82"	"O03"	"Encounter for cesarean delivery without indication"	"Spontaneous abortion"	1	0	16033	16033
"I95"	"M65"	"Hypotension"	"Synovitis and tenosynovitis"	1	26	365	391
"G55"	"O04"	"Nerve root and plexus compressions in diseases classd elswhr"	"Complications following (induced) termination of pregnancy"	1	0	37	37
"F05"	"K70"	"Delirium due to known physiological condition"	"Alcoholic liver disease"	1	329	563	892
"L57"	"J34"	"Skin changes due to chronic expsr to nonionizing radiation"	"Other and unspecified disorders of nose and nasal sinuses"	1	14	99	113
"K80"	"H66"	"Cholelithiasis"	"Suppurative and unspecified otitis media"	1	86	443	529
"K59"	"M18"	"Other functional intestinal disorders"	"Osteoarthritis of first carpometacarpal joint"	1	370	590	960
"K70"	"M43"	"Alcoholic liver disease"	"Other deforming dorsopathies"	1	30	121	151
"J15"	"O23"	"Bacterial pneumonia, not elsewhere classified"	"Infections of genitourinary tract in pregnancy"	1	19	159	178
"H52"	"A09"	"Disorders of refraction and accommodation"	"Infectious gastroenteritis and colitis, unspecified"	1	370	1094	1464
"G31"	"G56"	"Oth degenerative diseases of nervous system, NEC"	"Mononeuropathies of upper limb"	1	15	178	193
"O75"	"H65"	"Oth complications of labor and delivery, NEC"	"Nonsuppurative otitis media"	1	1	65	66
"K80"	"O75"	"Cholelithiasis"	"Oth complications of labor and delivery, NEC"	1	280	1332	1612
"N18"	"G43"	"Chronic kidney disease (CKD)"	"Migraine"	1	18	254	272
"M16"	"H10"	"Osteoarthritis of hip"	"Conjunctivitis"	1	147	774	921
"K44"	"H65"	"Diaphragmatic hernia"	"Nonsuppurative otitis media"	1	99	251	350
"J15"	"L95"	"Bacterial pneumonia, not elsewhere classified"	"Vasculitis limited to skin, not elsewhere classified"	1	93	188	281
"M06"	"O23"	"Other rheumatoid arthritis"	"Infections of genitourinary tract in pregnancy"	1	18	70	88
"M79"	"H10"	"Oth and unsp soft tissue disorders, not elsewhere classified"	"Conjunctivitis"	1	1230	3224	4454
"E04"	"J36"	"Other nontoxic goiter"	"Peritonsillar abscess"	1	23	127	150
"O72"	"K40"	"Postpartum hemorrhage"	"Inguinal hernia"	1	51	503	554
"L08"	"Q17"	"Other local infections of skin and subcutaneous tissue"	"Other congenital malformations of ear"	1	6	105	111
"C15"	"H81"	"Malignant neoplasm of esophagus"	"Disorders of vestibular function"	1	5	108	113
"N84"	"F10"	"Polyp of female genital tract"	"Alcohol related disorders"	1	113	260	373
"M24"	"J35"	"Other specific joint derangements"	"Chronic diseases of tonsils and adenoids"	1	115	618	733
"D11"	"D25"	"Benign neoplasm of major salivary glands"	"Leiomyoma of uterus"	1	36	95	131
"J96"	"K59"	"Respiratory failure, not elsewhere classified"	"Other functional intestinal disorders"	1	4215	6307	10522
"G21"	"M47"	"Secondary parkinsonism"	"Spondylosis"	1	34	103	137
"K05"	"N83"	"Gingivitis and periodontal diseases"	"Noninflammatory disord of ovary, fallop and broad ligament"	1	55	143	198
"F19"	"J35"	"Other psychoactive substance related disorders"	"Chronic diseases of tonsils and adenoids"	1	1	44	45
"H91"	"O64"	"Other and unspecified hearing loss"	"Obstructed labor due to malposition and malpresent of fetus"	1	1	135	136
"N81"	"H80"	"Female genital prolapse"	"Otosclerosis"	1	38	232	270
"I21"	"M51"	"Acute myocardial infarction"	"Thoracic, thoracolum, and lumbosacral intvrt disc disorders"	1	1209	3750	4959
"I46"	"N43"	"Cardiac arrest"	"Hydrocele and spermatocele"	1	0	270	270
"C15"	"M48"	"Malignant neoplasm of esophagus"	"Other spondylopathies"	1	27	206	233
"N39"	"N99"	"Other disorders of urinary system"	"Intraop and postproc comp and disorders of GU sys, NEC"	1	926	1256	2182
"D63"	"K41"	"Anemia in chronic diseases classified elsewhere"	"Femoral hernia"	1	5	61	66
"K56"	"O02"	"Paralytic ileus and intestinal obstruction without hernia"	"Other abnormal products of conception"	1	3	190	193
"G25"	"F10"	"Other extrapyramidal and movement disorders"	"Alcohol related disorders"	1	135	293	428
"C34"	"K60"	"Malignant neoplasm of bronchus and lung"	"Fissure and fistula of anal and rectal regions"	1	6	306	312
"I27"	"N60"	"Other pulmonary heart diseases"	"Benign mammary dysplasia"	1	1	42	43
"O92"	"J30"	"Oth disord of brst/lactatn assoc w pregnancy and the puerp"	"Vasomotor and allergic rhinitis"	1	33	128	161
"O89"	"N97"	"Complications of anesthesia during the puerperium"	"Female infertility"	1	25	134	159
"F03"	"I67"	"Unspecified dementia"	"Other cerebrovascular diseases"	1	514	794	1308
"O40"	"O20"	"Polyhydramnios"	"Hemorrhage in early pregnancy"	1	199	927	1126
"G56"	"Q17"	"Mononeuropathies of upper limb"	"Other congenital malformations of ear"	1	0	64	64
"I46"	"N95"	"Cardiac arrest"	"Menopausal and other perimenopausal disorders"	1	0	284	284
"E13"	"I73"	"Other specified diabetes mellitus"	"Other peripheral vascular diseases"	1	145	251	396
"D32"	"M65"	"Benign neoplasm of meninges"	"Synovitis and tenosynovitis"	1	36	108	144
"D68"	"O04"	"Other coagulation defects"	"Complications following (induced) termination of pregnancy"	1	57	612	669
"N95"	"K80"	"Menopausal and other perimenopausal disorders"	"Cholelithiasis"	1	808	1378	2186
"L98"	"E66"	"Oth disorders of skin, subcu, not elsewhere classified"	"Overweight and obesity"	1	731	1329	2060
"D62"	"H02"	"Acute posthemorrhagic anemia"	"Other disorders of eyelid"	1	110	247	357
"J16"	"M16"	"Pneumonia due to oth infectious organisms, NEC"	"Osteoarthritis of hip"	1	25	109	134
"M18"	"N20"	"Osteoarthritis of first carpometacarpal joint"	"Calculus of kidney and ureter"	1	75	226	301
"M25"	"H52"	"Other joint disorder, not elsewhere classified"	"Disorders of refraction and accommodation"	1	374	556	930
"N30"	"M67"	"Cystitis"	"Other disorders of synovium and tendon"	1	873	1419	2292
"M80"	"N62"	"Osteoporosis with current pathological fracture"	"Hypertrophy of breast"	1	6	169	175
"J38"	"J45"	"Diseases of vocal cords and larynx, not elsewhere classified"	"Asthma"	1	713	924	1637
"J18"	"E04"	"Pneumonia, unspecified organism"	"Other nontoxic goiter"	1	946	2835	3781
"M50"	"H65"	"Cervical disc disorders"	"Nonsuppurative otitis media"	1	72	151	223
"E11"	"H72"	"Type 2 diabetes mellitus"	"Perforation of tympanic membrane"	1	140	238	378
"M80"	"H83"	"Osteoporosis with current pathological fracture"	"Other diseases of inner ear"	1	0	321	321
"I25"	"M67"	"Chronic ischemic heart disease"	"Other disorders of synovium and tendon"	1	487	1155	1642
"I46"	"M75"	"Cardiac arrest"	"Shoulder lesions"	1	1	856	857
"J18"	"N45"	"Pneumonia, unspecified organism"	"Orchitis and epididymitis"	1	823	1508	2331
"I42"	"N94"	"Cardiomyopathy"	"Pain and oth cond assoc w fem gntl org and menstrual cycle"	1	1	49	50
"E64"	"K42"	"Sequelae of malnutrition and other nutritional deficiencies"	"Umbilical hernia"	1	30	96	126
"J90"	"H02"	"Pleural effusion, not elsewhere classified"	"Other disorders of eyelid"	1	78	300	378
"I26"	"M20"	"Pulmonary embolism"	"Acquired deformities of fingers and toes"	1	86	626	712
"N92"	"O32"	"Excessive, frequent and irregular menstruation"	"Maternal care for malpresentation of fetus"	1	0	1641	1641
"H81"	"O42"	"Disorders of vestibular function"	"Premature rupture of membranes"	1	48	193	241
"N87"	"O23"	"Dysplasia of cervix uteri"	"Infections of genitourinary tract in pregnancy"	1	306	466	772
"M79"	"O65"	"Oth and unsp soft tissue disorders, not elsewhere classified"	"Obstructed labor due to maternal pelvic abnormality"	1	0	669	669
"J33"	"O20"	"Nasal polyp"	"Hemorrhage in early pregnancy"	1	11	49	60
"C25"	"I44"	"Malignant neoplasm of pancreas"	"Atrioventricular and left bundle-branch block"	1	28	157	185
"J18"	"H04"	"Pneumonia, unspecified organism"	"Disorders of lacrimal system"	1	317	753	1070
"K83"	"M43"	"Other diseases of biliary tract"	"Other deforming dorsopathies"	1	24	101	125
"I35"	"N87"	"Nonrheumatic aortic valve disorders"	"Dysplasia of cervix uteri"	1	0	108	108
"D18"	"O80"	"Hemangioma and lymphangioma, any site"	"Encounter for full-term uncomplicated delivery"	1	81	437	518
"I95"	"N92"	"Hypotension"	"Excessive, frequent and irregular menstruation"	1	16	307	323
"L40"	"O70"	"Psoriasis"	"Perineal laceration during delivery"	1	150	417	567
"M16"	"M67"	"Osteoarthritis of hip"	"Other disorders of synovium and tendon"	1	589	1300	1889
"N39"	"C53"	"Other disorders of urinary system"	"Malignant neoplasm of cervix uteri"	1	106	663	769
"C67"	"I20"	"Malignant neoplasm of bladder"	"Angina pectoris"	1	332	1087	1419
"E86"	"N92"	"Volume depletion"	"Excessive, frequent and irregular menstruation"	1	0	926	926
"H04"	"O62"	"Disorders of lacrimal system"	"Abnormalities of forces of labor"	1	8	141	149
"M87"	"C50"	"Osteonecrosis"	"Malignant neoplasm of breast"	1	7	198	205
"O68"	"G40"	"Labor and delivery comp by abnlt of fetal acid-base balance"	"Epilepsy and recurrent seizures"	1	207	674	881
"N13"	"M71"	"Obstructive and reflux uropathy"	"Other bursopathies"	1	25	95	120
"N30"	"H36"	"Cystitis"	"Retinal disorders in diseases classified elsewhere"	1	865	1805	2670
"C16"	"M18"	"Malignant neoplasm of stomach"	"Osteoarthritis of first carpometacarpal joint"	1	0	39	39
"H90"	"O42"	"Conductive and sensorineural hearing loss"	"Premature rupture of membranes"	1	73	153	226
"J44"	"O99"	"Other chronic obstructive pulmonary disease"	"Oth maternal diseases classd elsw but compl preg/chldbrth"	1	40	249	289
"O72"	"K44"	"Postpartum hemorrhage"	"Diaphragmatic hernia"	1	261	504	765
"K65"	"O00"	"Peritonitis"	"Ectopic pregnancy"	1	4	41	45
"D72"	"O03"	"Other disorders of white blood cells"	"Spontaneous abortion"	1	0	29	29
"N30"	"O48"	"Cystitis"	"Late pregnancy"	1	217	531	748
"M75"	"H72"	"Shoulder lesions"	"Perforation of tympanic membrane"	1	126	370	496
"J96"	"L03"	"Respiratory failure, not elsewhere classified"	"Cellulitis and acute lymphangitis"	1	27	1039	1066
"N30"	"Q17"	"Cystitis"	"Other congenital malformations of ear"	1	39	205	244
"N39"	"Q82"	"Other disorders of urinary system"	"Other congenital malformations of skin"	1	56	204	260
"C25"	"N20"	"Malignant neoplasm of pancreas"	"Calculus of kidney and ureter"	1	9	249	258
"N89"	"I83"	"Other noninflammatory disorders of vagina"	"Varicose veins of lower extremities"	1	67	181	248
"I97"	"K05"	"Intraop and postproc comp and disorders of circ sys, NEC"	"Gingivitis and periodontal diseases"	1	32	100	132
"G96"	"O46"	"Other disorders of central nervous system"	"Antepartum hemorrhage, not elsewhere classified"	1	1	62	63
"N25"	"C67"	"Disorders resulting from impaired renal tubular function"	"Malignant neoplasm of bladder"	1	10	48	58
"M50"	"D25"	"Cervical disc disorders"	"Leiomyoma of uterus"	1	351	755	1106
"K57"	"J36"	"Diverticular disease of intestine"	"Peritonsillar abscess"	1	0	150	150
"G24"	"K35"	"Dystonia"	"Acute appendicitis"	1	17	71	88
"D80"	"O80"	"Immunodeficiency with predominantly antibody defects"	"Encounter for full-term uncomplicated delivery"	1	5	64	69
"I50"	"K61"	"Heart failure"	"Abscess of anal and rectal regions"	1	206	662	868
"M17"	"M62"	"Osteoarthritis of knee"	"Other disorders of muscle"	1	0	6173	6173
"E87"	"A69"	"Other disorders of fluid, electrolyte and acid-base balance"	"Other spirochetal infections"	1	5	86	91
"O47"	"H65"	"False labor"	"Nonsuppurative otitis media"	1	5	136	141
"J15"	"H72"	"Bacterial pneumonia, not elsewhere classified"	"Perforation of tympanic membrane"	1	41	225	266
"O69"	"N97"	"Labor and delivery complicated by umbilical cord comp"	"Female infertility"	1	49	274	323
"H52"	"N97"	"Disorders of refraction and accommodation"	"Female infertility"	1	180	393	573
"H26"	"K44"	"Other cataract"	"Diaphragmatic hernia"	1	684	1110	1794
"C64"	"M71"	"Malignant neoplasm of kidney, except renal pelvis"	"Other bursopathies"	1	7	50	57
"K22"	"J38"	"Other diseases of esophagus"	"Diseases of vocal cords and larynx, not elsewhere classified"	1	212	337	549
"O30"	"N70"	"Multiple gestation"	"Salpingitis and oophoritis"	1	121	535	656
"J81"	"I10"	"Pulmonary edema"	"Essential (primary) hypertension"	1	0	7879	7879
"C24"	"K57"	"Malignant neoplasm of other and unsp parts of biliary tract"	"Diverticular disease of intestine"	1	23	190	213
"J93"	"M20"	"Pneumothorax and air leak"	"Acquired deformities of fingers and toes"	1	52	152	204
"O44"	"N80"	"Placenta previa"	"Endometriosis"	1	104	211	315
"J15"	"I83"	"Bacterial pneumonia, not elsewhere classified"	"Varicose veins of lower extremities"	1	0	2548	2548
"E16"	"N95"	"Other disorders of pancreatic internal secretion"	"Menopausal and other perimenopausal disorders"	1	57	160	217
"C78"	"Q66"	"Secondary malignant neoplasm of resp and digestive organs"	"Congenital deformities of feet"	1	0	42	42
"E66"	"M20"	"Overweight and obesity"	"Acquired deformities of fingers and toes"	1	1039	1681	2720
"G82"	"M23"	"Paraplegia (paraparesis) and quadriplegia (quadriparesis)"	"Internal derangement of knee"	1	72	191	263
"M06"	"N94"	"Other rheumatoid arthritis"	"Pain and oth cond assoc w fem gntl org and menstrual cycle"	1	48	172	220
"O30"	"N97"	"Multiple gestation"	"Female infertility"	1	0	11092	11092
"Q27"	"D18"	"Other congenital malformations of peripheral vascular system"	"Hemangioma and lymphangioma, any site"	1	171	497	668
"A46"	"N95"	"Erysipelas"	"Menopausal and other perimenopausal disorders"	1	239	540	779
"G45"	"K35"	"Transient cerebral ischemic attacks and related syndromes"	"Acute appendicitis"	1	166	488	654
"E04"	"D24"	"Other nontoxic goiter"	"Benign neoplasm of breast"	1	266	520	786
"K29"	"L03"	"Gastritis and duodenitis"	"Cellulitis and acute lymphangitis"	1	403	644	1047
"F05"	"C71"	"Delirium due to known physiological condition"	"Malignant neoplasm of brain"	1	92	223	315
"C90"	"I25"	"Multiple myeloma and malignant plasma cell neoplasms"	"Chronic ischemic heart disease"	1	228	490	718
"J10"	"J45"	"Influenza due to other identified influenza virus"	"Asthma"	1	134	482	616
"L89"	"K44"	"Pressure ulcer"	"Diaphragmatic hernia"	1	65	415	480
"M60"	"O03"	"Myositis"	"Spontaneous abortion"	1	0	25	25
"M53"	"O71"	"Other and unspecified dorsopathies, not elsewhere classified"	"Other obstetric trauma"	1	10	233	243
"E83"	"O80"	"Disorders of mineral metabolism"	"Encounter for full-term uncomplicated delivery"	1	0	185	185
"H57"	"E16"	"Other disorders of eye and adnexa"	"Other disorders of pancreatic internal secretion"	1	35	177	212
"N39"	"G35"	"Other disorders of urinary system"	"Multiple sclerosis"	1	0	1235	1235
"C48"	"I25"	"Malignant neoplasm of retroperitoneum and peritoneum"	"Chronic ischemic heart disease"	1	24	81	105
"K74"	"J34"	"Fibrosis and cirrhosis of liver"	"Other and unspecified disorders of nose and nasal sinuses"	1	0	52	52
"I62"	"J45"	"Other and unspecified nontraumatic intracranial hemorrhage"	"Asthma"	1	9	60	69
"C64"	"M67"	"Malignant neoplasm of kidney, except renal pelvis"	"Other disorders of synovium and tendon"	1	16	92	108
"C18"	"N40"	"Malignant neoplasm of colon"	"Benign prostatic hyperplasia"	1	788	2009	2797
"E86"	"N45"	"Volume depletion"	"Orchitis and epididymitis"	1	204	814	1018
"H90"	"N95"	"Conductive and sensorineural hearing loss"	"Menopausal and other perimenopausal disorders"	1	306	461	767
"C83"	"O04"	"Non-follicular lymphoma"	"Complications following (induced) termination of pregnancy"	1	0	26	26
"J34"	"Q37"	"Other and unspecified disorders of nose and nasal sinuses"	"Cleft palate with cleft lip"	1	23	92	115
"E03"	"D24"	"Other hypothyroidism"	"Benign neoplasm of breast"	1	64	609	673
"N95"	"F10"	"Menopausal and other perimenopausal disorders"	"Alcohol related disorders"	1	263	429	692
"I81"	"I20"	"Portal vein thrombosis"	"Angina pectoris"	1	19	131	150
"N28"	"L08"	"Oth disorders of kidney and ureter, not elsewhere classified"	"Other local infections of skin and subcutaneous tissue"	1	109	237	346
"K90"	"A08"	"Intestinal malabsorption"	"Viral and other specified intestinal infections"	1	54	158	212
"A41"	"C90"	"Other sepsis"	"Multiple myeloma and malignant plasma cell neoplasms"	1	427	1781	2208
"H57"	"G43"	"Other disorders of eye and adnexa"	"Migraine"	1	340	512	852
"C43"	"M23"	"Malignant melanoma of skin"	"Internal derangement of knee"	1	271	673	944
"N18"	"N70"	"Chronic kidney disease (CKD)"	"Salpingitis and oophoritis"	1	0	60	60
"J03"	"Q68"	"Acute tonsillitis"	"Other congenital musculoskeletal deformities"	1	32	161	193
"C56"	"M62"	"Malignant neoplasm of ovary"	"Other disorders of muscle"	1	46	220	266
"I35"	"C50"	"Nonrheumatic aortic valve disorders"	"Malignant neoplasm of breast"	1	178	1126	1304
"C15"	"F10"	"Malignant neoplasm of esophagus"	"Alcohol related disorders"	1	51	671	722
"I74"	"F10"	"Arterial embolism and thrombosis"	"Alcohol related disorders"	1	168	476	644
"N19"	"M19"	"Unspecified kidney failure"	"Other and unspecified osteoarthritis"	1	381	672	1053
"I51"	"N43"	"Complications and ill-defined descriptions of heart disease"	"Hydrocele and spermatocele"	1	32	123	155
"K59"	"N75"	"Other functional intestinal disorders"	"Diseases of Bartholin's gland"	1	64	245	309
"O70"	"O04"	"Perineal laceration during delivery"	"Complications following (induced) termination of pregnancy"	1	0	20014	20014
"N47"	"Q66"	"Disorders of prepuce"	"Congenital deformities of feet"	1	123	289	412
"A49"	"H91"	"Bacterial infection of unspecified site"	"Other and unspecified hearing loss"	1	0	3523	3523
"E87"	"K05"	"Other disorders of fluid, electrolyte and acid-base balance"	"Gingivitis and periodontal diseases"	1	288	1001	1289
"O99"	"L60"	"Oth maternal diseases classd elsw but compl preg/chldbrth"	"Nail disorders"	1	77	310	387
"C71"	"D25"	"Malignant neoplasm of brain"	"Leiomyoma of uterus"	1	0	98	98
"L91"	"C50"	"Hypertrophic disorders of skin"	"Malignant neoplasm of breast"	1	36	103	139
"I20"	"C62"	"Angina pectoris"	"Malignant neoplasm of testis"	1	13	129	142
"M06"	"O68"	"Other rheumatoid arthritis"	"Labor and delivery comp by abnlt of fetal acid-base balance"	1	43	259	302
"F41"	"J90"	"Other anxiety disorders"	"Pleural effusion, not elsewhere classified"	1	292	775	1067
"O63"	"F10"	"Long labor"	"Alcohol related disorders"	1	0	299	299
"C43"	"I83"	"Malignant melanoma of skin"	"Varicose veins of lower extremities"	1	193	427	620
"M81"	"D17"	"Osteoporosis without current pathological fracture"	"Benign lipomatous neoplasm"	1	214	906	1120
"M85"	"D86"	"Other disorders of bone density and structure"	"Sarcoidosis"	1	84	498	582
"F03"	"E03"	"Unspecified dementia"	"Other hypothyroidism"	1	1202	1932	3134
"J22"	"E10"	"Unspecified acute lower respiratory infection"	"Type 1 diabetes mellitus"	1	142	547	689
"G64"	"K91"	"Other disorders of peripheral nervous system"	"Intraop and postproc comp and disorders of dgstv sys, NEC"	1	0	35	35
"O04"	"L20"	"Complications following (induced) termination of pregnancy"	"Atopic dermatitis"	1	185	344	529
"L40"	"M02"	"Psoriasis"	"Postinfective and reactive arthropathies"	1	137	252	389
"I51"	"M17"	"Complications and ill-defined descriptions of heart disease"	"Osteoarthritis of knee"	1	197	974	1171
"I35"	"M43"	"Nonrheumatic aortic valve disorders"	"Other deforming dorsopathies"	1	74	445	519
"K02"	"M54"	"Dental caries"	"Dorsalgia"	1	378	699	1077
"M23"	"O20"	"Internal derangement of knee"	"Hemorrhage in early pregnancy"	1	441	1315	1756
"G95"	"E05"	"Other and unspecified diseases of spinal cord"	"Thyrotoxicosis [hyperthyroidism]"	1	28	161	189
"L97"	"H28"	"Non-pressure chronic ulcer of lower limb, NEC"	"Cataract in diseases classified elsewhere"	1	33	96	129
"E87"	"Q44"	"Other disorders of fluid, electrolyte and acid-base balance"	"Congenital malform of gallbladder, bile ducts and liver"	1	4	36	40
"Q51"	"O20"	"Congenital malformations of uterus and cervix"	"Hemorrhage in early pregnancy"	1	208	331	539
"B02"	"H10"	"Zoster [herpes zoster]"	"Conjunctivitis"	1	163	294	457
"D12"	"J30"	"Benign neoplasm of colon, rectum, anus and anal canal"	"Vasomotor and allergic rhinitis"	1	9	455	464
"E04"	"O42"	"Other nontoxic goiter"	"Premature rupture of membranes"	1	72	563	635
"M19"	"N97"	"Other and unspecified osteoarthritis"	"Female infertility"	1	0	289	289
"M35"	"H83"	"Other systemic involvement of connective tissue"	"Other diseases of inner ear"	1	45	356	401
"G30"	"D64"	"Alzheimer's disease"	"Other anemias"	1	527	955	1482
"E86"	"D03"	"Volume depletion"	"Melanoma in situ"	1	39	156	195
"I95"	"H33"	"Hypotension"	"Retinal detachments and breaks"	1	19	199	218
"K57"	"J38"	"Diverticular disease of intestine"	"Diseases of vocal cords and larynx, not elsewhere classified"	1	181	545	726
"J93"	"K40"	"Pneumothorax and air leak"	"Inguinal hernia"	1	152	612	764
"E34"	"M16"	"Other endocrine disorders"	"Osteoarthritis of hip"	1	51	147	198
"K72"	"M77"	"Hepatic failure, not elsewhere classified"	"Other enthesopathies"	1	3	75	78
"K05"	"O04"	"Gingivitis and periodontal diseases"	"Complications following (induced) termination of pregnancy"	1	0	224	224
"G56"	"O75"	"Mononeuropathies of upper limb"	"Oth complications of labor and delivery, NEC"	1	109	481	590
"C83"	"E78"	"Non-follicular lymphoma"	"Disorders of lipoprotein metabolism and other lipidemias"	1	173	466	639
"G95"	"I71"	"Other and unspecified diseases of spinal cord"	"Aortic aneurysm and dissection"	1	91	174	265
"L97"	"I74"	"Non-pressure chronic ulcer of lower limb, NEC"	"Arterial embolism and thrombosis"	1	268	504	772
"A46"	"M06"	"Erysipelas"	"Other rheumatoid arthritis"	1	353	695	1048
"K76"	"N43"	"Other diseases of liver"	"Hydrocele and spermatocele"	1	43	107	150
"I83"	"O63"	"Varicose veins of lower extremities"	"Long labor"	1	0	625	625
"M23"	"Q82"	"Internal derangement of knee"	"Other congenital malformations of skin"	1	147	250	397
"D25"	"N71"	"Leiomyoma of uterus"	"Inflammatory disease of uterus, except cervix"	1	286	587	873
"E68"	"E66"	"Sequelae of hyperalimentation"	"Overweight and obesity"	1	0	4479	4479
"C25"	"I69"	"Malignant neoplasm of pancreas"	"Sequelae of cerebrovascular disease"	1	153	490	643
"K60"	"O65"	"Fissure and fistula of anal and rectal regions"	"Obstructed labor due to maternal pelvic abnormality"	1	4	253	257
"N18"	"H80"	"Chronic kidney disease (CKD)"	"Otosclerosis"	1	0	134	134
"M79"	"O12"	"Oth and unsp soft tissue disorders, not elsewhere classified"	"Gestational edema and proteinuria without hypertension"	1	61	171	232
"K65"	"D17"	"Peritonitis"	"Benign lipomatous neoplasm"	1	68	149	217
"K57"	"M72"	"Diverticular disease of intestine"	"Fibroblastic disorders"	1	398	1377	1775
"K22"	"H66"	"Other diseases of esophagus"	"Suppurative and unspecified otitis media"	1	15	126	141
"K04"	"H83"	"Diseases of pulp and periapical tissues"	"Other diseases of inner ear"	1	41	253	294
"E86"	"I83"	"Volume depletion"	"Varicose veins of lower extremities"	1	0	4110	4110
"J69"	"K92"	"Pneumonitis due to solids and liquids"	"Other diseases of digestive system"	1	535	948	1483
"D62"	"N40"	"Acute posthemorrhagic anemia"	"Benign prostatic hyperplasia"	1	225	1077	1302
"M76"	"O32"	"Enthesopathies, lower limb, excluding foot"	"Maternal care for malpresentation of fetus"	1	39	110	149
"L57"	"O70"	"Skin changes due to chronic expsr to nonionizing radiation"	"Perineal laceration during delivery"	1	3	149	152
"H65"	"Q22"	"Nonsuppurative otitis media"	"Congenital malformations of pulmonary and tricuspid valves"	1	121	249	370
"F33"	"H43"	"Major depressive disorder, recurrent"	"Disorders of vitreous body"	1	41	224	265
"K31"	"C15"	"Other diseases of stomach and duodenum"	"Malignant neoplasm of esophagus"	1	86	211	297
"I63"	"M16"	"Cerebral infarction"	"Osteoarthritis of hip"	1	0	5545	5545
"K04"	"N40"	"Diseases of pulp and periapical tissues"	"Benign prostatic hyperplasia"	1	254	488	742
"I46"	"Q61"	"Cardiac arrest"	"Cystic kidney disease"	1	23	108	131
"D17"	"F10"	"Benign lipomatous neoplasm"	"Alcohol related disorders"	1	327	741	1068
"D69"	"H10"	"Purpura and other hemorrhagic conditions"	"Conjunctivitis"	1	87	202	289
"J22"	"M24"	"Unspecified acute lower respiratory infection"	"Other specific joint derangements"	1	5	40	45
"M18"	"M50"	"Osteoarthritis of first carpometacarpal joint"	"Cervical disc disorders"	1	163	418	581
"A49"	"O28"	"Bacterial infection of unspecified site"	"Abnormal findings on antenatal screening of mother"	1	8	51	59
"L90"	"O28"	"Atrophic disorders of skin"	"Abnormal findings on antenatal screening of mother"	1	29	86	115
"M81"	"O68"	"Osteoporosis without current pathological fracture"	"Labor and delivery comp by abnlt of fetal acid-base balance"	1	0	130	130
"D12"	"O75"	"Benign neoplasm of colon, rectum, anus and anal canal"	"Oth complications of labor and delivery, NEC"	1	0	81	81
"H91"	"Q85"	"Other and unspecified hearing loss"	"Phakomatoses, not elsewhere classified"	1	33	96	129
"F33"	"D17"	"Major depressive disorder, recurrent"	"Benign lipomatous neoplasm"	1	81	262	343
"O99"	"K35"	"Oth maternal diseases classd elsw but compl preg/chldbrth"	"Acute appendicitis"	1	0	2923	2923
"I74"	"M05"	"Arterial embolism and thrombosis"	"Rheumatoid arthritis with rheumatoid factor"	1	53	122	175
"G21"	"F10"	"Secondary parkinsonism"	"Alcohol related disorders"	1	28	118	146
"E64"	"M17"	"Sequelae of malnutrition and other nutritional deficiencies"	"Osteoarthritis of knee"	1	32	458	490
"K52"	"H90"	"Other and unsp noninfective gastroenteritis and colitis"	"Conductive and sensorineural hearing loss"	1	324	755	1079
"C71"	"H33"	"Malignant neoplasm of brain"	"Retinal detachments and breaks"	1	4	77	81
"C44"	"H40"	"Other and unspecified malignant neoplasm of skin"	"Glaucoma"	1	341	769	1110
"G25"	"H91"	"Other extrapyramidal and movement disorders"	"Other and unspecified hearing loss"	1	191	589	780
"K52"	"J35"	"Other and unsp noninfective gastroenteritis and colitis"	"Chronic diseases of tonsils and adenoids"	1	265	676	941
"O72"	"L05"	"Postpartum hemorrhage"	"Pilonidal cyst and sinus"	1	0	905	905
"E55"	"M67"	"Vitamin D deficiency"	"Other disorders of synovium and tendon"	1	40	160	200
"J96"	"M71"	"Respiratory failure, not elsewhere classified"	"Other bursopathies"	1	0	430	430
"C25"	"N47"	"Malignant neoplasm of pancreas"	"Disorders of prepuce"	1	6	68	74
"E78"	"N88"	"Disorders of lipoprotein metabolism and other lipidemias"	"Other noninflammatory disorders of cervix uteri"	1	0	92	92
"H90"	"O14"	"Conductive and sensorineural hearing loss"	"Pre-eclampsia"	1	28	82	110
"C83"	"K35"	"Non-follicular lymphoma"	"Acute appendicitis"	1	14	88	102
"I27"	"C50"	"Other pulmonary heart diseases"	"Malignant neoplasm of breast"	1	52	216	268
"J70"	"C50"	"Respiratory conditions due to other external agents"	"Malignant neoplasm of breast"	1	20	189	209
"C06"	"I20"	"Malignant neoplasm of other and unspecified parts of mouth"	"Angina pectoris"	1	21	147	168
"E78"	"O10"	"Disorders of lipoprotein metabolism and other lipidemias"	"Pre-existing hypertension compl preg/chldbrth"	1	12	98	110
"M19"	"O82"	"Other and unspecified osteoarthritis"	"Encounter for cesarean delivery without indication"	1	0	423	423
"I61"	"J44"	"Nontraumatic intracerebral hemorrhage"	"Other chronic obstructive pulmonary disease"	1	1113	1571	2684
"E83"	"I48"	"Disorders of mineral metabolism"	"Atrial fibrillation and flutter"	1	837	1515	2352
"I49"	"K43"	"Other cardiac arrhythmias"	"Ventral hernia"	1	296	504	800
"C77"	"M79"	"Secondary and unspecified malignant neoplasm of lymph nodes"	"Oth and unsp soft tissue disorders, not elsewhere classified"	1	223	824	1047
"H35"	"O32"	"Other retinal disorders"	"Maternal care for malpresentation of fetus"	1	6	46	52
"K80"	"K00"	"Cholelithiasis"	"Disorders of tooth development and eruption"	1	10	139	149
"K75"	"M54"	"Other inflammatory liver diseases"	"Dorsalgia"	1	65	186	251
"K64"	"O99"	"Hemorrhoids and perianal venous thrombosis"	"Oth maternal diseases classd elsw but compl preg/chldbrth"	1	0	1879	1879
"N39"	"K12"	"Other disorders of urinary system"	"Stomatitis and related lesions"	1	173	313	486
"I50"	"D36"	"Heart failure"	"Benign neoplasm of other and unspecified sites"	1	28	111	139
"I82"	"I10"	"Other venous embolism and thrombosis"	"Essential (primary) hypertension"	1	1108	1888	2996
"J18"	"M19"	"Pneumonia, unspecified organism"	"Other and unspecified osteoarthritis"	1	3435	5414	8849
"N39"	"M48"	"Other disorders of urinary system"	"Other spondylopathies"	1	2509	4483	6992
"M46"	"O72"	"Other inflammatory spondylopathies"	"Postpartum hemorrhage"	1	166	289	455
"I97"	"H91"	"Intraop and postproc comp and disorders of circ sys, NEC"	"Other and unspecified hearing loss"	1	79	265	344
"J81"	"L03"	"Pulmonary edema"	"Cellulitis and acute lymphangitis"	1	25	161	186
"J98"	"I21"	"Other respiratory disorders"	"Acute myocardial infarction"	1	591	1031	1622
"C25"	"N63"	"Malignant neoplasm of pancreas"	"Unspecified lump in breast"	1	0	82	82
"C94"	"I10"	"Other leukemias of specified cell type"	"Essential (primary) hypertension"	1	44	125	169
"F43"	"A09"	"Reaction to severe stress, and adjustment disorders"	"Infectious gastroenteritis and colitis, unspecified"	1	253	776	1029
"K76"	"K26"	"Other diseases of liver"	"Duodenal ulcer"	1	423	679	1102
"M75"	"N62"	"Shoulder lesions"	"Hypertrophy of breast"	1	543	1251	1794
"C77"	"N71"	"Secondary and unspecified malignant neoplasm of lymph nodes"	"Inflammatory disease of uterus, except cervix"	1	2	32	34
"F32"	"N87"	"Depressive episode"	"Dysplasia of cervix uteri"	1	85	268	353
"L08"	"O03"	"Other local infections of skin and subcutaneous tissue"	"Spontaneous abortion"	1	44	372	416
"I50"	"O80"	"Heart failure"	"Encounter for full-term uncomplicated delivery"	1	0	147	147
"M99"	"C50"	"Biomechanical lesions, not elsewhere classified"	"Malignant neoplasm of breast"	1	77	175	252
"D68"	"I80"	"Other coagulation defects"	"Phlebitis and thrombophlebitis"	1	0	5955	5955
"M99"	"O03"	"Biomechanical lesions, not elsewhere classified"	"Spontaneous abortion"	1	0	141	141
"G43"	"H72"	"Migraine"	"Perforation of tympanic membrane"	1	46	120	166
"I51"	"I21"	"Complications and ill-defined descriptions of heart disease"	"Acute myocardial infarction"	1	829	2626	3455
"C79"	"L02"	"Secondary malignant neoplasm of other and unspecified sites"	"Cutaneous abscess, furuncle and carbuncle"	1	108	816	924
"K22"	"M62"	"Other diseases of esophagus"	"Other disorders of muscle"	1	197	795	992
"G20"	"K35"	"Parkinson's disease"	"Acute appendicitis"	1	26	104	130
"O08"	"O68"	"Complications following ectopic and molar pregnancy"	"Labor and delivery comp by abnlt of fetal acid-base balance"	1	1168	1617	2785
"I38"	"I48"	"Endocarditis, valve unspecified"	"Atrial fibrillation and flutter"	1	452	735	1187
"H25"	"M23"	"Age-related cataract"	"Internal derangement of knee"	1	0	7615	7615
"A46"	"H80"	"Erysipelas"	"Otosclerosis"	1	0	165	165
"I46"	"C54"	"Cardiac arrest"	"Malignant neoplasm of corpus uteri"	1	0	107	107
"H54"	"K30"	"Blindness and low vision"	"Functional dyspepsia"	1	149	311	460
"D46"	"M17"	"Myelodysplastic syndromes"	"Osteoarthritis of knee"	1	8	355	363
"K65"	"N87"	"Peritonitis"	"Dysplasia of cervix uteri"	1	25	102	127
"C78"	"I34"	"Secondary malignant neoplasm of resp and digestive organs"	"Nonrheumatic mitral valve disorders"	1	70	389	459
"G97"	"G91"	"Intraop and postproc comp and disorders of nervous sys, NEC"	"Hydrocephalus"	1	46	149	195
"M70"	"J34"	"Soft tissue disorders related to use, overuse and pressure"	"Other and unspecified disorders of nose and nasal sinuses"	1	255	488	743
"L08"	"Q87"	"Other local infections of skin and subcutaneous tissue"	"Oth congenital malform syndromes affecting multiple systems"	1	9	62	71
"J96"	"G37"	"Respiratory failure, not elsewhere classified"	"Other demyelinating diseases of central nervous system"	1	55	129	184
"A41"	"D09"	"Other sepsis"	"Carcinoma in situ of other and unspecified sites"	1	288	438	726
"L89"	"E78"	"Pressure ulcer"	"Disorders of lipoprotein metabolism and other lipidemias"	1	310	1560	1870
"D53"	"F10"	"Other nutritional anemias"	"Alcohol related disorders"	1	150	317	467
"G82"	"O80"	"Paraplegia (paraparesis) and quadriplegia (quadriparesis)"	"Encounter for full-term uncomplicated delivery"	1	0	97	97
"L08"	"O48"	"Other local infections of skin and subcutaneous tissue"	"Late pregnancy"	1	16	147	163
"F02"	"G56"	"Dementia in other diseases classified elsewhere"	"Mononeuropathies of upper limb"	1	6	73	79
"L60"	"Q53"	"Nail disorders"	"Undescended and ectopic testicle"	1	0	82	82
"J18"	"H81"	"Pneumonia, unspecified organism"	"Disorders of vestibular function"	1	0	6441	6441
"N84"	"O75"	"Polyp of female genital tract"	"Oth complications of labor and delivery, NEC"	1	14	254	268
"G47"	"O08"	"Sleep disorders"	"Complications following ectopic and molar pregnancy"	1	4	88	92
"G81"	"E78"	"Hemiplegia and hemiparesis"	"Disorders of lipoprotein metabolism and other lipidemias"	1	206	395	601
"L97"	"D24"	"Non-pressure chronic ulcer of lower limb, NEC"	"Benign neoplasm of breast"	1	0	113	113
"H36"	"N76"	"Retinal disorders in diseases classified elsewhere"	"Other inflammation of vagina and vulva"	1	40	141	181
"I33"	"H83"	"Acute and subacute endocarditis"	"Other diseases of inner ear"	1	0	93	93
"H36"	"K35"	"Retinal disorders in diseases classified elsewhere"	"Acute appendicitis"	1	59	257	316
"D12"	"K29"	"Benign neoplasm of colon, rectum, anus and anal canal"	"Gastritis and duodenitis"	1	2205	3858	6063
"E78"	"M02"	"Disorders of lipoprotein metabolism and other lipidemias"	"Postinfective and reactive arthropathies"	1	126	512	638
"D25"	"O23"	"Leiomyoma of uterus"	"Infections of genitourinary tract in pregnancy"	1	8	229	237
"I10"	"D30"	"Essential (primary) hypertension"	"Benign neoplasm of urinary organs"	1	1842	2650	4492
"N92"	"O80"	"Excessive, frequent and irregular menstruation"	"Encounter for full-term uncomplicated delivery"	1	0	13244	13244
"E41"	"I83"	"Nutritional marasmus"	"Varicose veins of lower extremities"	1	0	108	108
"N87"	"O03"	"Dysplasia of cervix uteri"	"Spontaneous abortion"	1	705	1219	1924
"C80"	"H26"	"Malignant neoplasm without specification of site"	"Other cataract"	1	19	184	203
"M25"	"O02"	"Other joint disorder, not elsewhere classified"	"Other abnormal products of conception"	1	86	746	832
"M16"	"H00"	"Osteoarthritis of hip"	"Hordeolum and chalazion"	1	35	111	146
"M10"	"I42"	"Gout"	"Cardiomyopathy"	1	382	777	1159
"K22"	"L05"	"Other diseases of esophagus"	"Pilonidal cyst and sinus"	1	13	58	71
"C15"	"K58"	"Malignant neoplasm of esophagus"	"Irritable bowel syndrome"	1	1	54	55
"M85"	"N91"	"Other disorders of bone density and structure"	"Absent, scanty and rare menstruation"	1	17	100	117
"N18"	"C20"	"Chronic kidney disease (CKD)"	"Malignant neoplasm of rectum"	1	125	601	726
"I38"	"I70"	"Endocarditis, valve unspecified"	"Atherosclerosis"	1	85	167	252
"M81"	"G82"	"Osteoporosis without current pathological fracture"	"Paraplegia (paraparesis) and quadriplegia (quadriparesis)"	1	117	267	384
"D09"	"I48"	"Carcinoma in situ of other and unspecified sites"	"Atrial fibrillation and flutter"	1	168	465	633
"I48"	"M18"	"Atrial fibrillation and flutter"	"Osteoarthritis of first carpometacarpal joint"	1	333	715	1048
"C20"	"O80"	"Malignant neoplasm of rectum"	"Encounter for full-term uncomplicated delivery"	1	0	42	42
"A41"	"J31"	"Other sepsis"	"Chronic rhinitis, nasopharyngitis and pharyngitis"	1	24	126	150
"K44"	"N80"	"Diaphragmatic hernia"	"Endometriosis"	1	63	219	282
"L82"	"C43"	"Seborrheic keratosis"	"Malignant melanoma of skin"	1	164	1256	1420
"H25"	"K43"	"Age-related cataract"	"Ventral hernia"	1	1197	2385	3582
"I15"	"H36"	"Secondary hypertension"	"Retinal disorders in diseases classified elsewhere"	1	259	557	816
"K66"	"O26"	"Other disorders of peritoneum"	"Maternal care for oth conditions predom related to pregnancy"	1	26	81	107
"K57"	"M17"	"Diverticular disease of intestine"	"Osteoarthritis of knee"	1	0	9014	9014
"I83"	"H66"	"Varicose veins of lower extremities"	"Suppurative and unspecified otitis media"	1	66	212	278
"N76"	"O20"	"Other inflammation of vagina and vulva"	"Hemorrhage in early pregnancy"	1	277	536	813
"G45"	"M16"	"Transient cerebral ischemic attacks and related syndromes"	"Osteoarthritis of hip"	1	1457	2234	3691
"O99"	"L01"	"Oth maternal diseases classd elsw but compl preg/chldbrth"	"Impetigo"	1	24	105	129
"K58"	"D25"	"Irritable bowel syndrome"	"Leiomyoma of uterus"	1	418	722	1140
"E87"	"K57"	"Other disorders of fluid, electrolyte and acid-base balance"	"Diverticular disease of intestine"	1	1246	3885	5131
"G45"	"J45"	"Transient cerebral ischemic attacks and related syndromes"	"Asthma"	1	777	1346	2123
"K91"	"O48"	"Intraop and postproc comp and disorders of dgstv sys, NEC"	"Late pregnancy"	1	0	28	28
"O34"	"O61"	"Maternal care for abnormality of pelvic organs"	"Failed induction of labor"	1	333	524	857
"K52"	"K61"	"Other and unsp noninfective gastroenteritis and colitis"	"Abscess of anal and rectal regions"	1	223	408	631
"E86"	"O00"	"Volume depletion"	"Ectopic pregnancy"	1	0	39	39
"D32"	"N92"	"Benign neoplasm of meninges"	"Excessive, frequent and irregular menstruation"	1	0	199	199
"C61"	"H65"	"Malignant neoplasm of prostate"	"Nonsuppurative otitis media"	1	24	176	200
"N30"	"H72"	"Cystitis"	"Perforation of tympanic membrane"	1	152	407	559
"E11"	"K42"	"Type 2 diabetes mellitus"	"Umbilical hernia"	1	1144	1719	2863
"L89"	"K59"	"Pressure ulcer"	"Other functional intestinal disorders"	1	1072	1738	2810
"D05"	"N87"	"Carcinoma in situ of breast"	"Dysplasia of cervix uteri"	1	0	47	47
"M02"	"O04"	"Postinfective and reactive arthropathies"	"Complications following (induced) termination of pregnancy"	1	101	274	375
"M77"	"O46"	"Other enthesopathies"	"Antepartum hemorrhage, not elsewhere classified"	1	2	108	110
"N62"	"Q17"	"Hypertrophy of breast"	"Other congenital malformations of ear"	1	0	84	84
"F44"	"M62"	"Dissociative and conversion disorders"	"Other disorders of muscle"	1	74	225	299
"G62"	"O23"	"Other and unspecified polyneuropathies"	"Infections of genitourinary tract in pregnancy"	1	0	25	25
"E73"	"O48"	"Lactose intolerance"	"Late pregnancy"	1	0	30	30
"M48"	"N87"	"Other spondylopathies"	"Dysplasia of cervix uteri"	1	0	212	212
"E78"	"O32"	"Disorders of lipoprotein metabolism and other lipidemias"	"Maternal care for malpresentation of fetus"	1	0	72	72
"G93"	"O64"	"Other disorders of brain"	"Obstructed labor due to malposition and malpresent of fetus"	1	0	30	30
"M75"	"O22"	"Shoulder lesions"	"Venous complications and hemorrhoids in pregnancy"	1	0	35	35
"N39"	"L30"	"Other disorders of urinary system"	"Other and unspecified dermatitis"	1	831	1174	2005
"C26"	"M75"	"Malignant neoplasm of other and ill-defined digestive organs"	"Shoulder lesions"	1	0	28	28
"I49"	"N81"	"Other cardiac arrhythmias"	"Female genital prolapse"	1	350	920	1270
"M80"	"I10"	"Osteoporosis with current pathological fracture"	"Essential (primary) hypertension"	1	0	17700	17700
"I24"	"I25"	"Other acute ischemic heart diseases"	"Chronic ischemic heart disease"	1	2843	3346	6189
"K62"	"J34"	"Other diseases of anus and rectum"	"Other and unspecified disorders of nose and nasal sinuses"	1	179	525	704
"O47"	"Q66"	"False labor"	"Congenital deformities of feet"	1	15	57	72
"I35"	"J42"	"Nonrheumatic aortic valve disorders"	"Unspecified chronic bronchitis"	1	648	898	1546
"D04"	"K40"	"Carcinoma in situ of skin"	"Inguinal hernia"	1	21	121	142
"E86"	"G80"	"Volume depletion"	"Cerebral palsy"	1	234	393	627
"N94"	"O04"	"Pain and oth cond assoc w fem gntl org and menstrual cycle"	"Complications following (induced) termination of pregnancy"	1	0	3295	3295
"I48"	"G52"	"Atrial fibrillation and flutter"	"Disorders of other cranial nerves"	1	16	60	76
"K85"	"O02"	"Acute pancreatitis"	"Other abnormal products of conception"	1	30	173	203
"L50"	"O48"	"Urticaria"	"Late pregnancy"	1	48	215	263
"K72"	"O62"	"Hepatic failure, not elsewhere classified"	"Abnormalities of forces of labor"	1	0	34	34
"D30"	"Q85"	"Benign neoplasm of urinary organs"	"Phakomatoses, not elsewhere classified"	1	4	33	37
"K59"	"H93"	"Other functional intestinal disorders"	"Other disorders of ear, not elsewhere classified"	1	0	3189	3189
"G45"	"C50"	"Transient cerebral ischemic attacks and related syndromes"	"Malignant neoplasm of breast"	1	509	776	1285
"E89"	"F10"	"Postproc endocrine and metabolic comp and disorders, NEC"	"Alcohol related disorders"	1	49	164	213
"O35"	"G40"	"Maternal care for known or suspected fetal abnlt and damage"	"Epilepsy and recurrent seizures"	1	2	51	53
"E86"	"I42"	"Volume depletion"	"Cardiomyopathy"	1	603	1628	2231
"M80"	"I63"	"Osteoporosis with current pathological fracture"	"Cerebral infarction"	1	1506	1804	3310
"N19"	"K44"	"Unspecified kidney failure"	"Diaphragmatic hernia"	1	229	720	949
"K64"	"M16"	"Hemorrhoids and perianal venous thrombosis"	"Osteoarthritis of hip"	1	68	1167	1235
"O44"	"O03"	"Placenta previa"	"Spontaneous abortion"	1	203	786	989
"D72"	"O80"	"Other disorders of white blood cells"	"Encounter for full-term uncomplicated delivery"	1	0	103	103
"H50"	"Q89"	"Other strabismus"	"Other congenital malformations, not elsewhere classified"	1	22	83	105
"M84"	"M51"	"Disorder of continuity of bone"	"Thoracic, thoracolum, and lumbosacral intvrt disc disorders"	1	137	264	401
"K52"	"E11"	"Other and unsp noninfective gastroenteritis and colitis"	"Type 2 diabetes mellitus"	1	1764	3505	5269
"G35"	"F10"	"Multiple sclerosis"	"Alcohol related disorders"	1	73	151	224
"K56"	"H66"	"Paralytic ileus and intestinal obstruction without hernia"	"Suppurative and unspecified otitis media"	1	68	187	255
"K59"	"I70"	"Other functional intestinal disorders"	"Atherosclerosis"	1	2171	4444	6615
"I25"	"J05"	"Chronic ischemic heart disease"	"Acute obstructive laryngitis [croup] and epiglottitis"	1	18	65	83
"K43"	"J34"	"Ventral hernia"	"Other and unspecified disorders of nose and nasal sinuses"	1	60	241	301
"A04"	"M23"	"Other bacterial intestinal infections"	"Internal derangement of knee"	1	147	492	639
"K52"	"M32"	"Other and unsp noninfective gastroenteritis and colitis"	"Systemic lupus erythematosus (SLE)"	1	19	79	98
"J93"	"M79"	"Pneumothorax and air leak"	"Oth and unsp soft tissue disorders, not elsewhere classified"	1	330	484	814
"C16"	"C61"	"Malignant neoplasm of stomach"	"Malignant neoplasm of prostate"	1	103	327	430
"I48"	"G50"	"Atrial fibrillation and flutter"	"Disorders of trigeminal nerve"	1	178	356	534
"G25"	"J44"	"Other extrapyramidal and movement disorders"	"Other chronic obstructive pulmonary disease"	1	397	586	983
"I83"	"K01"	"Varicose veins of lower extremities"	"Embedded and impacted teeth"	1	43	112	155
"M19"	"M71"	"Other and unspecified osteoarthritis"	"Other bursopathies"	1	370	840	1210
"C18"	"O68"	"Malignant neoplasm of colon"	"Labor and delivery comp by abnlt of fetal acid-base balance"	1	0	42	42
"M16"	"L20"	"Osteoarthritis of hip"	"Atopic dermatitis"	1	20	67	87
"I50"	"N85"	"Heart failure"	"Other noninflammatory disorders of uterus, except cervix"	1	24	131	155
"C15"	"I69"	"Malignant neoplasm of esophagus"	"Sequelae of cerebrovascular disease"	1	138	341	479
"O72"	"M22"	"Postpartum hemorrhage"	"Disorder of patella"	1	0	3039	3039
"G35"	"O04"	"Multiple sclerosis"	"Complications following (induced) termination of pregnancy"	1	0	373	373
"K74"	"O99"	"Fibrosis and cirrhosis of liver"	"Oth maternal diseases classd elsw but compl preg/chldbrth"	1	5	50	55
"M18"	"O99"	"Osteoarthritis of first carpometacarpal joint"	"Oth maternal diseases classd elsw but compl preg/chldbrth"	1	0	82	82
"F41"	"B27"	"Other anxiety disorders"	"Infectious mononucleosis"	1	0	63	63
"E03"	"E05"	"Other hypothyroidism"	"Thyrotoxicosis [hyperthyroidism]"	1	0	6509	6509
"C77"	"E78"	"Secondary and unspecified malignant neoplasm of lymph nodes"	"Disorders of lipoprotein metabolism and other lipidemias"	1	451	1276	1727
"J22"	"G62"	"Unspecified acute lower respiratory infection"	"Other and unspecified polyneuropathies"	1	89	234	323
"G44"	"N60"	"Other headache syndromes"	"Benign mammary dysplasia"	1	157	314	471
"E10"	"H83"	"Type 1 diabetes mellitus"	"Other diseases of inner ear"	1	213	861	1074
"A04"	"N39"	"Other bacterial intestinal infections"	"Other disorders of urinary system"	1	1951	2463	4414
"H18"	"O04"	"Other disorders of cornea"	"Complications following (induced) termination of pregnancy"	1	0	116	116
"I61"	"D12"	"Nontraumatic intracerebral hemorrhage"	"Benign neoplasm of colon, rectum, anus and anal canal"	1	302	726	1028
"C34"	"H60"	"Malignant neoplasm of bronchus and lung"	"Otitis externa"	1	11	187	198
"M79"	"I47"	"Oth and unsp soft tissue disorders, not elsewhere classified"	"Paroxysmal tachycardia"	1	1430	1836	3266
"B44"	"M05"	"Aspergillosis"	"Rheumatoid arthritis with rheumatoid factor"	1	0	28	28
"J18"	"M25"	"Pneumonia, unspecified organism"	"Other joint disorder, not elsewhere classified"	1	1723	2454	4177
"N18"	"N04"	"Chronic kidney disease (CKD)"	"Nephrotic syndrome"	1	521	1058	1579
"C80"	"N20"	"Malignant neoplasm without specification of site"	"Calculus of kidney and ureter"	1	5	130	135
"E78"	"N92"	"Disorders of lipoprotein metabolism and other lipidemias"	"Excessive, frequent and irregular menstruation"	1	0	3003	3003
"N92"	"Q78"	"Excessive, frequent and irregular menstruation"	"Other osteochondrodysplasias"	1	5	49	54
"K70"	"H11"	"Alcoholic liver disease"	"Other disorders of conjunctiva"	1	30	90	120
"A40"	"E78"	"Streptococcal sepsis"	"Disorders of lipoprotein metabolism and other lipidemias"	1	177	457	634
"K59"	"H04"	"Other functional intestinal disorders"	"Disorders of lacrimal system"	1	167	453	620
"K92"	"I73"	"Other diseases of digestive system"	"Other peripheral vascular diseases"	1	831	1592	2423
"N19"	"K29"	"Unspecified kidney failure"	"Gastritis and duodenitis"	1	719	1502	2221
"H25"	"K50"	"Age-related cataract"	"Crohn's disease [regional enteritis]"	1	266	489	755
"D64"	"O71"	"Other anemias"	"Other obstetric trauma"	1	0	179	179
"C88"	"C85"	"Malig immunoproliferative dis and certain oth B-cell lymph"	"Oth and unspecified types of non-Hodgkin lymphoma"	1	187	406	593
"A41"	"G44"	"Other sepsis"	"Other headache syndromes"	1	94	544	638
"I44"	"E10"	"Atrioventricular and left bundle-branch block"	"Type 1 diabetes mellitus"	1	650	1336	1986
"H80"	"O80"	"Otosclerosis"	"Encounter for full-term uncomplicated delivery"	1	58	527	585
"K74"	"O80"	"Fibrosis and cirrhosis of liver"	"Encounter for full-term uncomplicated delivery"	1	0	47	47
"G47"	"M31"	"Sleep disorders"	"Other necrotizing vasculopathies"	1	89	177	266
"N30"	"N40"	"Cystitis"	"Benign prostatic hyperplasia"	1	0	22006	22006
"G30"	"N84"	"Alzheimer's disease"	"Polyp of female genital tract"	1	0	74	74
"M75"	"H93"	"Shoulder lesions"	"Other disorders of ear, not elsewhere classified"	1	1660	2086	3746
"E56"	"M62"	"Other vitamin deficiencies"	"Other disorders of muscle"	1	10	111	121
"M17"	"O75"	"Osteoarthritis of knee"	"Oth complications of labor and delivery, NEC"	1	0	126	126
"M79"	"Q21"	"Oth and unsp soft tissue disorders, not elsewhere classified"	"Congenital malformations of cardiac septa"	1	46	341	387
"K52"	"M71"	"Other and unsp noninfective gastroenteritis and colitis"	"Other bursopathies"	1	96	227	323
"G95"	"D14"	"Other and unspecified diseases of spinal cord"	"Benign neoplasm of middle ear and respiratory system"	1	9	62	71
"I65"	"H80"	"Occls and stenosis of precerb art, not rslt in cereb infrc"	"Otosclerosis"	1	4	40	44
"M18"	"M79"	"Osteoarthritis of first carpometacarpal joint"	"Oth and unsp soft tissue disorders, not elsewhere classified"	1	807	1174	1981
"K21"	"N75"	"Gastro-esophageal reflux disease"	"Diseases of Bartholin's gland"	1	35	133	168
"K46"	"N92"	"Unspecified abdominal hernia"	"Excessive, frequent and irregular menstruation"	1	23	126	149
"O70"	"O21"	"Perineal laceration during delivery"	"Excessive vomiting in pregnancy"	1	3843	6412	10255
"D35"	"H83"	"Benign neoplasm of other and unspecified endocrine glands"	"Other diseases of inner ear"	1	14	89	103
"C78"	"A15"	"Secondary malignant neoplasm of resp and digestive organs"	"Respiratory tuberculosis"	1	2	69	71
"O92"	"K00"	"Oth disord of brst/lactatn assoc w pregnancy and the puerp"	"Disorders of tooth development and eruption"	1	0	40	40
"D63"	"K04"	"Anemia in chronic diseases classified elsewhere"	"Diseases of pulp and periapical tissues"	1	104	367	471
"K91"	"O26"	"Intraop and postproc comp and disorders of dgstv sys, NEC"	"Maternal care for oth conditions predom related to pregnancy"	1	8	95	103
"I26"	"C34"	"Pulmonary embolism"	"Malignant neoplasm of bronchus and lung"	1	1424	1779	3203
"I67"	"H25"	"Other cerebrovascular diseases"	"Age-related cataract"	1	738	996	1734
"N18"	"M83"	"Chronic kidney disease (CKD)"	"Adult osteomalacia"	1	48	133	181
"G98"	"N84"	"Other disorders of nervous system not elsewhere classified"	"Polyp of female genital tract"	1	27	113	140
"E21"	"O99"	"Hyperparathyroidism and other disorders of parathyroid gland"	"Oth maternal diseases classd elsw but compl preg/chldbrth"	1	16	162	178
"E27"	"J35"	"Other disorders of adrenal gland"	"Chronic diseases of tonsils and adenoids"	1	18	111	129
"J44"	"K80"	"Other chronic obstructive pulmonary disease"	"Cholelithiasis"	1	3128	5071	8199
"C23"	"M75"	"Malignant neoplasm of gallbladder"	"Shoulder lesions"	1	0	26	26
"J22"	"N97"	"Unspecified acute lower respiratory infection"	"Female infertility"	1	0	35	35
"M72"	"N63"	"Fibroblastic disorders"	"Unspecified lump in breast"	1	73	214	287
"N84"	"O30"	"Polyp of female genital tract"	"Multiple gestation"	1	42	162	204
"N19"	"I50"	"Unspecified kidney failure"	"Heart failure"	1	4376	7380	11756
"I42"	"C50"	"Cardiomyopathy"	"Malignant neoplasm of breast"	1	76	461	537
"K59"	"K85"	"Other functional intestinal disorders"	"Acute pancreatitis"	1	1006	1588	2594
"J15"	"H36"	"Bacterial pneumonia, not elsewhere classified"	"Retinal disorders in diseases classified elsewhere"	1	196	1116	1312
"N30"	"O03"	"Cystitis"	"Spontaneous abortion"	1	919	1684	2603
"E64"	"K26"	"Sequelae of malnutrition and other nutritional deficiencies"	"Duodenal ulcer"	1	114	391	505
"D63"	"F10"	"Anemia in chronic diseases classified elsewhere"	"Alcohol related disorders"	1	94	1002	1096
"N28"	"O04"	"Oth disorders of kidney and ureter, not elsewhere classified"	"Complications following (induced) termination of pregnancy"	1	12	79	91
"C90"	"M51"	"Multiple myeloma and malignant plasma cell neoplasms"	"Thoracic, thoracolum, and lumbosacral intvrt disc disorders"	1	47	262	309
"K00"	"N47"	"Disorders of tooth development and eruption"	"Disorders of prepuce"	1	32	132	164
"L97"	"E05"	"Non-pressure chronic ulcer of lower limb, NEC"	"Thyrotoxicosis [hyperthyroidism]"	1	133	529	662
"E87"	"O86"	"Other disorders of fluid, electrolyte and acid-base balance"	"Other puerperal infections"	1	0	35	35
"N64"	"K00"	"Other disorders of breast"	"Disorders of tooth development and eruption"	1	23	84	107
"K60"	"O62"	"Fissure and fistula of anal and rectal regions"	"Abnormalities of forces of labor"	1	208	1455	1663
"C79"	"L72"	"Secondary malignant neoplasm of other and unspecified sites"	"Follicular cysts of skin and subcutaneous tissue"	1	9	166	175
"M79"	"N87"	"Oth and unsp soft tissue disorders, not elsewhere classified"	"Dysplasia of cervix uteri"	1	564	1219	1783
"M54"	"O60"	"Dorsalgia"	"Preterm labor"	1	51	314	365
"N28"	"H83"	"Oth disorders of kidney and ureter, not elsewhere classified"	"Other diseases of inner ear"	1	0	158	158
"M48"	"C54"	"Other spondylopathies"	"Malignant neoplasm of corpus uteri"	1	56	172	228
"K56"	"K26"	"Paralytic ileus and intestinal obstruction without hernia"	"Duodenal ulcer"	1	624	1185	1809
"K72"	"M02"	"Hepatic failure, not elsewhere classified"	"Postinfective and reactive arthropathies"	1	1	32	33
"F17"	"M43"	"Nicotine dependence"	"Other deforming dorsopathies"	1	59	237	296
"G54"	"O04"	"Nerve root and plexus disorders"	"Complications following (induced) termination of pregnancy"	1	0	126	126
"M81"	"O23"	"Osteoporosis without current pathological fracture"	"Infections of genitourinary tract in pregnancy"	1	0	52	52
"G43"	"O46"	"Migraine"	"Antepartum hemorrhage, not elsewhere classified"	1	75	195	270
"E88"	"O62"	"Other and unspecified metabolic disorders"	"Abnormalities of forces of labor"	1	7	156	163
"L97"	"O99"	"Non-pressure chronic ulcer of lower limb, NEC"	"Oth maternal diseases classd elsw but compl preg/chldbrth"	1	4	51	55
"J81"	"I83"	"Pulmonary edema"	"Varicose veins of lower extremities"	1	81	505	586
"M85"	"J45"	"Other disorders of bone density and structure"	"Asthma"	1	0	2055	2055
"K76"	"O02"	"Other diseases of liver"	"Other abnormal products of conception"	1	2	132	134
"O91"	"A63"	"Infect of breast assoc w pregnancy, the puerp and lactation"	"Oth predominantly sexually transmitted diseases, NEC"	1	0	175	175
"E11"	"H91"	"Type 2 diabetes mellitus"	"Other and unspecified hearing loss"	1	6062	9413	15475
"I62"	"M16"	"Other and unspecified nontraumatic intracranial hemorrhage"	"Osteoarthritis of hip"	1	8	103	111
"J96"	"N93"	"Respiratory failure, not elsewhere classified"	"Other abnormal uterine and vaginal bleeding"	1	31	167	198
"N28"	"H43"	"Oth disorders of kidney and ureter, not elsewhere classified"	"Disorders of vitreous body"	1	33	171	204
"M10"	"M95"	"Gout"	"Oth acquired deformities of ms sys and connective tissue"	1	11	49	60
"H53"	"K80"	"Visual disturbances"	"Cholelithiasis"	1	332	721	1053
"L40"	"O99"	"Psoriasis"	"Oth maternal diseases classd elsw but compl preg/chldbrth"	1	230	357	587
"O72"	"H65"	"Postpartum hemorrhage"	"Nonsuppurative otitis media"	1	0	486	486
"D64"	"F13"	"Other anemias"	"Sedative, hypnotic, or anxiolytic related disorders"	1	129	231	360
"M65"	"O70"	"Synovitis and tenosynovitis"	"Perineal laceration during delivery"	1	1179	1541	2720
"I49"	"O66"	"Other cardiac arrhythmias"	"Other obstructed labor"	1	3	63	66
"E11"	"O02"	"Type 2 diabetes mellitus"	"Other abnormal products of conception"	1	0	425	425
"E86"	"K05"	"Volume depletion"	"Gingivitis and periodontal diseases"	1	418	1559	1977
"C25"	"K86"	"Malignant neoplasm of pancreas"	"Other diseases of pancreas"	1	588	990	1578
"L57"	"N95"	"Skin changes due to chronic expsr to nonionizing radiation"	"Menopausal and other perimenopausal disorders"	1	61	204	265
"D43"	"O80"	"Neoplasm of uncertain behavior of brain and cnsl"	"Encounter for full-term uncomplicated delivery"	1	0	87	87
"I44"	"H83"	"Atrioventricular and left bundle-branch block"	"Other diseases of inner ear"	1	0	611	611
"C44"	"M62"	"Other and unspecified malignant neoplasm of skin"	"Other disorders of muscle"	1	65	1058	1123
"A49"	"N30"	"Bacterial infection of unspecified site"	"Cystitis"	1	3250	5620	8870
"C61"	"M18"	"Malignant neoplasm of prostate"	"Osteoarthritis of first carpometacarpal joint"	1	39	131	170
"I63"	"O68"	"Cerebral infarction"	"Labor and delivery comp by abnlt of fetal acid-base balance"	1	0	129	129
"L28"	"I20"	"Lichen simplex chronicus and prurigo"	"Angina pectoris"	1	128	246	374
"D63"	"L05"	"Anemia in chronic diseases classified elsewhere"	"Pilonidal cyst and sinus"	1	0	29	29
"D50"	"O99"	"Iron deficiency anemia"	"Oth maternal diseases classd elsw but compl preg/chldbrth"	1	203	1283	1486
"N18"	"C82"	"Chronic kidney disease (CKD)"	"Follicular lymphoma"	1	13	90	103
"K64"	"G51"	"Hemorrhoids and perianal venous thrombosis"	"Facial nerve disorders"	1	0	166	166
"I28"	"I25"	"Other diseases of pulmonary vessels"	"Chronic ischemic heart disease"	1	63	142	205
"D12"	"H50"	"Benign neoplasm of colon, rectum, anus and anal canal"	"Other strabismus"	1	90	270	360
"I52"	"E78"	"Other heart disorders in diseases classified elsewhere"	"Disorders of lipoprotein metabolism and other lipidemias"	1	16	66	82
"K55"	"H83"	"Vascular disorders of intestine"	"Other diseases of inner ear"	1	0	123	123
"A49"	"M67"	"Bacterial infection of unspecified site"	"Other disorders of synovium and tendon"	1	131	523	654
"G83"	"O62"	"Other paralytic syndromes"	"Abnormalities of forces of labor"	1	3	69	72
"F33"	"H81"	"Major depressive disorder, recurrent"	"Disorders of vestibular function"	1	237	752	989
"J18"	"I47"	"Pneumonia, unspecified organism"	"Paroxysmal tachycardia"	1	4291	7426	11717
"D05"	"M51"	"Carcinoma in situ of breast"	"Thoracic, thoracolum, and lumbosacral intvrt disc disorders"	1	58	154	212
"A41"	"D68"	"Other sepsis"	"Other coagulation defects"	1	428	678	1106
"E83"	"D17"	"Disorders of mineral metabolism"	"Benign lipomatous neoplasm"	1	15	180	195
"E78"	"K40"	"Disorders of lipoprotein metabolism and other lipidemias"	"Inguinal hernia"	1	0	7331	7331
"J15"	"C10"	"Bacterial pneumonia, not elsewhere classified"	"Malignant neoplasm of oropharynx"	1	95	204	299
"H25"	"O99"	"Age-related cataract"	"Oth maternal diseases classd elsw but compl preg/chldbrth"	1	0	134	134
"K12"	"C11"	"Stomatitis and related lesions"	"Malignant neoplasm of nasopharynx"	1	14	65	79
"J22"	"M81"	"Unspecified acute lower respiratory infection"	"Osteoporosis without current pathological fracture"	1	658	1003	1661
"C34"	"L82"	"Malignant neoplasm of bronchus and lung"	"Seborrheic keratosis"	1	46	154	200
"L97"	"J33"	"Non-pressure chronic ulcer of lower limb, NEC"	"Nasal polyp"	1	2	45	47
"F06"	"M31"	"Other mental disorders due to known physiological condition"	"Other necrotizing vasculopathies"	1	7	81	88
"C50"	"O80"	"Malignant neoplasm of breast"	"Encounter for full-term uncomplicated delivery"	1	0	1154	1154
"H91"	"M23"	"Other and unspecified hearing loss"	"Internal derangement of knee"	1	2195	4661	6856
"J18"	"M72"	"Pneumonia, unspecified organism"	"Fibroblastic disorders"	1	0	3318	3318
"N18"	"O12"	"Chronic kidney disease (CKD)"	"Gestational edema and proteinuria without hypertension"	1	4	69	73
"J91"	"I63"	"Pleural effusion in conditions classified elsewhere"	"Cerebral infarction"	1	187	357	544
"N47"	"L20"	"Disorders of prepuce"	"Atopic dermatitis"	1	102	384	486
"I35"	"A63"	"Nonrheumatic aortic valve disorders"	"Oth predominantly sexually transmitted diseases, NEC"	1	2	89	91
"N17"	"E66"	"Acute kidney failure"	"Overweight and obesity"	1	508	2040	2548
"L30"	"L03"	"Other and unspecified dermatitis"	"Cellulitis and acute lymphangitis"	1	195	513	708
"F20"	"O80"	"Schizophrenia"	"Encounter for full-term uncomplicated delivery"	1	31	147	178
"F20"	"F99"	"Schizophrenia"	"Mental disorder, not otherwise specified"	1	178	351	529
"J15"	"J32"	"Bacterial pneumonia, not elsewhere classified"	"Chronic sinusitis"	1	141	420	561
"D09"	"M21"	"Carcinoma in situ of other and unspecified sites"	"Other acquired deformities of limbs"	1	0	25	25
"I73"	"M16"	"Other peripheral vascular diseases"	"Osteoarthritis of hip"	1	894	2464	3358
"J15"	"C32"	"Bacterial pneumonia, not elsewhere classified"	"Malignant neoplasm of larynx"	1	60	424	484
"N17"	"C91"	"Acute kidney failure"	"Lymphoid leukemia"	1	74	208	282
"O12"	"F10"	"Gestational edema and proteinuria without hypertension"	"Alcohol related disorders"	1	8	83	91
"C34"	"H61"	"Malignant neoplasm of bronchus and lung"	"Other disorders of external ear"	1	22	193	215
"C15"	"I42"	"Malignant neoplasm of esophagus"	"Cardiomyopathy"	1	18	78	96
"N13"	"J36"	"Obstructive and reflux uropathy"	"Peritonsillar abscess"	1	9	45	54
"D61"	"M20"	"Oth aplastic anemias and other bone marrow failure syndromes"	"Acquired deformities of fingers and toes"	1	4	53	57
"K20"	"N97"	"Esophagitis"	"Female infertility"	1	14	86	100
"J94"	"E04"	"Other pleural conditions"	"Other nontoxic goiter"	1	27	83	110
"M25"	"O34"	"Other joint disorder, not elsewhere classified"	"Maternal care for abnormality of pelvic organs"	1	137	381	518
"C67"	"N81"	"Malignant neoplasm of bladder"	"Female genital prolapse"	1	34	152	186
"J93"	"E11"	"Pneumothorax and air leak"	"Type 2 diabetes mellitus"	1	395	605	1000
"C67"	"M79"	"Malignant neoplasm of bladder"	"Oth and unsp soft tissue disorders, not elsewhere classified"	1	185	310	495
"I69"	"K25"	"Sequelae of cerebrovascular disease"	"Gastric ulcer"	1	2331	2977	5308
"K44"	"O47"	"Diaphragmatic hernia"	"False labor"	1	30	221	251
"C10"	"M67"	"Malignant neoplasm of oropharynx"	"Other disorders of synovium and tendon"	1	2	42	44
"M54"	"O62"	"Dorsalgia"	"Abnormalities of forces of labor"	1	0	7317	7317
"D22"	"K00"	"Melanocytic nevi"	"Disorders of tooth development and eruption"	1	16	80	96
"N30"	"K13"	"Cystitis"	"Other diseases of lip and oral mucosa"	1	163	423	586
"F99"	"O04"	"Mental disorder, not otherwise specified"	"Complications following (induced) termination of pregnancy"	1	71	235	306
"K11"	"D25"	"Diseases of salivary glands"	"Leiomyoma of uterus"	1	46	152	198
"D64"	"K57"	"Other anemias"	"Diverticular disease of intestine"	1	4871	6288	11159
"A49"	"M51"	"Bacterial infection of unspecified site"	"Thoracic, thoracolum, and lumbosacral intvrt disc disorders"	1	0	1732	1732
"C76"	"E11"	"Malignant neoplasm of other and ill-defined sites"	"Type 2 diabetes mellitus"	1	173	284	457
"E86"	"E21"	"Volume depletion"	"Hyperparathyroidism and other disorders of parathyroid gland"	1	641	897	1538
"K08"	"C32"	"Other disorders of teeth and supporting structures"	"Malignant neoplasm of larynx"	1	272	509	781
"B37"	"M71"	"Candidiasis"	"Other bursopathies"	1	25	101	126
"L40"	"O65"	"Psoriasis"	"Obstructed labor due to maternal pelvic abnormality"	1	0	77	77
"I26"	"N48"	"Pulmonary embolism"	"Other disorders of penis"	1	65	162	227
"O72"	"K90"	"Postpartum hemorrhage"	"Intestinal malabsorption"	1	158	272	430
"C78"	"D35"	"Secondary malignant neoplasm of resp and digestive organs"	"Benign neoplasm of other and unspecified endocrine glands"	1	45	167	212
"H26"	"J30"	"Other cataract"	"Vasomotor and allergic rhinitis"	1	30	197	227
"D09"	"K57"	"Carcinoma in situ of other and unspecified sites"	"Diverticular disease of intestine"	1	85	272	357
"N95"	"O34"	"Menopausal and other perimenopausal disorders"	"Maternal care for abnormality of pelvic organs"	1	0	33	33
"K25"	"D24"	"Gastric ulcer"	"Benign neoplasm of breast"	1	71	284	355
"I26"	"J33"	"Pulmonary embolism"	"Nasal polyp"	1	21	91	112
"J90"	"M21"	"Pleural effusion, not elsewhere classified"	"Other acquired deformities of limbs"	1	18	118	136
"K85"	"O65"	"Acute pancreatitis"	"Obstructed labor due to maternal pelvic abnormality"	1	0	106	106
"K31"	"K40"	"Other diseases of stomach and duodenum"	"Inguinal hernia"	1	91	266	357
"C15"	"N47"	"Malignant neoplasm of esophagus"	"Disorders of prepuce"	1	13	58	71
"G45"	"O30"	"Transient cerebral ischemic attacks and related syndromes"	"Multiple gestation"	1	0	29	29
"J38"	"O62"	"Diseases of vocal cords and larynx, not elsewhere classified"	"Abnormalities of forces of labor"	1	79	254	333
"K21"	"C62"	"Gastro-esophageal reflux disease"	"Malignant neoplasm of testis"	1	14	64	78
"K56"	"A63"	"Paralytic ileus and intestinal obstruction without hernia"	"Oth predominantly sexually transmitted diseases, NEC"	1	17	122	139
"M20"	"J30"	"Acquired deformities of fingers and toes"	"Vasomotor and allergic rhinitis"	1	142	357	499
"N40"	"J36"	"Benign prostatic hyperplasia"	"Peritonsillar abscess"	1	31	108	139
"E66"	"N87"	"Overweight and obesity"	"Dysplasia of cervix uteri"	1	1374	2605	3979
"K56"	"C20"	"Paralytic ileus and intestinal obstruction without hernia"	"Malignant neoplasm of rectum"	1	0	4838	4838
"I35"	"D10"	"Nonrheumatic aortic valve disorders"	"Benign neoplasm of mouth and pharynx"	1	74	172	246
"K92"	"H11"	"Other diseases of digestive system"	"Other disorders of conjunctiva"	1	61	211	272
"J22"	"H93"	"Unspecified acute lower respiratory infection"	"Other disorders of ear, not elsewhere classified"	1	0	134	134
"J15"	"I25"	"Bacterial pneumonia, not elsewhere classified"	"Chronic ischemic heart disease"	1	0	15727	15727
"I69"	"K35"	"Sequelae of cerebrovascular disease"	"Acute appendicitis"	1	254	724	978
"C64"	"K80"	"Malignant neoplasm of kidney, except renal pelvis"	"Cholelithiasis"	1	171	373	544
"K62"	"N63"	"Other diseases of anus and rectum"	"Unspecified lump in breast"	1	210	613	823
"B02"	"O20"	"Zoster [herpes zoster]"	"Hemorrhage in early pregnancy"	1	2	47	49
